bill_id,roll_call_id,date,chamber,description,yea,nay,nv,absent,total
892443,631827,2017-04-24,Assembly,"Do pass as amended, and be re-referred to the Committee on [Appropriations] with recommendation: To Consent Calendar",7,3,0,0,10
892444,645200,2017-05-15,Assembly,"Do pass and be re-referred to the Committee on [Appropriations]",8,1,1,0,10
892445,634380,2017-04-26,Assembly,"Do pass and be re-referred to the Committee on [Appropriations]",10,2,1,0,13
892445,651696,2017-05-26,Assembly,"Do pass as amended",12,4,1,0,17
892445,655885,2017-05-31,Assembly,"AB 33 QUIRK Assembly Third Reading",58,17,5,0,80
892446,604222,2017-03-15,Senate,"Do pass as amended, but first amend, and re-refer to the Committee on [Human Services]",7,0,0,0,7
892446,631571,2017-04-25,Senate,"Do pass as amended, but first amend, and re-refer to the Committee on [Appropriations] with the recommendation: To Consent Calendar",5,0,0,0,5
892446,644259,2017-05-15,Senate,"Placed on suspense file",7,0,0,0,7
892446,650709,2017-05-25,Senate,"Do pass",7,0,0,0,7
892446,655754,2017-05-31,Senate,"Special Consent SB12 Beall",40,0,0,0,40
892446,669158,2017-06-27,Assembly,"Do pass as amended, and be re-referred to the Committee on [Higher Education] with recommendation: To Consent Calendar",7,0,0,0,7
892446,672087,2017-07-11,Assembly,"Do pass as amended and be re-referred to the Committee on [Appropriations]",13,0,0,0,13
892446,674571,2017-09-01,Assembly,"Do pass as amended",16,0,1,0,17
892446,675947,2017-09-13,Assembly,"SB 12 Beall Senate Third Reading By GIPSON",77,0,2,0,79
892446,676096,2017-09-14,Senate,"Unfinished Business SB12 Beall et al. Concurrence",40,0,0,0,40
892447,604249,2017-03-15,Senate,"Do pass, but first be re-referred to the Committee on [Appropriations]",7,0,0,0,7
892447,617397,2017-04-03,Senate,"Placed on suspense file",7,0,0,0,7
892448,603182,2017-03-14,Assembly,"Do pass and be re-referred to the Committee on [Appropriations]",2,4,1,0,7
892448,603183,2017-03-14,Assembly,Reconsideration,7,0,0,0,7
892449,580877,2017-02-09,Senate,"Do pass as amended, but first amend, and re-refer to the Committee on [Rules]",7,2,0,0,9
892449,618547,2017-04-04,Senate,"Do pass as amended, but first amend, and re-refer to the Committee on [Appropriations]",9,1,1,0,11
892449,647893,2017-05-22,Senate,"Placed on suspense file",7,0,0,0,7
892449,650614,2017-05-25,Senate,"Do pass as amended",5,2,0,0,7
892449,654445,2017-05-30,Senate,"Senate 3rd Reading SB57 Stern et al. Urgency Clause",24,9,7,0,40
892449,654446,2017-05-30,Senate,"Senate 3rd Reading SB57 Stern et al. Urgency Clause Reconsider",40,0,0,0,40
892450,605262,2017-03-15,Assembly,"Do pass and be re-referred to the Committee on [Housing and Community Development]",6,1,0,0,7
892450,620070,2017-04-05,Assembly,"Do pass as amended and be re-referred to the Committee on [Appropriations]",7,0,0,0,7
892450,651835,2017-05-26,Assembly,"Do pass as amended",13,4,0,0,17
892450,656075,2017-05-31,Assembly,"AB 10 GARCIA, C. Assembly Third Reading",68,6,6,0,80
892450,669561,2017-06-28,Senate,"Do pass, but first be re-referred to the Committee on [Appropriations]",7,0,0,0,7
892450,671830,2017-07-10,Senate,"Placed on suspense file",7,0,0,0,7
892450,674468,2017-09-01,Senate,"Do pass as amended",7,0,0,0,7
892450,675086,2017-09-06,Senate,"Assembly 3rd Reading AB10 Cristina Garcia By Mitchell",39,0,1,0,40
892450,675469,2017-09-11,Assembly,"AB 10 GARCIA, C. Concurrence in Senate Amendments",70,4,5,0,79
892451,630448,2017-04-24,Senate,"Do pass, but first be re-referred to the Committee on [Appropriations]",2,3,0,0,5
892451,630449,2017-04-24,Senate,"[First] hearing set for [04-24-2017]: Failed passage in Committee. Reconsideration granted",5,0,0,0,5
892453,631681,2017-04-24,Assembly,"Do pass and be re-referred to the Committee on [Appropriations]",7,4,3,0,14
892453,631682,2017-04-24,Assembly,Reconsideration,14,0,0,0,14
892453,684188,2018-01-08,Assembly,"Do pass and be re-referred to the Committee on [Appropriations]",5,5,4,0,14
892454,619866,2017-04-05,Assembly,"Do pass as amended and be re-referred to the Committee on [Education]",7,0,0,0,7
892454,628026,2017-04-19,Assembly,"Do pass and be re-referred to the Committee on [Appropriations]",5,2,0,0,7
892454,651594,2017-05-26,Assembly,"Do pass as amended",12,5,0,0,17
892454,656106,2017-05-31,Assembly,"AB 45 THURMOND Assembly Third Reading",53,19,8,0,80
892454,669107,2017-06-27,Senate,"Do pass as amended, but first amend, and re-refer to the Committee on [Education]",9,3,1,0,13
892454,672320,2017-07-12,Senate,"Do pass, but first be re-referred to the Committee on [Appropriations]",5,2,0,0,7
892454,673780,2017-08-21,Senate,"Placed on suspense file",7,0,0,0,7
892454,674653,2017-09-01,Senate,"Do pass as amended",5,2,0,0,7
892454,675911,2017-09-13,Senate,"Assembly 3rd Reading AB45 Thurmond By Lara",27,12,1,0,40
892454,676310,2017-09-14,Assembly,"AB 45 Thurmond Concurrence in Senate Amendments",56,23,0,0,79
892457,617676,2017-04-03,Senate,"Senate 3rd Reading SCR4 Nguyen",39,0,1,0,40
892457,625968,2017-04-17,Assembly,"Be adopted. To Consent Calendar",9,0,2,0,11
892457,629010,2017-04-20,Assembly,"SCR 4 Nguyen Consent Calendar Second Day Regular Session",74,0,6,0,80
892458,620021,2017-04-05,Assembly,"Do pass",7,0,0,0,7
892458,626014,2017-04-17,Assembly,"AB 4 WALDRON Assembly Third Reading",76,0,4,0,80
892458,658718,2017-06-06,Senate,"Do pass and be ordered to the Consent Calendar",4,0,1,0,5
892458,661579,2017-06-12,Senate,"Consent Calendar 2nd AB4 Waldron",38,0,2,0,40
892459,634653,2017-04-26,Senate,"Do pass as amended, but first amend, and re-refer to the Committee on [Appropriations]",7,0,0,0,7
892459,644681,2017-05-15,Senate,"Placed on suspense file",7,0,0,0,7
892460,626135,2017-04-17,Assembly,"Be re-referred to the Committees on [Natural Resources] and [Housing and Community Development]",9,0,2,0,11
892461,577876,2017-02-06,Senate,"Do pass, but first be re-referred to the Committee on [Budget and Fiscal Review ]",3,2,0,0,5
892461,580858,2017-02-09,Senate,"Do pass",11,4,2,0,17
892461,587494,2017-02-17,Senate,"Senate 3rd Reading SB28 Pan",26,7,7,0,40
892461,596637,2017-03-02,Assembly,"Do pass",22,5,2,0,29
892461,600779,2017-03-09,Assembly,"SB 28 Pan Senate Third Reading By TING",61,14,5,0,80
892462,629146,2017-04-19,Assembly,"Do pass and be re-referred to the Committee on [Appropriations]",6,1,0,0,7
892462,642474,2017-05-10,Assembly,"Do pass",15,0,2,0,17
892462,654090,2017-05-30,Assembly,"AB 46 COOPER Assembly Third Reading",71,2,7,0,80
892462,668538,2017-06-26,Senate,"Do pass, but first be re-referred to the Committee on [Judiciary]",5,0,0,0,5
892462,672360,2017-07-11,Senate,"Do pass, but first be re-referred to the Committee on [Appropriations]",7,0,0,0,7
892462,673769,2017-08-21,Senate,"Placed on suspense file",7,0,0,0,7
892462,674555,2017-09-01,Senate,"Do pass",7,0,0,0,7
892462,676149,2017-09-14,Senate,"Special Consent Calendar # AB46",40,0,0,0,40
892463,578986,2017-02-07,Assembly,"Do pass and be re-referred to the Committee on [Appropriations]",10,5,0,0,15
892463,590796,2017-02-22,Assembly,"Do pass as amended",12,5,0,0,17
892463,607056,2017-03-20,Assembly,"AB 18 GARCIA, E. Third Reading Urgency",54,19,7,0,80
892463,674307,2017-08-31,Senate,"Do pass, but first be re-referred to the Committee on [Governance and Finance]",6,2,1,0,9
892463,674308,2017-08-31,Senate,"Do pass, but first be re-referred to the Committee on [Appropriations]",4,1,2,0,7
892463,771366,2018-08-13,Senate,"Do pass, but first be re-referred to the Committee on [Appropriations]",5,0,4,0,9
892463,771722,2018-08-16,Senate,"Placed on suspense file",7,0,0,0,7
892464,608406,2017-03-21,Assembly,"Do pass as amended and be re-referred to the Committee on [Appropriations]",15,0,0,0,15
892465,613904,2017-03-28,Senate,"Do pass, but first be re-referred to the Committee on [Appropriations]",12,0,1,0,13
892465,626127,2017-04-17,Senate,"Do pass",7,0,0,0,7
892465,629096,2017-04-20,Senate,"Senate 3rd Reading SB20 Hill et al",40,0,0,0,40
892465,668669,2017-06-26,Assembly,"Do pass as amended and be re-referred to the Committee on [Appropriations]",14,0,0,0,14
892465,674250,2017-08-30,Assembly,"Do pass. To Consent Calendar",15,0,2,0,17
892465,675701,2017-09-12,Assembly,"SB 20 Hill Senate Third Reading By NAZARIAN",78,0,1,0,79
892465,675776,2017-09-13,Senate,"Unfinished Business SB20 Hill et al. Concurrence",39,0,1,0,40
892467,633658,2017-04-25,Assembly,"Do pass and be re-referred to the Committee on [Appropriations]",9,3,1,0,13
892468,599788,2017-03-07,Senate,"Do pass, but first be re-referred to the Committee on [Environmental Quality]",8,4,1,0,13
892468,614973,2017-03-29,Senate,"Do pass, but first be re-referred to the Committee on [Governance and Finance]",4,2,1,0,7
892468,628021,2017-04-19,Senate,"Do pass as amended, but first amend, and re-refer to the Committee on [Appropriations]",5,1,1,0,7
892468,644426,2017-05-15,Senate,"Placed on suspense file",7,0,0,0,7
892468,650408,2017-05-25,Senate,"Do pass as amended",5,2,0,0,7
892468,656578,2017-06-01,Senate,"Senate 3rd Reading SB4 Mendoza",27,13,0,0,40
892468,672031,2017-07-11,Assembly,"Do pass and be re-referred to the Committee on [Local Government]",15,0,0,0,15
892468,672560,2017-07-12,Assembly,"Do pass as amended",9,0,0,0,9
892468,675450,2017-09-11,Assembly,"SB 4 Mendoza Third Reading Urgency By QUIRK-SILVA",73,1,5,0,79
892468,675878,2017-09-13,Senate,"That the Assembly amendments be concurred in",9,0,0,0,9
892468,676109,2017-09-14,Senate,"Unfinished Business SB4 Mendoza Urgency Clause Concurrence",38,0,2,0,40
892469,609907,2017-03-22,Assembly,"Do pass and be re-referred to the Committee on [Appropriations]",6,0,1,0,7
892470,633538,2017-04-26,Assembly,"Amend, and re-refer to the Committee on [Elections and Redistricting]",5,0,2,0,7
892471,634654,2017-04-26,Senate,"Do pass as amended, but first amend, and re-refer to the Committee on [Public Safety]",8,0,1,0,9
892471,647969,2017-05-22,Senate,"Placed on suspense file",7,0,0,0,7
892472,628084,2017-04-19,Senate,"Do pass as amended, but first amend, and re-refer to the Committee on [Appropriations]",7,0,0,0,7
892472,648014,2017-05-22,Senate,"Senate 3rd Reading SB11 Gaines",37,0,3,0,40
892472,668978,2017-06-26,Assembly,"Do pass as amended and be re-referred to the Committee on [Appropriations]",9,0,1,0,10
892472,672933,2017-07-19,Assembly,"Do pass. To Consent Calendar",16,0,1,0,17
892472,674114,2017-08-24,Assembly,"SB 11 Gaines Consent Calendar Second Day Regular Session",76,0,3,0,79
892472,674394,2017-08-31,Senate,"Special Consent Calendar # SB11",37,0,3,0,40
892474,573000,2017-01-30,Assembly,"Do pass and be re-referred to the Committee on [Appropriations]",13,0,1,0,14
892474,580181,2017-02-08,Assembly,"Do pass",11,0,6,0,17
892474,582629,2017-02-13,Assembly,"AB 28 FRAZIER Third Reading Urgency",73,0,7,0,80
892474,594948,2017-02-28,Senate,"Do pass as amended, but first amend, and re-refer to the Committee on [Appropriations]",13,0,0,0,13
892474,602371,2017-03-13,Senate,"Do pass",7,0,0,0,7
892474,605299,2017-03-16,Senate,"Assembly 3rd Reading AB28 Frazier et al. By Beall Urgency Clause",39,0,1,0,40
892474,606939,2017-03-20,Assembly,"AB 28 FRAZIER Concurrence in Senate Amendments",77,0,3,0,80
892476,629046,2017-04-19,Assembly,"Do pass and be re-referred to the Committee on [Appropriations]",5,2,0,0,7
892477,626927,2017-04-18,Senate,"Do pass, but first be re-referred to the Committee on [Appropriations]",7,0,0,0,7
892477,635814,2017-05-01,Senate,"Placed on suspense file",7,0,0,0,7
892477,650589,2017-05-25,Senate,"Do pass",7,0,0,0,7
892477,655869,2017-05-31,Senate,"Special Consent Calendar # SB40",40,0,0,0,40
892477,669203,2017-06-27,Assembly,"Do pass as amended",6,0,1,0,7
892477,672905,2017-07-19,Assembly,"Do pass. To Consent Calendar",16,0,1,0,17
892477,674074,2017-08-24,Assembly,"SB 40 Roth Consent Calendar Second Day Regular Session",76,0,3,0,79
892477,674269,2017-08-31,Senate,"Special Consent Calendar # SB40",37,0,3,0,40
892478,618282,2017-04-04,Senate,"Do pass, but first be re-referred to the Committee on [Appropriations]",5,1,1,0,7
892478,644357,2017-05-15,Senate,"Placed on suspense file",7,0,0,0,7
892478,650447,2017-05-25,Senate,"Do pass",5,2,0,0,7
892478,655919,2017-05-31,Senate,"Senate 3rd Reading SB10 Hertzberg et al",26,11,3,0,40
892478,672111,2017-07-11,Assembly,"Do pass and be re-referred to the Committee on [Appropriations]",4,2,1,0,7
892478,771750,2018-08-16,Assembly,"Do pass as amended",11,1,5,0,17
892478,772195,2018-08-20,Assembly,"SB 10 Hertzberg Senate Third Reading By BONTA",42,31,7,0,80
892478,772384,2018-08-21,Senate,"Unfinished Business SB10 Hertzberg et al. Concurrence",26,12,2,0,40
892479,583682,2017-02-14,Senate,"Do pass, but first be re-referred to the Committee on [Environmental Quality]",8,3,2,0,13
892479,590605,2017-02-22,Senate,"Do pass, but first be re-referred to the Committee on [Governance and Finance]",4,2,1,0,7
892479,599885,2017-03-08,Senate,"Do pass, but first be re-referred to the Committee on [Appropriations]",5,1,1,0,7
892479,617594,2017-04-03,Senate,"Do pass as amended",5,2,0,0,7
892479,621052,2017-04-06,Senate,"Senate 3rd Reading SB1 Beall et al. Urgency Clause",27,11,2,0,40
892479,621190,2017-04-06,Assembly,"SB 1 Beall Third Reading Urgency By FRAZIER",54,26,0,0,80
892480,627746,2017-04-19,Assembly,"Do pass and be re-referred to the Committee on [Natural Resources]",14,0,1,0,15
892480,632143,2017-04-24,Assembly,"Do pass and be re-referred to the Committee on [Appropriations]",10,0,0,0,10
892480,637614,2017-05-03,Assembly,"Do pass. To Consent Calendar",16,0,1,0,17
892480,643675,2017-05-11,Assembly,"AB 36 NAZARIAN Consent Calendar Second Day Regular Session",77,0,3,0,80
892480,658824,2017-06-06,Senate,"Do pass, but first be re-referred to the Committee on [Appropriations]",10,0,1,0,11
892480,674186,2017-08-28,Senate,"Placed on suspense file",3,2,2,0,7
892480,676591,2017-09-15,Senate,"W/O REF. TO FILE AB36 Nazarian By Wiener",36,0,4,0,40
892481,598869,2017-03-07,Assembly,"Do pass and be re-referred to the Committee on [Appropriations]",7,0,0,0,7
892481,651524,2017-05-26,Assembly,"Do pass",17,0,0,0,17
892481,654323,2017-05-30,Assembly,"AB 60 SANTIAGO Assembly Third Reading",75,0,5,0,80
892481,762929,2018-06-12,Senate,"Do pass, but first be re-referred to the Committee on [Appropriations]",6,0,1,0,7
892481,769560,2018-07-02,Senate,"Placed on suspense file",7,0,0,0,7
892481,771644,2018-08-16,Senate,"Do pass",7,0,0,0,7
892481,772692,2018-08-24,Senate,"Special Consent AB60 Santiago",39,0,1,0,40
892481,773521,2018-08-29,Assembly,"AB 60 SANTIAGO Concurrence in Senate Amendments",80,0,0,0,80
892482,567598,2017-01-13,Assembly,"Be adopted. To third reading",7,3,1,0,11
892482,568079,2017-01-17,Assembly,"HR 5 BURKE Assembly Third Reading",52,17,11,0,80
892483,566279,2016-12-05,Assembly,"HR 3 RENDON By CALDERON",79,0,1,0,80
892484,618527,2017-04-04,Assembly,"Do pass as amended and be re-referred to the Committee on [Rules]",11,0,0,0,11
892484,637537,2017-05-03,Assembly,"Do pass. To Consent Calendar",16,0,1,0,17
892484,643503,2017-05-11,Assembly,"AB 31 RODRIGUEZ Consent Calendar Second Day Regular Session",77,0,3,0,80
892484,672365,2017-07-11,Senate,"Do pass as amended, but first amend, and re-refer to the Committee on [Appropriations] with the recommendation: To Consent Calendar",7,0,0,0,7
892484,673918,2017-08-21,Senate,"Placed on suspense file",7,0,0,0,7
892484,674606,2017-09-01,Senate,"Do pass",7,0,0,0,7
892484,676127,2017-09-14,Senate,"Assembly 3rd Reading AB31 Rodriguez By Jackson",27,10,3,0,40
892484,676462,2017-09-15,Assembly,"AB 31 Rodriguez Concurrence in Senate Amendments",75,0,4,0,79
892484,774576,2017-08-21,Senate,,7,0,0,0,7
892485,573712,2017-01-31,Senate,"Do pass, but first be re-referred to the Committee on [Human Services]",5,2,0,0,7
892485,583657,2017-02-14,Senate,"Do pass as amended, but first amend, and re-refer to the Committee on [Appropriations]",3,1,1,0,5
892485,602451,2017-03-13,Senate,"Placed on suspense file",2,4,1,0,7
892485,602452,2017-03-13,Senate,"Do pass",5,2,0,0,7
892485,617349,2017-04-03,Senate,"Senate 3rd Reading SB6 Hueso et al. Urgency Clause",28,11,1,0,40
892485,676234,2017-09-14,Assembly,"SB 6 Hueso Third Reading Urgency By GARCIA, E",78,0,1,0,79
892485,676570,2017-09-15,Senate,"Unfinished Business SB6 Hueso et al. Urgency Clause Concurrence",37,0,3,0,40
892486,567600,2017-01-13,Senate,"Be adopted. Ordered to third reading",5,2,0,0,7
892486,568117,2017-01-17,Senate,"Senate 3rd Reading SR9 Jackson et al",27,11,2,0,40
892488,684917,2018-01-09,Assembly,"Do pass as amended and be re-referred to the Committee on [Appropriations]",14,0,1,0,15
892488,686199,2018-01-18,Assembly,"Do pass",17,0,0,0,17
892488,690054,2018-01-29,Assembly,"AB 11 MCCARTY Assembly Third Reading",77,0,0,0,77
892488,768810,2018-06-27,Senate,"Do pass as amended, but first amend, and re-refer to the Committee on [Appropriations]",9,0,0,0,9
892488,770573,2018-08-06,Senate,"Placed on suspense file",7,0,0,0,7
892488,771614,2018-08-16,Senate,"Do pass",7,0,0,0,7
892488,772484,2018-08-23,Senate,"Assembly 3rd Reading AB11 McCarty et al. By Mitchell",38,0,2,0,40
892488,774040,2018-08-31,Assembly,"AB 11 MCCARTY Concurrence in Senate Amendments",80,0,0,0,80
892489,578976,2017-02-07,Assembly,"Do pass and be re-referred to the Committee on [Human Services]",5,0,2,0,7
892489,583746,2017-02-14,Assembly,"Do pass as amended and be re-referred to the Committee on [Appropriations]",4,1,2,0,7
892489,651559,2017-05-26,Assembly,"Do pass as amended",11,6,0,0,17
892489,656801,2017-06-01,Assembly,"AB 3 BONTA Assembly Third Reading",53,24,3,0,80
892489,765184,2018-06-19,Senate,"Do pass, but first be re-referred to the Committee on [Appropriations]",5,2,0,0,7
892489,769568,2018-07-02,Senate,"Placed on suspense file",7,0,0,0,7
892490,627970,2017-04-19,Assembly,"Do pass as amended and be re-referred to the Committee on [Appropriations]",13,0,0,0,13
892490,637229,2017-05-03,Assembly,"Do pass. To Consent Calendar",16,0,1,0,17
892490,643479,2017-05-11,Assembly,"AB 44 REYES Consent Calendar Second Day Regular Session",77,0,3,0,80
892490,672351,2017-07-12,Senate,"Do pass as amended, but first amend, and re-refer to the Committee on [Appropriations]",5,0,0,0,5
892490,675670,2017-09-12,Senate,"Assembly 3rd Reading AB44 Reyes et al. By Leyva",40,0,0,0,40
892490,675804,2017-09-13,Assembly,"AB 44 Reyes Concurrence in Senate Amendments",78,0,1,0,79
892491,628015,2017-04-19,Assembly,"Do pass as amended and be re-referred to the Committee on [Appropriations]",4,2,1,0,7
892491,651582,2017-05-26,Assembly,"Do pass",12,5,0,0,17
892491,655916,2017-05-31,Assembly,"AB 20 KALRA Assembly Third Reading",50,24,6,0,80
892491,671913,2017-07-10,Senate,"Do pass as amended, but first amend, and re-refer to the Committee on [Appropriations]",3,2,0,0,5
892491,674270,2017-08-31,Senate,"Assembly 3rd Reading AB20 Kalra By Pan",24,14,2,0,40
892491,674896,2017-09-05,Assembly,"AB 20 KALRA Concurrence in Senate Amendments",46,28,5,0,79
892492,605481,2017-03-15,Assembly,"Do pass as amended and be re-referred to the Committee on [Appropriations]",7,0,0,0,7
892492,620036,2017-04-05,Assembly,"Do pass",17,0,0,0,17
892492,634361,2017-04-27,Assembly,"AB 24 EGGMAN Assembly Third Reading",74,0,6,0,80
892492,660212,2017-06-07,Senate,"Do pass, but first be re-referred to the Committee on [Appropriations]",7,0,0,0,7
892492,674434,2017-08-31,Senate,"Assembly 3rd Reading AB24 Eggman et al. By Stern",39,0,1,0,40
892492,674863,2017-09-05,Assembly,"AB 24 EGGMAN Concurrence in Senate Amendments",76,0,3,0,79
892493,610175,2017-03-22,Senate,"Do pass, but first be re-referred to the Committee on [Appropriations]",6,0,1,0,7
892493,617369,2017-04-03,Senate,"Placed on suspense file",7,0,0,0,7
892493,650394,2017-05-25,Senate,"Do pass",7,0,0,0,7
892493,655741,2017-05-31,Senate,"Senate 3rd Reading SB52 Newman",39,1,0,0,40
892493,671018,2017-07-03,Assembly,"Be re-referred to the Committee on [Transportation]",11,0,0,0,11
892493,671858,2017-07-10,Assembly,"Do pass and be re-referred to the Committee on [Appropriations] with recommendation: To Consent Calendar",14,0,0,0,14
892493,674682,2017-09-01,Assembly,"Do pass",16,0,1,0,17
892493,675111,2017-09-07,Assembly,"SB 52 Newman Senate Third Reading By DALY",77,0,2,0,79
892493,675647,2017-09-12,Senate,"That the Assembly amendments be concurred in",10,0,3,0,13
892493,675892,2017-09-13,Senate,"Unfinished Business SB52 Newman Concurrence",40,0,0,0,40
892498,630485,2017-04-24,Assembly,"Do pass and be re-referred to the Committee on [Appropriations]",8,3,0,0,11
892498,642395,2017-05-10,Assembly,"Do pass",12,5,0,0,17
892498,644525,2017-05-15,Assembly,"AB 38 STONE Assembly Third Reading",55,23,2,0,80
892498,766306,2018-06-20,Senate,"Do pass as amended, but first amend, and re-refer to the Committee on [Appropriations]",5,2,0,0,7
892498,772610,2018-08-23,Senate,"Assembly 3rd Reading AB38 Mark Stone By Galgiani",28,11,1,0,40
892498,773036,2018-08-27,Assembly,"AB 38 STONE Concurrence in Senate Amendments",55,23,2,0,80
892499,598970,2017-03-07,Senate,"Do pass as amended, but first amend, and re-refer to the Committee on [Governance and Finance]",7,2,0,0,9
892499,610104,2017-03-22,Senate,"Do pass as amended, but first amend, and re-refer to the Committee on [Appropriations]",5,1,1,0,7
892499,644362,2017-05-15,Senate,"Placed on suspense file",7,0,0,0,7
892499,650824,2017-05-25,Senate,"Do pass as amended",5,2,0,0,7
892499,654289,2017-05-30,Senate,"Senate 3rd Reading SB5 De León et al. Urgency Clause",31,9,0,0,40
892499,674333,2017-08-31,Assembly,"Do pass as amended and be re-referred to the Committee on [Appropriations]",11,2,2,0,15
892499,675602,2017-09-12,Assembly,"Do pass",10,5,2,0,17
892499,676474,2017-09-15,Assembly,"SB 5 De León Third Reading Urgency By GARCIA, E",56,21,2,0,79
892499,676475,2017-09-16,Senate,"W/O REF. TO FILE SB5 De León Urgency Clause Concurrence",27,9,4,0,40
892500,605079,2017-03-15,Assembly,"Do pass and be re-referred to the Committee on [Appropriations]",7,0,0,0,7
892500,620080,2017-04-05,Assembly,"Do pass",17,0,0,0,17
892500,626149,2017-04-17,Assembly,"AB 37 O'DONNELL Assembly Third Reading",74,0,6,0,80
892500,660094,2017-06-07,Senate,"Do pass, but first be re-referred to the Committee on [Appropriations] with the recommendation: To Consent Calendar",7,0,0,0,7
892500,670962,2017-07-03,Senate,"Consent Calendar 2nd AB37",33,0,7,0,40
892501,637378,2017-05-02,Senate,"Do pass as amended, but first amend, and re-refer to the Committee on [Appropriations]",5,2,0,0,7
892501,654416,2017-05-30,Senate,"Senate 3rd Reading SB33 Dodd et al",26,13,1,0,40
892501,668954,2017-06-27,Assembly,"Do pass as amended",8,3,0,0,11
892501,674900,2017-09-05,Assembly,"SB 33 Dodd Senate Third Reading By DABABNEH",46,23,10,0,79
892501,675078,2017-09-06,Senate,"Unfinished Business SB33 Dodd et al. Concurrence",25,13,2,0,40
892502,613242,2017-03-27,Senate,"Do pass as amended, but first amend, and re-refer to the Committee on [Environmental Quality]",8,1,0,0,9
892502,620113,2017-04-05,Senate,"Do pass, but first be re-referred to the Committee on [Judiciary]",5,2,0,0,7
892502,633096,2017-04-25,Senate,"Do pass as amended, but first amend, and re-refer to the Committee on [Appropriations]",5,2,0,0,7
892502,644408,2017-05-15,Senate,"Placed on suspense file",7,0,0,0,7
892502,650720,2017-05-25,Senate,"Do pass",5,2,0,0,7
892502,654454,2017-05-30,Senate,"Senate 3rd Reading SB51 Jackson",28,11,1,0,40
892502,668649,2017-06-26,Assembly,"Do pass and be re-referred to the Committee on [Judiciary]",10,0,0,0,10
892502,672140,2017-07-11,Assembly,"Do pass as amended and be re-referred to the Committee on [Appropriations]",10,1,0,0,11
892502,674256,2017-08-30,Assembly,"Do pass",11,4,2,0,17
892502,674931,2017-09-05,Assembly,"SB 51 Jackson Senate Third Reading By GARCIA, C",59,13,7,0,79
892502,675085,2017-09-06,Senate,"Unfinished Business SB51 Jackson Concurrence",29,11,0,0,40
892503,626988,2017-04-18,Senate,"Do pass as amended, but first amend, and re-refer to the Committee on [Appropriations]",5,0,0,0,5
892503,644373,2017-05-15,Senate,"Placed on suspense file",7,0,0,0,7
892503,650583,2017-05-25,Senate,"Do pass",7,0,0,0,7
892503,654036,2017-05-30,Senate,"Senate 3rd Reading SB45 Mendoza et al",40,0,0,0,40
892503,672363,2017-07-12,Assembly,"Do pass as amended, and be re-referred to the Committee on [Appropriations] with recommendation: To Consent Calendar",6,0,1,0,7
892503,674033,2017-08-23,Assembly,"Do pass. To Consent Calendar",15,0,2,0,17
892503,674377,2017-08-31,Assembly,"SB 45 Mendoza Consent Calendar Second Day Regular Session",73,0,6,0,79
892503,674913,2017-09-05,Senate,"Special Consent SB45 Mendoza et al",40,0,0,0,40
892504,636634,2017-05-02,Assembly,"Do pass as amended and be re-referred to the Committee on [Health]",10,0,6,0,16
892504,641609,2017-05-09,Assembly,"Do pass as amended",9,2,4,0,15
892505,626916,2017-04-18,Assembly,"Do pass and be re-referred to the Committee on [Appropriations]",14,0,2,0,16
892505,651579,2017-05-26,Assembly,"Do pass as amended",12,0,5,0,17
892505,656851,2017-06-01,Assembly,"AB 64 BONTA Assembly Third Reading",71,1,8,0,80
892505,671933,2017-07-10,Senate,"Do pass, but first be re-referred to the Committee on [Appropriations]",9,0,0,0,9
892505,673804,2017-08-21,Senate,"Placed on suspense file",7,0,0,0,7
892506,608422,2017-03-21,Assembly,"Do pass and be re-referred to the Committee on [Appropriations]",5,2,0,0,7
892506,619720,2017-04-05,Assembly,"Do pass",11,6,0,0,17
892506,629137,2017-04-20,Assembly,"AB 7 GIPSON Assembly Third Reading",44,29,7,0,80
892506,666339,2017-06-20,Senate,"Do pass, but first be re-referred to the Committee on [Appropriations]",5,2,0,0,7
892506,671922,2017-07-10,Senate,"Placed on suspense file",7,0,0,0,7
892506,674524,2017-09-01,Senate,"Do pass",5,2,0,0,7
892506,675585,2017-09-12,Senate,"Assembly 3rd Reading AB7 Gipson et al. By Portantino",24,14,2,0,40
892506,675787,2017-09-13,Assembly,"AB 7 Gipson Concurrence in Senate Amendments",43,32,4,0,79
892507,626933,2017-04-18,Assembly,"Do pass and be re-referred to the Committee on [Appropriations]",4,2,1,0,7
892507,651583,2017-05-26,Assembly,"Do pass as amended",9,7,1,0,17
892507,656835,2017-06-01,Assembly,"AB 42 BONTA Assembly Third Reading",35,37,8,0,80
892508,629452,2017-04-19,Assembly,"Do pass and be re-referred to the Committee on [Appropriations]",5,1,1,0,7
892508,637586,2017-05-03,Assembly,"Do pass",11,4,2,0,17
892508,643469,2017-05-11,Assembly,"AB 55 THURMOND Assembly Third Reading",53,19,8,0,80
892508,669765,2017-06-28,Senate,"Do pass, but first be re-referred to the Committee on [Appropriations]",3,1,1,0,5
892508,674286,2017-08-31,Senate,"Assembly 3rd Reading AB55 Thurmond By Bradford",26,12,2,0,40
892508,674944,2017-09-05,Assembly,"AB 55 THURMOND Concurrence in Senate Amendments",53,22,4,0,79
892511,637581,2017-05-03,Assembly,"Do pass. To Consent Calendar",13,0,0,0,13
892511,643553,2017-05-11,Assembly,"AB 61 HOLDEN Consent Calendar Second Day Regular Session",77,0,3,0,80
892511,669836,2017-06-28,Senate,"Do pass as amended",9,0,4,0,13
892511,672776,2017-07-17,Senate,"Special Consent Calendar # AB61",38,0,2,0,40
892511,674912,2017-09-05,Senate,"Assembly 3rd Reading AB61 Holden By Mendoza",40,0,0,0,40
892511,675180,2017-09-07,Assembly,"AB 61 HOLDEN Concurrence in Senate Amendments",79,0,0,0,79
892513,613752,2017-03-28,Assembly,"Do pass as amended and be re-referred to the Committee on [Appropriations]",9,3,1,0,13
892513,651809,2017-05-26,Assembly,"Do pass as amended",12,5,0,0,17
892513,656041,2017-05-31,Assembly,"AB 19 SANTIAGO Assembly Third Reading",56,18,6,0,80
892513,672420,2017-07-12,Senate,"Do pass, but first be re-referred to the Committee on [Appropriations]",7,0,0,0,7
892513,673843,2017-08-21,Senate,"Placed on suspense file",7,0,0,0,7
892513,674552,2017-09-01,Senate,"Do pass as amended",5,2,0,0,7
892513,675645,2017-09-12,Senate,"Assembly 3rd Reading AB19 Santiago et al. By Hernandez",31,7,2,0,40
892513,675936,2017-09-13,Assembly,"AB 19 Santiago Concurrence in Senate Amendments",61,16,2,0,79
892515,684162,2018-01-08,Assembly,"Do pass and be re-referred to the Committee on [Appropriations]",4,9,1,0,14
892516,594981,2017-02-28,Senate,"Do pass, but first be re-referred to the Committee on [Governance and Finance]",9,3,1,0,13
892516,604221,2017-03-15,Senate,"Do pass as amended, but first amend, and re-refer to the Committee on [Appropriations]",5,2,0,0,7
892516,617533,2017-04-03,Senate,"Placed on suspense file",7,0,0,0,7
892516,650740,2017-05-25,Senate,"Do pass as amended",5,2,0,0,7
892516,671585,2017-07-06,Senate,"Senate 3rd Reading SB2 Atkins et al. Urgency Clause",27,12,1,0,40
892516,672408,2017-07-12,Assembly,"Do pass and be re-referred to the Committee on [Rules]",5,2,0,0,7
892516,676269,2017-09-14,Assembly,"SB 2 Atkins Third Reading Urgency By GRAY",54,25,0,0,79
892516,676504,2017-09-15,Senate,"Unfinished Business SB2 Atkins et al. Urgency Clause Concurrence",27,11,2,0,40
892518,631788,2017-04-25,Senate,"Do pass, but first be re-referred to the Committee on [Appropriations]",8,3,2,0,13
892518,644371,2017-05-15,Senate,"Placed on suspense file",7,0,0,0,7
892518,650715,2017-05-25,Senate,"Do pass as amended",5,2,0,0,7
892518,656635,2017-06-01,Senate,"Senate 3rd Reading SB30 Lara",23,16,1,0,40
892518,763449,2018-06-14,Assembly,"Be re-referred to the Committee on [Insurance]",7,0,4,0,11
892518,766007,2018-06-20,Assembly,"Do pass as amended and be re-referred to the Committee on [Appropriations]",12,0,1,0,13
892518,771071,2018-08-08,Assembly,"Do pass",15,0,2,0,17
892518,772258,2018-08-20,Assembly,"SB 30 Lara Senate Third Reading By DALY",72,2,6,0,80
892518,772533,2018-08-23,Senate,"That the Assembly amendments be concurred in",9,2,2,0,13
892518,772695,2018-08-24,Senate,"Unfinished Business SB30 Lara et al. Concurrence",28,10,2,0,40
892519,603298,2017-03-14,Senate,"Do pass as amended, but first amend, and re-refer to the Committee on [Judiciary]",7,1,1,0,9
892519,619693,2017-04-04,Senate,"Do pass as amended, but first amend, and re-refer to the Committee on [Appropriations]",5,0,2,0,7
892519,635641,2017-05-01,Senate,"Placed on suspense file",7,0,0,0,7
892519,650716,2017-05-25,Senate,"Do pass as amended",5,2,0,0,7
892519,654076,2017-05-30,Senate,"Senate 3rd Reading SB50 Allen et al",26,13,1,0,40
892519,661554,2017-06-12,Senate,"Senate 3rd Reading SB50 Allen et al",27,13,0,0,40
892519,668547,2017-06-26,Assembly,"Do pass as amended and be re-referred to the Committee on [Judiciary]",7,3,0,0,10
892519,672123,2017-07-11,Assembly,"Do pass as amended and be re-referred to the Committee on [Appropriations]",9,1,1,0,11
892519,674637,2017-09-01,Assembly,"Do pass as amended",11,5,1,0,17
892519,675858,2017-09-13,Assembly,"SB 50 Allen Senate Third Reading By FRIEDMAN",55,21,3,0,79
892519,676114,2017-09-14,Senate,"Unfinished Business SB50 Allen et al. Concurrence",28,12,0,0,40
892520,608197,2017-03-21,Senate,"Do pass, but first be re-referred to the Committee on [Appropriations]",5,0,0,0,5
892520,628909,2017-04-20,Senate,"Senate 3rd Reading SB24 Portantino",40,0,0,0,40
892520,672515,2017-07-12,Assembly,"Do pass and be re-referred to the Committee on [Appropriations] with recommendation: To Consent Calendar",6,0,1,0,7
892520,674028,2017-08-23,Assembly,"Do pass. To Consent Calendar",15,0,2,0,17
892521,607201,2017-03-20,Assembly,"Be adopted. To Consent Calendar",14,0,0,0,14
892521,611162,2017-03-23,Assembly,"ACR 2 MAYES Consent Calendar Second Day Regular Session",76,0,4,0,80
892521,672220,2017-07-11,Senate,"Be adopted, but first be re-referred to the Committee on [Appropriations] with recommendation: To Consent Calendar",11,0,2,0,13
892521,674126,2017-08-24,Senate,"Consent Calendar 2nd ACR2",38,0,2,0,40
892522,614965,2017-03-28,Senate,"Do pass, but first be re-referred to the Committee on [Appropriations]",5,2,0,0,7
892522,626116,2017-04-17,Senate,"Placed on suspense file",7,0,0,0,7
892522,650613,2017-05-25,Senate,"Do pass",5,2,0,0,7
892522,654400,2017-05-30,Senate,"Senate 3rd Reading SB29 Lara",26,13,1,0,40
892522,669084,2017-06-27,Assembly,"Do pass and be re-referred to the Committee on [Appropriations]",7,2,2,0,11
892522,674444,2017-09-01,Assembly,"Do pass",11,5,1,0,17
892522,675263,2017-09-08,Assembly,"SB 29 Lara Senate Third Reading By REYES Amendment Set #1",52,24,3,0,79
892522,675514,2017-09-11,Assembly,"SB 29 Lara Senate Third Reading By REYES",52,24,3,0,79
892522,675783,2017-09-13,Senate,"Unfinished Business SB29 Lara et al. Concurrence",27,13,0,0,40
892523,566281,2016-12-05,Assembly,"HR 4 RENDON Assembly Third Reading",57,14,9,0,80
892524,613522,2017-03-28,Assembly,"Do pass and be re-referred to the Committee on [Judiciary]",8,4,1,0,13
892524,627031,2017-04-18,Assembly,"Do pass as amended and be re-referred to the Committee on [Appropriations]",8,3,0,0,11
892524,651646,2017-05-26,Assembly,"Do pass as amended",12,5,0,0,17
892524,656970,2017-06-01,Assembly,"AB 21 KALRA Assembly Third Reading",55,23,2,0,80
892524,669754,2017-06-28,Senate,"Do pass as amended, but first amend, and re-refer to the Committee on [Judiciary]",5,0,2,0,7
892524,672343,2017-07-11,Senate,"Do pass as amended, but first amend, and re-refer to the Committee on [Appropriations]",5,2,0,0,7
892524,673779,2017-08-21,Senate,"Placed on suspense file",7,0,0,0,7
892524,674579,2017-09-01,Senate,"Do pass as amended",5,2,0,0,7
892524,675578,2017-09-12,Senate,"Assembly 3rd Reading AB21 Kalra et al. By Hueso",29,8,3,0,40
892524,675941,2017-09-13,Assembly,"AB 21 Kalra Concurrence in Senate Amendments",58,19,2,0,79
892525,627892,2017-04-19,Senate,"Do pass as amended, but first amend, and re-refer to the Committee on [Appropriations]",7,0,0,0,7
892525,644998,2017-05-15,Senate,"Placed on suspense file",7,0,0,0,7
892525,650750,2017-05-25,Senate,"Do pass as amended",6,0,1,0,7
892525,655770,2017-05-31,Senate,"Senate 3rd Reading SB15 Leyva Urgency Clause",39,0,1,0,40
892525,672040,2017-07-11,Assembly,"Do pass as amended and be re-referred to the Committee on [Appropriations]",13,0,0,0,13
892526,641789,2017-05-09,Senate,"Do pass as amended",11,0,2,0,13
892526,647913,2017-05-22,Senate,"Senate 3rd Reading SB56 Mendoza",37,0,3,0,40
892526,671393,2017-07-05,Assembly,"Do pass",19,0,2,0,21
892526,674986,2017-09-05,Assembly,"SB 56 Mendoza Senate Third Reading By SALAS",75,0,4,0,79
892526,675140,2017-09-07,Senate,"Special Consent SB56 Mendoza",40,0,0,0,40
892527,642435,2017-05-09,Senate,"Do pass",7,0,0,0,7
892527,644428,2017-05-15,Senate,"Senate 3rd Reading SB36 Jackson",39,0,1,0,40
892527,672810,2017-07-18,Assembly,"Do pass as amended",11,0,0,0,11
892527,674698,2017-09-01,Assembly,"SB 36 Jackson Senate Third Reading By STONE",76,0,3,0,79
892527,675671,2017-09-12,Senate,"Unfinished Business SB36 Jackson Concurrence",40,0,0,0,40
892528,625973,2017-04-17,Senate,"Senate 3rd Reading SCR2 Nguyen",39,0,1,0,40
892528,630491,2017-04-24,Assembly,"Be adopted. To third reading",11,0,0,0,11
892529,668620,2017-06-26,Senate,"Be adopted, but first be re-referred to the Committee on [Elections and Constitutional Amendments]",2,3,0,0,5
892531,608347,2017-03-21,Senate,"Do pass, but first be re-referred to the Committee on [Appropriations]",5,2,0,0,7
892531,617371,2017-04-03,Senate,"Placed on suspense file",7,0,0,0,7
892531,650789,2017-05-25,Senate,"Do pass",5,2,0,0,7
892531,653949,2017-05-30,Senate,"Senate 3rd Reading SB8 Beall et al",27,13,0,0,40
892531,669190,2017-06-27,Assembly,"Do pass and be re-referred to the Committee on [Appropriations]",4,2,1,0,7
892532,594907,2017-02-28,Assembly,"Do pass and be re-referred to the Committee on [Appropriations]",7,0,0,0,7
892532,620126,2017-04-05,Assembly,"Do pass",17,0,0,0,17
892532,634620,2017-04-27,Assembly,"AB 41 CHIU Assembly Third Reading",74,0,6,0,80
892532,658844,2017-06-06,Senate,"Do pass, but first be re-referred to the Committee on [Appropriations]",7,0,0,0,7
892532,668660,2017-06-26,Senate,"Placed on suspense file",7,0,0,0,7
892532,674449,2017-09-01,Senate,"Do pass as amended",6,0,1,0,7
892532,676154,2017-09-14,Senate,"Special Consent Calendar # AB41",40,0,0,0,40
892532,676323,2017-09-14,Assembly,"AB 41 Chiu Special Consent Calendar 1st Day Regular Session",79,0,0,0,79
892533,634554,2017-04-26,Assembly,"Do pass as amended and be re-referred to the Committee on [Appropriations]",13,0,0,0,13
892533,651552,2017-05-26,Assembly,"Do pass as amended",16,0,1,0,17
892533,656185,2017-05-31,Assembly,"AB 25 NAZARIAN Assembly Third Reading",76,1,3,0,80
892533,669114,2017-06-27,Senate,"Do pass, but first be re-referred to the Committee on [Energy, Utilities and Communications]",11,1,1,0,13
892533,674970,2017-09-05,Senate,"Assembly 3rd Reading AB25 Nazarian et al. By Allen",36,3,1,0,40
892533,675120,2017-09-07,Assembly,"AB 25 NAZARIAN Concurrence in Senate Amendments",79,0,0,0,79
892534,644465,2017-05-15,Senate,"Senate 3rd Reading SR10 Nguyen",39,0,1,0,40
892535,566282,2016-12-05,Assembly,"HR 2 RENDON By CALDERON",79,0,1,0,80
892536,633353,2017-04-25,Assembly,"Do pass as amended and be re-referred to the Committee on [Appropriations]",7,0,0,0,7
892536,651577,2017-05-26,Assembly,"Do pass",16,0,1,0,17
892536,655902,2017-05-31,Assembly,"AB 26 CABALLERO Assembly Third Reading",77,0,3,0,80
892536,669666,2017-06-28,Senate,"Do pass as amended, but first amend, and re-refer to the Committee on [Human Services]",7,0,0,0,7
892536,672318,2017-07-11,Senate,"Do pass, but first be re-referred to the Committee on [Appropriations]",7,0,0,0,7
892536,673826,2017-08-21,Senate,"Placed on suspense file",7,0,0,0,7
892536,674718,2017-09-01,Senate,"Do pass",7,0,0,0,7
892536,675803,2017-09-13,Senate,"Assembly 3rd Reading AB26 Caballero By Mitchell",40,0,0,0,40
892536,676364,2017-09-14,Assembly,"AB 26 Caballero Concurrence in Senate Amendments",79,0,0,0,79
892537,580999,2017-02-09,Senate,"Do pass",11,5,1,0,17
892537,587495,2017-02-17,Senate,"Senate 3rd Reading SB47 Committee On B. & F.R. (Mitchell)",26,8,6,0,40
892537,596594,2017-03-02,Assembly,"Do pass",22,5,2,0,29
892537,600800,2017-03-09,Assembly,"SB 47 B. & F. R. Senate Third Reading By TING",63,13,4,0,80
892539,603386,2017-03-14,Senate,"Do pass, but first be re-referred to the Committee on [Environmental Quality]",7,2,0,0,9
892539,620101,2017-04-05,Senate,"Do pass, but first be re-referred to the Committee on [Judiciary]",5,2,0,0,7
892539,633109,2017-04-25,Senate,"Do pass, but first be re-referred to the Committee on [Appropriations]",5,2,0,0,7
892539,644296,2017-05-15,Senate,"Placed on suspense file",7,0,0,0,7
892539,650698,2017-05-25,Senate,"Do pass as amended",5,2,0,0,7
892539,654365,2017-05-30,Senate,"Senate 3rd Reading SB49 De León et al",24,13,3,0,40
892539,668999,2017-06-27,Assembly,"Do pass and be re-referred to the Committee on [Natural Resources]",4,2,1,0,7
892539,672058,2017-07-10,Assembly,"Do pass and be re-referred to the Committee on [Judiciary]",7,3,0,0,10
892539,672059,2017-07-11,Assembly,"Do pass as amended and be re-referred to the Committee on [Appropriations]",8,3,0,0,11
892539,674594,2017-09-01,Assembly,"Do pass as amended",10,5,2,0,17
892539,675273,2017-09-08,Assembly,"SB 49 De León Senate Third Reading By STONE Amendment Set #1",43,25,11,0,79
892540,603334,2017-03-14,Assembly,"Do pass as amended and be re-referred to the Committee on [Appropriations]",6,1,0,0,7
892543,614759,2017-03-28,Senate,"Do pass, but first be re-referred to the Committee on [Appropriations]",5,2,0,0,7
892543,625899,2017-04-17,Senate,"Senate 3rd Reading SB16 Wieckowski",28,12,0,0,40
892543,662121,2017-06-13,Assembly,"Do pass",8,3,0,0,11
892543,670246,2017-06-29,Assembly,"SB 16 Wieckowski Senate Third Reading By MCCARTY",38,24,18,0,80
892544,566283,2016-12-05,Senate,"W/O REF. TO FILE SCR1 Fuller",40,0,0,0,40
892544,566284,2016-12-05,Assembly,"SCR 1 Fuller By CALDERON",79,0,1,0,80
892545,594975,2017-02-28,Senate,"Do pass, but first be re-referred to the Committee on [Governance and Finance]",10,2,1,0,13
892545,610158,2017-03-22,Senate,"Do pass, but first be re-referred to the Committee on [Appropriations]",5,2,0,0,7
892545,617544,2017-04-03,Senate,"Placed on suspense file",7,0,0,0,7
892545,650718,2017-05-25,Senate,"Do pass",5,2,0,0,7
892545,656571,2017-06-01,Senate,"Senate 3rd Reading SB3 Beall et al. Urgency Clause",30,9,1,0,40
892545,672425,2017-07-12,Assembly,"Do pass and be re-referred to the Committee on [Rules]",5,1,1,0,7
892545,676244,2017-09-14,Assembly,"SB 3 Beall Third Reading Urgency By GLORIA",56,21,2,0,79
892545,676473,2017-09-15,Senate,"Unfinished Business SB3 Beall et al. Urgency Clause Concurrence",30,8,2,0,40
892546,608299,2017-03-21,Senate,"Do pass, but first be re-referred to the Committee on [Judiciary]",10,0,1,0,11
892546,620086,2017-04-04,Senate,"Do pass, but first be re-referred to the Committee on [Rules]",6,0,1,0,7
892546,630484,2017-04-24,Senate,"Placed on suspense file",7,0,0,0,7
892546,650719,2017-05-25,Senate,"Do pass as amended",7,0,0,0,7
892546,656091,2017-05-31,Senate,"Senate 3rd Reading SB19 Hill",39,0,1,0,40
892546,667296,2017-06-21,Assembly,"Do pass and be re-referred to the Committee on [Judiciary]",14,0,1,0,15
892546,672097,2017-07-11,Assembly,"Do pass and be re-referred to the Committee on [Appropriations]",11,0,0,0,11
892546,674597,2017-09-01,Assembly,"Do pass as amended",16,0,1,0,17
892546,676492,2017-09-15,Assembly,"SB 19 Hill Senate Third Reading By LEVINE",79,0,0,0,79
892546,676493,2017-09-15,Senate,"Unfinished Business SB19 Hill et al. Concurrence",38,0,2,0,40
892548,613974,2017-03-27,Assembly,"Do pass as amended and be re-referred to the Committee on [Appropriations]",8,1,1,0,10
892549,603153,2017-03-14,Senate,"Do pass as amended, but first amend, and re-refer to the Committee on [Environmental Quality]",8,0,1,0,9
892549,627983,2017-04-19,Senate,"Do pass, but first be re-referred to the Committee on [Appropriations]",6,0,1,0,7
892549,635776,2017-05-01,Senate,"Placed on suspense file",7,0,0,0,7
892549,650682,2017-05-25,Senate,"Do pass as amended",5,1,1,0,7
892549,656036,2017-05-31,Senate,"Senate 3rd Reading SB44 Jackson et al",33,6,1,0,40
892549,672098,2017-07-10,Assembly,"Do pass and be re-referred to the Committee on [Appropriations]",10,0,0,0,10
892549,674568,2017-09-01,Assembly,"Do pass",16,0,1,0,17
892549,675183,2017-09-07,Assembly,"SB 44 Jackson Senate Third Reading By LIMÓN",76,0,3,0,79
892550,616299,2017-03-29,Senate,"Do pass, but first be re-referred to the Committee on [Governance and Finance]",8,0,1,0,9
892550,627985,2017-04-19,Senate,"Do pass, but first be re-referred to the Committee on [Appropriations]",6,1,0,0,7
892550,636141,2017-05-01,Senate,"Placed on suspense file",7,0,0,0,7
892551,627131,2017-04-18,Senate,"Do pass as amended, but first amend, and re-refer to the Committee on [Appropriations]",11,0,2,0,13
892551,644476,2017-05-15,Senate,"Placed on suspense file",7,0,0,0,7
892552,567152,2017-01-09,Assembly,"Be adopted as amended",11,0,0,0,11
892552,587554,2017-02-17,Senate,"Special Consent Calendar # ACR3 Choi et al",30,0,10,0,40
892554,631883,2017-04-24,Assembly,"Do pass and be re-referred to the Committee on [Appropriations]",11,3,0,0,14
892554,651543,2017-05-26,Assembly,"Do pass as amended",12,5,0,0,17
892554,655745,2017-05-31,Assembly,"AB 17 HOLDEN Assembly Third Reading",71,4,5,0,80
892554,672093,2017-07-11,Senate,"Do pass, but first be re-referred to the Committee on [Appropriations]",12,1,0,0,13
892554,673749,2017-08-21,Senate,"Placed on suspense file",7,0,0,0,7
892554,674476,2017-09-01,Senate,"Do pass as amended",7,0,0,0,7
892554,675131,2017-09-07,Senate,"Assembly 3rd Reading AB17 Holden et al. By Allen",37,2,1,0,40
892554,675590,2017-09-12,Assembly,"AB 17 HOLDEN Concurrence in Senate Amendments",76,2,1,0,79
892555,637482,2017-05-03,Senate,"Do pass, but first be re-referred to the Committee on [Governmental Organization]",5,0,2,0,7
892555,641497,2017-05-09,Senate,"Do pass as amended, but first amend, and re-refer to the Committee on [Appropriations]",10,0,3,0,13
892557,594931,2017-02-28,Assembly,"Do pass as amended and be re-referred to the Committee on [Appropriations]",7,0,0,0,7
892557,619992,2017-04-05,Assembly,"Do pass. To Consent Calendar",17,0,0,0,17
892557,629028,2017-04-20,Assembly,"AB 6 LACKEY Consent Calendar Second Day",74,0,6,0,80
892558,603330,2017-03-14,Assembly,"Do pass as amended and be re-referred to the Committee on [Appropriations]",6,1,0,0,7
892559,634354,2017-04-26,Assembly,"Do pass",4,1,2,0,7
892559,647993,2017-05-22,Assembly,"AB 32 RODRIGUEZ Assembly Third Reading",67,6,7,0,80
892559,672045,2017-07-11,Senate,"Do pass",11,0,2,0,13
892559,674342,2017-08-31,Senate,"Assembly 3rd Reading AB32 Rodriguez By Hueso",39,0,1,0,40
892560,627044,2017-04-18,Assembly,"Do pass as amended, and be re-referred to the Committee on [Appropriations] with recommendation: To Consent Calendar",7,0,0,0,7
892561,629049,2017-04-19,Senate,"Do pass as amended, but first amend, and re-refer to the Committee on [Appropriations]",7,2,0,0,9
892561,644466,2017-05-15,Senate,"Placed on suspense file",7,0,0,0,7
892561,650823,2017-05-25,Senate,"Do pass",5,2,0,0,7
892561,654045,2017-05-30,Senate,"Senate 3rd Reading SB17 Hernandez et al",28,10,2,0,40
892561,669004,2017-06-27,Assembly,"Do pass as amended and be re-referred to the Committee on [Appropriations]",11,0,4,0,15
892561,674672,2017-09-01,Assembly,"Do pass as amended",12,3,2,0,17
892561,675304,2017-09-11,Assembly,"SB 17 Hernandez Senate Third Reading By WOOD",66,9,4,0,79
892561,675756,2017-09-13,Senate,"Unfinished Business SB17 Hernandez et al. Concurrence",32,8,0,0,40
892562,619889,2017-04-05,Assembly,"Do pass as amended and be re-referred to the Committee on [Revenue and Taxation]",7,0,0,0,7
892562,641699,2017-05-08,Assembly,"Do pass as amended and be re-referred to the Committee on [Appropriations]",8,1,1,0,10
892563,566285,2016-12-05,Assembly,"HR 1 COOLEY Motion to Lay on the Table By CALDERON",55,25,0,0,80
892563,566286,2016-12-05,Assembly,"HR 1 COOLEY",55,25,0,0,80
892564,600018,2017-03-08,Senate,"Do pass as amended, but first amend, and re-refer to the Committee on [Appropriations]",7,0,0,0,7
892564,603174,2017-03-08,Senate,"Amendments (Committee's)",7,0,0,0,7
892564,603175,2017-03-08,Senate,"Do pass as amended",7,0,0,0,7
892564,617759,2017-04-03,Senate,"Placed on suspense file",7,0,0,0,7
892564,650798,2017-05-25,Senate,"Do pass",7,0,0,0,7
892564,655950,2017-05-31,Senate,"Special Consent Calendar # SB55",40,0,0,0,40
892564,667227,2017-06-21,Assembly,"Do pass and be re-referred to the Committee on [Appropriations]",6,0,1,0,7
892565,684900,2018-01-09,Senate,"Do pass, but first be re-referred to the Committee on [Appropriations] with the recommendation: To Consent Calendar",7,0,0,0,7
892565,685400,2018-01-16,Senate,"Placed on suspense file",7,0,0,0,7
892565,686178,2018-01-18,Senate,"Do pass as amended",7,0,0,0,7
892565,690047,2018-01-29,Senate,"Senate 3rd Reading SB38 Roth et al",39,0,1,0,40
892565,762124,2018-06-12,Assembly,"Do pass and be re-referred to the Committee on [Appropriations] with recommendation: To Consent Calendar",9,0,1,0,10
892566,626906,2017-04-18,Senate,"Do pass, but first be re-referred to the Committee on [Appropriations] with the recommendation: To Consent Calendar",12,0,1,0,13
892566,644451,2017-05-15,Senate,"Placed on suspense file",7,0,0,0,7
892566,650552,2017-05-25,Senate,"Do pass as amended",7,0,0,0,7
892566,655805,2017-05-31,Senate,"Senate 3rd Reading SB46 Leyva",32,4,4,0,40
892566,768951,2018-06-27,Assembly,"Do pass and be re-referred to the Committee on [Appropriations]",7,0,0,0,7
892566,771537,2018-08-16,Assembly,"Do pass",14,2,1,0,17
892566,773832,2018-08-30,Assembly,"SB 46 Leyva Senate Third Reading By GLORIA",73,4,3,0,80
892566,774192,2018-08-31,Senate,"Unfinished Business SB46 Leyva Concurrence",30,8,2,0,40
892567,573690,2017-01-31,Senate,"Do pass, but first be re-referred to the Committee on [Appropriations]",5,2,0,0,7
892567,602274,2017-03-13,Senate,"Placed on suspense file",2,5,0,0,7
892567,602275,2017-03-13,Senate,"Do pass",5,2,0,0,7
892567,617339,2017-04-03,Senate,"Senate 3rd Reading SB54 De León et al",27,12,1,0,40
892567,662278,2017-06-13,Assembly,"Do pass and be re-referred to the Committee on [Judiciary]",5,2,0,0,7
892567,671350,2017-07-05,Assembly,"Do pass as amended and be re-referred to the Committee on [Appropriations]",8,3,0,0,11
892567,674628,2017-09-01,Assembly,"Do pass",11,5,1,0,17
892567,676484,2017-09-15,Assembly,"SB 54 De León Senate Third Reading By GONZALEZ FLETCHER",51,26,2,0,79
892567,676485,2017-09-16,Senate,"Unfinished Business SB54 De León et al. Concurrence",27,11,2,0,40
892568,599935,2017-03-07,Senate,"Do pass, but first be re-referred to the Committee on [Governance and Finance]",7,3,3,0,13
892568,634590,2017-04-26,Senate,"Do pass, but first be re-referred to the Committee on [Rules]",4,2,1,0,7
892568,647959,2017-05-22,Senate,"Placed on suspense file",7,0,0,0,7
892568,650736,2017-05-25,Senate,"Do pass as amended",5,2,0,0,7
892568,656577,2017-06-01,Senate,"Senate 3rd Reading SB35 Wiener et al",25,12,3,0,40
892568,670386,2017-06-28,Assembly,"Do pass as amended and be re-referred to the Committee on [Housing and Community Development]",6,2,1,0,9
892568,672317,2017-07-12,Assembly,"Do pass and be re-referred to the Committee on [Rules]",5,1,1,0,7
892568,676232,2017-09-14,Assembly,"SB 35 Wiener Senate Third Reading By GRAYSON",47,27,5,0,79
892568,676580,2017-09-15,Senate,"Unfinished Business SB35 Wiener et al. Concurrence",23,14,3,0,40
892569,603678,2017-03-14,Senate,"Do pass, but first be re-referred to the Committee on [Appropriations] with the recommendation: To Consent Calendar",8,0,1,0,9
892569,617632,2017-04-03,Senate,"Placed on suspense file",7,0,0,0,7
892570,577993,2017-02-06,Senate,"Do pass, but first be re-referred to the Committee on [Budget and Fiscal Review ]",4,1,0,0,5
892570,580995,2017-02-09,Senate,"Do pass",12,4,1,0,17
892570,587513,2017-02-17,Senate,"Senate 3rd Reading SB48 Committee On B. & F.R. (Mitchell)",27,7,6,0,40
892570,596742,2017-03-02,Assembly,"Do pass",24,3,2,0,29
892570,600745,2017-03-09,Assembly,"SB 48 B. & F. R. Senate Third Reading By TING",70,4,6,0,80
892572,625937,2017-04-17,Assembly,"Do pass and be re-referred to the Committee on [Appropriations]",8,3,3,0,14
892572,651677,2017-05-26,Assembly,"Do pass as amended",11,6,0,0,17
892572,656943,2017-06-01,Assembly,"AB 63 FRAZIER Assembly Third Reading",47,21,12,0,80
892572,672103,2017-07-11,Senate,"Do pass, but first be re-referred to the Committee on [Appropriations]",12,0,1,0,13
892572,673892,2017-08-21,Senate,"Placed on suspense file",7,0,0,0,7
892572,674484,2017-09-01,Senate,"Do pass",5,2,0,0,7
892572,675466,2017-09-11,Senate,"Assembly 3rd Reading AB63 Frazier et al. By Newman",32,8,0,0,40
892572,675869,2017-09-13,Assembly,"AB 63 FRAZIER Concurrence in Senate Amendments",47,25,7,0,79
892573,605295,2017-03-15,Assembly,"Do pass as amended",6,0,1,0,7
892573,654125,2017-05-30,Assembly,"AB 23 RIDLEY-THOMAS Third Reading Urgency Amendment Set #1",47,22,11,0,80
892573,656811,2017-06-01,Assembly,"AB 23 RIDLEY-THOMAS Third Reading Urgency",72,1,7,0,80
892573,671297,2017-07-05,Senate,"Do pass, but first be re-referred to the Committee on [Judiciary]",5,0,2,0,7
892573,672864,2017-07-18,Senate,"Do pass as amended",7,0,0,0,7
892573,675126,2017-09-07,Senate,"Assembly 3rd Reading AB23 Ridley-Thomas et al. By Mitchell Urgency Clause",40,0,0,0,40
892573,675399,2017-09-11,Assembly,"AB 23 RIDLEY-THOMAS Concurrence in Senate Amendments",75,0,4,0,79
892575,582531,2017-02-13,Assembly,"Be adopted. To third reading",9,0,2,0,11
892575,605417,2017-03-16,Senate,"Assembly 3rd Reading ACR1 Muratsuchi et al. By Pan",39,0,1,0,40
892576,618569,2017-04-04,Assembly,"Do pass and be re-referred to the Committee on [Public Safety]",15,0,1,0,16
892576,631840,2017-04-25,Assembly,"Do pass and be re-referred to the Committee on [Appropriations] with recommendation: To Consent Calendar",7,0,0,0,7
892576,651877,2017-05-26,Assembly,"Do pass as amended",16,0,1,0,17
892576,655761,2017-05-31,Assembly,"AB 40 SANTIAGO Third Reading Urgency",77,0,3,0,80
892576,670980,2017-07-03,Senate,"Do pass as amended, but first amend, and re-refer to the Committee on [Judiciary]",6,0,3,0,9
892576,672839,2017-07-18,Senate,"Do pass as amended, but first amend, and re-refer to the Committee on [Appropriations]",7,0,0,0,7
892576,674200,2017-08-28,Senate,"Placed on suspense file",7,0,0,0,7
892576,674502,2017-09-01,Senate,"Do pass as amended",7,0,0,0,7
892576,676178,2017-09-14,Senate,"Special Consent Calendar # AB40 Santiago By Lara Urgency Clause",40,0,0,0,40
892576,676179,2017-09-14,Assembly,"AB 40 Santiago Special Consent Calendar 1st Day",79,0,0,0,79
892577,603477,2017-03-14,Senate,"Do pass as amended, but first amend, and re-refer to the Committee on [Appropriations]",7,1,1,0,9
892577,618005,2017-04-03,Senate,"Placed on suspense file",7,0,0,0,7
892577,650680,2017-05-25,Senate,"Do pass as amended",5,2,0,0,7
892577,655975,2017-05-31,Senate,"Senate 3rd Reading SB42 Hill et al. Urgency Clause",28,11,1,0,40
892577,665256,2017-06-19,Assembly,"Do pass as amended and be re-referred to the Committee on [Judiciary]",6,1,1,0,8
892577,672233,2017-07-11,Assembly,"Do pass and be re-referred to the Committee on [Appropriations]",9,2,0,0,11
892577,674833,2017-09-01,Assembly,"Do pass",11,5,1,0,17
892577,675207,2017-09-07,Assembly,"SB 42 Hill Third Reading Urgency By MULLIN",57,20,2,0,79
892577,675424,2017-09-11,Senate,"Unfinished Business SB42 Hill et al. Urgency Clause Concurrence",28,12,0,0,40
892578,642698,2017-05-10,Assembly,"Be adopted and re-referred to the Committee on [Appropriations]",7,0,0,0,7
892578,651965,2017-05-26,Assembly,"Be adopted",17,0,0,0,17
892578,655852,2017-05-31,Assembly,"ACA 1 MULLIN Assembly Third Reading",75,0,5,0,80
892578,672616,2017-07-12,Senate,"Be adopted, but first be re-referred to the Committee on [Appropriations]",5,0,0,0,5
892578,672728,2017-07-17,Senate,"Assembly 3rd Reading ACA1 Mayes By Roth",27,13,0,0,40
892578,672729,2017-07-17,Assembly,"ACA 1 MAYES Concurrence in Senate Amendments",59,11,9,0,79
892579,614860,2017-03-28,Senate,"Do pass, but first be re-referred to the Committee on [Appropriations]",6,1,0,0,7
892579,626117,2017-04-17,Senate,"Placed on suspense file",7,0,0,0,7
892580,627883,2017-04-19,Assembly,"Do pass and be re-referred to the Committee on [Jobs, Economic Development, and the Economy]",7,0,0,0,7
892580,631816,2017-04-25,Assembly,"Do pass and be re-referred to the Committee on [Appropriations]",6,1,0,0,7
892580,645883,2017-05-17,Assembly,"Do pass",12,4,1,0,17
892580,647809,2017-05-22,Assembly,"AB 56 HOLDEN Assembly Third Reading",61,13,6,0,80
892580,662462,2017-06-13,Senate,"Do pass, but first be re-referred to the Committee on [Business, Professions and Economic Development]",12,1,0,0,13
892580,669051,2017-06-26,Senate,"Do pass, but first be re-referred to the Committee on [Appropriations]",9,0,0,0,9
892580,674360,2017-08-31,Senate,"Assembly 3rd Reading AB56 Holden By Atkins",39,1,0,0,40
892583,608191,2017-03-21,Senate,"Do pass as amended, but first amend, and re-refer to the Committee on [Judiciary]",4,2,1,0,7
892583,633216,2017-04-25,Senate,"Do pass as amended, but first amend, and re-refer to the Committee on [Appropriations]",5,2,0,0,7
892583,644412,2017-05-15,Senate,"Placed on suspense file",7,0,0,0,7
892583,650452,2017-05-25,Senate,"Do pass as amended",5,2,0,0,7
892583,655952,2017-05-31,Senate,"Senate 3rd Reading SB21 Hill et al",21,15,4,0,40
892583,669000,2017-06-27,Assembly,"Do pass and be re-referred to the Committee on [Privacy and Consumer Protection]",4,2,1,0,7
892583,672146,2017-07-11,Assembly,"Do pass as amended and be re-referred to the Committee on [Appropriations]",6,3,1,0,10
892583,777582,2017-05-25,Senate,,7,0,0,0,7
892584,573681,2017-01-31,Senate,"Do pass, but first be re-referred to the Committee on [Appropriations]",6,0,1,0,7
892584,602420,2017-03-13,Senate,"Do pass",5,0,2,0,7
892584,617550,2017-04-03,Senate,"Senate 3rd Reading SB31 Lara et al. Urgency Clause",36,0,4,0,40
892584,662463,2017-06-13,Assembly,"Do pass and be re-referred to the Committee on [Appropriations]",11,0,0,0,11
892584,674589,2017-09-01,Assembly,"Do pass",16,0,1,0,17
892584,676589,2017-09-15,Assembly,"SB 31 Lara Third Reading Urgency By CHIU",76,2,1,0,79
892584,676590,2017-09-15,Senate,"Unfinished Business SB31 Lara et al. Urgency Clause Concurrence",36,0,4,0,40
892585,684738,2018-01-09,Assembly,"Do pass and be re-referred to the Committee on [Appropriations]",7,0,0,0,7
892585,686224,2018-01-18,Assembly,"Do pass as amended",16,0,1,0,17
892586,608343,2017-03-21,Senate,"Do pass as amended, but first amend, and re-refer to the Committee on [Appropriations]",7,0,0,0,7
892586,625951,2017-04-17,Senate,"Placed on suspense file",7,0,0,0,7
892587,627764,2017-04-19,Assembly,"Do pass and be re-referred to the Committee on [Appropriations]",4,1,2,0,7
892587,637457,2017-05-03,Assembly,"Do pass",11,4,2,0,17
892587,640434,2017-05-08,Assembly,"AB 22 BONTA Assembly Third Reading",41,30,9,0,80
892587,672067,2017-07-11,Senate,"Do pass as amended",12,0,1,0,13
892587,675700,2017-09-12,Senate,"Assembly 3rd Reading AB22 Bonta By Glazer",39,0,1,0,40
892587,676066,2017-09-14,Assembly,"With recommendation: That Senate amendments be concurred in",9,0,1,0,10
892587,676480,2017-09-15,Assembly,"AB 22 BONTA Concurrence in Senate Amendments",78,0,1,0,79
892588,614885,2017-03-29,Senate,"Do pass as amended, but first amend, and re-refer to the Committee on [Public Safety]",7,0,0,0,7
892588,631968,2017-04-25,Senate,"Do pass as amended, but first amend, and re-refer to the Committee on [Appropriations]",6,0,1,0,7
892588,644421,2017-05-15,Senate,"Placed on suspense file",7,0,0,0,7
892589,633370,2017-04-26,Assembly,"Do pass as amended and be re-referred to the Committee on [Appropriations]",7,0,0,0,7
892589,649381,2017-05-24,Assembly,"Do pass",11,5,1,0,17
892589,654477,2017-05-30,Assembly,"AB 62 WOOD Assembly Third Reading",48,21,11,0,80
892591,566287,2016-12-05,Senate,"W/O REF. TO FILE SR7 De León",27,3,10,0,40
892592,629136,2017-04-19,Senate,"Do pass, but first be re-referred to the Committee on [Appropriations]",9,0,0,0,9
892592,644361,2017-05-15,Senate,"Placed on suspense file",7,0,0,0,7
892592,650744,2017-05-25,Senate,"Do pass",7,0,0,0,7
892592,654435,2017-05-30,Senate,"Senate 3rd Reading SB43 Hill et al",40,0,0,0,40
892593,642532,2017-05-10,Assembly,"Be adopted. To third reading",5,2,0,0,7
892593,644314,2017-05-15,Assembly,"AJR 1 LOW Assembly Third Reading",46,26,8,0,80
892593,658762,2017-06-06,Senate,"Be adopted. Ordered to third reading",3,1,1,0,5
892593,673782,2017-08-21,Senate,"Assembly 3rd Reading AJR1 Low et al. By Hill",26,12,2,0,40
892594,618183,2017-04-03,Senate,"Do pass, but first be re-referred to the Committee on [Veterans Affairs]",9,0,0,0,9
892594,631683,2017-04-25,Senate,"Do pass, but first be re-referred to the Committee on [Appropriations]",7,0,0,0,7
892594,644600,2017-05-15,Senate,"Placed on suspense file",7,0,0,0,7
892595,633466,2017-04-26,Senate,"Do pass, but first be re-referred to the Committee on [Appropriations] with the recommendation: To Consent Calendar",7,0,0,0,7
892595,644458,2017-05-15,Senate,"Consent Calendar 2nd SB25 Portantino et al. Urgency Clause",39,0,1,0,40
892595,740504,2018-04-16,Assembly,"Be re-referred to the Committee on [Elections and Redistricting]",9,0,2,0,11
892595,768879,2018-06-27,Assembly,"Do pass as amended",6,1,0,0,7
892595,771787,2018-08-16,Assembly,"Do pass as amended",12,0,5,0,17
892595,773402,2018-08-29,Assembly,"SB 25 Portantino Senate Third Reading By RUBIO",65,12,3,0,80
892595,773793,2018-08-30,Senate,"That the Assembly amendments be concurred in",4,1,0,0,5
892595,774123,2018-08-31,Senate,"Unfinished Business SB25 Portantino et al. Concurrence",29,9,2,0,40
892597,621169,2017-04-06,Assembly,"Be adopted. To third reading",9,0,2,0,11
892597,625931,2017-04-17,Assembly,"AJR 3 NAZARIAN Assembly Third Reading",76,0,4,0,80
892597,644350,2017-05-15,Senate,"Special Consent Calendar # AJR3",39,0,1,0,40
892700,571906,2017-01-26,Senate,"Senate 3rd Reading SCR5 Mendoza",38,0,2,0,40
892700,577954,2017-02-06,Assembly,"Be adopted. To Consent Calendar",11,0,0,0,11
892700,580897,2017-02-09,Assembly,"SCR 5 Mendoza Consent Calendar Second Day Regular Session",78,0,2,0,80
893404,599932,2017-03-08,Assembly,"Do pass and be re-referred to the Committee on [Health]",6,1,0,0,7
893404,608420,2017-03-21,Assembly,"Do pass and be re-referred to the Committee on [Appropriations]",13,1,1,0,15
893404,651555,2017-05-26,Assembly,"Do pass",12,5,0,0,17
893404,656980,2017-06-01,Assembly,"AB 74 CHIU Assembly Third Reading",61,16,3,0,80
893404,669007,2017-06-27,Senate,"Do pass, but first be re-referred to the Committee on [Appropriations]",11,1,1,0,13
893404,672698,2017-07-17,Senate,"Placed on suspense file",7,0,0,0,7
893404,674638,2017-09-01,Senate,"Do pass as amended",7,0,0,0,7
893404,675428,2017-09-11,Senate,"Assembly 3rd Reading AB74 Chiu et al. By Glazer",35,0,5,0,40
893404,675899,2017-09-13,Assembly,"AB 74 CHIU Concurrence in Senate Amendments",60,18,1,0,79
893405,621047,2017-04-05,Assembly,"Do pass and be re-referred to the Committee on [Natural Resources]",5,0,4,0,9
893405,631727,2017-04-24,Assembly,"Do pass as amended and be re-referred to the Committee on [Appropriations]",7,1,2,0,10
893405,651705,2017-05-26,Assembly,"Do pass",12,5,0,0,17
893405,656932,2017-06-01,Assembly,"AB 73 CHIU Assembly Third Reading",56,20,4,0,80
893405,669127,2017-06-27,Senate,"Do pass, but first be re-referred to the Committee on [Environmental Quality]",8,3,2,0,13
893405,671348,2017-07-05,Senate,"Do pass, but first be re-referred to the Committee on [Governance and Finance]",4,2,1,0,7
893405,672367,2017-07-12,Senate,"Do pass, but first be re-referred to the Committee on [Appropriations]",5,2,0,0,7
893405,672735,2017-07-17,Senate,"Do pass",5,2,0,0,7
893405,676525,2017-09-15,Senate,"Assembly 3rd Reading AB73 Chiu et al. By Roth",25,10,5,0,40
893405,676526,2017-09-15,Assembly,"AB 73 CHIU Concurrence in Senate Amendments",54,23,2,0,79
893405,777238,2017-09-15,Senate,"Assemblpan=""2""> ?",5,10,5,0,20
893407,599928,2017-03-08,Assembly,"Do pass and be re-referred to the Committee on [Revenue and Taxation]",5,2,0,0,7
893407,645176,2017-05-15,Assembly,"Do pass and be re-referred to the Committee on [Appropriations]",7,3,0,0,10
893407,651591,2017-05-26,Assembly,"Do pass",10,6,1,0,17
893408,633526,2017-04-26,Assembly,"Do pass and be re-referred to the Committee on [Appropriations]",6,1,0,0,7
893408,651692,2017-05-26,Assembly,"Do pass",13,4,0,0,17
893408,656816,2017-06-01,Assembly,"AB 72 SANTIAGO Assembly Third Reading",58,19,3,0,80
893408,672114,2017-07-11,Senate,"Do pass, but first be re-referred to the Committee on [Appropriations]",11,2,0,0,13
893408,672695,2017-07-17,Senate,"Do pass",5,2,0,0,7
893408,676544,2017-09-15,Senate,"Assembly 3rd Reading AB72 Santiago et al. By Atkins",28,8,4,0,40
893408,676545,2017-09-15,Assembly,"AB 72 SANTIAGO Concurrence in Senate Amendments",58,18,3,0,79
893408,777782,2017-09-15,Senate,"Asse  ?",5,8,4,0,17
893630,674855,2017-09-05,Senate,"Senate 3rd Reading SCR6 Nguyen et al",38,0,2,0,40
893630,675301,2017-09-11,Assembly,"Be adopted. To third reading",7,0,4,0,11
893778,631824,2017-04-25,Senate,"Be adopted, but first be re-referred to the Committee on [Appropriations]",11,0,2,0,13
893778,644541,2017-05-15,Senate,"Senate 3rd Reading SCR8 Portantino et al",35,1,4,0,40
893778,671941,2017-07-10,Assembly,"Be adopted. To third reading",11,3,0,0,14
893778,674289,2017-08-31,Assembly,"SCR 8 Portantino Senate Third Reading By FRAZIER",52,5,22,0,79
893778,674926,2017-09-05,Senate,"Unfinished Business SCR8 Portantino et al. Concurrence",38,0,2,0,40
893779,567595,2017-01-13,Senate,"Senate 3rd Reading SCR7 Moorlach",35,0,5,0,40
893779,578164,2017-02-06,Assembly,"Be adopted. To Consent Calendar",11,0,0,0,11
893779,581034,2017-02-09,Assembly,"SCR 7 Moorlach Consent Calendar Second Day Regular Session",78,0,2,0,80
893779,582525,2017-02-13,Senate,"Unfinished Business SCR7 Moorlach et al. Concurrence",38,0,2,0,40
893962,610246,2017-03-22,Senate,"Do pass, but first be re-referred to the Committee on [Appropriations]",7,0,0,0,7
893962,617536,2017-04-03,Senate,"Do pass",7,0,0,0,7
893962,621115,2017-04-06,Senate,"Senate 3rd Reading SB61 Hertzberg",39,0,1,0,40
893962,667340,2017-06-19,Assembly,"Do pass as amended and be re-referred to the Committee on [Appropriations]",9,0,1,0,10
893962,672876,2017-07-19,Assembly,"Do pass. To Consent Calendar",16,0,1,0,17
893962,674136,2017-08-24,Assembly,"SB 61 Hertzberg Consent Calendar Second Day Regular Session",76,0,3,0,79
893962,674422,2017-08-31,Senate,"Special Consent Calendar # SB61",37,0,3,0,40
893963,609022,2017-03-21,Senate,"Be adopted. Ordered to third reading",4,1,0,0,5
893963,612773,2017-03-27,Senate,"Senate 3rd Reading SJR3 Hill et al",25,12,3,0,40
893963,663228,2017-06-14,Assembly,"Be adopted. To third reading",4,2,1,0,7
893963,670273,2017-06-29,Assembly,"SJR 3 Hill Senate Third Reading By LOW",44,24,12,0,80
894144,610116,2017-03-22,Senate,"Do pass as amended, but first amend, and re-refer to the Committee on [Judiciary]",4,1,0,0,5
894144,620087,2017-04-04,Senate,"Do pass as amended, but first amend, and re-refer to the Committee on [Appropriations]",4,1,2,0,7
894144,630513,2017-04-24,Senate,"Placed on suspense file",7,0,0,0,7
894144,650676,2017-05-25,Senate,"Do pass as amended",5,2,0,0,7
894144,654218,2017-05-30,Senate,"Senate 3rd Reading SB63 Jackson et al",25,13,2,0,40
894144,667174,2017-06-21,Assembly,"Do pass and be re-referred to the Committee on [Judiciary]",5,1,1,0,7
894144,669006,2017-06-27,Assembly,"Do pass and be re-referred to the Committee on [Appropriations]",9,1,1,0,11
894144,674604,2017-09-01,Assembly,"Do pass",10,6,1,0,17
894144,675596,2017-09-12,Assembly,"SB 63 Jackson Senate Third Reading By GONZALEZ FLETCHER",51,15,13,0,79
894144,675758,2017-09-13,Senate,"Unfinished Business SB63 Jackson et al. Concurrence",25,13,2,0,40
894145,627712,2017-04-18,Senate,"Do pass, but first be re-referred to the Committee on [Appropriations]",8,2,1,0,11
894145,638646,2017-05-04,Senate,"Senate 3rd Reading SB64 Wieckowski",26,11,3,0,40
894145,758874,2018-05-31,Assembly,"Be re-referred to the Committees on [Natural Resources] and [Utilities and Energy]",7,0,4,0,11
894145,765116,2018-06-18,Assembly,"Do pass as amended and be re-referred to the Committee on [Utilities and Energy]",6,3,1,0,10
894145,768772,2018-06-27,Assembly,"Do pass as amended and be re-referred to the Committee on [Appropriations]",9,5,1,0,15
894145,771924,2018-08-16,Assembly,"Do pass as amended",12,0,5,0,17
894145,773291,2018-08-29,Assembly,"SB 64 Wieckowski Senate Third Reading By EGGMAN",33,37,10,0,80
894145,777398,2018-08-16,Assembly,,9,0,5,0,14
894146,627054,2017-04-18,Senate,"Do pass, but first be re-referred to the Committee on [Business, Professions and Economic Development] with the recommendation: To Consent Calendar",12,0,1,0,13
894146,631767,2017-04-24,Senate,"Do pass, but first be re-referred to the Committee on [Appropriations]",9,0,0,0,9
894146,644300,2017-05-15,Senate,"Placed on suspense file",7,0,0,0,7
894146,650742,2017-05-25,Senate,"Do pass as amended",6,0,1,0,7
894146,656092,2017-05-31,Senate,"Senate 3rd Reading SB62 Jackson et al",39,0,1,0,40
894146,672133,2017-07-11,Assembly,"Do pass and be re-referred to the Committee on [Housing and Community Development]",6,0,1,0,7
894146,672332,2017-07-12,Assembly,"Do pass as amended and be re-referred to the Committee on [Appropriations]",7,0,0,0,7
894679,619776,2017-04-04,Senate,"Do pass, but first be re-referred to the Committee on [Public Safety]",10,0,3,0,13
894679,631460,2017-04-25,Senate,"Do pass as amended, but first amend, and re-refer to the Committee on [Appropriations]",7,0,0,0,7
894679,654346,2017-05-30,Senate,"Senate 3rd Reading SB65 Hill et al",40,0,0,0,40
894679,672101,2017-07-11,Assembly,"Do pass and be re-referred to the Committee on [Appropriations]",6,0,1,0,7
894679,672850,2017-07-19,Assembly,"Do pass. To Consent Calendar",16,0,1,0,17
894679,674084,2017-08-24,Assembly,"SB 65 Hill Consent Calendar Second Day Regular Session",76,0,3,0,79
898133,578260,2017-02-06,Assembly,"Be adopted. To third reading",11,0,0,0,11
898133,587588,2017-02-17,Senate,"W/O REF. TO FILE ACR6 Holden By Bradford",34,0,6,0,40
898135,571754,2017-01-26,Senate,"Senate 3rd Reading SCR13 Pan",37,0,3,0,40
898135,582506,2017-02-13,Assembly,"Be adopted. To Consent Calendar",9,0,2,0,11
898135,587446,2017-02-17,Assembly,"SCR 13 Pan Consent Calendar Second Day",72,0,8,0,80
898135,589696,2017-02-21,Senate,"Unfinished Business SCR13 Pan et al. Concurrence",38,0,2,0,40
898136,567057,2017-01-09,Assembly,"Be adopted as amended",11,0,0,0,11
898136,568143,2017-01-17,Senate,"Assembly 3rd Reading ACR5 Holden et al. By Bradford",38,0,2,0,40
898138,665342,2017-06-19,Senate,"Senate 3rd Reading SCR12 Pan",39,0,1,0,40
898138,670974,2017-07-03,Assembly,"Be adopted. To Consent Calendar",11,0,0,0,11
898138,671614,2017-07-06,Assembly,"SCR 12 Pan Consent Calendar Second Day Regular Session",74,0,6,0,80
898138,674113,2017-08-24,Senate,"Special Consent SCR12",38,0,2,0,40
898140,620007,2017-04-05,Assembly,"Do pass and be re-referred to the Committee on [Appropriations]",6,1,0,0,7
898141,569089,2017-01-19,Assembly,"Be adopted. To third reading",9,0,2,0,11
898141,587477,2017-02-17,Senate,"Special Consent Calendar # ACR4",30,0,10,0,40
898143,644256,2017-05-15,Senate,"Senate 3rd Reading SCR14 Pan et al",39,0,1,0,40
898143,651426,2017-05-26,Assembly,"Be adopted. To Consent Calendar",9,0,2,0,11
898143,655824,2017-05-31,Assembly,"SCR 14 Pan Consent Calendar Second Day",76,0,4,0,80
898145,594856,2017-02-28,Assembly,"Do pass and be re-referred to the Committee on [Appropriations] with recommendation: To Consent Calendar",7,0,0,0,7
898145,620077,2017-04-05,Assembly,"Do pass. To Consent Calendar",17,0,0,0,17
898145,629143,2017-04-20,Assembly,"AB 78 COOPER Consent Calendar Second Day Regular Session",74,0,6,0,80
898145,662395,2017-06-13,Senate,"Do pass, but first be re-referred to the Committee on [Appropriations] with the recommendation: To Consent Calendar",7,0,0,0,7
898145,670952,2017-07-03,Senate,"Consent Calendar 2nd AB78",33,0,7,0,40
898148,674707,2017-09-01,Senate,"Senate 3rd Reading SCR9 Pan",37,0,3,0,40
898148,675271,2017-09-08,Assembly,"Be adopted. To Consent Calendar",9,0,2,0,11
898148,675648,2017-09-12,Assembly,"SCR 9 Pan Consent Calendar Second Day",79,0,0,0,79
898150,582444,2017-02-13,Senate,"Senate 3rd Reading SCR11 Pan",38,0,2,0,40
898150,605283,2017-03-16,Assembly,"Be adopted. To Consent Calendar",9,0,2,0,11
898150,611170,2017-03-23,Assembly,"SCR 11 Pan Consent Calendar Second Day Regular Session",76,0,4,0,80
898151,604398,2017-03-15,Assembly,"Do pass as amended and be re-referred to the Committee on [Natural Resources]",10,5,0,0,15
898151,619189,2017-04-03,Assembly,"Do pass as amended and be re-referred to the Committee on [Appropriations]",7,3,0,0,10
898151,651837,2017-05-26,Assembly,"Do pass",12,5,0,0,17
898151,655815,2017-05-31,Assembly,"AB 79 LEVINE Assembly Third Reading",56,19,5,0,80
898151,666190,2017-06-20,Senate,"Do pass as amended, but first amend, and re-refer to the Committee on [Environmental Quality]",9,1,1,0,11
898151,671302,2017-07-05,Senate,"Do pass, but first be re-referred to the Committee on [Appropriations]",5,2,0,0,7
898151,672748,2017-07-17,Senate,"Placed on suspense file",7,0,0,0,7
898151,674660,2017-09-01,Senate,"Do pass as amended",5,2,0,0,7
898151,675503,2017-09-11,Senate,"Assembly 3rd Reading AB79 Levine et al. By Stern",28,11,1,0,40
898151,675948,2017-09-13,Assembly,"AB 79 LEVINE Concurrence in Senate Amendments",56,21,2,0,79
898153,627028,2017-04-18,Assembly,"Do pass and be re-referred to the Committee on [Privacy and Consumer Protection]",15,0,1,0,16
898153,631711,2017-04-25,Assembly,"Do pass and be re-referred to the Committee on [Appropriations]",10,0,0,0,10
898153,651910,2017-05-26,Assembly,"Do pass",17,0,0,0,17
898153,656077,2017-05-31,Assembly,"AB 76 CHAU Assembly Third Reading",77,0,3,0,80
898153,669137,2017-06-26,Senate,"Do pass, but first be re-referred to the Committee on [Judiciary]",9,0,0,0,9
898153,672388,2017-07-11,Senate,"Do pass, but first be re-referred to the Committee on [Appropriations] with the recommendation: To Consent Calendar",7,0,0,0,7
898153,673764,2017-08-21,Senate,"Placed on suspense file",7,0,0,0,7
899607,608186,2017-03-21,Assembly,"Do pass and be re-referred to the Committee on [Appropriations]",15,0,0,0,15
899607,651934,2017-05-26,Assembly,"Do pass as amended",12,0,5,0,17
899607,656039,2017-05-31,Assembly,"AB 82 MEDINA Assembly Third Reading",68,2,10,0,80
899607,672631,2017-07-12,Senate,"Do pass, but first be re-referred to the Committee on [Appropriations]",8,0,1,0,9
899607,673786,2017-08-21,Senate,"Placed on suspense file",7,0,0,0,7
899607,674456,2017-09-01,Senate,"Do pass as amended",7,0,0,0,7
899607,675816,2017-09-13,Senate,"Assembly 3rd Reading AB82 Medina et al. By Lara",39,1,0,0,40
899607,676359,2017-09-14,Assembly,"AB 82 Medina Concurrence in Senate Amendments",69,2,8,0,79
899609,633491,2017-04-26,Assembly,"Do pass",6,1,0,0,7
899609,638624,2017-05-04,Assembly,"AB 84 MULLIN Assembly Third Reading",52,20,8,0,80
899609,672538,2017-07-12,Senate,"Do pass",4,0,1,0,5
899609,771449,2018-08-14,Senate,"Do pass, but first be re-referred to the Committee on [Appropriations]",3,2,0,0,5
899612,614984,2017-03-29,Assembly,"Do pass and be re-referred to the Committee on [Appropriations]",5,2,0,0,7
899612,651878,2017-05-26,Assembly,"Do pass",12,5,0,0,17
899612,656277,2017-05-31,Assembly,"AB 83 SANTIAGO Assembly Third Reading",54,23,3,0,80
899612,668694,2017-06-26,Senate,"Do pass, but first be re-referred to the Committee on [Judiciary]",3,2,0,0,5
899612,672527,2017-07-11,Senate,"Do pass, but first be re-referred to the Committee on [Appropriations]",5,2,0,0,7
899612,673936,2017-08-21,Senate,"Placed on suspense file",7,0,0,0,7
899612,674795,2017-09-01,Senate,"Do pass as amended",5,2,0,0,7
899612,675440,2017-09-11,Senate,"Assembly 3rd Reading AB83 Santiago By Wiener",26,12,2,0,40
899612,675960,2017-09-13,Assembly,"With recommendation: That Senate amendments be concurred in",5,1,1,0,7
899612,676262,2017-09-14,Assembly,"AB 83 SANTIAGO Concurrence in Senate Amendments",54,25,0,0,79
899612,774573,2017-08-21,Senate,,5,2,0,0,7
899615,609874,2017-03-22,Senate,"Do pass, but first be re-referred to the Committee on [Appropriations]",5,2,0,0,7
899615,656221,2017-05-31,Senate,"Senate 3rd Reading SB66 Wieckowski",27,13,0,0,40
899617,684187,2018-01-08,Assembly,"Do pass and be re-referred to the Committee on [Communications and Conveyance]",9,4,1,0,14
899617,685834,2018-01-11,Assembly,"Do pass and be re-referred to the Committee on [Appropriations]",9,4,0,0,13
899617,686151,2018-01-18,Assembly,"Do pass",12,5,0,0,17
899617,690074,2018-01-29,Assembly,"AB 87 TING Assembly Third Reading",45,27,5,0,77
899617,762263,2018-06-12,Senate,"Do pass, but first be re-referred to the Committee on [Public Safety]",12,0,1,0,13
899617,768249,2018-06-26,Senate,"Do pass, but first be re-referred to the Committee on [Appropriations] with the recommendation: To Consent Calendar",7,0,0,0,7
899617,771339,2018-08-13,Senate,"Assembly 3rd Reading AB87 Ting et al. By Allen",37,0,3,0,40
899617,772553,2018-08-23,Assembly,"With recommendation: That Senate amendments be concurred in",13,0,1,0,14
899617,772954,2018-08-27,Assembly,"AB 87 TING Concurrence in Senate Amendments",80,0,0,0,80
899621,618498,2017-04-04,Senate,"Do pass as amended, but first amend, and re-refer to the Committee on [Appropriations]",5,0,2,0,7
899621,635694,2017-05-01,Senate,"Placed on suspense file",7,0,0,0,7
899623,610023,2017-03-22,Senate,"Do pass as amended, but first amend, and re-refer to the Committee on [Appropriations]",6,0,1,0,7
899623,625920,2017-04-17,Senate,"Placed on suspense file",7,0,0,0,7
899623,650555,2017-05-25,Senate,"Do pass as amended",5,2,0,0,7
899623,656800,2017-06-01,Senate,"Senate 3rd Reading SB68 Lara",31,9,0,0,40
899623,672063,2017-07-11,Assembly,"Do pass and be re-referred to the Committee on [Appropriations]",10,2,1,0,13
899623,674727,2017-09-01,Assembly,"Do pass as amended",11,5,1,0,17
899623,675921,2017-09-13,Assembly,"SB 68 Lara Senate Third Reading By BOCANEGRA",54,19,6,0,79
899623,676078,2017-09-14,Senate,"Unfinished Business SB68 Lara et al. Concurrence",29,10,1,0,40
899627,613822,2017-03-28,Assembly,"Do pass as amended and be re-referred to the Committee on [Appropriations]",7,0,0,0,7
899627,643246,2017-05-10,Assembly,"Do pass. To Consent Calendar",17,0,0,0,17
899627,646526,2017-05-18,Assembly,"AB 86 CALDERON Consent Calendar Second Day Regular Session",69,0,11,0,80
899627,669176,2017-06-27,Senate,"Do pass, but first be re-referred to the Committee on [Appropriations]",13,0,0,0,13
899627,671827,2017-07-10,Senate,"Placed on suspense file",7,0,0,0,7
899629,599040,2017-03-07,Assembly,"Do pass and be re-referred to the Committee on [Veterans Affairs]",7,0,0,0,7
899629,610511,2017-03-21,Assembly,"Do pass and be re-referred to the Committee on [Appropriations]",8,0,2,0,10
899629,652118,2017-05-26,Assembly,"Do pass",14,0,3,0,17
899629,655994,2017-05-31,Assembly,"AB 85 RODRIGUEZ Assembly Third Reading",70,1,9,0,80
899629,669222,2017-06-27,Senate,"Do pass as amended, but first amend, and re-refer to the Committee on [Veterans Affairs]",5,0,0,0,5
899629,774488,2017-03-21,Assembly,,7,0,2,0,9
899631,610053,2017-03-22,Assembly,"Do pass as amended and be re-referred to the Committee on [Appropriations]",7,0,0,0,7
899631,633507,2017-04-26,Assembly,"Do pass. To Consent Calendar",16,0,1,0,17
899631,638647,2017-05-04,Assembly,"AB 81 GONZALEZ FLETCHER Consent Calendar Second Day Regular Session",76,0,4,0,80
899631,660087,2017-06-07,Senate,"Do pass, but first be re-referred to the Committee on [Appropriations]",7,0,0,0,7
899631,668641,2017-06-26,Senate,"Placed on suspense file",7,0,0,0,7
899631,674690,2017-09-01,Senate,"Do pass as amended",7,0,0,0,7
899631,675311,2017-09-11,Senate,"Assembly 3rd Reading AB81 Gonzalez Fletcher By Lara",39,0,1,0,40
899631,675785,2017-09-13,Assembly,"AB 81 GONZALEZ FLETCHER Concurrence in Senate Amendments",77,0,2,0,79
899633,618322,2017-04-04,Senate,"Do pass, but first be re-referred to the Committee on [Appropriations]",1,3,3,0,7
899633,618323,2017-04-04,Senate,"[First] hearing set for [04-04-2017]: Failed passage in Committee. Reconsideration granted",4,0,3,0,7
899633,684762,2018-01-09,Senate,"Do pass, but first be re-referred to the Committee on [Appropriations]",2,3,2,0,7
902363,604357,2017-03-15,Assembly,"Do pass. To Consent Calendar",17,0,4,0,21
902363,611123,2017-03-23,Assembly,"AB 88 NAZARIAN Assembly Third Reading",76,0,4,0,80
902363,662421,2017-06-13,Senate,"Do pass and be ordered to the Consent Calendar",12,0,1,0,13
902363,664999,2017-06-19,Senate,"Consent Calendar 2nd AB88",33,0,7,0,40
902377,618514,2017-04-04,Senate,"Do pass as amended, but first amend, and re-refer to the Committee on [Transportation and Housing]",8,3,0,0,11
902377,641580,2017-05-09,Senate,"Do pass as amended, but first amend, and re-refer to the Committee on [Appropriations]",9,3,1,0,13
902377,647961,2017-05-22,Senate,"Placed on suspense file",7,0,0,0,7
902377,650708,2017-05-25,Senate,"Do pass as amended",5,2,0,0,7
902377,656013,2017-05-31,Senate,"Senate 3rd Reading SB71 Wiener et al",24,13,3,0,40
902377,740824,2018-04-16,Assembly,"Be re-referred to the Committees on [Natural Resources] and [Judiciary]",9,0,2,0,11
902377,768167,2018-06-25,Assembly,"Do pass as amended and be re-referred to the Committee on [Judiciary]",6,1,3,0,10
902377,769700,2018-07-03,Assembly,"Do pass as amended",8,0,2,0,10
902392,571785,2017-01-26,Assembly,"Be adopted. To third reading",8,0,2,0,10
902392,573121,2017-01-30,Assembly,"HR 6 BURKE Assembly Third Reading",57,17,6,0,80
902407,606856,2017-03-20,Assembly,"Do pass as amended and be re-referred to the Committee on [Appropriations]",11,2,1,0,14
902407,651830,2017-05-26,Assembly,"Do pass as amended",12,0,5,0,17
902407,655974,2017-05-31,Assembly,"AB 91 CERVANTES Assembly Third Reading",73,1,6,0,80
902407,672021,2017-07-11,Senate,"Do pass, but first be re-referred to the Committee on [Appropriations]",13,0,0,0,13
902407,673797,2017-08-21,Senate,"Placed on suspense file",7,0,0,0,7
902407,674612,2017-09-01,Senate,"Do pass",7,0,0,0,7
902407,773504,2018-08-29,Assembly,"With recommendation: That Senate amendments be concurred in",13,0,1,0,14
902407,773505,2018-08-29,Senate,"Assembly 3rd Reading AB91 Cervantes et al. By Roth",39,0,1,0,40
902407,773858,2018-08-30,Assembly,"AB 91 CERVANTES Concurrence in Senate Amendments",78,0,2,0,80
902422,613788,2017-03-28,Assembly,"Do pass and be re-referred to the Committee on [Appropriations]",16,0,0,0,16
902422,633207,2017-04-26,Assembly,"Do pass. To Consent Calendar",16,0,1,0,17
902422,638528,2017-05-04,Assembly,"AB 93 MEDINA Consent Calendar Second Day Regular Session",76,0,4,0,80
902422,732550,2018-04-02,Senate,"Do pass, but first be re-referred to the Committee on [Appropriations]",9,0,0,0,9
902422,767890,2018-06-25,Senate,"Do pass",7,0,0,0,7
902422,772237,2018-08-20,Senate,"Assembly 3rd Reading AB93 Medina By Pan",39,0,1,0,40
902422,772541,2018-08-23,Assembly,"AB 93 MEDINA Concurrence in Senate Amendments",79,0,1,0,80
902437,626774,2017-04-18,Assembly,"Do pass and be re-referred to the Committee on [Appropriations]",5,2,0,0,7
902437,651606,2017-05-26,Assembly,"Do pass",10,6,1,0,17
902437,656852,2017-06-01,Assembly,"AB 90 WEBER Assembly Third Reading",42,36,2,0,80
902437,672200,2017-07-11,Senate,"Do pass as amended, but first amend, and re-refer to the Committee on [Appropriations]",5,2,0,0,7
902437,673819,2017-08-21,Senate,"Placed on suspense file",7,0,0,0,7
902437,674498,2017-09-01,Senate,"Do pass as amended",5,2,0,0,7
902437,675769,2017-09-13,Senate,"Assembly 3rd Reading AB90 Weber et al. By Mitchell",25,14,1,0,40
902437,676270,2017-09-14,Assembly,"AB 90 Weber Concurrence in Senate Amendments",42,32,5,0,79
902452,613898,2017-03-28,Assembly,"Do pass and be re-referred to the Committee on [Appropriations]",14,1,1,0,16
902452,619911,2017-04-05,Assembly,"Do pass",17,0,0,0,17
902452,628970,2017-04-20,Assembly,"AB 89 LEVINE Assembly Third Reading",72,1,7,0,80
902452,657912,2017-06-05,Senate,"Do pass, but first be re-referred to the Committee on [Appropriations]",9,0,0,0,9
902452,673814,2017-08-21,Senate,"Assembly 3rd Reading AB89 Levine et al. By Hill",37,1,2,0,40
902467,567647,2017-01-13,Senate,"Be adopted. Ordered to third reading",5,2,0,0,7
902467,568928,2017-01-19,Senate,"Senate 3rd Reading SR12 Atkins",22,7,11,0,40
902467,568929,2017-01-19,Senate,"Senate 3rd Reading SR12 Atkins Reconsider",30,0,10,0,40
902467,568930,2017-01-19,Senate,"Senate 3rd Reading SR12 Atkins",24,7,9,0,40
902481,684160,2018-01-08,Senate,"Do pass, but first be re-referred to the Committee on [Appropriations]",7,2,0,0,9
902481,685459,2018-01-16,Senate,"Do pass as amended",7,0,0,0,7
902481,686858,2018-01-22,Senate,"Senate 3rd Reading SB70 Bates",35,2,3,0,40
902481,762225,2018-06-12,Assembly,"Do pass as amended and be re-referred to the Committee on [Appropriations]",18,0,1,0,19
902481,768919,2018-06-27,Assembly,"Do pass. To Consent Calendar",16,0,1,0,17
902481,769764,2018-07-05,Assembly,"SB 70 Bates Consent Calendar Second Day Regular Session",69,0,11,0,80
902481,772348,2018-08-21,Senate,"Unfinished Business SB70 Bates Concurrence",36,2,2,0,40
902496,610322,2017-03-22,Assembly,"Do pass",7,0,0,0,7
902496,633085,2017-04-26,Assembly,"Do pass. To Consent Calendar",16,0,1,0,17
902496,638673,2017-05-04,Assembly,"AB 92 BONTA Consent Calendar Second Day Regular Session",76,0,4,0,80
902496,662250,2017-06-13,Senate,"Do pass and be ordered to the Consent Calendar",12,0,1,0,13
902496,664994,2017-06-19,Senate,"Consent Calendar 2nd AB92",33,0,7,0,40
905868,646375,2017-05-18,Assembly,"AB 123 TING Assembly Third Reading",45,25,10,0,80
905868,667309,2017-06-20,Senate,"Do pass",11,4,2,0,17
905869,646638,2017-05-18,Assembly,"AB 115 TING Assembly Third Reading",45,25,10,0,80
905869,662245,2017-06-13,Senate,"Do pass",12,4,1,0,17
905869,664137,2017-06-15,Senate,"Assembly 3rd Reading AB115 Ting et al. By Mitchell",28,10,2,0,40
905869,664138,2017-06-15,Assembly,"AB 115 TING Concurrence in Senate Amendments",58,19,3,0,80
905870,646472,2017-05-18,Assembly,"AB 120 TING Assembly Third Reading",45,25,10,0,80
905870,662261,2017-06-13,Senate,"Do pass",11,5,1,0,17
905870,664038,2017-06-15,Senate,"Assembly 3rd Reading AB120 Ting By Mitchell",27,11,2,0,40
905870,664039,2017-06-15,Assembly,"AB 120 TING Concurrence in Senate Amendments",68,8,4,0,80
905871,646557,2017-05-18,Assembly,"AB 106 TING Assembly Third Reading",45,25,10,0,80
905871,662509,2017-06-13,Senate,"Do pass",13,4,0,0,17
905871,714527,2018-03-01,Senate,"Do pass",15,0,1,0,16
905871,719862,2018-03-08,Senate,"Assembly 3rd Reading AB106 BUDGET (Ting) By Mitchell",35,1,3,0,39
905871,719863,2018-03-08,Assembly,"AB 106 BUDGET Concurrence in Senate Amendments By TING",69,1,7,0,77
905872,646627,2017-05-18,Assembly,"AB 105 TING Assembly Third Reading",45,25,10,0,80
905872,662507,2017-06-13,Senate,"Do pass",12,5,0,0,17
905872,714491,2018-03-01,Senate,"Do pass",15,0,1,0,16
905872,719779,2018-03-08,Senate,"Assembly 3rd Reading AB105 BUDGET (Ting) By Mitchell",36,0,3,0,39
905872,719780,2018-03-08,Assembly,"AB 105 BUDGET Concurrence in Senate Amendments By TING",71,0,6,0,77
905873,646631,2017-05-18,Assembly,"AB 107 TING Assembly Third Reading",45,25,10,0,80
905873,662510,2017-06-13,Senate,"Do pass",17,0,0,0,17
905873,664209,2017-06-15,Senate,"Assembly 3rd Reading AB107 BUDGET (Ting) By Mitchell",38,0,2,0,40
905873,664210,2017-06-15,Assembly,"AB 107 BUDGET Concurrence in Senate Amendments By TING",79,0,1,0,80
905874,672197,2017-07-11,Assembly,"Be adopted as amended",14,0,1,0,15
905874,674365,2017-08-31,Senate,"Assembly 3rd Reading ACR8 Jones-Sawyer et al. By Hernandez",38,0,2,0,40
905876,646470,2017-05-18,Assembly,"AB 134 TING Assembly Third Reading",45,25,10,0,80
905876,675961,2017-09-13,Senate,"Do pass",11,4,2,0,17
905876,676560,2017-09-15,Senate,"Assembly 3rd Reading AB134 BUDGET (Ting) By Mitchell",28,9,3,0,40
905876,676561,2017-09-15,Assembly,"AB 134 BUDGET Concurrence in Senate Amendments By TING",58,19,2,0,79
905877,646471,2017-05-18,Assembly,"AB 101 TING Assembly Third Reading",45,25,10,0,80
905877,662207,2017-06-13,Senate,"Do pass",15,1,1,0,17
905878,646618,2017-05-18,Assembly,"AB 122 TING Assembly Third Reading",45,25,10,0,80
905878,667378,2017-06-20,Senate,"Do pass",11,4,2,0,17
905879,646594,2017-05-18,Assembly,"AB 116 TING Assembly Third Reading",45,25,10,0,80
905880,646630,2017-05-18,Assembly,"AB 102 TING Assembly Third Reading",45,25,10,0,80
905880,662468,2017-06-13,Senate,"Do pass",11,6,0,0,17
905880,664223,2017-06-15,Senate,"Assembly 3rd Reading AB102 BUDGET (Ting) By Mitchell",22,13,5,0,40
905880,664224,2017-06-15,Assembly,"AB 102 BUDGET Concurrence in Senate Amendments By TING",52,25,3,0,80
905881,646473,2017-05-18,Assembly,"AB 97 TING Assembly Third Reading",45,25,10,0,80
905881,651395,2017-05-26,Senate,"Assembly 3rd Reading AB97 Ting By Mitchell",24,10,6,0,40
905881,651396,2017-05-26,Assembly,"AB 97 TING Concurrence in Senate Amendments",2,74,4,0,80
905881,664017,2017-06-15,Senate,"Conference Report AB97 Ting By Mitchell",28,10,2,0,40
905881,664018,2017-06-15,Assembly,"AB 97 TING Conference Report",59,20,1,0,80
905884,646549,2017-05-18,Assembly,"AB 129 TING Assembly Third Reading",45,25,10,0,80
905884,675963,2017-09-13,Senate,"Do pass",12,5,0,0,17
905884,676512,2017-09-15,Senate,"Assembly 3rd Reading AB129 BUDGET (Ting) By Mitchell",28,11,1,0,40
905884,676513,2017-09-15,Assembly,"AB 129 BUDGET Concurrence in Senate Amendments By TING",78,1,0,0,79
905885,646577,2017-05-18,Assembly,"AB 136 TING Assembly Third Reading",45,25,10,0,80
905886,646653,2017-05-18,Assembly,"AB 126 TING Assembly Third Reading",45,25,10,0,80
905886,667285,2017-06-20,Senate,"Do pass as amended",13,0,4,0,17
905886,668721,2017-06-26,Senate,"Assembly 3rd Reading AB126 BUDGET (Ting) By Mitchell",37,1,2,0,40
905886,670396,2017-06-29,Assembly,"AB 126 BUDGET Concurrence in Senate Amendments By TING",74,0,6,0,80
905887,646565,2017-05-18,Assembly,"AB 125 TING Assembly Third Reading",45,25,10,0,80
905887,667290,2017-06-20,Senate,"Do pass",11,3,3,0,17
905890,646617,2017-05-18,Assembly,"AB 137 TING Assembly Third Reading",45,25,10,0,80
905893,646637,2017-05-18,Assembly,"AB 109 TING Assembly Third Reading",45,25,10,0,80
905893,675888,2017-09-13,Senate,"Do pass",11,5,1,0,17
905893,676444,2017-09-15,Senate,"Assembly 3rd Reading AB109 Ting By Mitchell",31,9,0,0,40
905893,676445,2017-09-15,Assembly,"AB 109 TING Concurrence in Senate Amendments",75,4,0,0,79
905894,608308,2017-03-21,Assembly,"Do pass and be re-referred to the Committee on [Appropriations] with recommendation: To Consent Calendar",15,0,0,0,15
905894,620186,2017-04-05,Assembly,"Do pass. To Consent Calendar",17,0,0,0,17
905894,629123,2017-04-20,Assembly,"AB 148 MATHIS Consent Calendar Second Day Regular Session",74,0,6,0,80
905894,672537,2017-07-12,Senate,"Do pass as amended, but first amend, and re-refer to the Committee on [Appropriations]",8,0,1,0,9
905894,673995,2017-08-21,Senate,"Placed on suspense file",7,0,0,0,7
905896,646567,2017-05-18,Assembly,"AB 127 TING Assembly Third Reading",45,25,10,0,80
905896,675962,2017-09-13,Senate,"Do pass",12,4,1,0,17
905900,646372,2017-05-18,Assembly,"AB 121 TING Assembly Third Reading",45,25,10,0,80
905900,646373,2017-05-18,Assembly,"AB 121 TING Assembly Third Reading",45,25,10,0,80
905900,667287,2017-06-20,Senate,"Do pass",11,4,2,0,17
905901,646496,2017-05-18,Assembly,"AB 104 TING Assembly Third Reading",45,25,10,0,80
905901,667289,2017-06-20,Senate,"Do pass",11,4,2,0,17
905903,646376,2017-05-18,Assembly,"AB 100 TING Assembly Third Reading",45,25,10,0,80
905906,646621,2017-05-18,Assembly,"AB 114 TING Assembly Third Reading",45,25,10,0,80
905906,662511,2017-06-13,Senate,"Do pass",11,1,5,0,17
905906,667909,2017-06-22,Senate,"Assembly 3rd Reading AB114 Ting By Mitchell",35,1,4,0,40
905906,668640,2017-06-26,Assembly,"AB 114 BUDGET Concurrence in Senate Amendments By TING",74,0,6,0,80
905906,777242,2017-06-22,Senate,,11,1,4,0,16
905908,627105,2017-04-18,Senate,"Do pass, but first be re-referred to the Committee on [Appropriations]",2,5,0,0,7
905908,627106,2017-04-18,Senate,"[Final] hearing set for [04-18-2017]: Failed passage in Committee. Reconsideration granted",7,0,0,0,7
905909,646445,2017-05-18,Assembly,"AB 118 TING Assembly Third Reading",45,25,10,0,80
905909,669070,2017-06-27,Senate,"Do pass",9,4,4,0,17
905910,646616,2017-05-18,Assembly,"AB 110 TING Assembly Third Reading",45,25,10,0,80
905910,662506,2017-06-13,Senate,"Do pass",14,2,1,0,17
905910,716712,2018-03-05,Senate,"Do pass",15,0,1,0,16
905910,719843,2018-03-08,Senate,"Assembly 3rd Reading AB110 BUDGET (Ting) By Mitchell",36,0,3,0,39
905910,719844,2018-03-08,Assembly,"AB 110 BUDGET Concurrence in Senate Amendments By TING",67,2,8,0,77
905913,646605,2017-05-18,Assembly,"AB 108 TING Assembly Third Reading",45,25,10,0,80
905913,662431,2017-06-13,Senate,"Do pass",12,5,0,0,17
905913,714418,2018-03-01,Senate,"Do pass",15,0,1,0,16
905913,719911,2018-03-08,Senate,"Assembly 3rd Reading AB108 BUDGET (Ting) By Mitchell",36,0,3,0,39
905913,719912,2018-03-08,Assembly,"AB 108 BUDGET Concurrence in Senate Amendments By TING",71,0,6,0,77
905913,775246,2018-03-08,Senate,"Assembly 3rd Reading AB108 BUDGET (Tin",15,0,3,0,18
905914,646599,2017-05-18,Assembly,"AB 112 TING Assembly Third Reading",45,25,10,0,80
905914,662493,2017-06-13,Senate,"Do pass",11,5,1,0,17
905915,646636,2017-05-18,Assembly,"AB 135 TING Assembly Third Reading",45,25,10,0,80
905915,675964,2017-09-13,Senate,"Do pass",15,1,1,0,17
905915,676509,2017-09-15,Senate,"Assembly 3rd Reading AB135 BUDGET (Ting) By Mitchell",32,6,2,0,40
905915,676510,2017-09-15,Assembly,"AB 135 BUDGET Concurrence in Senate Amendments By TING",54,25,0,0,79
905916,572967,2017-01-30,Senate,"Senate 3rd Reading SCR15 Gaines",36,0,4,0,40
905917,646591,2017-05-18,Assembly,"AB 113 TING Assembly Third Reading",45,25,10,0,80
905917,667194,2017-06-20,Senate,"Do pass",11,4,2,0,17
905918,646626,2017-05-18,Assembly,"AB 128 TING Assembly Third Reading",45,25,10,0,80
905918,673999,2017-08-22,Senate,"Do pass",11,5,1,0,17
905919,594738,2017-02-28,Assembly,"Do pass",7,0,0,0,7
905919,611009,2017-03-23,Assembly,"AB 149 JONES-SAWYER Assembly Third Reading",62,1,17,0,80
905919,672284,2017-07-12,Senate,"Do pass as amended, but first amend, and re-refer to the Committee on [Appropriations]",7,0,0,0,7
905919,673842,2017-08-21,Senate,"Do pass",7,0,0,0,7
905919,674315,2017-08-31,Senate,"Special Consent AB149",37,0,3,0,40
905919,674938,2017-09-05,Assembly,"AB 149 JONES-SAWYER Concurrence in Senate Amendments",77,0,2,0,79
905921,646655,2017-05-18,Assembly,"AB 130 TING Assembly Third Reading",45,25,10,0,80
905921,675966,2017-09-13,Senate,"Do pass",12,4,1,0,17
905921,676518,2017-09-15,Senate,"Assembly 3rd Reading AB130 BUDGET (Ting) By Mitchell",30,7,3,0,40
905921,676519,2017-09-15,Assembly,"AB 130 BUDGET Concurrence in Senate Amendments By TING",62,15,2,0,79
905925,618262,2017-04-04,Assembly,"Do pass",3,6,2,0,11
905925,618263,2017-04-04,Assembly,Reconsideration,11,0,0,0,11
905926,646569,2017-05-18,Assembly,"AB 99 TING Assembly Third Reading",45,25,10,0,80
905926,662160,2017-06-13,Senate,"Do pass",17,0,0,0,17
905926,664145,2017-06-15,Senate,"Assembly 3rd Reading AB99 Ting et al. By Mitchell",38,0,2,0,40
905926,664146,2017-06-15,Assembly,"AB 99 TING Concurrence in Senate Amendments",78,0,2,0,80
905929,646574,2017-05-18,Assembly,"AB 103 TING Assembly Third Reading",45,25,10,0,80
905929,662381,2017-06-13,Senate,"Do pass",12,5,0,0,17
905929,664213,2017-06-15,Senate,"Assembly 3rd Reading AB103 BUDGET (Ting) By Mitchell",26,11,3,0,40
905929,664214,2017-06-15,Assembly,"AB 103 BUDGET Concurrence in Senate Amendments By TING",52,26,2,0,80
905930,646639,2017-05-18,Assembly,"AB 111 TING Assembly Third Reading",45,25,10,0,80
905930,662298,2017-06-13,Senate,"Do pass",15,1,1,0,17
905930,664095,2017-06-15,Senate,"Assembly 3rd Reading AB111 BUDGET (Ting) By Mitchell",30,7,3,0,40
905930,664096,2017-06-15,Assembly,"AB 111 BUDGET Concurrence in Senate Amendments By TING",61,16,3,0,80
905931,646417,2017-05-18,Assembly,"AB 131 TING Assembly Third Reading",45,25,10,0,80
905931,675949,2017-09-13,Senate,"Do pass",15,1,1,0,17
905931,676602,2017-09-15,Senate,"Assembly 3rd Reading AB131 BUDGET (Ting) By Mitchell",34,4,2,0,40
905931,676603,2017-09-15,Assembly,"AB 131 BUDGET Concurrence in Senate Amendments By TING",78,1,0,0,79
905932,646504,2017-05-18,Assembly,"AB 119 TING Assembly Third Reading",45,25,10,0,80
905932,646505,2017-05-18,Assembly,"AB 119 TING Assembly Third Reading",45,25,10,0,80
905932,662505,2017-06-13,Senate,"Do pass",12,5,0,0,17
905932,664023,2017-06-15,Senate,"Assembly 3rd Reading AB119 BUDGET (Ting) By Mitchell",27,10,3,0,40
905932,664024,2017-06-15,Assembly,"AB 119 BUDGET Concurrence in Senate Amendments By TING",54,23,3,0,80
905933,612809,2017-03-27,Senate,"Do pass, but first be re-referred to the Committee on [Judiciary]",5,0,0,0,5
905933,628082,2017-04-18,Senate,"Do pass, but first be re-referred to the Committee on [Appropriations] with the recommendation: To Consent Calendar",7,0,0,0,7
905933,635785,2017-05-01,Senate,"Placed on suspense file",7,0,0,0,7
905933,650814,2017-05-25,Senate,"Do pass",7,0,0,0,7
905933,654581,2017-05-30,Senate,"Senate 3rd Reading SB76 Nielsen",40,0,0,0,40
905933,667102,2017-06-21,Assembly,"Do pass and be re-referred to the Committee on [Judiciary]",6,0,1,0,7
905933,669185,2017-06-27,Assembly,"Do pass as amended and be re-referred to the Committee on [Appropriations]",11,0,0,0,11
905933,674651,2017-09-01,Assembly,"Do pass",16,0,1,0,17
905934,646493,2017-05-18,Assembly,"AB 124 TING Assembly Third Reading",45,25,10,0,80
905936,646511,2017-05-18,Assembly,"AB 98 TING Assembly Third Reading",45,25,10,0,80
905936,662504,2017-06-13,Senate,"Do pass",15,2,0,0,17
905936,664115,2017-06-15,Senate,"Assembly 3rd Reading AB98 BUDGET (Ting) By Mitchell",32,6,2,0,40
905936,664116,2017-06-15,Assembly,"AB 98 BUDGET Concurrence in Senate Amendments By TING",77,1,2,0,80
905937,646536,2017-05-18,Assembly,"AB 132 TING Assembly Third Reading",45,25,10,0,80
905937,674001,2017-08-22,Senate,"Do pass",11,5,1,0,17
905937,675486,2017-09-11,Senate,"Do pass, but first be re-referred to the Committee on [Appropriations]",11,1,1,0,13
905937,676468,2017-09-15,Senate,"Do pass",5,0,2,0,7
905937,676469,2017-09-15,Senate,"Assembly 3rd Reading AB132 Jones-Sawyer et al. By Lara",29,5,6,0,40
905937,676470,2017-09-16,Assembly,"AB 132 JONES-SAWYER Concurrence in Senate Amendments",63,8,8,0,79
905937,777275,2017-09-15,Senate,"Assembly 3rd Reading AB132 Jones-Sawyer et acolspan=""2""> ?",5,5,6,0,16
905938,603392,2017-03-13,Assembly,"Do pass as amended and be re-referred to the Committee on [Appropriations]",10,0,0,0,10
905938,620122,2017-04-05,Assembly,"Do pass. To Consent Calendar",17,0,0,0,17
905938,629635,2017-04-20,Assembly,"AB 94 RODRIGUEZ Consent Calendar Second Day Regular Session",74,0,6,0,80
905938,660182,2017-06-07,Senate,"Do pass, but first be re-referred to the Committee on [Appropriations] with the recommendation: To Consent Calendar",7,0,0,0,7
905938,671000,2017-07-03,Senate,"Consent Calendar 2nd AB94",33,0,7,0,40
905939,646619,2017-05-18,Assembly,"AB 117 TING Assembly Third Reading",45,25,10,0,80
905942,646369,2017-05-18,Assembly,"AB 133 TING Assembly Third Reading",45,25,10,0,80
905942,675965,2017-09-13,Senate,"Do pass",14,2,1,0,17
905942,676611,2017-09-15,Senate,"Assembly 3rd Reading AB133 BUDGET (Ting) By Mitchell",30,9,1,0,40
905942,676612,2017-09-15,Assembly,"AB 133 BUDGET Concurrence in Senate Amendments By TING",62,17,0,0,79
908653,643677,2017-05-11,Senate,"Senate 3rd Reading SB90 B. & F.R",26,9,5,0,40
908653,664143,2017-06-15,Assembly,"SB 90 B. & F. R. Senate Third Reading By TING",79,0,1,0,80
908653,664144,2017-06-15,Senate,"Unfinished Business SB90 B. & F.R. (Mitchell) Concurrence",28,10,2,0,40
908654,643396,2017-05-11,Senate,"Senate 3rd Reading SB86 B. & F.R",26,9,5,0,40
908656,643595,2017-05-11,Senate,"Senate 3rd Reading SB88 B. & F.R",26,9,5,0,40
908656,667957,2017-06-22,Assembly,"SB 88 B. & F. R. Senate Third Reading By TING",52,22,6,0,80
908656,668574,2017-06-26,Senate,"Unfinished Business SB88 B. & F.R. (Mitchell) Concurrence",27,12,1,0,40
908659,643565,2017-05-11,Senate,"Senate 3rd Reading SB113 B. & F.R",26,9,5,0,40
908659,674025,2017-08-23,Assembly,"Do pass",16,10,3,0,29
908659,674085,2017-08-24,Assembly,"SB 113 B. & F. R. Senate Third Reading By TING",52,25,2,0,79
908659,674086,2017-08-24,Senate,"Unfinished Business SB113 B. & F.R. (Mitchell) Concurrence",25,13,2,0,40
908661,594930,2017-02-28,Assembly,"Do pass and be re-referred to the Committee on [Appropriations]",5,2,0,0,7
908661,651811,2017-05-26,Assembly,"Do pass as amended",12,5,0,0,17
908661,656282,2017-05-31,Assembly,"AB 154 LEVINE Assembly Third Reading",76,0,4,0,80
908661,672154,2017-07-11,Senate,"Do pass as amended",7,0,0,0,7
908661,674371,2017-08-31,Senate,"Special Consent Calendar # AB154",37,0,3,0,40
908661,674952,2017-09-05,Assembly,"AB 154 LEVINE Concurrence in Senate Amendments",77,0,2,0,79
908663,637493,2017-05-03,Senate,"Do pass and be ordered to the Consent Calendar",8,0,1,0,9
908663,644365,2017-05-15,Senate,"Consent Calendar 2nd SB133",39,0,1,0,40
908663,672191,2017-07-11,Assembly,"Do pass. To Consent Calendar",15,0,0,0,15
908663,673761,2017-08-21,Assembly,"SB 133 Hernandez Senate Third Reading By WOOD Amend By WOOD Set #1",53,18,8,0,79
908663,674226,2017-08-29,Assembly,"Do pass as amended and be re-referred to the Committee on [Appropriations]",10,0,5,0,15
908663,675402,2017-09-11,Assembly,"Do pass as amended",12,3,2,0,17
908663,676424,2017-09-15,Senate,"That the Assembly amendments be concurred in",9,0,0,0,9
908663,676596,2017-09-15,Assembly,"SB 133 Hernandez Senate Third Reading By WOOD",61,8,10,0,79
908663,676597,2017-09-15,Senate,"Unfinished Business SB133 Hernandez et al. Concurrence",38,0,2,0,40
908665,643667,2017-05-11,Senate,"Senate 3rd Reading SB121 B. & F.R",26,9,5,0,40
908665,716801,2018-03-05,Assembly,"Do pass",24,0,5,0,29
908666,614790,2017-03-29,Senate,"Do pass, but first be re-referred to the Committee on [Appropriations]",5,0,2,0,7
908666,626195,2017-04-17,Senate,"Do pass",5,0,2,0,7
908666,630323,2017-04-24,Senate,"Senate 3rd Reading SB80 Wieckowski",27,7,6,0,40
908666,665033,2017-06-19,Assembly,"Do pass as amended and be re-referred to the Committee on [Appropriations]",6,0,2,0,8
908666,672868,2017-07-19,Assembly,"Do pass",13,3,1,0,17
908666,675137,2017-09-07,Assembly,"SB 80 Wieckowski Senate Third Reading By LIMÓN",57,18,4,0,79
908666,675367,2017-09-11,Senate,"Unfinished Business SB80 Wieckowski Concurrence",29,7,4,0,40
908668,643568,2017-05-11,Senate,"Senate 3rd Reading SB82 B. & F.R. (Mitchell)",26,9,5,0,40
908672,641795,2017-05-09,Senate,"Do pass as amended, but first amend, and re-refer to the Committee on [Appropriations]",8,2,1,0,11
908672,647856,2017-05-22,Senate,"Placed on suspense file",7,0,0,0,7
908672,650705,2017-05-25,Senate,"Do pass as amended",5,2,0,0,7
908672,655776,2017-05-31,Senate,"Senate 3rd Reading SB100 De León",25,13,2,0,40
908672,672355,2017-07-12,Assembly,"Do pass and be re-referred to the Committee on [Natural Resources]",10,4,1,0,15
908672,672667,2017-07-13,Assembly,"Do pass as amended and be re-referred to the Committee on [Appropriations]",7,0,3,0,10
908672,674646,2017-09-01,Assembly,"Do pass",11,5,1,0,17
908672,769680,2018-07-03,Assembly,"Do pass as amended",10,5,0,0,15
908672,773069,2018-08-28,Assembly,"SB 100 De León Senate Third Reading By GONZALEZ FLETCHER Motion to Appeal the Decision of the Chair By MELENDEZ",21,54,5,0,80
908672,773070,2018-08-28,Assembly,"SB 100 De León Senate Third Reading By GONZALEZ FLETCHER",44,33,3,0,80
908672,773323,2018-08-29,Senate,"Unfinished Business SB100 De León et al. Concurrence",25,13,2,0,40
908673,643364,2017-05-11,Senate,"Senate 3rd Reading SB108 B. & F.R",26,9,5,0,40
908673,667948,2017-06-22,Assembly,"SB 108 B. & F. R. Senate Third Reading By TING",53,19,8,0,80
908673,668584,2017-06-26,Senate,"Unfinished Business SB108 B. & F.R. (Mitchell) Concurrence",28,11,1,0,40
908675,627848,2017-04-19,Assembly,"Do pass as amended and be re-referred to the Committee on [Appropriations]",7,0,0,0,7
908677,643659,2017-05-11,Senate,"Senate 3rd Reading SB89 B. & F.R",26,9,5,0,40
908677,664052,2017-06-15,Assembly,"SB 89 B. & F. R. Senate Third Reading By TING",64,14,2,0,80
908677,664053,2017-06-15,Senate,"Unfinished Business SB89 B. & F.R. (Mitchell) Concurrence",27,11,2,0,40
908678,643441,2017-05-11,Senate,"Senate 3rd Reading SB97 B. & F.R",26,9,5,0,40
908678,667937,2017-06-22,Assembly,"SB 97 B. & F. R. Senate Third Reading By TING",53,17,10,0,80
908678,668693,2017-06-26,Senate,"Unfinished Business SB97 B. & F.R. (Mitchell) Concurrence",27,11,2,0,40
908680,643630,2017-05-11,Senate,"Senate 3rd Reading SB103 B. & F.R",26,9,5,0,40
908680,668678,2017-06-26,Assembly,"Do pass",18,11,0,0,29
908680,670373,2017-06-29,Assembly,"SB 103 B. & F. R. Senate Third Reading By TING",52,23,5,0,80
908680,671606,2017-07-06,Senate,"Unfinished Business SB103 B. & F.R. (Mitchell) Concurrence",27,12,1,0,40
908682,643547,2017-05-11,Senate,"Senate 3rd Reading SB94 B. & F.R",26,9,5,0,40
908682,664086,2017-06-15,Assembly,"SB 94 B. & F. R. Senate Third Reading By TING",73,2,5,0,80
908682,664087,2017-06-15,Senate,"Unfinished Business SB94 B. & F.R. (Mitchell) Concurrence",31,7,2,0,40
908684,643619,2017-05-11,Senate,"Senate 3rd Reading SB83 B. & F.R",26,9,5,0,40
908685,643448,2017-05-11,Senate,"Senate 3rd Reading SB109 B. & F.R",26,9,5,0,40
908687,643631,2017-05-11,Senate,"Senate 3rd Reading SB98 B. & F.R",26,9,5,0,40
908689,630254,2017-04-24,Senate,"Do pass",15,0,2,0,17
908689,634666,2017-04-27,Senate,"Senate 3rd Reading SB130 B. & F.R. (Mitchell)",34,0,6,0,40
908689,638491,2017-05-04,Assembly,"SB 130 B. & F. R. Senate Third Reading By TING",72,1,7,0,80
908691,643573,2017-05-11,Senate,"Senate 3rd Reading SB104 B. & F.R",26,9,5,0,40
908692,643424,2017-05-11,Senate,"Senate 3rd Reading SB87 B. & F.R",26,9,5,0,40
908694,643647,2017-05-11,Senate,"Senate 3rd Reading SB119 B. & F.R",26,9,5,0,40
908694,676172,2017-09-14,Assembly,"Do pass",19,7,3,0,29
908696,643636,2017-05-11,Senate,"Senate 3rd Reading SB102 B. & F.R",26,9,5,0,40
908699,643657,2017-05-11,Senate,"Senate 3rd Reading SB84 B. & F.R",26,9,5,0,40
908699,667804,2017-06-22,Assembly,"SB 84 B. & F. R. Senate Third Reading By TING",69,4,7,0,80
908699,668539,2017-06-26,Senate,"Unfinished Business SB84 B. & F.R. (Mitchell) Concurrence",24,13,3,0,40
908701,643610,2017-05-11,Senate,"Senate 3rd Reading SB85 B. & F.R",26,9,5,0,40
908701,664098,2017-06-15,Assembly,"SB 85 B. & F. R. Senate Third Reading By TING",72,6,2,0,80
908701,664099,2017-06-15,Senate,"Unfinished Business SB85 B. & F.R. (Mitchell) Concurrence",37,1,2,0,40
908703,643643,2017-05-11,Senate,"Senate 3rd Reading SB117 B. & F.R",26,9,5,0,40
908703,674047,2017-08-23,Assembly,"Do pass",15,11,3,0,29
908703,674120,2017-08-24,Assembly,"SB 117 B. & F. R. Senate Third Reading By TING Motion to Re-refer to Committee By HARPER",26,48,5,0,79
908703,674121,2017-08-24,Assembly,"SB 117 B. & F. R. Senate Third Reading By TING",48,29,2,0,79
908703,674122,2017-08-24,Senate,"Unfinished Business SB117 B. & F.R. (Mitchell) Concurrence",25,13,2,0,40
908704,594910,2017-02-28,Assembly,"Do pass and be re-referred to the Committee on [Veterans Affairs] with recommendation: To Consent Calendar",7,0,0,0,7
908704,609787,2017-03-21,Assembly,"Do pass and be re-referred to the Committee on [Appropriations]",10,0,0,0,10
908704,620089,2017-04-05,Assembly,"Do pass. To Consent Calendar",17,0,0,0,17
908704,629114,2017-04-20,Assembly,"AB 153 CHÁVEZ Consent Calendar Second Day Regular Session",74,0,6,0,80
908704,658874,2017-06-06,Senate,"Do pass, but first be re-referred to the Committee on [Veterans Affairs] with the recommendation: To Consent Calendar",7,0,0,0,7
908704,668951,2017-06-27,Senate,"Do pass, but first be re-referred to the Committee on [Appropriations]",7,0,0,0,7
908704,671836,2017-07-10,Senate,"Placed on suspense file",7,0,0,0,7
908704,674566,2017-09-01,Senate,"Do pass",7,0,0,0,7
908704,676045,2017-09-14,Senate,"Special Consent Calendar # AB153",40,0,0,0,40
908706,632029,2017-04-24,Assembly,"Do pass as amended and be re-referred to the Committee on [Appropriations]",9,1,0,0,10
908706,651880,2017-05-26,Assembly,"Do pass",12,3,2,0,17
908709,627899,2017-04-19,Senate,"Do pass as amended, but first amend, and re-refer to the Committee on [Appropriations]",7,0,0,0,7
908709,644354,2017-05-15,Senate,"Placed on suspense file",7,0,0,0,7
908709,650711,2017-05-25,Senate,"Do pass as amended",5,2,0,0,7
908709,655832,2017-05-31,Senate,"Senate 3rd Reading SB78 Leyva et al",32,5,3,0,40
908711,643682,2017-05-11,Senate,"Senate 3rd Reading SB115 B. & F.R",26,9,5,0,40
908711,676247,2017-09-14,Assembly,"Do pass",20,5,4,0,29
908712,643611,2017-05-11,Senate,"Senate 3rd Reading SB93 B. & F.R",26,9,5,0,40
908712,676256,2017-09-14,Assembly,"Do pass",24,3,2,0,29
908714,643594,2017-05-11,Senate,"Senate 3rd Reading SB111 B. & F.R",26,9,5,0,40
908714,667916,2017-06-22,Assembly,"SB 111 B. & F. R. Senate Third Reading Amend By TING Set #1",73,0,7,0,80
908716,643650,2017-05-11,Senate,"Senate 3rd Reading SB99 B. & F.R",26,9,5,0,40
908718,643575,2017-05-11,Senate,"Senate 3rd Reading SB106 B. & F.R",26,9,5,0,40
908718,667953,2017-06-22,Assembly,"SB 106 B. & F. R. Senate Third Reading By TING",56,13,11,0,80
908718,671541,2017-07-06,Senate,"Unfinished Business SB106 B. & F.R. (Mitchell) Concurrence",27,9,4,0,40
908719,594951,2017-02-28,Assembly,"Do pass and be re-referred to the Committee on [Appropriations] with recommendation: To Consent Calendar",7,0,0,0,7
908723,643582,2017-05-11,Senate,"Senate 3rd Reading SB122 B. & F.R",26,9,5,0,40
908724,627860,2017-04-19,Senate,"Do pass as amended, but first amend, and re-refer to the Committee on [Appropriations]",5,2,0,0,7
908724,644455,2017-05-15,Senate,"Placed on suspense file",7,0,0,0,7
908724,650449,2017-05-25,Senate,"Do pass",5,2,0,0,7
908724,654305,2017-05-30,Senate,"Senate 3rd Reading SB135 Dodd et al",27,12,1,0,40
908724,672588,2017-07-12,Assembly,"Do pass and be re-referred to the Committee on [Appropriations]",6,0,1,0,7
908726,643632,2017-05-11,Senate,"Senate 3rd Reading SB105 B. & F.R",26,9,5,0,40
908728,643646,2017-05-11,Senate,"Senate 3rd Reading SB107 B. & F.R",26,9,5,0,40
908728,667871,2017-06-22,Assembly,"SB 107 B. & F. R. Senate Third Reading By TING",71,1,8,0,80
908728,668687,2017-06-26,Senate,"Unfinished Business SB107 B. & F.R. (Mitchell) Concurrence",29,10,1,0,40
908731,626379,2017-04-17,Senate,"Do pass",11,5,1,0,17
908731,626380,2017-04-17,Senate,"Senate 3rd Reading SB131 B. & F.R. (Mitchell)",28,12,0,0,40
908731,630509,2017-04-24,Assembly,"Do pass",21,5,3,0,29
908731,630510,2017-04-24,Assembly,"SB 131 B. & F. R. Senate Third Reading By TING",59,13,8,0,80
908733,643366,2017-05-11,Senate,"Senate 3rd Reading SB112 B. & F.R",26,9,5,0,40
908733,676190,2017-09-14,Assembly,"Do pass",17,9,3,0,29
908733,676563,2017-09-15,Assembly,"SB 112 B. & F. R. Senate Third Reading",58,20,1,0,79
908733,676564,2017-09-15,Senate,"W/O REF. TO FILE SB112 B.&F.R. (Mitchell)",27,11,2,0,40
908735,637443,2017-05-03,Senate,"Do pass and be ordered to the Consent Calendar",8,0,1,0,9
908735,644353,2017-05-15,Senate,"Consent Calendar 2nd SB134",39,0,1,0,40
908735,672128,2017-07-11,Assembly,"Do pass. To Consent Calendar",15,0,0,0,15
908735,771549,2018-08-16,Assembly,"SB 134 Hernandez Senate Third Reading By SALAS Amendment Set #1",55,21,4,0,80
908735,772919,2018-08-27,Assembly,"Do pass",11,5,1,0,17
908735,773113,2018-08-27,Assembly,"Do pass and be re-referred to the Committee on [Appropriations]",5,1,1,0,7
908735,773959,2018-08-31,Senate,"That the Assembly amendments be concurred in",4,2,1,0,7
908735,774100,2018-08-31,Senate,"Unfinished Business SB134 Hernandez et al. Concurrence",23,14,3,0,40
908735,774101,2018-08-31,Assembly,"SB 134 Hernandez Senate Third Reading By SALAS",54,24,2,0,80
908737,643668,2017-05-11,Senate,"Senate 3rd Reading SB92 B. & F.R",26,9,5,0,40
908737,664286,2017-06-15,Assembly,"SB 92 B. & F. R. Senate Third Reading By TING",55,23,2,0,80
908737,664287,2017-06-15,Senate,"Unfinished Business SB92 B. & F.R. (Mitchell) Concurrence",28,10,2,0,40
908738,643548,2017-05-11,Senate,"Senate 3rd Reading SB116 B. & F.R",26,9,5,0,40
908738,676249,2017-09-14,Assembly,"Do pass",26,1,2,0,29
908738,716410,2018-03-05,Assembly,"Do pass",24,0,5,0,29
908740,643463,2017-05-11,Senate,"Senate 3rd Reading SB120 B. & F.R",26,9,5,0,40
908740,676250,2017-09-14,Assembly,"Do pass",16,9,4,0,29
908740,716422,2018-03-05,Assembly,"Do pass",24,0,5,0,29
908740,772675,2018-08-24,Assembly,"SB 120 Senate Third Reading By FRIEDMAN Amendment Set #1",50,23,7,0,80
908740,773053,2018-08-28,Assembly,"Do pass",7,0,3,0,10
908740,773316,2018-08-29,Assembly,"SB 120 Roth Senate Third Reading By FRIEDMAN",50,25,5,0,80
908740,774084,2018-08-31,Senate,"That the measure be held in committee pursuant to Senate Rule 29.10",7,0,0,0,7
908742,643387,2017-05-11,Senate,"Senate 3rd Reading SB114 B. & F.R",26,9,5,0,40
908742,676253,2017-09-14,Assembly,"Do pass",27,0,2,0,29
908743,643633,2017-05-11,Senate,"Senate 3rd Reading SB95 B. & F.R",26,9,5,0,40
908745,643584,2017-05-11,Senate,"Senate 3rd Reading SB110 B. & F.R",26,9,5,0,40
908745,667874,2017-06-22,Assembly,"SB 110 B. & F. R. Senate Third Reading By TING",71,0,9,0,80
908745,668674,2017-06-26,Senate,"Unfinished Business SB110 B. & F.R. (Mitchell) Concurrence",30,8,2,0,40
908749,643640,2017-05-11,Senate,"Senate 3rd Reading SB118 B. & F.R",26,9,5,0,40
908749,676258,2017-09-14,Assembly,"Do pass",18,9,2,0,29
908749,716782,2018-03-05,Assembly,"Do pass",23,1,5,0,29
908752,626300,2017-04-17,Senate,"Do pass",12,5,0,0,17
908752,626301,2017-04-17,Senate,"Senate 3rd Reading SB132 B. & F.R. (Mitchell)",27,13,0,0,40
908752,630469,2017-04-24,Assembly,"Do pass",17,9,3,0,29
908752,630470,2017-04-24,Assembly,"SB 132 B. & F. R. Senate Third Reading By TING Amend By HARPER Set #1 Motion to Lay on the Table By BONTA",51,24,5,0,80
908752,630471,2017-04-24,Assembly,"SB 132 B. & F. R. Senate Third Reading By TING",52,24,4,0,80
908754,643652,2017-05-11,Senate,"Senate 3rd Reading SB91 B. & F.R",26,9,5,0,40
908756,643453,2017-05-11,Senate,"Senate 3rd Reading SB96 B. & F.R",26,9,5,0,40
908756,663993,2017-06-15,Assembly,"SB 96 B. & F. R. Senate Third Reading Amend By STEINORTH Set #1 Motion to Lay on the Table By CALDERON",50,25,5,0,80
908756,663994,2017-06-15,Assembly,"SB 96 B. & F. R. Senate Third Reading Amend By HARPER Set #2 Motion to Lay on the Table By CALDERON",51,25,4,0,80
908756,663995,2017-06-15,Assembly,"SB 96 B. & F. R. Senate Third Reading By TING Motion to Appeal the Decision of the Chair By GALLAGHER",23,52,5,0,80
908756,663996,2017-06-15,Assembly,"SB 96 B. & F. R. Senate Third Reading By TING",52,27,1,0,80
908756,663997,2017-06-15,Senate,"Unfinished Business SB96 B. & F.R. (Mitchell) Concurrence",26,11,3,0,40
908757,620082,2017-04-05,Senate,"Do pass, but first be re-referred to the Committee on [Environmental Quality]",6,0,1,0,7
908757,628289,2017-04-19,Senate,"Do pass, but first be re-referred to the Committee on [Appropriations]",7,0,0,0,7
908757,635851,2017-05-01,Senate,"Placed on suspense file",7,0,0,0,7
908761,643407,2017-05-11,Senate,"Senate 3rd Reading SB101 B. & F.R",26,9,5,0,40
911313,626808,2017-04-18,Senate,"Do pass, but first be re-referred to the Committee on [Appropriations]",10,0,3,0,13
911313,644284,2017-05-15,Senate,"Placed on suspense file",7,0,0,0,7
911313,650728,2017-05-25,Senate,"Do pass",5,2,0,0,7
911313,654361,2017-05-30,Senate,"Senate 3rd Reading SB136 Leyva Urgency Clause",28,12,0,0,40
911313,669549,2017-06-28,Assembly,"Do pass and be re-referred to the Committee on [Appropriations]",7,0,0,0,7
911313,672895,2017-07-19,Assembly,"Do pass",12,2,3,0,17
911313,674349,2017-08-31,Assembly,"SB 136 Leyva Third Reading Urgency By CHIU",53,17,9,0,79
911313,676505,2017-09-15,Assembly,"SB 136 Leyva Third Reading Urgency By CHIU",59,15,5,0,79
911313,676506,2017-09-16,Senate,"Unfinished Business SB136 Leyva Urgency Clause Concurrence",27,10,3,0,40
911317,631418,2017-04-25,Assembly,"Do pass. To Consent Calendar",15,0,0,0,15
911317,638539,2017-05-04,Assembly,"AB 156 WOOD Consent Calendar Second Day",76,0,4,0,80
911317,672840,2017-07-19,Senate,"Do pass",8,0,1,0,9
911317,674887,2017-09-05,Senate,"That the measure be returned to Senate Floor for consideration. Ordered to third reading",9,0,0,0,9
911317,676558,2017-09-15,Senate,"Assembly 3rd Reading AB156 Wood By Hernandez",38,0,2,0,40
911317,676559,2017-09-16,Assembly,"AB 156 WOOD Concurrence in Senate Amendments",74,0,5,0,79
911322,598939,2017-03-07,Assembly,"Do pass and be re-referred to the Committee on [Appropriations]",7,0,0,0,7
911327,632959,2017-04-25,Senate,"Do pass as amended, but first amend, and re-refer to the Committee on [Appropriations]",13,0,0,0,13
911327,647798,2017-05-22,Senate,"Senate 3rd Reading SB137 Allen",37,0,3,0,40
911336,632049,2017-04-25,Assembly,"Do pass. To Consent Calendar",15,0,0,0,15
911336,638549,2017-05-04,Assembly,"AB 157 WOOD Consent Calendar Second Day Regular Session",76,0,4,0,80
911336,672856,2017-07-19,Senate,"Do pass",8,0,1,0,9
911341,627014,2017-04-18,Assembly,"Do pass and be re-referred to the Committee on [Appropriations] with recommendation: To Consent Calendar",7,0,0,0,7
913397,614779,2017-03-29,Senate,"Do pass and be ordered to the Consent Calendar",7,0,0,0,7
913397,661178,2017-04-06,Senate,"Consent Calendar 2nd SB141 Nguyen",39,0,1,0,40
913397,667267,2017-06-19,Assembly,"Do pass",9,0,1,0,10
913397,670344,2017-06-29,Assembly,"SB 141 Nguyen Senate Third Reading By CHEN",72,0,8,0,80
913407,633266,2017-04-25,Assembly,"Do pass and be re-referred to the Committee on [Appropriations]",6,0,1,0,7
913407,651848,2017-05-26,Assembly,"Do pass",13,2,2,0,17
913407,655749,2017-05-31,Assembly,"AB 164 ARAMBULA Assembly Third Reading",65,4,11,0,80
913407,669078,2017-06-27,Senate,"Do pass, but first be re-referred to the Committee on [Appropriations]",4,0,1,0,5
913407,671862,2017-07-10,Senate,"Placed on suspense file",7,0,0,0,7
913413,632623,2017-04-25,Assembly,"Do pass and be re-referred to the Committee on [Appropriations] with recommendation: To Consent Calendar",7,0,0,0,7
913413,651789,2017-05-26,Assembly,"Do pass",17,0,0,0,17
913413,654101,2017-05-30,Assembly,"AB 166 SALAS Assembly Third Reading",76,0,4,0,80
913413,676139,2017-09-14,Senate,"Do pass, but first be re-referred to the Committee on [Transportation and Housing]",5,2,0,0,7
913413,676430,2017-09-15,Senate,"Do pass",5,2,0,0,7
913413,676431,2017-09-15,Senate,"W/O REF. TO FILE AB166 Salas By Beall",27,11,2,0,40
913413,676432,2017-09-16,Assembly,"With recommendation: That Senate amendments be concurred in",4,2,1,0,7
913418,603402,2017-03-14,Senate,"Do pass as amended, but first amend, and re-refer to the Committee on [Appropriations]",9,0,0,0,9
913418,617677,2017-04-03,Senate,"Placed on suspense file",7,0,0,0,7
913418,650621,2017-05-25,Senate,"Do pass",7,0,0,0,7
913418,656073,2017-05-31,Senate,"Special Consent Calendar # SB144 McGuire et al. Urgency Clause",40,0,0,0,40
913418,669076,2017-06-27,Assembly,"Do pass and be re-referred to the Committee on [Appropriations]",15,0,0,0,15
913418,672861,2017-07-19,Assembly,"Do pass",16,0,1,0,17
913418,674934,2017-09-05,Assembly,"SB 144 McGuire Third Reading Urgency By DAHLE",75,0,4,0,79
913423,613535,2017-03-27,Assembly,"Do pass and be re-referred to the Committee on [Jobs, Economic Development, and the Economy]",8,0,2,0,10
913423,631439,2017-04-25,Assembly,"Do pass as amended and be re-referred to the Committee on [Appropriations]",7,0,0,0,7
913423,651865,2017-05-26,Assembly,"Do pass",17,0,0,0,17
913423,654275,2017-05-30,Assembly,"AB 162 CERVANTES Assembly Third Reading",75,0,5,0,80
913423,753341,2018-05-15,Senate,"Do pass, but first be re-referred to the Committee on [Appropriations]",12,0,1,0,13
913423,769611,2018-07-02,Senate,"Do pass",7,0,0,0,7
913423,777219,2017-03-27,Assembly,"Do pass and be re-referred to the Committee on No Votes Recorded:",0,0,2,0,2
913429,607011,2017-03-20,Assembly,"Be adopted. To Consent Calendar",14,0,0,0,14
913429,611142,2017-03-23,Assembly,"ACR 9 GONZALEZ FLETCHER Consent Calendar Second Day Regular Session",76,0,4,0,80
913429,672135,2017-07-11,Senate,"Be adopted, but first be re-referred to the Committee on [Appropriations] with recommendation: To Consent Calendar",11,0,2,0,13
913429,674077,2017-08-24,Senate,"Consent Calendar 2nd ACR9",38,0,2,0,40
913436,604372,2017-03-15,Senate,"Do pass, but first be re-referred to the Committee on [Appropriations]",7,0,0,0,7
913436,617343,2017-04-03,Senate,"Placed on suspense file",7,0,0,0,7
913436,650818,2017-05-25,Senate,"Do pass as amended",7,0,0,0,7
913436,656803,2017-06-01,Senate,"Senate 3rd Reading SB138 McGuire et al",40,0,0,0,40
913436,672635,2017-07-12,Assembly,"Do pass and be re-referred to the Committee on [Appropriations]",7,0,0,0,7
913436,674448,2017-09-01,Assembly,"Do pass",16,0,1,0,17
913436,675221,2017-09-07,Assembly,"SB 138 McGuire Senate Third Reading By GONZALEZ FLETCHER",79,0,0,0,79
913436,676147,2017-09-14,Senate,"Special Consent SB138",40,0,0,0,40
913446,633624,2017-04-26,Senate,"Do pass, but first be re-referred to the Committee on [Appropriations] with the recommendation: To Consent Calendar",7,0,0,0,7
913446,644348,2017-05-15,Senate,"Consent Calendar 2nd SB140",39,0,1,0,40
913446,667313,2017-06-21,Assembly,"Do pass and be re-referred to the Committee on [Appropriations] with recommendation: To Consent Calendar",6,0,1,0,7
913451,614787,2017-03-29,Assembly,"Do pass and be re-referred to the Committee on [Appropriations]",5,2,0,0,7
913451,651517,2017-05-26,Assembly,"Do pass",13,4,0,0,17
913451,655859,2017-05-31,Assembly,"AB 161 LEVINE Assembly Third Reading",62,14,4,0,80
913451,669071,2017-06-27,Senate,"Do pass, but first be re-referred to the Committee on [Appropriations]",11,1,1,0,13
913462,571711,2017-01-26,Assembly,"Be adopted. To third reading",11,0,0,0,11
913462,587533,2017-02-17,Senate,"Special Consent Calendar # ACR10",30,0,10,0,40
913468,627205,2017-04-18,Senate,"Do pass as amended, but first amend, and re-refer to the Committee on [Appropriations] with the recommendation: To Consent Calendar",7,0,0,0,7
913468,644410,2017-05-15,Senate,"Placed on suspense file",7,0,0,0,7
913468,650690,2017-05-25,Senate,"Do pass as amended",5,1,1,0,7
913468,656151,2017-05-31,Senate,"Senate 3rd Reading SB142 Beall",35,4,1,0,40
913468,768274,2018-06-26,Assembly,"Do pass and be re-referred to the Committee on [Appropriations]",7,0,0,0,7
913473,608482,2017-03-21,Senate,"Do pass, but first be re-referred to the Committee on [Appropriations]",5,1,1,0,7
913473,617482,2017-04-03,Senate,"Placed on suspense file",7,0,0,0,7
916310,631674,2017-04-25,Assembly,"Do pass and be re-referred to the Committee on [Appropriations] with recommendation: To Consent Calendar",15,0,1,0,16
916310,637319,2017-05-03,Assembly,"Do pass. To Consent Calendar",16,0,1,0,17
916310,643641,2017-05-11,Assembly,"AB 171 LACKEY Consent Calendar Second Day Regular Session",77,0,3,0,80
916310,672875,2017-07-19,Senate,"Do pass and be ordered to the Consent Calendar",7,0,0,0,7
916314,631710,2017-04-24,Assembly,"Do pass and be re-referred to the Committee on [Appropriations]",11,2,1,0,14
916314,637414,2017-05-03,Assembly,"Do pass",16,0,1,0,17
916314,643673,2017-05-11,Assembly,"AB 174 BIGELOW Assembly Third Reading",70,2,8,0,80
916314,674995,2017-09-05,Senate,"Assembly 3rd Reading AB174 Bigelow By Gaines Urgency Clause",40,0,0,0,40
916314,675224,2017-09-07,Assembly,"AB 174 BIGELOW Concurrence - Urgency Added",79,0,0,0,79
916320,603562,2017-03-14,Assembly,"Do pass and be re-referred to the Committee on [Veterans Affairs]",13,0,0,0,13
916320,620846,2017-04-04,Assembly,"Do pass and be re-referred to the Committee on [Appropriations]",10,0,0,0,10
916320,633668,2017-04-26,Assembly,"Do pass. To Consent Calendar",16,0,1,0,17
916320,638357,2017-05-04,Assembly,"AB 172 CHÁVEZ Consent Calendar Second Day Regular Session",76,0,4,0,80
916320,660668,2017-06-07,Senate,"Do pass, but first be re-referred to the Committee on [Veterans Affairs] with the recommendation: To Consent Calendar",7,0,0,0,7
916320,669120,2017-06-27,Senate,"Do pass, but first be re-referred to the Committee on [Appropriations] with the recommendation: To Consent Calendar",7,0,0,0,7
916320,672996,2017-07-20,Senate,"Consent Calendar 2nd AB172",38,0,2,0,40
916322,626878,2017-04-18,Assembly,"Do pass and be re-referred to the Committee on [Health]",11,3,2,0,16
916322,631659,2017-04-25,Assembly,"Do pass and be re-referred to the Committee on [Appropriations]",14,0,1,0,15
916322,651967,2017-05-26,Assembly,"Do pass as amended",14,3,0,0,17
916322,655783,2017-05-31,Assembly,"AB 175 CHAU Assembly Third Reading",61,13,6,0,80
916322,669172,2017-06-26,Senate,"Do pass, but first be re-referred to the Committee on [Health]",5,2,2,0,9
916322,672615,2017-07-12,Senate,"Do pass, but first be re-referred to the Committee on [Appropriations]",8,0,1,0,9
916322,673754,2017-08-21,Senate,"Placed on suspense file",7,0,0,0,7
916324,620978,2017-04-05,Assembly,"Do pass and be re-referred to the Committee on [Appropriations]",6,0,1,0,7
916324,633549,2017-04-26,Assembly,"Do pass. To Consent Calendar",16,0,1,0,17
916324,638590,2017-05-04,Assembly,"AB 170 O'DONNELL Consent Calendar Second Day Regular Session",76,0,4,0,80
916324,659766,2017-06-07,Senate,"Do pass, but first be re-referred to the Committee on [Appropriations] with the recommendation: To Consent Calendar",7,0,0,0,7
916324,670959,2017-07-03,Senate,"Consent Calendar 2nd AB170",33,0,7,0,40
916327,637452,2017-05-02,Senate,"Do pass as amended",5,1,1,0,7
916327,647921,2017-05-22,Senate,"Senate 3rd Reading SB147 Dodd",25,6,9,0,40
916327,672377,2017-07-12,Assembly,"Do pass as amended",4,2,1,0,7
916327,674372,2017-08-31,Assembly,"SB 147 Dodd Senate Third Reading By KALRA",73,0,6,0,79
916327,674853,2017-09-05,Senate,"Unfinished Business SB147 Dodd Concurrence",40,0,0,0,40
916330,629111,2017-04-19,Assembly,"Do pass and be re-referred to the Committee on [Appropriations]",5,2,0,0,7
916330,642479,2017-05-10,Assembly,"Do pass",11,6,0,0,17
916330,647910,2017-05-22,Assembly,"AB 168 EGGMAN Assembly Third Reading",60,9,11,0,80
916330,663173,2017-06-14,Senate,"Do pass, but first be re-referred to the Committee on [Rules]",4,1,0,0,5
916330,671871,2017-07-10,Senate,"Do pass, but first be re-referred to the Committee on [Appropriations]",3,2,0,0,5
916330,675620,2017-09-12,Senate,"Assembly 3rd Reading AB168 Eggman et al. By Jackson",27,10,3,0,40
916330,676252,2017-09-14,Assembly,"AB 168 EGGMAN Concurrence in Senate Amendments",57,15,7,0,79
916332,627029,2017-04-18,Senate,"Do pass, but first be re-referred to the Committee on [Appropriations] with the recommendation: To Consent Calendar",12,0,1,0,13
916332,638342,2017-05-04,Senate,"Consent Calendar 2nd SB145 Hill Urgency Clause",38,0,2,0,40
916332,668671,2017-06-26,Assembly,"Do pass and be re-referred to the Committee on [Communications and Conveyance]",14,0,0,0,14
916332,672430,2017-07-12,Assembly,"Do pass and be re-referred to the Committee on [Appropriations] with recommendation: To Consent Calendar",13,0,0,0,13
916332,674029,2017-08-23,Assembly,"Do pass",14,0,3,0,17
916332,676542,2017-09-15,Assembly,"SB 145 Hill Third Reading Urgency By BERMAN",76,2,1,0,79
916332,676543,2017-09-15,Senate,"Unfinished Business SB145 Hill et al. Urgency Clause Concurrence",38,0,2,0,40
916336,569040,2017-01-19,Senate,"Senate 3rd Reading SR13 De León",31,0,9,0,40
916340,599165,2017-03-07,Assembly,"Do pass as amended, and be re-referred to the Committee on [Appropriations] with recommendation: To Consent Calendar",7,0,0,0,7
916343,614910,2017-03-29,Senate,"Do pass as amended, but first amend, and re-refer to the Committee on [Appropriations]",6,1,0,0,7
916343,630405,2017-04-24,Senate,"Placed on suspense file",7,0,0,0,7
916346,571760,2017-01-26,Assembly,"Be adopted. To third reading",11,0,0,0,11
916346,593546,2017-02-27,Senate,"Assembly 3rd Reading ACR11 Baker et al. By Leyva",38,0,2,0,40
916346,596757,2017-03-02,Assembly,"ACR 11 BAKER Concurrence in Senate Amendments",74,0,6,0,80
916348,605187,2017-03-15,Assembly,"Do pass and be re-referred to the Committee on [Appropriations]",7,0,0,0,7
916348,651625,2017-05-26,Assembly,"Do pass",16,0,1,0,17
916348,656107,2017-05-31,Assembly,"AB 169 O'DONNELL Assembly Third Reading",77,0,3,0,80
918802,569718,2017-01-23,Assembly,"Be adopted. To third reading",10,0,1,0,11
918802,587473,2017-02-17,Senate,"Special Consent Calendar # ACR13",30,0,10,0,40
918829,632288,2017-04-25,Senate,"Do pass as amended, but first amend, and re-refer to the Committee on [Appropriations]",6,0,1,0,7
918829,654671,2017-05-30,Senate,"Senate 3rd Reading SB156 Anderson et al. Urgency Clause",40,0,0,0,40
918829,669960,2017-06-27,Assembly,"Do pass and be re-referred to the Committee on [Appropriations]",8,1,1,0,10
918829,674262,2017-08-30,Assembly,"Do pass",15,0,2,0,17
918829,675216,2017-09-07,Assembly,"SB 156 Anderson Third Reading Urgency By GONZALEZ FLETCHER",73,2,4,0,79
918829,676285,2017-09-14,Senate,"Special Consent Calendar SB156 Anderson et al. Urgency Clause",40,0,0,0,40
918857,627035,2017-04-17,Assembly,"Do pass as amended and be re-referred to the Committee on [Appropriations]",10,0,0,0,10
918886,631828,2017-04-24,Assembly,"Do pass and be re-referred to the Committee on [Appropriations]",9,5,0,0,14
918886,637600,2017-05-03,Assembly,"Do pass",11,5,1,0,17
918886,654005,2017-05-30,Assembly,"AB 179 CERVANTES Assembly Third Reading",52,24,4,0,80
918886,672148,2017-07-11,Senate,"Do pass as amended, but first amend, and re-refer to the Committee on [Appropriations]",9,4,0,0,13
918886,674384,2017-08-31,Senate,"Assembly 3rd Reading AB179 Cervantes et al. By Beall",24,13,3,0,40
918886,674910,2017-09-05,Assembly,"AB 179 CERVANTES Concurrence in Senate Amendments",50,25,4,0,79
918916,620367,2017-04-04,Senate,"Do pass and be ordered to the Consent Calendar",6,0,1,0,7
918916,629207,2017-04-20,Senate,"Consent Calendar 2nd SB153 Anderson et al",36,0,4,0,40
918916,662187,2017-06-13,Assembly,"Do pass. To Consent Calendar",11,0,0,0,11
918916,665304,2017-06-19,Assembly,"SB 153 Anderson Consent Calendar Second Day",74,0,6,0,80
918946,603333,2017-03-14,Assembly,"Be adopted. To Consent Calendar",11,0,0,0,11
918946,630531,2017-04-24,Senate,"Special Consent ACR12 Gallagher et al",37,0,3,0,40
918975,610106,2017-03-22,Senate,"Do pass, but first be re-referred to the Committee on [Appropriations] with the recommendation: To Consent Calendar",7,0,0,0,7
918975,617330,2017-04-03,Senate,"Placed on suspense file",7,0,0,0,7
919007,603223,2017-03-14,Senate,"Be adopted, but first be re-referred to the Committee on [Elections and Constitutional Amendments]",9,0,4,0,13
919007,608204,2017-03-21,Senate,"Be adopted, but first be re-referred to the Committee on [Appropriations]",4,1,0,0,5
919007,617561,2017-04-03,Senate,"Be adopted",5,2,0,0,7
919064,615000,2017-03-28,Senate,"Do pass, but first be re-referred to the Committee on [Elections and Constitutional Amendments]",5,2,0,0,7
919064,626796,2017-04-18,Senate,"Do pass, but first be re-referred to the Committee on [Appropriations]",4,1,0,0,5
919064,635811,2017-05-01,Senate,"Placed on suspense file",7,0,0,0,7
919064,650627,2017-05-25,Senate,"Do pass",5,2,0,0,7
919064,656066,2017-05-31,Senate,"Senate 3rd Reading SB149 McGuire et al",27,13,0,0,40
919064,672364,2017-07-12,Assembly,"Do pass and be re-referred to the Committee on [Appropriations]",4,2,1,0,7
919064,674035,2017-08-23,Assembly,"Do pass",10,5,2,0,17
919064,675106,2017-09-07,Assembly,"SB 149 McGuire Senate Third Reading By SANTIAGO Amend By HARPER Set #1 Motion to Lay on the Table By CALDERON",50,26,3,0,79
919064,676194,2017-09-14,Assembly,"SB 149 McGuire Senate Third Reading By SANTIAGO",54,23,2,0,79
919064,676457,2017-09-15,Senate,"Unfinished Business SB149 McGuire et al. Concurrence",27,11,2,0,40
919064,774565,2017-09-07,Assembly,,10,26,3,0,39
919127,684186,2018-01-08,Assembly,"Be adopted and re-referred to the Committee on [Appropriations]",2,7,1,0,10
919156,608255,2017-03-21,Assembly,"Do pass and be re-referred to the Committee on [Appropriations]",14,0,1,0,15
919188,619891,2017-04-05,Senate,"Do pass, but first be re-referred to the Committee on [Appropriations]",9,0,0,0,9
919188,635838,2017-05-01,Senate,"Senate 3rd Reading SB152 Hernandez et al",37,0,3,0,40
919188,666596,2017-06-20,Assembly,"Do pass and be re-referred to the Committee on [Appropriations]",15,0,0,0,15
919188,669748,2017-06-28,Assembly,"Do pass. To Consent Calendar",14,0,3,0,17
919188,671601,2017-07-06,Assembly,"SB 152 Hernandez Consent Calendar Second Day Regular Session",74,0,6,0,80
919188,772712,2018-08-24,Assembly,"SB 152 Hernandez Senate Third Reading Amend By WOOD Set #1",50,24,6,0,80
919188,773081,2018-08-28,Assembly,"Do pass",6,3,0,0,9
919188,773972,2018-08-31,Senate,"That the Assembly amendments be concurred in",5,2,0,0,7
919188,774216,2018-08-31,Senate,"Unfinished Business SB152 McGuire Concurrence",26,13,1,0,40
919188,774217,2018-08-31,Assembly,"SB 152 McGuire Senate Third Reading By WOOD",50,28,2,0,80
919215,619791,2017-04-04,Senate,"Do pass as amended, but first amend, and re-refer to the Committee on [Appropriations]",6,0,1,0,7
919215,654397,2017-05-30,Senate,"Senate 3rd Reading SB157 Wieckowski",40,0,0,0,40
919215,666139,2017-06-20,Assembly,"Do pass and be re-referred to the Committee on [Privacy and Consumer Protection] with recommendation: To Consent Calendar",11,0,0,0,11
919215,669022,2017-06-27,Assembly,"Do pass and be re-referred to the Committee on [Appropriations] with recommendation: To Consent Calendar",10,0,0,0,10
919215,672873,2017-07-19,Assembly,"Do pass. To Consent Calendar",16,0,1,0,17
919215,674076,2017-08-24,Assembly,"SB 157 Wieckowski Consent Calendar Second Day Regular Session",76,0,3,0,79
919244,626777,2017-04-18,Assembly,"Do pass and be re-referred to the Committee on [Appropriations] with recommendation: To Consent Calendar",15,0,0,0,15
919244,633218,2017-04-26,Assembly,"Do pass. To Consent Calendar",16,0,1,0,17
919244,638332,2017-05-04,Assembly,"AB 180 WOOD Consent Calendar Second Day Regular Session",76,0,4,0,80
919244,667082,2017-06-21,Senate,"Do pass, but first be re-referred to the Committee on [Appropriations]",9,0,0,0,9
919244,772447,2018-08-22,Senate,"Do pass, but first be re-referred to the Committee on [Appropriations]",9,0,0,0,9
919244,773269,2018-08-29,Senate,"Do pass",6,0,1,0,7
919244,774110,2018-08-31,Senate,"Assembly 3rd Reading AB180 Wood et al. By McGuire Urgency Clause",39,0,1,0,40
919244,774111,2018-08-31,Assembly,"AB 180 Wood Concurrence - Urgency Added",80,0,0,0,80
919302,619714,2017-04-05,Senate,"Do pass as amended, but first amend, and re-refer to the Committee on [Transportation and Housing]",5,2,0,0,7
919302,631846,2017-04-25,Senate,"Do pass as amended, but first amend, and re-refer to the Committee on [Appropriations]",9,4,0,0,13
919302,647805,2017-05-22,Senate,"Placed on suspense file",7,0,0,0,7
919302,650724,2017-05-25,Senate,"Do pass",5,2,0,0,7
919302,654310,2017-05-30,Senate,"Senate 3rd Reading SB150 Allen",26,13,1,0,40
919302,668643,2017-06-26,Assembly,"Do pass and be re-referred to the Committee on [Natural Resources]",11,2,1,0,14
919302,672176,2017-07-10,Assembly,"Do pass and be re-referred to the Committee on [Appropriations]",8,0,2,0,10
919302,674582,2017-09-01,Assembly,"Do pass",13,1,3,0,17
919302,675196,2017-09-07,Assembly,"SB 150 Allen Senate Third Reading By GONZALEZ FLETCHER",69,6,4,0,79
919302,675373,2017-09-11,Senate,"Unfinished Business SB150 Allen et al. Concurrence",31,8,1,0,40
921884,605322,2017-03-15,Assembly,"Do pass and be re-referred to the Committee on [Appropriations] with recommendation: To Consent Calendar",7,0,0,0,7
921884,619713,2017-04-05,Assembly,"Do pass. To Consent Calendar",17,0,0,0,17
921884,629188,2017-04-20,Assembly,"AB 192 MEDINA Consent Calendar Second Day Regular Session",74,0,6,0,80
921884,660508,2017-06-07,Senate,"Do pass, but first be re-referred to the Committee on [Appropriations] with the recommendation: To Consent Calendar",7,0,0,0,7
921884,670998,2017-07-03,Senate,"Consent Calendar 2nd AB192",33,0,7,0,40
921884,671511,2017-07-06,Assembly,"AB 192 MEDINA Concurrence in Senate Amendments",76,0,4,0,80
921912,669699,2017-06-28,Assembly,"Be adopted and re-referred to the Committee on [Appropriations]",2,4,1,0,7
921940,608949,2017-03-21,Assembly,"Do pass and be re-referred to the Committee on [Natural Resources]",14,0,1,0,15
921940,627560,2017-04-17,Assembly,"Do pass and be re-referred to the Committee on [Appropriations]",10,0,0,0,10
921940,651503,2017-05-26,Assembly,"Do pass",17,0,0,0,17
921940,655800,2017-05-31,Assembly,"AB 196 BIGELOW Assembly Third Reading",77,0,3,0,80
921940,671381,2017-07-05,Senate,"Do pass, but first be re-referred to the Committee on [Appropriations]",6,0,1,0,7
921940,672722,2017-07-17,Senate,"Placed on suspense file",7,0,0,0,7
921996,603519,2017-03-14,Senate,"Do pass, but first be re-referred to the Committee on [Appropriations]",9,0,0,0,9
921996,617840,2017-04-03,Senate,"Placed on suspense file",7,0,0,0,7
921996,650795,2017-05-25,Senate,"Do pass",7,0,0,0,7
921996,655872,2017-05-31,Senate,"Special Consent Calendar # SB161",40,0,0,0,40
921996,669498,2017-06-27,Assembly,"Do pass and be re-referred to the Committee on [Appropriations]",15,0,0,0,15
921996,674655,2017-09-01,Assembly,"Do pass",16,0,1,0,17
921996,675203,2017-09-07,Assembly,"SB 161 McGuire Senate Third Reading By GARCIA, C",79,0,0,0,79
921996,777243,2017-09-01,Assembly,<,15,0,1,0,16
922024,632586,2017-04-24,Assembly,"Do pass and be re-referred to the Committee on [Appropriations]",10,3,1,0,14
922024,651900,2017-05-26,Assembly,"Do pass as amended",12,5,0,0,17
922024,655997,2017-05-31,Assembly,"AB 193 CERVANTES Assembly Third Reading",56,20,4,0,80
922024,669215,2017-06-27,Senate,"Do pass as amended, but first amend, and re-refer to the Committee on [Environmental Quality]",9,3,1,0,13
922024,671343,2017-07-05,Senate,"Do pass, but first be re-referred to the Committee on [Appropriations]",4,1,2,0,7
922024,673762,2017-08-21,Senate,"Placed on suspense file",7,0,0,0,7
922024,674788,2017-09-01,Senate,"Do pass",5,2,0,0,7
922024,771454,2018-08-14,Senate,"That the measure be returned to Senate Floor for consideration. Ordered to third reading",10,3,0,0,13
922024,772247,2018-08-20,Senate,"Assembly 3rd Reading AB193 Cervantes et al. By Roth",29,10,1,0,40
922024,772509,2018-08-23,Assembly,"AB 193 CERVANTES Concurrence in Senate Amendments",58,20,2,0,80
922052,610230,2017-03-22,Assembly,"Do pass and be re-referred to the Committee on [Appropriations]",7,0,0,0,7
922052,620583,2017-04-05,Assembly,"Do pass. To Consent Calendar",17,0,0,0,17
922052,629233,2017-04-20,Assembly,"AB 195 OBERNOLTE Consent Calendar Second Day Regular Session",74,0,6,0,80
922052,659652,2017-06-06,Senate,"Do pass, but first be re-referred to the Committee on [Appropriations] with the recommendation: To Consent Calendar",4,0,1,0,5
922052,670981,2017-07-03,Senate,"Consent Calendar 2nd AB195",33,0,7,0,40
922080,620071,2017-04-04,Senate,"Do pass, but first be re-referred to the Committee on [Appropriations]",13,0,0,0,13
922080,630505,2017-04-24,Senate,"Do pass",7,0,0,0,7
922080,635790,2017-05-01,Senate,"Senate 3rd Reading SB158 Monning et al",37,0,3,0,40
922080,671859,2017-07-10,Assembly,"Do pass as amended and be re-referred to the Committee on [Appropriations]",14,0,0,0,14
922109,600111,2017-03-08,Senate,"Do pass, but first be re-referred to the Committee on [Appropriations]",7,0,0,0,7
922109,617731,2017-04-03,Senate,"Do pass",7,0,0,0,7
922109,621203,2017-04-06,Senate,"Senate 3rd Reading SB164 McGuire et al",39,0,1,0,40
922109,666422,2017-06-20,Assembly,"Do pass and be re-referred to the Committee on [Appropriations]",13,0,0,0,13
922109,669890,2017-06-28,Assembly,"Do pass. To Consent Calendar",14,0,3,0,17
922109,671573,2017-07-06,Assembly,"SB 164 McGuire Consent Calendar Second Day Regular Session",74,0,6,0,80
922137,608319,2017-03-21,Assembly,"Do pass as amended and be re-referred to the Committee on [Public Safety]",9,4,2,0,15
922137,631512,2017-04-25,Assembly,"Do pass",4,3,0,0,7
922137,656875,2017-06-01,Assembly,"AB 186 EGGMAN Assembly Third Reading",41,33,6,0,80
922137,671582,2017-07-05,Senate,"Do pass, but first be re-referred to the Committee on [Public Safety]",5,3,1,0,9
922137,672167,2017-07-11,Senate,"Do pass as amended",5,2,0,0,7
922137,675624,2017-09-12,Senate,"Assembly 3rd Reading AB186 Eggman et al. By Wiener",19,17,4,0,40
922137,675625,2017-09-12,Senate,"Assembly 3rd Reading AB186 Eggman et al. By Wiener Reconsider",40,0,0,0,40
922137,772336,2018-08-21,Senate,"Assembly 3rd Reading AB186 Eggman et al. By Wiener",21,16,3,0,40
922137,772987,2018-08-27,Assembly,"AB 186 EGGMAN Concurrence in Senate Amendments",42,30,8,0,80
922193,612694,2017-03-27,Assembly,"Do pass and be re-referred to the Committee on [Appropriations]",14,0,0,0,14
922193,651872,2017-05-26,Assembly,"Do pass as amended",16,0,1,0,17
922193,655755,2017-05-31,Assembly,"AB 188 SALAS Assembly Third Reading",77,0,3,0,80
922193,669048,2017-06-27,Senate,"Do pass, but first be re-referred to the Committee on [Environmental Quality] with the recommendation: To Consent Calendar",12,0,1,0,13
922193,671324,2017-07-05,Senate,"Do pass, but first be re-referred to the Committee on [Appropriations]",7,0,0,0,7
922193,673883,2017-08-21,Senate,"Do pass",6,0,1,0,7
922193,674339,2017-08-31,Senate,"Special Consent Calendar # AB188",37,0,3,0,40
922193,675627,2017-09-12,Senate,"Assembly 3rd Reading AB188 Salas et al. By Lara",40,0,0,0,40
922193,675940,2017-09-13,Assembly,"AB 188 Salas Concurrence in Senate Amendments",77,0,2,0,79
922221,668975,2017-06-27,Senate,"Do pass, but first be re-referred to the Committee on [Transportation and Housing]",8,0,1,0,9
922221,672091,2017-07-11,Senate,"Do pass, but first be re-referred to the Committee on [Appropriations]",12,0,1,0,13
922221,673903,2017-08-21,Senate,"Do pass",7,0,0,0,7
922221,674094,2017-08-24,Senate,"Senate 3rd Reading SB159 Allen Urgency Clause",38,0,2,0,40
922221,674347,2017-08-31,Assembly,"Do pass and be re-referred to the Committee on [Appropriations]",11,1,3,0,15
922221,675334,2017-09-11,Assembly,"Do pass",15,0,2,0,17
922221,676379,2017-09-14,Assembly,"SB 159 Allen Third Reading Urgency By EGGMAN",74,1,4,0,79
922221,676528,2017-09-15,Senate,"Unfinished Business SB159 Allen Urgency Clause Concurrence",37,1,2,0,40
922249,626035,2017-04-17,Senate,"Do pass as amended, but first amend, and re-refer to the Committee on [Appropriations]",9,0,0,0,9
922249,644336,2017-05-15,Senate,"Placed on suspense file",7,0,0,0,7
922249,650741,2017-05-25,Senate,"Do pass",7,0,0,0,7
922249,656203,2017-05-31,Senate,"Special Consent Calendar # SB162",40,0,0,0,40
922249,669116,2017-06-27,Assembly,"Do pass and be re-referred to the Committee on [Appropriations]",12,0,4,0,16
922277,605253,2017-03-15,Assembly,"Do pass and be re-referred to the Committee on [Appropriations]",7,0,0,0,7
922277,651562,2017-05-26,Assembly,"Do pass as amended",12,0,5,0,17
922277,654419,2017-05-30,Assembly,"AB 185 O'DONNELL Assembly Second Reading Amendment Set #1",52,22,6,0,80
922277,656834,2017-06-01,Assembly,"AB 185 O'DONNELL Assembly Third Reading",50,26,4,0,80
922277,768934,2018-06-27,Senate,"Do pass, but first be re-referred to the Committee on [Appropriations]",7,0,0,0,7
922277,770307,2018-08-06,Senate,"Placed on suspense file",7,0,0,0,7
922304,603681,2017-03-14,Senate,"Do pass, but first be re-referred to the Committee on [Appropriations] with the recommendation: To Consent Calendar",11,0,2,0,13
922304,661224,2017-04-06,Senate,"Consent Calendar 2nd SB165 Portantino",39,0,1,0,40
922304,667374,2017-06-21,Assembly,"Do pass and be re-referred to the Committee on [Appropriations] with recommendation: To Consent Calendar",17,0,4,0,21
922304,672917,2017-07-19,Assembly,"Do pass. To Consent Calendar",16,0,1,0,17
922361,610110,2017-03-22,Assembly,"Do pass as amended and be re-referred to the Committee on [Appropriations]",5,1,1,0,7
922361,620132,2017-04-05,Assembly,"Do pass",12,5,0,0,17
922361,629408,2017-04-20,Assembly,"AB 187 GLORIA Assembly Third Reading",58,13,9,0,80
922361,659750,2017-06-06,Senate,"Do pass, but first be re-referred to the Committee on [Appropriations]",3,1,1,0,5
922361,673956,2017-08-21,Senate,"Assembly 3rd Reading AB187 Gloria By Stern",27,11,2,0,40
922389,571814,2017-01-26,Assembly,"Be adopted. To third reading",11,0,0,0,11
922389,576023,2017-02-02,Assembly,"HR 8 WALDRON Assembly Third Reading",77,0,3,0,80
922417,605220,2017-03-15,Assembly,"Do pass as amended and be re-referred to the Committee on [Appropriations]",5,2,0,0,7
922417,651982,2017-05-26,Assembly,"Do pass as amended",12,5,0,0,17
922417,655766,2017-05-31,Assembly,"AB 189 LOW Assembly Third Reading",60,13,7,0,80
922417,671335,2017-07-05,Senate,"Do pass, but first be re-referred to the Committee on [Appropriations]",5,1,1,0,7
922417,672747,2017-07-17,Senate,"Placed on suspense file",7,0,0,0,7
922417,674683,2017-09-01,Senate,"Do pass as amended",5,1,1,0,7
922417,675054,2017-09-06,Senate,"Assembly 3rd Reading AB189 Low By Portantino",31,7,2,0,40
922417,675492,2017-09-11,Assembly,"AB 189 LOW Concurrence in Senate Amendments",64,10,5,0,79
922417,775208,2017-05-26,Assembly,,5,2,0,0,7
922445,608459,2017-03-21,Assembly,"Do pass as amended and be re-referred to the Committee on [Appropriations]",15,0,0,0,15
922445,651909,2017-05-26,Assembly,"Do pass as amended",16,0,1,0,17
922445,656060,2017-05-31,Assembly,"AB 182 WALDRON Assembly Third Reading",77,0,3,0,80
922445,669825,2017-06-28,Senate,"Do pass, but first be re-referred to the Committee on [Appropriations]",7,0,2,0,9
922445,672730,2017-07-17,Senate,"Placed on suspense file",7,0,0,0,7
922473,627955,2017-04-19,Assembly,"Do pass and be re-referred to the Committee on [Appropriations] with recommendation: To Consent Calendar",7,0,0,0,7
922473,638024,2017-05-03,Assembly,"Do pass. To Consent Calendar",16,0,1,0,17
922473,643686,2017-05-11,Assembly,"AB 183 LACKEY Consent Calendar Second Day Regular Session",77,0,3,0,80
922473,661667,2017-06-12,Senate,"Do pass, but first be re-referred to the Committee on [Appropriations] with the recommendation: To Consent Calendar",5,0,0,0,5
922473,671003,2017-07-03,Senate,"Consent Calendar 2nd AB183",33,0,7,0,40
922473,772300,2018-08-20,Assembly,"AB 183 LACKEY Concurrence in Senate Amendments",80,0,0,0,80
922529,594693,2017-02-28,Assembly,"Do pass as amended and be re-referred to the Committee on [Appropriations]",6,1,0,0,7
922529,620052,2017-04-05,Assembly,"Do pass",17,0,0,0,17
922529,630358,2017-04-24,Assembly,"AB 194 PATTERSON Assembly Third Reading",71,4,5,0,80
922529,658880,2017-06-06,Senate,"Do pass, but first be re-referred to the Committee on [Appropriations]",2,2,3,0,7
922529,658881,2017-06-06,Senate,"[First] hearing set for [06-06-2017]: Failed passage in Committee. Reconsideration granted",7,0,0,0,7
922557,610006,2017-03-20,Assembly,"Do pass and be re-referred to the Committee on [Appropriations]",9,1,0,0,10
922557,620066,2017-04-05,Assembly,"Do pass",13,4,0,0,17
922557,634533,2017-04-27,Assembly,"AB 184 BERMAN Assembly Third Reading",63,9,8,0,80
922557,662472,2017-06-13,Senate,"Do pass, but first be re-referred to the Committee on [Appropriations]",7,2,0,0,9
922557,674343,2017-08-31,Senate,"Assembly 3rd Reading AB184 Berman et al. By Hill",35,4,1,0,40
922557,674977,2017-09-05,Assembly,"AB 184 BERMAN Concurrence in Senate Amendments",65,11,3,0,79
922584,608424,2017-03-21,Assembly,"Do pass",15,0,0,0,15
922584,615969,2017-03-30,Assembly,"AB 191 WOOD Assembly Third Reading",75,0,5,0,80
922584,667067,2017-06-21,Senate,"Do pass",9,0,0,0,9
922584,673917,2017-08-21,Senate,"Assembly 3rd Reading AB191 Wood By Hernandez",39,0,1,0,40
927758,582914,2017-02-13,Assembly,"Be adopted. To third reading",9,0,2,0,11
927758,616022,2017-03-30,Senate,"Special Consent Calendar # ACR14",37,0,3,0,40
927779,634652,2017-04-26,Assembly,"Do pass and be re-referred to the Committee on [Appropriations] with recommendation: To Consent Calendar",7,0,0,0,7
927779,651948,2017-05-26,Assembly,"Do pass",17,0,0,0,17
927779,654464,2017-05-30,Assembly,"AB 203 O'DONNELL Assembly Third Reading",76,0,4,0,80
927779,667453,2017-06-21,Senate,"Do pass as amended, but first amend, and re-refer to the Committee on [Appropriations] with the recommendation: To Consent Calendar",6,0,1,0,7
927779,672749,2017-07-17,Senate,"Placed on suspense file",7,0,0,0,7
927779,674832,2017-09-01,Senate,"Do pass",7,0,0,0,7
927779,676093,2017-09-14,Senate,"Special Consent Calendar # AB203",40,0,0,0,40
927779,676368,2017-09-14,Assembly,"AB 203 O'Donnell Special Consent Calendar 1st Day Regular Session",79,0,0,0,79
927788,610176,2017-03-20,Assembly,"Do pass and be re-referred to the Committee on [Appropriations] with recommendation: To Consent Calendar",10,0,0,0,10
927788,651540,2017-05-26,Assembly,"Do pass",17,0,0,0,17
927788,654266,2017-05-30,Assembly,"AB 211 BIGELOW Assembly Third Reading",76,0,4,0,80
927788,672073,2017-07-11,Senate,"Do pass, but first be re-referred to the Committee on [Appropriations] with the recommendation: To Consent Calendar",9,0,0,0,9
927797,603275,2017-03-14,Assembly,"Do pass and be re-referred to the Committee on [Appropriations]",5,2,0,0,7
927797,651530,2017-05-26,Assembly,"Do pass",12,5,0,0,17
927797,656957,2017-06-01,Assembly,"AB 208 EGGMAN Assembly Third Reading",46,27,7,0,80
927797,672158,2017-07-11,Senate,"Do pass, but first be re-referred to the Committee on [Appropriations]",4,2,1,0,7
927797,673841,2017-08-21,Senate,"Placed on suspense file",7,0,0,0,7
927797,674495,2017-09-01,Senate,"Do pass as amended",5,2,0,0,7
927797,675594,2017-09-12,Senate,"Assembly 3rd Reading AB208 Eggman By Lara",24,15,1,0,40
927797,676196,2017-09-14,Assembly,"AB 208 EGGMAN Concurrence in Senate Amendments",45,29,5,0,79
927797,777563,2017-09-12,Senate,,5,15,1,0,21
927820,603264,2017-03-14,Assembly,"Do pass as amended and be re-referred to the Committee on [Appropriations]",13,0,0,0,13
927820,651814,2017-05-26,Assembly,"Do pass",17,0,0,0,17
927820,654015,2017-05-30,Assembly,"AB 204 MEDINA Assembly Third Reading",74,1,5,0,80
927820,667200,2017-06-21,Senate,"Do pass as amended, but first amend, and re-refer to the Committee on [Appropriations] with the recommendation: To Consent Calendar",6,0,1,0,7
927820,671846,2017-07-10,Senate,"Placed on suspense file",7,0,0,0,7
927829,612725,2017-03-27,Senate,"Do pass, but first be re-referred to the Committee on [Appropriations]",9,0,0,0,9
927829,629126,2017-04-20,Senate,"Senate 3rd Reading SB175 McGuire",36,4,0,0,40
927829,763495,2018-06-14,Assembly,"Be re-referred to the Committees on [Human Services] and [Judiciary]",7,0,4,0,11
927829,768751,2018-06-26,Assembly,"Do pass and be re-referred to the Committee on [Judiciary] with recommendation: To Consent Calendar",7,0,0,0,7
927829,769175,2018-06-28,Assembly,"Do pass as amended and be re-referred to the Committee on [Appropriations]",9,0,1,0,10
927829,771053,2018-08-08,Assembly,"Do pass. To Consent Calendar",17,0,0,0,17
927829,771733,2018-08-16,Assembly,"SB 175 McGuire Consent Calendar Second Day Regular Session",76,0,4,0,80
927829,772358,2018-08-21,Senate,"That the Assembly amendments be concurred in",5,0,2,0,7
927829,772683,2018-08-24,Senate,"Unfinished Business SB175 McGuire et al. Urgency Clause Concurrence",39,0,1,0,40
927840,634568,2017-04-26,Senate,"Do pass as amended, but first amend, and re-refer to the Committee on [Appropriations]",7,0,2,0,9
927840,644414,2017-05-15,Senate,"Placed on suspense file",7,0,0,0,7
927858,627938,2017-04-19,Senate,"Do pass, but first be re-referred to the Committee on [Judiciary]",5,1,1,0,7
927858,633428,2017-04-25,Senate,"Do pass, but first be re-referred to the Committee on [Appropriations]",5,1,1,0,7
927858,644407,2017-05-15,Senate,"Placed on suspense file",7,0,0,0,7
927858,650663,2017-05-25,Senate,"Do pass as amended",5,2,0,0,7
927858,656086,2017-05-31,Senate,"Senate 3rd Reading SB169 Jackson et al",26,10,4,0,40
927858,668946,2017-06-27,Assembly,"Do pass and be re-referred to the Committee on [Higher Education]",9,1,1,0,11
927858,672061,2017-07-11,Assembly,"Do pass and be re-referred to the Committee on [Appropriations]",11,2,0,0,13
927858,674687,2017-09-01,Assembly,"Do pass as amended",11,5,1,0,17
927858,675755,2017-09-13,Assembly,"SB 169 Jackson Senate Third Reading By GONZALEZ FLETCHER",61,12,6,0,79
927858,676046,2017-09-14,Senate,"Unfinished Business SB169 Jackson et al. Concurrence",28,10,2,0,40
927892,619916,2017-04-04,Assembly,"Do pass as amended and be re-referred to the Committee on [Privacy and Consumer Protection]",7,0,0,0,7
927892,631568,2017-04-25,Assembly,"Do pass as amended and be re-referred to the Committee on [Appropriations]",9,0,1,0,10
927892,645797,2017-05-17,Assembly,"Do pass. To Consent Calendar",17,0,0,0,17
927892,651424,2017-05-26,Assembly,"AB 210 SANTIAGO Consent Calendar Second Day",76,0,4,0,80
927892,669087,2017-06-27,Senate,"Do pass as amended, but first amend, and re-refer to the Committee on [Judiciary]",5,0,0,0,5
927892,672352,2017-07-11,Senate,"Do pass, but first be re-referred to the Committee on [Appropriations]",7,0,0,0,7
927892,675404,2017-09-11,Senate,"Assembly 3rd Reading AB210 Santiago et al. By Mitchell",40,0,0,0,40
927892,675916,2017-09-13,Assembly,"AB 210 SANTIAGO Concurrence in Senate Amendments",79,0,0,0,79
927902,604220,2017-03-15,Assembly,"Do pass and be re-referred to the Committee on [Appropriations]",5,1,1,0,7
927902,651729,2017-05-26,Assembly,"Do pass",11,5,1,0,17
927902,655976,2017-05-31,Assembly,"AB 199 CHU Assembly Third Reading",60,14,6,0,80
927902,669751,2017-06-28,Senate,"Do pass, but first be re-referred to the Committee on [Appropriations]",3,1,1,0,5
927902,672710,2017-07-17,Senate,"Placed on suspense file",7,0,0,0,7
927902,674663,2017-09-01,Senate,"Do pass",5,2,0,0,7
927902,675793,2017-09-13,Senate,"Assembly 3rd Reading AB199 Chu et al. By Hernandez",28,12,0,0,40
927902,676287,2017-09-14,Assembly,"AB 199 Chu Concurrence in Senate Amendments",57,20,2,0,79
927910,603406,2017-03-13,Assembly,"Do pass as amended and be re-referred to the Committee on [Appropriations]",6,1,3,0,10
927921,634491,2017-04-26,Senate,"Do pass as amended, but first amend, and re-refer to the Committee on [Appropriations]",9,0,0,0,9
927921,644247,2017-05-15,Senate,"Placed on suspense file",7,0,0,0,7
927921,650714,2017-05-25,Senate,"Do pass",5,1,1,0,7
927921,654223,2017-05-30,Senate,"Senate 3rd Reading SB171 Hernandez et al",37,0,3,0,40
927921,672186,2017-07-11,Assembly,"Do pass and be re-referred to the Committee on [Appropriations]",14,0,1,0,15
927921,674601,2017-09-01,Assembly,"Do pass",16,0,1,0,17
927921,675325,2017-09-11,Assembly,"Do pass",12,0,2,0,14
927921,676520,2017-09-15,Assembly,"SB 171 Hernandez Senate Third Reading By WOOD",79,0,0,0,79
927921,676521,2017-09-15,Senate,"Unfinished Business SB171 Hernandez et al. Concurrence",38,0,2,0,40
927931,627999,2017-04-19,Senate,"Do pass, but first be re-referred to the Committee on [Appropriations]",5,0,2,0,7
927931,644282,2017-05-15,Senate,"Placed on suspense file",7,0,0,0,7
927931,650739,2017-05-25,Senate,"Do pass",5,2,0,0,7
927931,656648,2017-06-01,Senate,"Senate 3rd Reading SB168 Wieckowski",14,17,9,0,40
927931,656649,2017-06-01,Senate,"Senate 3rd Reading SB168 Wieckowski Reconsider",38,0,2,0,40
927931,690069,2018-01-29,Senate,"Senate 3rd Reading SB168 Wieckowski",28,6,6,0,40
927931,768282,2018-06-25,Assembly,"Do pass as amended and be re-referred to the Committee on [Appropriations]",7,0,3,0,10
927931,771748,2018-08-16,Assembly,"Do pass as amended",12,0,5,0,17
927931,772691,2018-08-24,Assembly,"SB 168 Wieckowski Senate Third Reading By BLOOM Amendment Set #1",43,22,15,0,80
927931,773117,2018-08-28,Assembly,"Do pass",7,2,1,0,10
927931,773997,2018-08-31,Assembly,"SB 168 Wieckowski Senate Third Reading By BLOOM",29,30,21,0,80
927944,613474,2017-03-28,Senate,"Do pass, but first be re-referred to the Committee on [Appropriations]",11,0,2,0,13
927944,626034,2017-04-17,Senate,"Placed on suspense file",7,0,0,0,7
927944,650722,2017-05-25,Senate,"Do pass as amended",7,0,0,0,7
927944,656291,2017-05-31,Senate,"Senate 3rd Reading SB173 Dodd",39,0,1,0,40
927944,669743,2017-06-28,Assembly,"Do pass and be re-referred to the Committee on [Appropriations]",7,0,0,0,7
927944,674474,2017-09-01,Assembly,"Do pass",16,0,1,0,17
927944,676297,2017-09-14,Assembly,"SB 173 Dodd Senate Third Reading By MULLIN",78,0,1,0,79
927944,676522,2017-09-15,Senate,"Unfinished Business SB173 Dodd Concurrence",38,0,2,0,40
927955,631525,2017-04-25,Assembly,"Do pass as amended and be re-referred to the Committee on [Appropriations]",15,0,0,0,15
927955,651801,2017-05-26,Assembly,"Do pass",17,0,0,0,17
927955,654035,2017-05-30,Assembly,"AB 205 WOOD Assembly Third Reading",76,0,4,0,80
927955,672580,2017-07-12,Senate,"Do pass, but first be re-referred to the Committee on [Appropriations]",8,0,1,0,9
927955,673807,2017-08-21,Senate,"Placed on suspense file",7,0,0,0,7
927955,674673,2017-09-01,Senate,"Do pass",7,0,0,0,7
927955,675649,2017-09-12,Senate,"That the measure be returned to Senate Floor for consideration. Ordered to third reading",9,0,0,0,9
927955,675874,2017-09-13,Senate,"Assembly 3rd Reading AB205 Wood et al. By Hernandez",40,0,0,0,40
927955,676151,2017-09-14,Assembly,"With recommendation: That Senate amendments be concurred in",11,0,3,0,14
927955,676539,2017-09-15,Assembly,"AB 205 WOOD Concurrence in Senate Amendments",78,0,1,0,79
927967,626950,2017-04-18,Senate,"Do pass, but first be re-referred to the Committee on [Judiciary]",9,2,2,0,13
927967,637225,2017-05-02,Senate,"Do pass as amended",6,0,1,0,7
927967,656622,2017-06-01,Senate,"Senate 3rd Reading SB167 Skinner et al",30,10,0,0,40
927967,669669,2017-06-28,Assembly,"Do pass and be re-referred to the Committee on [Local Government]",6,1,0,0,7
927967,672315,2017-07-12,Assembly,"Do pass and be re-referred to the Committee on [Rules]",7,1,1,0,9
927967,676328,2017-09-14,Assembly,"SB 167 Skinner Senate Third Reading By BOCANEGRA",59,18,2,0,79
927967,676581,2017-09-15,Senate,"Unfinished Business SB167 Skinner et al. Concurrence",28,9,3,0,40
927977,608428,2017-03-21,Assembly,"Do pass and be re-referred to the Committee on [Appropriations]",14,0,1,0,15
927987,613835,2017-03-28,Senate,"Do pass as amended, but first amend, and re-refer to the Committee on [Environmental Quality]",8,0,5,0,13
927987,672819,2017-07-18,Senate,"Do pass, but first be re-referred to the Committee on [Appropriations]",10,1,0,0,11
927987,673737,2017-08-21,Senate,"Do pass",7,0,0,0,7
927987,674110,2017-08-24,Senate,"Senate 3rd Reading SB174 Lara Urgency Clause",36,0,4,0,40
927987,763363,2018-06-14,Assembly,"Be re-referred to the Committee on [Judiciary]",7,0,4,0,11
927987,769706,2018-07-03,Assembly,"Do pass as amended",7,2,1,0,10
927987,772183,2018-08-20,Assembly,"SB 174 Lara Senate Third Reading By GONZALEZ FLETCHER",46,26,8,0,80
927987,772549,2018-08-23,Senate,"That the Assembly amendments be concurred in",5,2,0,0,7
927987,772664,2018-08-24,Senate,"Unfinished Business SB174 Lara et al. Concurrence",26,11,3,0,40
927996,582360,2017-02-13,Senate,"Senate 3rd Reading SCR16 Leyva et al",38,0,2,0,40
927996,591893,2017-02-23,Assembly,"Be adopted. To Consent Calendar",6,0,5,0,11
928006,578048,2017-02-06,Senate,"Senate 3rd Reading SR14 Lara",40,0,0,0,40
928014,619957,2017-04-05,Assembly,"Do pass",17,0,0,0,17
928014,628945,2017-04-20,Assembly,"AB 212 GONZALEZ FLETCHER Third Reading Urgency",71,0,9,0,80
928014,668537,2017-06-26,Senate,"Do pass",7,0,0,0,7
928014,670364,2017-06-29,Senate,"Assembly 3rd Reading AB212 Gonzalez Fletcher By Lara Urgency Clause",34,0,6,0,40
928024,599934,2017-03-07,Senate,"Do pass, but first be re-referred to the Committee on [Governance and Finance]",9,1,3,0,13
928024,634592,2017-04-26,Senate,"Do pass as amended, but first amend, and re-refer to the Committee on [Appropriations]",5,1,1,0,7
928024,656720,2017-06-01,Senate,"Senate 3rd Reading SB166 Skinner",28,12,0,0,40
928024,670347,2017-06-28,Assembly,"Do pass and be re-referred to the Committee on [Housing and Community Development]",6,2,1,0,9
928024,672387,2017-07-12,Assembly,"Do pass and be re-referred to the Committee on [Rules]",5,2,0,0,7
928024,676370,2017-09-14,Assembly,"SB 166 Skinner Senate Third Reading By BLOOM",54,24,1,0,79
928024,676482,2017-09-15,Senate,"Unfinished Business SB166 Skinner et al. Concurrence",24,11,5,0,40
928033,669623,2017-06-28,Assembly,"Do pass",11,0,6,0,17
928033,671016,2017-07-03,Assembly,"AB 213 GONZALEZ FLETCHER Third Reading Urgency",65,0,15,0,80
928033,674215,2017-08-28,Senate,"Do pass",7,0,0,0,7
928033,674373,2017-08-31,Senate,"Assembly 3rd Reading AB213 Gonzalez Fletcher By Lara Urgency Clause",36,0,4,0,40
928033,674971,2017-09-05,Assembly,"AB 213 GONZALEZ FLETCHER Concurrence in Senate Amendments",76,0,3,0,79
930939,603376,2017-03-14,Assembly,"Do pass and be re-referred to the Committee on [Human Services]",12,0,1,0,13
930939,609831,2017-03-21,Assembly,"Do pass and be re-referred to the Committee on [Appropriations]",7,0,0,0,7
930939,619799,2017-04-05,Assembly,"Do pass",17,0,0,0,17
930939,638287,2017-05-04,Assembly,"AB 214 WEBER Assembly Third Reading",73,0,7,0,80
930939,660147,2017-06-07,Senate,"Do pass, but first be re-referred to the Committee on [Human Services]",7,0,0,0,7
930939,662478,2017-06-13,Senate,"Do pass as amended, but first amend, and re-refer to the Committee on [Appropriations] with the recommendation: To Consent Calendar",4,0,1,0,5
930939,670973,2017-07-03,Senate,"Consent Calendar 2nd AB214",33,0,7,0,40
930939,671855,2017-07-10,Assembly,"AB 214 WEBER Concurrence in Senate Amendments",76,0,4,0,80
930963,610300,2017-03-22,Assembly,"Do pass and be re-referred to the Committee on [Appropriations]",5,2,0,0,7
930963,652057,2017-05-26,Assembly,"Do pass",12,5,0,0,17
930963,655810,2017-05-31,Assembly,"AB 216 GONZALEZ FLETCHER Assembly Third Reading",61,10,9,0,80
930963,672620,2017-07-12,Senate,"Do pass, but first be re-referred to the Committee on [Appropriations]",5,0,0,0,5
930963,673857,2017-08-21,Senate,"Placed on suspense file",7,0,0,0,7
930963,674736,2017-09-01,Senate,"Do pass as amended",5,2,0,0,7
930963,766898,2018-06-21,Senate,"Assembly 3rd Reading AB216 Gonzalez Fletcher By Lara",29,8,2,0,39
930963,769535,2018-07-02,Assembly,"AB 216 GONZALEZ FLETCHER Concurrence in Senate Amendments",61,14,5,0,80
930987,684717,2018-01-09,Senate,"Do pass",5,2,0,0,7
930987,690021,2018-01-29,Senate,"Senate 3rd Reading SB183 Lara et al",28,7,5,0,40
930987,768119,2018-06-26,Assembly,"Do pass and be re-referred to the Committee on [Judiciary]",5,2,0,0,7
930987,769713,2018-07-03,Assembly,"Do pass as amended",8,1,1,0,10
930987,771757,2018-08-16,Assembly,"Do pass",12,5,0,0,17
930987,772652,2018-08-24,Assembly,"SB 183 Lara Senate Third Reading By ARAMBULA Amendment Set #1",50,22,8,0,80
930987,773119,2018-08-28,Assembly,"SB 183 Lara Senate Third Reading By ARAMBULA",57,22,1,0,80
930987,773502,2018-08-29,Senate,"Unfinished Business SB183 Lara et al. Concurrence",29,8,3,0,40
931012,662382,2017-06-13,Senate,"Do pass, but first be re-referred to the Committee on [Appropriations]",9,0,0,0,9
931012,670328,2017-06-29,Senate,"Senate 3rd Reading SB178 Wieckowski Urgency Clause",36,0,4,0,40
931012,672576,2017-07-12,Assembly,"Do pass and be re-referred to the Committee on [Appropriations] with recommendation: To Consent Calendar",9,0,0,0,9
931012,674007,2017-08-23,Assembly,"Do pass. To Consent Calendar",15,0,2,0,17
931012,674356,2017-08-31,Assembly,"SB 178 Wieckowski Consent Calendar Second Day Regular Session",73,0,6,0,79
931012,777409,2017-08-23,Assembly,,9,0,2,0,11
931037,637492,2017-05-03,Senate,"Do pass, but first be re-referred to the Committee on [Judiciary]",5,0,2,0,7
931037,642819,2017-05-09,Senate,"Do pass as amended",5,1,1,0,7
931037,647810,2017-05-22,Senate,"Senate 3rd Reading SB182 Bradford",29,3,8,0,40
931037,669818,2017-06-28,Assembly,"Do pass as amended and be re-referred to the Committee on [Privacy and Consumer Protection]",13,0,0,0,13
931037,672816,2017-07-18,Assembly,"Do pass as amended",10,0,0,0,10
931037,675231,2017-09-07,Assembly,"SB 182 Bradford Senate Third Reading By OBERNOLTE",71,4,4,0,79
931037,675309,2017-09-11,Senate,"Unfinished Business SB182 Bradford Concurrence",32,4,4,0,40
931061,582489,2017-02-13,Assembly,"Be adopted. To third reading",9,0,2,0,11
931086,620081,2017-04-04,Senate,"Do pass, but first be re-referred to the Committee on [Judiciary]",9,1,3,0,13
931086,633238,2017-04-25,Senate,"Do pass, but first be re-referred to the Committee on [Appropriations]",5,1,1,0,7
931086,644368,2017-05-15,Senate,"Placed on suspense file",7,0,0,0,7
931086,650498,2017-05-25,Senate,"Do pass as amended",5,2,0,0,7
931086,655970,2017-05-31,Senate,"Senate 3rd Reading SB179 Atkins et al",26,12,2,0,40
931086,669117,2017-06-27,Assembly,"Do pass as amended and be re-referred to the Committee on [Transportation]",9,1,1,0,11
931086,671887,2017-07-10,Assembly,"Do pass and be re-referred to the Committee on [Appropriations]",11,3,0,0,14
931086,674716,2017-09-01,Assembly,"Do pass as amended",11,5,1,0,17
931086,675875,2017-09-13,Assembly,"SB 179 Atkins Senate Third Reading By GLORIA",57,21,1,0,79
931086,676105,2017-09-14,Senate,"Unfinished Business SB179 Atkins et al. Concurrence",26,12,2,0,40
931112,603202,2017-03-14,Assembly,"Do pass and be re-referred to the Committee on [Appropriations]",11,1,1,0,13
931161,631446,2017-04-25,Senate,"Do pass, but first be re-referred to the Committee on [Appropriations]",2,3,2,0,7
931186,632256,2017-04-25,Senate,"Do pass, but first be re-referred to the Committee on [Environmental Quality]",5,6,2,0,13
931186,632257,2017-04-25,Senate,"[First] hearing set for [04-25-2017]: Failed passage in Committee. Reconsideration granted",13,0,0,0,13
931211,626788,2017-04-18,Senate,"Do pass",5,2,0,0,7
931211,644477,2017-05-15,Senate,"Senate 3rd Reading SB180 Mitchell et al",22,13,5,0,40
931211,669059,2017-06-27,Assembly,"Do pass",4,2,1,0,7
931211,675597,2017-09-12,Assembly,"SB 180 Mitchell Senate Third Reading By KALRA",41,33,5,0,79
931235,616045,2017-03-29,Senate,"Do pass as amended, but first amend, and re-refer to the Committee on [Appropriations]",7,0,2,0,9
931235,626024,2017-04-17,Senate,"Placed on suspense file",7,0,0,0,7
934104,637365,2017-05-03,Assembly,"Do pass and be re-referred to the Committee on [Appropriations]",3,3,7,0,13
934126,617734,2017-04-03,Senate,"Senate 3rd Reading SCR18 Berryhill et al. By Allen",39,0,1,0,40
934126,629319,2017-04-20,Assembly,"Be adopted. To Consent Calendar",9,0,2,0,11
934126,634655,2017-04-27,Assembly,"SCR 18 Berryhill, T. Consent Calendar Second Day Regular Session",75,0,5,0,80
934186,575940,2017-02-02,Senate,"Senate 3rd Reading SR15 Leyva et al",39,0,1,0,40
934245,620111,2017-04-04,Senate,"Do pass, but first be re-referred to the Committee on [Public Safety]",12,1,0,0,13
934245,631673,2017-04-25,Senate,"Do pass, but first be re-referred to the Committee on [Appropriations]",6,1,0,0,7
934245,644406,2017-05-15,Senate,"Placed on suspense file",7,0,0,0,7
934245,650286,2017-05-25,Senate,"Do pass as amended",5,2,0,0,7
934245,655753,2017-05-31,Senate,"Senate 3rd Reading SB185 Hertzberg et al",34,6,0,0,40
934245,671874,2017-07-10,Assembly,"Do pass and be re-referred to the Committee on [Public Safety]",9,4,1,0,14
934245,672035,2017-07-11,Assembly,"Do pass and be re-referred to the Committee on [Appropriations]",5,0,2,0,7
934279,573079,2017-01-30,Assembly,"Be adopted. To third reading",11,0,0,0,11
934279,578142,2017-02-06,Assembly,"ACR 15 ACOSTA Assembly Third Reading",59,4,17,0,80
934279,598775,2017-03-06,Senate,"Assembly 3rd Reading ACR15 Acosta et al. By Nguyen",27,1,12,0,40
934339,603555,2017-03-14,Senate,"Do pass, but first be re-referred to the Committee on [Appropriations] with the recommendation: To Consent Calendar",11,0,2,0,13
934339,661169,2017-04-06,Senate,"Consent Calendar 2nd SB188 Jackson",39,0,1,0,40
934339,672017,2017-07-10,Assembly,"Do pass as amended and be re-referred to the Committee on [Appropriations]",7,3,0,0,10
934373,603529,2017-03-14,Assembly,"Do pass as amended",11,0,0,0,11
934373,615873,2017-03-30,Assembly,"AB 218 BONTA Assembly Third Reading",74,0,6,0,80
934373,666204,2017-06-20,Senate,"Do pass as amended, and be ordered to the Consent Calendar",7,0,0,0,7
934373,674277,2017-08-31,Senate,"Assembly 3rd Reading AB218 Bonta By Allen",39,0,1,0,40
934373,674867,2017-09-05,Assembly,"AB 218 BONTA Concurrence in Senate Amendments",77,0,2,0,79
934398,610137,2017-03-22,Senate,"Do pass, but first be re-referred to the Committee on [Judiciary] with the recommendation: To Consent Calendar",7,0,0,0,7
934398,615030,2017-03-28,Senate,"Do pass and be ordered to the Consent Calendar",7,0,0,0,7
934398,621150,2017-04-06,Senate,"Consent Calendar 2nd SB184 Morrell Urgency Clause",39,0,1,0,40
934398,666322,2017-06-20,Assembly,"Do pass and be re-referred to the Committee on [Local Government] with recommendation: To Consent Calendar",9,0,1,0,10
934398,672652,2017-07-12,Assembly,"Do pass",9,0,0,0,9
934398,674396,2017-08-31,Assembly,"SB 184 Morrell Senate Third Reading By MELENDEZ",74,0,5,0,79
934398,674909,2017-09-05,Senate,"Special Consent SB184",40,0,0,0,40
934432,575657,2017-02-02,Senate,"Senate 3rd Reading SCR17 Fuller et al",38,0,2,0,40
934432,582817,2017-02-13,Assembly,"Be adopted. To Consent Calendar",9,0,2,0,11
934432,587518,2017-02-17,Assembly,"SCR 17 Fuller Consent Calendar Second Day Regular Session",72,0,8,0,80
934492,632123,2017-04-25,Senate,"Do pass as amended, but first amend, and re-refer to the Committee on [Appropriations] with the recommendation: To Consent Calendar",9,0,0,0,9
934492,644587,2017-05-15,Senate,"Placed on suspense file",7,0,0,0,7
934492,650805,2017-05-25,Senate,"Do pass",7,0,0,0,7
934492,656252,2017-05-31,Senate,"Special Consent Calendar # SB187",40,0,0,0,40
934492,669268,2017-06-27,Assembly,"Do pass and be re-referred to the Committee on [Appropriations]",15,0,0,0,15
934521,578119,2017-02-06,Assembly,"Be adopted. To Consent Calendar",11,0,0,0,11
934521,581089,2017-02-09,Assembly,"HR 10 CHAU Consent Calendar Second Day",78,0,2,0,80
934824,633355,2017-04-26,Senate,"Do pass, but first be re-referred to the Committee on [Appropriations]",5,0,0,0,5
934824,647981,2017-05-22,Senate,"Senate 3rd Reading SB189 Bradford",37,0,3,0,40
934824,672333,2017-07-12,Assembly,"Do pass as amended and be re-referred to the Committee on [Appropriations]",12,0,1,0,13
934824,674034,2017-08-23,Assembly,"Do pass",15,0,2,0,17
934824,675302,2017-09-11,Assembly,"SB 189 Bradford Senate Third Reading By DALY",78,0,1,0,79
934824,676161,2017-09-14,Senate,"Special Consent Calendar SB189",40,0,0,0,40
934825,618770,2017-04-03,Assembly,"Do pass as amended and be re-referred to the Committee on [Appropriations]",9,0,1,0,10
934827,594991,2017-02-28,Assembly,"Do pass and be re-referred to the Committee on [Appropriations]",7,0,0,0,7
934827,651836,2017-05-26,Assembly,"Do pass",17,0,0,0,17
934827,654467,2017-05-30,Assembly,"AB 229 BAKER Assembly Third Reading",77,0,3,0,80
934827,666282,2017-06-20,Senate,"Do pass, but first be re-referred to the Committee on [Appropriations]",6,0,1,0,7
934827,671886,2017-07-10,Senate,"Placed on suspense file",7,0,0,0,7
934828,605327,2017-03-15,Assembly,"Do pass as amended and be re-referred to the Committee on [Judiciary]",6,0,1,0,7
934828,613902,2017-03-28,Assembly,"Do pass as amended",11,0,0,0,11
934828,621226,2017-04-06,Assembly,"AB 233 GLORIA Assembly Third Reading",68,1,11,0,80
934828,663221,2017-06-14,Senate,"Do pass, but first be re-referred to the Committee on [Judiciary]",7,0,0,0,7
934828,672879,2017-07-18,Senate,"Do pass",7,0,0,0,7
934828,674897,2017-09-05,Senate,"Assembly 3rd Reading AB233 Gloria By Hueso",40,0,0,0,40
934828,675176,2017-09-07,Assembly,"AB 233 GLORIA Concurrence in Senate Amendments",73,1,5,0,79
934830,594970,2017-02-28,Assembly,"Do pass and be re-referred to the Committee on [Human Services] with recommendation: To Consent Calendar",7,0,0,0,7
934830,610136,2017-03-21,Assembly,"Do pass and be re-referred to the Committee on [Appropriations]",7,0,0,0,7
934831,603328,2017-03-13,Assembly,"Do pass as amended and be re-referred to the Committee on [Appropriations]",9,0,1,0,10
934833,633152,2017-04-25,Assembly,"Do pass as amended and be re-referred to the Committee on [Appropriations]",7,0,0,0,7
934833,651598,2017-05-26,Assembly,"Do pass",17,0,0,0,17
934833,655969,2017-05-31,Assembly,"AB 227 MAYES Assembly Third Reading",77,0,3,0,80
934834,609955,2017-03-22,Assembly,"Do pass and be re-referred to the Committee on [Appropriations] with recommendation: To Consent Calendar",7,0,0,0,7
934834,620125,2017-04-05,Assembly,"Do pass. To Consent Calendar",17,0,0,0,17
934834,629154,2017-04-20,Assembly,"AB 226 CERVANTES Consent Calendar Second Day Regular Session",74,0,6,0,80
934834,660188,2017-06-07,Senate,"Do pass as amended, but first amend, and re-refer to the Committee on [Appropriations] with the recommendation: To Consent Calendar",7,0,0,0,7
934834,668817,2017-06-26,Senate,"Placed on suspense file",7,0,0,0,7
934834,674542,2017-09-01,Senate,"Do pass",7,0,0,0,7
934834,675457,2017-09-11,Senate,"Assembly 3rd Reading AB226 Cervantes et al. By Galgiani",40,0,0,0,40
934834,675918,2017-09-13,Assembly,"AB 226 CERVANTES Concurrence in Senate Amendments",78,0,1,0,79
934835,603445,2017-03-14,Assembly,"Do pass and be re-referred to the Committee on [Appropriations]",13,0,0,0,13
934837,573032,2017-01-30,Assembly,"HR 11 RENDON Assembly Third Reading By CALDERON",80,0,0,0,80
934838,578146,2017-02-06,Assembly,"Be adopted. To third reading",11,0,0,0,11
934838,615937,2017-03-30,Senate,"Special Consent Calendar # ACR16",37,0,3,0,40
934840,633856,2017-04-26,Assembly,"Do pass as amended and be re-referred to the Committee on [Appropriations]",6,0,1,0,7
934841,631914,2017-04-25,Assembly,"Do pass as amended and be re-referred to the Committee on [Appropriations]",11,1,4,0,16
934841,651600,2017-05-26,Assembly,"Do pass as amended",12,1,4,0,17
934841,656059,2017-05-31,Assembly,"AB 224 THURMOND Assembly Third Reading",41,16,23,0,80
934842,608355,2017-03-21,Senate,"Do pass, but first be re-referred to the Committee on [Human Services]",6,1,0,0,7
934842,618421,2017-04-04,Senate,"Do pass, but first be re-referred to the Committee on [Appropriations]",4,0,1,0,5
934842,630442,2017-04-24,Senate,"Placed on suspense file",7,0,0,0,7
934842,650506,2017-05-25,Senate,"Do pass as amended",6,1,0,0,7
934842,654001,2017-05-30,Senate,"Senate 3rd Reading SB190 Mitchell et al",36,4,0,0,40
934842,669102,2017-06-27,Assembly,"Do pass and be re-referred to the Committee on [Appropriations]",6,0,1,0,7
934842,674005,2017-08-23,Assembly,"Do pass",9,1,7,0,17
934842,674962,2017-09-05,Assembly,"SB 190 Mitchell Senate Third Reading By JONES-SAWYER",57,9,13,0,79
934842,675089,2017-09-06,Senate,"Unfinished Business SB190 Mitchell et al. Concurrence",37,3,0,0,40
934844,594939,2017-02-28,Assembly,"Do pass and be re-referred to the Committee on [Appropriations]",5,2,0,0,7
934844,620027,2017-04-05,Assembly,"Do pass",11,5,1,0,17
934844,656907,2017-06-01,Assembly,"AB 222 BOCANEGRA Assembly Third Reading",54,21,5,0,80
934844,669095,2017-06-27,Senate,"Do pass, but first be re-referred to the Committee on [Appropriations]",5,2,0,0,7
934844,671937,2017-07-10,Senate,"Placed on suspense file",7,0,0,0,7
934844,674482,2017-09-01,Senate,"Do pass",5,2,0,0,7
934845,636584,2017-05-02,Assembly,"Do pass as amended and be re-referred to the Committee on [Judiciary]",10,0,0,0,10
934845,641448,2017-05-09,Assembly,"Do pass as amended",11,0,0,0,11
934845,651459,2017-05-26,Assembly,"AB 228 GLORIA Assembly Third Reading",74,0,6,0,80
934845,671948,2017-07-10,Senate,"Do pass, but first be re-referred to the Committee on [Judiciary]",8,0,1,0,9
934845,672890,2017-07-18,Senate,"Do pass as amended, and be ordered to the Consent Calendar",7,0,0,0,7
934845,675661,2017-09-12,Senate,"Assembly 3rd Reading AB228 Gloria et al. By Galgiani Urgency Clause",39,0,1,0,40
934845,675767,2017-09-13,Assembly,"AB 228 Gloria Concurrence - Urgency Added",77,0,2,0,79
937528,573108,2017-01-30,Senate,"Senate 3rd Reading SR16 De León et al",26,11,3,0,40
937921,603272,2017-03-14,Assembly,"Do pass and be re-referred to the Committee on [Veterans Affairs] with recommendation: To Consent Calendar",7,0,0,0,7
937921,620054,2017-04-04,Assembly,"Do pass and be re-referred to the Committee on [Appropriations]",10,0,0,0,10
937921,633503,2017-04-26,Assembly,"Do pass. To Consent Calendar",16,0,1,0,17
937921,638512,2017-05-04,Assembly,"AB 242 ARAMBULA Consent Calendar Second Day Regular Session",76,0,4,0,80
937921,669680,2017-06-28,Senate,"Do pass as amended, but first amend, and re-refer to the Committee on [Veterans Affairs] with the recommendation: To Consent Calendar",7,0,2,0,9
937921,672163,2017-07-11,Senate,"Do pass, but first be re-referred to the Committee on [Appropriations] with the recommendation: To Consent Calendar",6,0,1,0,7
937921,674064,2017-08-24,Senate,"Consent Calendar 2nd AB242",38,0,2,0,40
937921,674305,2017-08-31,Assembly,"AB 242 ARAMBULA Concurrence in Senate Amendments",77,0,2,0,79
937923,633200,2017-04-25,Assembly,"Do pass and be re-referred to the Committee on [Appropriations]",7,0,0,0,7
937923,651769,2017-05-26,Assembly,"Do pass",17,0,0,0,17
937923,653984,2017-05-30,Assembly,"AB 237 GONZALEZ FLETCHER Assembly Third Reading",77,0,3,0,80
937923,766206,2018-06-20,Senate,"Do pass, but first be re-referred to the Committee on [Judiciary]",7,0,0,0,7
937923,768780,2018-06-26,Senate,"Do pass as amended, but first amend, and re-refer to the Committee on [Appropriations]",6,0,1,0,7
937923,770390,2018-08-06,Senate,"Placed on suspense file",7,0,0,0,7
937923,771753,2018-08-16,Senate,"Do pass as amended",7,0,0,0,7
937923,773419,2018-08-29,Senate,"Assembly 3rd Reading AB237 Gonzalez Fletcher et al. By Hueso",33,0,7,0,40
937923,773819,2018-08-30,Assembly,"With recommendation: That Senate amendments be concurred in",12,0,5,0,17
937923,773820,2018-08-30,Assembly,"With recommendation: That Senate amendments be concurred in",8,0,3,0,11
937923,774238,2018-08-31,Assembly,"AB 237 GONZALEZ FLETCHER Concurrence in Senate Amendments",75,0,5,0,80
937925,599147,2017-03-07,Assembly,"Do pass and be re-referred to the Committee on [Appropriations]",7,0,0,0,7
937925,620211,2017-04-05,Assembly,"Do pass",15,0,2,0,17
937925,630648,2017-04-24,Assembly,"AB 249 GOMEZ Assembly Third Reading",71,0,9,0,80
937925,674224,2017-08-29,Senate,"Do pass, but first be re-referred to the Committee on [Appropriations]",4,1,0,0,5
937925,674725,2017-09-01,Senate,"Placed on suspense file",7,0,0,0,7
937925,674726,2017-09-01,Senate,"Do pass",5,2,0,0,7
937925,675415,2017-09-11,Senate,"Assembly 3rd Reading AB249 Mullin et al. By Allen Urgency Clause",29,9,2,0,40
937925,676047,2017-09-14,Assembly,"With recommendation: That Senate amendments be concurred in",4,2,1,0,7
937925,676476,2017-09-15,Assembly,"AB 249 MULLIN Concurrence - Urgency Added",59,15,5,0,79
937927,633247,2017-04-26,Assembly,"Do pass and be re-referred to the Committee on [Appropriations]",10,0,0,0,10
937927,643040,2017-05-10,Assembly,"Do pass",17,0,0,0,17
937927,644471,2017-05-15,Assembly,"AB 243 COOPER Assembly Third Reading",76,3,1,0,80
937927,666711,2017-06-20,Senate,"Do pass, but first be re-referred to the Committee on [Judiciary]",5,0,0,0,5
937928,636578,2017-05-02,Assembly,"Do pass and be re-referred to the Committee on [Health] with recommendation: To Consent Calendar",14,0,2,0,16
937928,641774,2017-05-09,Assembly,"Do pass as amended",14,0,1,0,15
937928,646407,2017-05-18,Assembly,"AB 238 STEINORTH Assembly Third Reading",68,0,12,0,80
937928,665181,2017-06-19,Senate,"Do pass",9,0,0,0,9
937929,605374,2017-03-15,Assembly,"Do pass as amended and be re-referred to the Committee on [Appropriations]",6,0,1,0,7
937929,633616,2017-04-26,Assembly,"Do pass. To Consent Calendar",16,0,1,0,17
937929,638715,2017-05-04,Assembly,"AB 235 O'DONNELL Consent Calendar Second Day Regular Session",76,0,4,0,80
937929,672506,2017-07-12,Senate,"Do pass, but first be re-referred to the Committee on [Appropriations]",7,0,0,0,7
937929,673935,2017-08-21,Senate,"Do pass as amended",7,0,0,0,7
937929,772806,2018-08-27,Senate,"Do pass, but first be re-referred to the Committee on [Appropriations]",4,0,1,0,5
937929,774257,2018-08-31,Assembly,"With recommendation: That Senate amendments be concurred in",7,0,0,0,7
937929,774258,2018-08-31,Senate,"Assembly 3rd Reading AB235 O'Donnell By Lara Urgency Clause",37,0,3,0,40
937929,774259,2018-08-31,Assembly,"AB 235 O'Donnell Concurrence - Urgency Added",80,0,0,0,80
937929,777245,2018-08-27,Senate,,7,0,1,0,8
937931,603403,2017-03-14,Assembly,"Do pass and be re-referred to the Committee on [Appropriations]",13,0,0,0,13
937932,599111,2017-03-07,Assembly,"Do pass and be re-referred to the Committee on [Appropriations]",7,0,0,0,7
937932,651953,2017-05-26,Assembly,"Do pass as amended",16,0,1,0,17
937932,656056,2017-05-31,Assembly,"AB 236 MAIENSCHEIN Assembly Third Reading",77,0,3,0,80
937932,668986,2017-06-27,Senate,"Do pass, but first be re-referred to the Committee on [Appropriations]",5,0,0,0,5
937932,671934,2017-07-10,Senate,"Placed on suspense file",7,0,0,0,7
937932,674644,2017-09-01,Senate,"Do pass as amended",7,0,0,0,7
937932,676077,2017-09-14,Senate,"Special Consent Calendar # AB236",40,0,0,0,40
937932,676300,2017-09-14,Assembly,"AB 236 Maienschein Special Consent Calendar 1st Day Regular Session",79,0,0,0,79
937933,599109,2017-03-07,Assembly,"Do pass and be re-referred to the Committee on [Appropriations]",6,1,0,0,7
937933,634385,2017-04-26,Assembly,"Do pass",10,4,3,0,17
937933,635775,2017-05-01,Assembly,"AB 245 GOMEZ Assembly Third Reading",49,10,21,0,80
937933,671336,2017-07-05,Senate,"Do pass as amended, but first amend, and re-refer to the Committee on [Appropriations]",5,2,0,0,7
937933,673774,2017-08-21,Senate,"Placed on suspense file",7,0,0,0,7
937933,674525,2017-09-01,Senate,"Do pass as amended",5,2,0,0,7
937933,675500,2017-09-11,Senate,"Assembly 3rd Reading AB245 Quirk et al. By Leyva",25,12,3,0,40
937933,675775,2017-09-13,Assembly,"AB 245 QUIRK Concurrence in Senate Amendments",64,9,6,0,79
937934,614900,2017-03-29,Senate,"Do pass, but first be re-referred to the Committee on [Appropriations]",7,0,0,0,7
937934,626359,2017-04-17,Senate,"Do pass",7,0,0,0,7
937934,635726,2017-05-01,Senate,"Senate 3rd Reading SB197 Bates et al",37,0,3,0,40
937934,667696,2017-06-19,Assembly,"Do pass as amended and be re-referred to the Committee on [Appropriations]",9,0,1,0,10
937935,614244,2017-03-28,Assembly,"Do pass as amended and be re-referred to the Committee on [Appropriations]",13,0,2,0,15
937935,619892,2017-04-05,Assembly,"Do pass. To Consent Calendar",17,0,0,0,17
937935,629117,2017-04-20,Assembly,"AB 251 BONTA Consent Calendar Second Day Regular Session",74,0,6,0,80
937935,672622,2017-07-12,Senate,"Do pass, but first be re-referred to the Committee on [Human Services]",6,1,2,0,9
937935,673738,2017-08-21,Senate,"Placed on suspense file",7,0,0,0,7
937935,674840,2017-09-01,Senate,"Do pass",5,2,0,0,7
937936,618299,2017-04-04,Senate,"Do pass as amended, but first amend, and re-refer to the Committee on [Appropriations]",6,0,1,0,7
937936,635819,2017-05-01,Senate,"Placed on suspense file",7,0,0,0,7
937937,599150,2017-03-07,Assembly,"Do pass and be re-referred to the Committee on [Appropriations]",5,2,0,0,7
937937,633716,2017-04-26,Assembly,"Do pass",11,4,2,0,17
937937,654521,2017-05-30,Assembly,"AB 248 REYES Assembly Third Reading",73,0,7,0,80
937937,671402,2017-07-05,Senate,"Do pass, but first be re-referred to the Committee on [Appropriations]",7,0,0,0,7
937937,676447,2017-09-15,Senate,"Assembly 3rd Reading AB248 Reyes et al. By Leyva",37,0,3,0,40
937938,582608,2017-02-13,Assembly,"Be adopted. To third reading",9,0,2,0,11
937938,602606,2017-03-13,Senate,"Assembly 3rd Reading ACR17 Mark Stone et al. By Jackson",36,0,4,0,40
937939,599108,2017-03-07,Assembly,"Do pass as amended and be re-referred to the Committee on [Appropriations]",5,0,2,0,7
937939,651691,2017-05-26,Assembly,"Do pass",12,5,0,0,17
937939,655923,2017-05-31,Assembly,"AB 246 SANTIAGO Assembly Third Reading",48,21,11,0,80
937939,671404,2017-07-05,Senate,"Do pass as amended, but first amend, and re-refer to the Committee on [Appropriations]",5,2,0,0,7
937939,673966,2017-08-21,Senate,"Placed on suspense file",7,0,0,0,7
937939,674779,2017-09-01,Senate,"Do pass as amended, but first amend, and re-refer to the Committee on [Rules]",5,2,0,0,7
937939,675310,2017-09-11,Senate,"Do pass, but first be re-referred to the Committee on [Appropriations]",7,0,0,0,7
937939,676449,2017-09-15,Senate,"Assembly 3rd Reading AB246 Santiago et al. By Galgiani",36,0,4,0,40
937939,676450,2017-09-16,Assembly,"With recommendation: That Senate amendments be concurred in",6,3,1,0,10
937939,676451,2017-09-16,Assembly,"AB 246 SANTIAGO Concurrence in Senate Amendments",70,6,3,0,79
937940,603263,2017-03-14,Assembly,"Do pass and be re-referred to the Committee on [Appropriations]",10,0,0,0,10
937943,642490,2017-05-10,Assembly,"Be adopted. To Consent Calendar",6,0,1,0,7
937943,646531,2017-05-18,Assembly,"HR 12 GOMEZ Consent Calendar Second Day Regular Session",69,0,11,0,80
937944,599049,2017-03-07,Assembly,"Do pass as amended and be re-referred to the Committee on [Appropriations]",7,0,0,0,7
937944,651564,2017-05-26,Assembly,"Do pass",17,0,0,0,17
937944,654298,2017-05-30,Assembly,"AB 247 GARCIA, C. Assembly Third Reading",77,0,3,0,80
937944,671370,2017-07-05,Senate,"Do pass as amended, but first amend, and re-refer to the Committee on [Appropriations]",7,0,0,0,7
937944,673766,2017-08-21,Senate,"Placed on suspense file",7,0,0,0,7
937944,674643,2017-09-01,Senate,"Do pass",7,0,0,0,7
937944,676088,2017-09-14,Senate,"Special Consent Calendar # AB247",40,0,0,0,40
937944,676327,2017-09-14,Assembly,"AB 247 Cristina Garcia Special Consent Calendar 1st Day Regular Session",79,0,0,0,79
937945,634742,2017-04-26,Senate,"Do pass, but first be re-referred to the Committee on [Judiciary]",9,0,0,0,9
937945,647854,2017-05-22,Senate,"Senate 3rd Reading SB199 Hernandez et al",37,0,3,0,40
937945,666633,2017-06-20,Assembly,"Do pass and be re-referred to the Committee on [Privacy and Consumer Protection] with recommendation: To Consent Calendar",15,0,0,0,15
937945,669118,2017-06-27,Assembly,"Do pass and be re-referred to the Committee on [Appropriations] with recommendation: To Consent Calendar",10,0,0,0,10
937946,604190,2017-03-15,Senate,"Do pass, but first be re-referred to the Committee on [Health]",7,0,0,0,7
937946,619905,2017-04-05,Senate,"Do pass, but first be re-referred to the Committee on [Appropriations]",9,0,0,0,9
937946,630433,2017-04-24,Senate,"Placed on suspense file",7,0,0,0,7
937947,619924,2017-04-05,Senate,"Do pass as amended, but first amend, and re-refer to the Committee on [Appropriations]",8,0,1,0,9
937947,644249,2017-05-15,Senate,"Placed on suspense file",7,0,0,0,7
937947,650529,2017-05-25,Senate,"Do pass",7,0,0,0,7
937947,654476,2017-05-30,Senate,"Senate 3rd Reading SB192 Beall",38,2,0,0,40
937947,765081,2018-06-19,Assembly,"Do pass and be re-referred to the Committee on [Appropriations] with recommendation: To Consent Calendar",15,0,0,0,15
937947,771081,2018-08-08,Assembly,"Do pass. To Consent Calendar",17,0,0,0,17
937947,771745,2018-08-16,Assembly,"SB 192 Beall Consent Calendar Second Day Regular Session",76,0,4,0,80
937947,772234,2018-08-20,Senate,"Unfinished Business SB192 Beall Concurrence",35,0,5,0,40
937948,614754,2017-03-29,Senate,"Be adopted, but first be re-referred to the Committee on [Elections and Constitutional Amendments]",5,2,0,0,7
937948,636622,2017-05-02,Senate,"Be adopted",4,1,0,0,5
937949,610007,2017-03-20,Assembly,"Do pass as amended and be re-referred to the Committee on [Appropriations]",9,1,0,0,10
937949,651779,2017-05-26,Assembly,"Do pass as amended",12,0,5,0,17
937949,655870,2017-05-31,Assembly,"AB 250 GONZALEZ FLETCHER Assembly Third Reading",67,6,7,0,80
937949,669144,2017-06-27,Senate,"Do pass as amended, but first amend, and re-refer to the Committee on [Appropriations]",7,1,1,0,9
937949,672708,2017-07-17,Senate,"Placed on suspense file",7,0,0,0,7
937949,674701,2017-09-01,Senate,"Do pass",5,2,0,0,7
937949,675355,2017-09-11,Senate,"Assembly 3rd Reading AB250 Gonzalez Fletcher By Hertzberg",30,10,0,0,40
937949,675843,2017-09-13,Assembly,"AB 250 GONZALEZ FLETCHER Concurrence in Senate Amendments",71,1,7,0,79
937950,631452,2017-04-24,Assembly,"Do pass",3,5,2,0,10
937950,631453,2017-04-24,Assembly,Reconsideration,10,0,0,0,10
940130,637483,2017-05-03,Assembly,"Do pass. To Consent Calendar",20,0,1,0,21
940130,643550,2017-05-11,Assembly,"AB 253 BIGELOW Consent Calendar Second Day Regular Session",77,0,3,0,80
940130,675472,2017-09-11,Senate,"Assembly 3rd Reading AB253 Bigelow By Berryhill Urgency Clause",39,0,1,0,40
940130,675614,2017-09-12,Assembly,"AB 253 BIGELOW Concurrence - Urgency Added",78,0,1,0,79
940133,608326,2017-03-21,Assembly,"Do pass as amended and be re-referred to the Committee on [Appropriations]",7,0,0,0,7
940133,633619,2017-04-26,Assembly,"Do pass",16,0,1,0,17
940133,635744,2017-05-01,Assembly,"AB 264 LOW Assembly Third Reading",74,0,6,0,80
940133,658818,2017-06-06,Senate,"Do pass, but first be re-referred to the Committee on [Appropriations]",6,0,1,0,7
940133,673893,2017-08-21,Senate,"Assembly 3rd Reading AB264 Low et al. By Anderson",39,0,1,0,40
940133,675204,2017-09-07,Assembly,"AB 264 LOW Concurrence in Senate Amendments",79,0,0,0,79
940141,629068,2017-04-19,Senate,"Do pass, but first be re-referred to the Committee on [Appropriations] with the recommendation: To Consent Calendar",9,0,0,0,9
940141,644411,2017-05-15,Senate,"Placed on suspense file",7,0,0,0,7
940145,603314,2017-03-14,Assembly,"Do pass as amended",11,0,0,0,11
940145,611082,2017-03-23,Assembly,"AB 260 SANTIAGO Assembly Third Reading",71,0,9,0,80
940145,669588,2017-06-27,Senate,"Do pass as amended, and be ordered to the Consent Calendar",6,0,1,0,7
940145,674364,2017-08-31,Senate,"Special Consent AB260",37,0,3,0,40
940145,674878,2017-09-05,Assembly,"AB 260 SANTIAGO Concurrence in Senate Amendments",77,0,2,0,79
940149,603270,2017-03-14,Assembly,"Do pass as amended, and be re-referred to the Committee on [Appropriations] with recommendation: To Consent Calendar",7,0,0,0,7
940149,619793,2017-04-05,Assembly,"Do pass. To Consent Calendar",17,0,0,0,17
940149,629077,2017-04-20,Assembly,"AB 255 GALLAGHER Consent Calendar Second Day Regular Session",74,0,6,0,80
940149,662119,2017-06-13,Senate,"Do pass and be ordered to the Consent Calendar",7,0,0,0,7
940149,665289,2017-06-19,Senate,"Consent Calendar 2nd AB255",33,0,7,0,40
940157,630529,2017-04-24,Assembly,"Be adopted. To third reading",11,0,0,0,11
940157,651400,2017-05-26,Senate,"Special Consent ACR18",37,0,3,0,40
940161,629029,2017-04-19,Assembly,"Do pass as amended and be re-referred to the Committee on [Appropriations]",6,1,0,0,7
940161,651983,2017-05-26,Assembly,"Do pass",11,5,1,0,17
940161,656284,2017-05-31,Assembly,"AB 263 RODRIGUEZ Assembly Third Reading",56,17,7,0,80
940161,669796,2017-06-28,Senate,"Do pass, but first be re-referred to the Committee on [Appropriations]",3,1,1,0,5
940161,671904,2017-07-10,Senate,"Placed on suspense file",7,0,0,0,7
940161,674535,2017-09-01,Senate,"Do pass, but first be re-referred to the Committee on [Rules]",5,2,0,0,7
940169,631447,2017-04-24,Assembly,"Bill measure be retained in committee, and subject matter be referred to Rules Committee for assignment to the proper committee",8,0,2,0,10
940173,620035,2017-04-05,Assembly,"Do pass and be re-referred to the Committee on [Natural Resources]",3,1,3,0,7
940173,628018,2017-04-19,Assembly,"Do pass and be re-referred to the Committee on [Natural Resources]",4,1,2,0,7
940173,631895,2017-04-24,Assembly,"Do pass and be re-referred to the Committee on [Appropriations]",7,1,2,0,10
940173,651780,2017-05-26,Assembly,"Do pass as amended",12,5,0,0,17
940173,655941,2017-05-31,Assembly,"AB 262 BONTA Assembly Third Reading",68,3,9,0,80
940173,669100,2017-06-27,Senate,"Do pass, but first be re-referred to the Committee on [Environmental Quality]",11,1,1,0,13
940173,671323,2017-07-05,Senate,"Do pass, but first be re-referred to the Committee on [Appropriations]",6,1,0,0,7
940173,673828,2017-08-21,Senate,"Placed on suspense file",7,0,0,0,7
940173,674610,2017-09-01,Senate,"Do pass",5,2,0,0,7
940173,675405,2017-09-11,Senate,"Assembly 3rd Reading AB262 Bonta et al. By Galgiani",30,9,1,0,40
940173,675757,2017-09-13,Assembly,"AB 262 BONTA Concurrence in Senate Amendments",64,12,3,0,79
940173,774541,2017-07-05,Senate,?,11,1,0,0,12
940177,613074,2017-03-27,Senate,"Do pass, but first be re-referred to the Committee on [Appropriations]",3,1,1,0,5
940177,626322,2017-04-17,Senate,"Placed on suspense file",7,0,0,0,7
940177,650771,2017-05-25,Senate,"Do pass",5,2,0,0,7
940177,654573,2017-05-30,Senate,"Senate 3rd Reading SB201 Skinner et al",26,12,2,0,40
940177,666774,2017-06-20,Assembly,"Do pass and be re-referred to the Committee on [Appropriations]",9,3,1,0,13
940177,674649,2017-09-01,Assembly,"Do pass",11,5,1,0,17
940177,675133,2017-09-07,Assembly,"SB 201 Skinner Senate Third Reading By AGUIAR-CURRY",52,25,2,0,79
940181,626998,2017-04-18,Assembly,"Do pass as amended and be re-referred to the Committee on [Appropriations]",9,2,4,0,15
940181,651876,2017-05-26,Assembly,"Do pass as amended",11,4,2,0,17
940181,655868,2017-05-31,Assembly,"AB 265 WOOD Assembly Third Reading",51,15,14,0,80
940181,671543,2017-07-05,Senate,"Do pass",7,2,0,0,9
940181,675634,2017-09-12,Senate,"Assembly 3rd Reading AB265 Wood et al. By Hernandez",23,15,2,0,40
940181,675886,2017-09-13,Assembly,"AB 265 Wood Concurrence in Senate Amendments",51,17,11,0,79
940185,627858,2017-04-19,Senate,"Do pass as amended, but first amend, and re-refer to the Committee on [Appropriations]",5,2,0,0,7
940185,644450,2017-05-15,Senate,"Placed on suspense file",7,0,0,0,7
940189,633350,2017-04-25,Assembly,"Do pass as amended and be re-referred to the Committee on [Appropriations]",7,0,0,0,7
940189,651658,2017-05-26,Assembly,"Do pass",17,0,0,0,17
940189,654442,2017-05-30,Assembly,"AB 258 ARAMBULA Assembly Third Reading",77,0,3,0,80
940189,667753,2017-06-21,Senate,"Do pass as amended, but first amend, and re-refer to the Committee on [Human Services]",5,0,2,0,7
940189,672522,2017-07-11,Senate,"Do pass as amended, but first amend, and re-refer to the Committee on [Appropriations]",7,0,0,0,7
940189,673859,2017-08-21,Senate,"Placed on suspense file",7,0,0,0,7
940189,674802,2017-09-01,Senate,"Do pass",7,0,0,0,7
940189,676052,2017-09-14,Senate,"Special Consent Calendar # AB258",40,0,0,0,40
940189,676385,2017-09-14,Assembly,"AB 258 Arambula Special Consent Calendar 1st Day Regular Session",79,0,0,0,79
940193,631931,2017-04-25,Assembly,"Do pass and be re-referred to the Committee on [Appropriations]",14,2,0,0,16
940193,642858,2017-05-10,Assembly,"Do pass",11,5,1,0,17
940197,627002,2017-04-18,Assembly,"Do pass and be re-referred to the Committee on [Education]",13,1,1,0,15
940197,634660,2017-04-26,Assembly,"Do pass as amended and be re-referred to the Committee on [Appropriations]",6,1,0,0,7
940197,651556,2017-05-26,Assembly,"Do pass as amended",12,5,0,0,17
940197,655823,2017-05-31,Assembly,"AB 254 THURMOND Assembly Third Reading",64,9,7,0,80
940197,671512,2017-07-05,Senate,"Do pass, but first be re-referred to the Committee on [Education]",9,0,0,0,9
940197,672398,2017-07-12,Senate,"Do pass, but first be re-referred to the Committee on [Appropriations]",7,0,0,0,7
940197,673850,2017-08-21,Senate,"Placed on suspense file",7,0,0,0,7
940201,633563,2017-04-25,Senate,"Do pass, but first be re-referred to the Committee on [Appropriations] with the recommendation: To Consent Calendar",7,0,0,0,7
940201,651476,2017-05-26,Senate,"Consent Calendar 2nd SB204 Dodd et al",37,0,3,0,40
940201,662328,2017-06-13,Assembly,"Do pass and be re-referred to the Committee on [Appropriations]",11,0,0,0,11
940201,669844,2017-06-28,Assembly,"Do pass. To Consent Calendar",14,0,3,0,17
940201,671524,2017-07-06,Assembly,"SB 204 Dodd Consent Calendar Second Day Regular Session",74,0,6,0,80
940201,671943,2017-07-10,Senate,"Unfinished Business SB204 Dodd et al. Concurrence",40,0,0,0,40
940205,594262,2017-02-27,Assembly,"Be adopted. To third reading",10,0,1,0,11
940209,621154,2017-04-05,Assembly,"Do pass and be re-referred to the Committee on [Appropriations] with recommendation: To Consent Calendar",7,0,0,0,7
940209,633555,2017-04-26,Assembly,"Do pass. To Consent Calendar",16,0,1,0,17
940209,638438,2017-05-04,Assembly,"AB 261 THURMOND Consent Calendar Second Day Regular Session",76,0,4,0,80
940209,659869,2017-06-07,Senate,"Do pass, but first be re-referred to the Committee on [Appropriations] with the recommendation: To Consent Calendar",7,0,0,0,7
940209,674387,2017-08-31,Senate,"Assembly 3rd Reading AB261 Thurmond By Leyva",39,0,1,0,40
940209,674918,2017-09-05,Assembly,"AB 261 THURMOND Concurrence in Senate Amendments",76,0,3,0,79
942279,614949,2017-03-28,Senate,"Do pass and be ordered to the Consent Calendar",7,0,0,0,7
942279,661165,2017-04-06,Senate,"Consent Calendar 2nd SB217 Wieckowski",39,0,1,0,40
942279,662368,2017-06-13,Assembly,"Do pass. To Consent Calendar",11,0,0,0,11
942279,665135,2017-06-19,Assembly,"SB 217 Wieckowski Consent Calendar Second Day Regular Session",74,0,6,0,80
942280,604338,2017-03-15,Senate,"Do pass and be ordered to the Consent Calendar",7,0,0,0,7
942280,611174,2017-03-23,Senate,"Consent Calendar 2nd SB207 Committee On GOV. & F. (McGuire) Urgency Clause",38,0,2,0,40
942280,663229,2017-06-14,Assembly,"Do pass. To Consent Calendar",9,0,0,0,9
942280,667887,2017-06-22,Assembly,"SB 207 GOV.& F. Consent Calendar Second Day Regular Session",74,0,6,0,80
942281,608307,2017-03-21,Assembly,"Do pass and be re-referred to the Committee on [Appropriations]",14,0,1,0,15
942281,651941,2017-05-26,Assembly,"Do pass",17,0,0,0,17
942281,654447,2017-05-30,Assembly,"AB 277 MATHIS Assembly Third Reading",77,0,3,0,80
942281,667298,2017-06-21,Senate,"Do pass, but first be re-referred to the Committee on [Appropriations] with the recommendation: To Consent Calendar",6,0,1,0,7
942281,671916,2017-07-10,Senate,"Placed on suspense file",7,0,0,0,7
942281,674504,2017-09-01,Senate,"Do pass",7,0,0,0,7
942281,676067,2017-09-14,Senate,"Special Consent Calendar # AB277",40,0,0,0,40
942282,603250,2017-03-14,Assembly,"Do pass and be re-referred to the Committee on [Privacy and Consumer Protection]",13,0,0,0,13
942282,614399,2017-03-28,Assembly,"Do pass and be re-referred to the Committee on [Appropriations] with recommendation: To Consent Calendar",10,0,0,0,10
942282,633434,2017-04-26,Assembly,"Do pass. To Consent Calendar",16,0,1,0,17
942282,638492,2017-05-04,Assembly,"AB 276 MEDINA Consent Calendar Second Day Regular Session",76,0,4,0,80
942282,766245,2018-06-20,Senate,"Do pass, but first be re-referred to the Committee on [Judiciary]",4,2,1,0,7
942282,769006,2018-06-26,Senate,"Do pass as amended, but first amend, and re-refer to the Committee on [Appropriations]",5,1,1,0,7
942282,770927,2018-08-06,Senate,"Placed on suspense file",7,0,0,0,7
942282,771999,2018-08-16,Senate,"Do pass as amended",5,2,0,0,7
942283,614843,2017-03-29,Senate,"Do pass",7,0,0,0,7
942283,626090,2017-04-17,Senate,"Senate 3rd Reading SB212 Jackson",40,0,0,0,40
942283,768368,2018-06-26,Assembly,"Do pass and be re-referred to the Committee on [Appropriations]",5,1,1,0,7
942283,771718,2018-08-16,Assembly,"Do pass",13,3,1,0,17
942283,773104,2018-08-28,Assembly,"Do pass and be re-referred to the Committee on [Appropriations]",5,0,2,0,7
942283,773286,2018-08-29,Assembly,"Do pass",14,1,2,0,17
942283,773963,2018-08-31,Senate,"That the Assembly amendments be concurred in",7,0,0,0,7
942283,774031,2018-08-31,Senate,"Unfinished Business SB212 Jackson et al. Concurrence",39,0,1,0,40
942283,774032,2018-08-31,Assembly,"SB 212 Jackson Senate Third Reading By TING",72,5,3,0,80
942284,684719,2018-01-09,Senate,"Do pass, but first be re-referred to the Committee on [Appropriations]",7,0,0,0,7
942284,685462,2018-01-16,Senate,"Placed on suspense file",7,0,0,0,7
942284,686187,2018-01-18,Senate,"Do pass",7,0,0,0,7
942284,690924,2018-01-30,Senate,"Senate 3rd Reading SB215 Beall et al",38,0,2,0,40
942284,762252,2018-06-12,Assembly,"Do pass as amended and be re-referred to the Committee on [Appropriations]",6,0,1,0,7
942284,771089,2018-08-08,Assembly,"Do pass",17,0,0,0,17
942284,772517,2018-08-23,Assembly,"SB 215 Beall Senate Third Reading By JONES-SAWYER Amendment Set #1",74,0,6,0,80
942284,773063,2018-08-28,Assembly,"SB 215 Beall Senate Third Reading By JONES-SAWYER",79,0,1,0,80
942284,773619,2018-08-29,Senate,"Unfinished Business SB215 Beall et al. Concurrence",36,2,2,0,40
942285,603367,2017-03-14,Assembly,"Do pass as amended and be re-referred to the Committee on [Appropriations]",7,0,0,0,7
942285,619695,2017-04-05,Assembly,"Do pass. To Consent Calendar",17,0,0,0,17
942285,628953,2017-04-20,Assembly,"AB 270 GALLAGHER Consent Calendar Second Day Regular Session",74,0,6,0,80
942285,666124,2017-06-20,Senate,"Do pass as amended, but first amend, and re-refer to the Committee on [Appropriations]",7,0,0,0,7
942285,671878,2017-07-10,Senate,"Placed on suspense file",7,0,0,0,7
942286,599830,2017-03-08,Senate,"Do pass as amended, but first amend, and re-refer to the Committee on [Environmental Quality]",7,0,0,0,7
942286,619824,2017-04-05,Senate,"Do pass, but first be re-referred to the Committee on [Appropriations]",7,0,0,0,7
942286,626081,2017-04-17,Senate,"Placed on suspense file",7,0,0,0,7
942286,650677,2017-05-25,Senate,"Do pass as amended",6,0,1,0,7
942286,656025,2017-05-31,Senate,"Senate 3rd Reading SB210 Leyva et al",39,0,1,0,40
942286,740569,2018-04-16,Assembly,"Be re-referred to the Committee on [Transportation]",9,0,2,0,11
942287,614924,2017-03-29,Senate,"Do pass and be ordered to the Consent Calendar",7,0,0,0,7
942287,661222,2017-04-06,Senate,"Consent Calendar 2nd SB205 Committee On GOV. & F. (McGuire)",39,0,1,0,40
942287,670252,2017-06-28,Assembly,"Do pass and be re-referred to the Committee on [Appropriations] with recommendation: To Consent Calendar",9,0,0,0,9
942287,672860,2017-07-19,Assembly,"Do pass. To Consent Calendar",16,0,1,0,17
942287,674985,2017-09-05,Assembly,"SB 205 GOV.& F. Senate Third Reading By AGUIAR-CURRY",76,0,3,0,79
942287,675135,2017-09-07,Senate,"Special Consent Calendar # SB205 GOV. & F",40,0,0,0,40
942289,604314,2017-03-15,Senate,"Do pass and be ordered to the Consent Calendar",7,0,0,0,7
942289,611165,2017-03-23,Senate,"Consent Calendar 2nd SB206 Committee On GOV. & F. (McGuire) Urgency Clause",38,0,2,0,40
942289,663890,2017-06-14,Assembly,"Do pass. To Consent Calendar",9,0,0,0,9
942289,667855,2017-06-22,Assembly,"SB 206 GOV.& F. Consent Calendar Second Day",74,0,6,0,80
942290,603687,2017-03-14,Senate,"Do pass, but first be re-referred to the Committee on [Appropriations]",8,1,0,0,9
942290,626213,2017-04-17,Senate,"Do pass",7,0,0,0,7
942290,630589,2017-04-24,Senate,"Senate 3rd Reading SB214 Atkins",33,5,2,0,40
942290,665456,2017-06-19,Assembly,"Do pass and be re-referred to the Committee on [Appropriations]",8,0,0,0,8
942290,669687,2017-06-28,Assembly,"Do pass",11,2,4,0,17
942290,675377,2017-09-11,Assembly,"SB 214 Atkins Senate Third Reading By GLORIA",66,10,3,0,79
942290,675723,2017-09-12,Senate,"Unfinished Business SB214 Atkins Concurrence",34,6,0,0,40
942291,598852,2017-03-07,Assembly,"Do pass and be re-referred to the Committee on [Appropriations]",7,0,0,0,7
942291,645913,2017-05-17,Assembly,"Do pass. To Consent Calendar",17,0,0,0,17
942291,651473,2017-05-26,Assembly,"AB 273 AGUIAR-CURRY Assembly Third Reading",73,0,7,0,80
942291,667120,2017-06-21,Senate,"Do pass, but first be re-referred to the Committee on [Human Services] with the recommendation: To Consent Calendar",6,0,1,0,7
942291,672299,2017-07-11,Senate,"Do pass, but first be re-referred to the Committee on [Appropriations] with the recommendation: To Consent Calendar",7,0,0,0,7
942291,673812,2017-08-21,Senate,"Placed on suspense file",7,0,0,0,7
942291,674720,2017-09-01,Senate,"Do pass as amended",7,0,0,0,7
942291,675057,2017-09-06,Senate,"Assembly 3rd Reading AB273 Aguiar-Curry et al. By Atkins",39,0,1,0,40
942291,675464,2017-09-11,Assembly,"AB 273 AGUIAR-CURRY Concurrence in Senate Amendments",77,0,2,0,79
942292,684184,2018-01-08,Assembly,"Do pass and be re-referred to the Committee on [Appropriations]",2,7,1,0,10
942293,629102,2017-04-19,Assembly,"Do pass and be re-referred to the Committee on [Revenue and Taxation]",7,2,0,0,9
942293,632069,2017-04-24,Assembly,"Do pass and be re-referred to the Committee on [Appropriations]",9,1,0,0,10
942293,649251,2017-05-24,Assembly,"Do pass",17,0,0,0,17
942293,654061,2017-05-30,Assembly,"AB 271 CABALLERO Assembly Third Reading",73,0,7,0,80
942293,671345,2017-07-05,Senate,"Do pass, but first be re-referred to the Committee on [Appropriations]",6,0,1,0,7
942294,575671,2017-02-02,Assembly,"Be adopted. To third reading",7,3,1,0,11
942294,582610,2017-02-13,Assembly,"HR 15 GOMEZ Assembly Third Reading",55,8,17,0,80
942295,603281,2017-03-14,Assembly,"Do pass and be re-referred to the Committee on [Appropriations]",7,0,0,0,7
942297,608179,2017-03-21,Assembly,"Do pass as amended and be re-referred to the Committee on [Aging and Long-Term Care]",15,0,0,0,15
942297,619975,2017-04-04,Assembly,"Do pass and be re-referred to the Committee on [Appropriations]",7,0,0,0,7
942297,633314,2017-04-26,Assembly,"Do pass. To Consent Calendar",16,0,1,0,17
942297,638497,2017-05-04,Assembly,"AB 275 WOOD Consent Calendar Second Day Regular Session",76,0,4,0,80
942297,659944,2017-06-07,Senate,"Do pass as amended, but first amend, and re-refer to the Committee on [Appropriations]",9,0,0,0,9
942297,672741,2017-07-17,Senate,"Assembly 3rd Reading AB275 Wood By McGuire",39,0,1,0,40
942297,673825,2017-08-21,Assembly,"AB 275 WOOD Concurrence in Senate Amendments",78,0,1,0,79
942298,613509,2017-03-28,Senate,"Do pass, but first be re-referred to the Committee on [Judiciary]",3,1,1,0,5
942298,633413,2017-04-25,Senate,"Do pass as amended, but first amend, and re-refer to the Committee on [Appropriations]",5,2,0,0,7
942298,644388,2017-05-15,Senate,"Placed on suspense file",7,0,0,0,7
942298,650675,2017-05-25,Senate,"Do pass as amended",5,2,0,0,7
942298,656267,2017-05-31,Senate,"Senate 3rd Reading SB219 Wiener et al",26,12,2,0,40
942298,666134,2017-06-20,Assembly,"Do pass as amended and be re-referred to the Committee on [Judiciary]",5,0,2,0,7
942298,672020,2017-07-11,Assembly,"Do pass as amended and be re-referred to the Committee on [Appropriations]",9,0,2,0,11
942298,674517,2017-09-01,Assembly,"Do pass",11,5,1,0,17
942298,675607,2017-09-12,Assembly,"SB 219 Wiener Senate Third Reading By CHIU",55,19,5,0,79
942298,675908,2017-09-13,Senate,"Unfinished Business SB219 Wiener et al. Concurrence",27,12,1,0,40
942299,615536,2017-03-29,Senate,"Do pass, but first be re-referred to the Committee on [Rules]",7,0,0,0,7
942299,636109,2017-05-01,Senate,"Placed on suspense file",7,0,0,0,7
942299,650778,2017-05-25,Senate,"Do pass",7,0,0,0,7
942299,655930,2017-05-31,Senate,"Special Consent Calendar # SB218",40,0,0,0,40
942299,672044,2017-07-10,Assembly,"Do pass as amended and be re-referred to the Committee on [Appropriations]",10,0,0,0,10
942299,674689,2017-09-01,Assembly,"Do pass as amended",16,0,1,0,17
942299,675900,2017-09-13,Assembly,"SB 218 Dodd Senate Third Reading By IRWIN",79,0,0,0,79
942299,676144,2017-09-14,Senate,"Unfinished Business SB218 Dodd Concurrence",40,0,0,0,40
942300,604301,2017-03-15,Senate,"Do pass and be ordered to the Consent Calendar",7,0,0,0,7
942300,661232,2017-03-23,Senate,"Consent Calendar 2nd SB208 Committee On GOV. & F. (McGuire)",38,0,2,0,40
942300,663865,2017-06-14,Assembly,"Do pass. To Consent Calendar",9,0,0,0,9
942300,667917,2017-06-22,Assembly,"SB 208 GOV.& F. Consent Calendar Second Day Regular Session",74,0,6,0,80
942301,620128,2017-04-04,Assembly,"Do pass and be re-referred to the Committee on [Water, Parks, and Wildlife]",7,0,0,0,7
942301,684722,2018-01-09,Assembly,"Do pass as amended and be re-referred to the Committee on [Appropriations]",10,2,3,0,15
942304,618538,2017-04-04,Senate,"Do pass, but first be re-referred to the Committee on [Judiciary]",4,0,1,0,5
942304,633533,2017-04-25,Senate,"Do pass as amended, but first amend, and re-refer to the Committee on [Appropriations]",7,0,0,0,7
942304,644271,2017-05-15,Senate,"Placed on suspense file",7,0,0,0,7
942304,650580,2017-05-25,Senate,"Do pass",5,2,0,0,7
942304,654019,2017-05-30,Senate,"Senate 3rd Reading SB213 Mitchell",31,7,2,0,40
942304,654020,2017-05-30,Senate,"Senate 3rd Reading SB213 Mitchell",40,0,0,0,40
942304,654021,2017-05-30,Senate,"Senate 3rd Reading SB213 Mitchell",28,12,0,0,40
942304,655782,2017-05-30,Senate,"Senate 3rd Reading SB213 Mitchell Reconsider",40,0,0,0,40
942304,669201,2017-06-27,Assembly,"Do pass and be re-referred to the Committee on [Judiciary]",6,0,1,0,7
942304,672042,2017-07-11,Assembly,"Do pass and be re-referred to the Committee on [Appropriations]",8,2,1,0,11
942304,674650,2017-09-01,Assembly,"Do pass as amended",11,5,1,0,17
942304,675278,2017-09-08,Assembly,"SB 213 Mitchell Senate Third Reading Amend By STONE Set #1",54,18,7,0,79
942304,675633,2017-09-11,Assembly,"Do pass",6,0,1,0,7
942304,676604,2017-09-15,Assembly,"SB 213 Mitchell Senate Third Reading By STONE",58,15,6,0,79
942304,676605,2017-09-15,Senate,"Unfinished Business SB213 Mitchell Concurrence",28,9,3,0,40
944184,578067,2017-02-06,Senate,"Senate 3rd Reading SR17 Atkins",40,0,0,0,40
944421,684741,2018-01-09,Senate,"Do pass and be ordered to the Consent Calendar",7,0,0,0,7
944421,689907,2018-01-29,Senate,"Consent Calendar SB221 Wiener et al",39,0,1,0,40
944421,764852,2018-06-19,Assembly,"Do pass and be re-referred to the Committee on [Appropriations]",4,2,1,0,7
944421,771064,2018-08-08,Assembly,"Do pass",12,5,0,0,17
944421,772947,2018-08-27,Assembly,"SB 221 Wiener Senate Third Reading By TING",44,31,5,0,80
944421,773278,2018-08-29,Senate,"That the Assembly amendments be concurred in",5,2,0,0,7
944421,773850,2018-08-30,Senate,"Unfinished Business SB221 Wiener et al. Concurrence",26,13,1,0,40
944422,626368,2017-04-17,Assembly,"Do pass and be re-referred to the Committee on [Appropriations]",3,1,10,0,14
944422,626369,2017-04-17,Assembly,Reconsideration,13,0,1,0,14
944423,608443,2017-03-21,Assembly,"Do pass as amended and be re-referred to the Committee on [Privacy and Consumer Protection]",7,1,3,0,11
944423,636387,2017-05-02,Assembly,"Do pass as amended",7,2,1,0,10
944423,647918,2017-05-22,Assembly,"AB 291 CHIU Assembly Third Reading",54,17,9,0,80
944423,666150,2017-06-20,Senate,"Do pass",5,2,0,0,7
944423,675050,2017-09-06,Senate,"Assembly 3rd Reading AB291 Chiu et al. By Lara",28,11,1,0,40
944423,675505,2017-09-11,Assembly,"AB 291 CHIU Concurrence in Senate Amendments",56,20,3,0,79
944425,684727,2018-01-09,Assembly,"Do pass",6,0,1,0,7
944425,686232,2018-01-18,Assembly,"AB 282 JONES-SAWYER Assembly Third Reading",45,17,15,0,77
944425,753172,2018-05-15,Senate,"Do pass as amended",5,2,0,0,7
944425,770250,2018-08-06,Senate,"Assembly 3rd Reading AB282 Jones-Sawyer et al. By Monning",25,9,5,0,39
944425,772131,2018-08-20,Assembly,"AB 282 JONES-SAWYER Concurrence in Senate Amendments",54,20,6,0,80
944426,619940,2017-04-05,Senate,"Do pass",5,2,0,0,7
944426,634480,2017-04-27,Senate,"Senate 3rd Reading SB231 Hertzberg",23,10,7,0,40
944426,663138,2017-06-14,Assembly,"Do pass",6,3,0,0,9
944426,674385,2017-08-31,Assembly,"SB 231 Hertzberg Senate Third Reading By GONZALEZ FLETCHER",41,29,9,0,79
944427,684863,2018-01-10,Senate,"Do pass, but first be re-referred to the Committee on [Appropriations]",5,1,1,0,7
944427,685458,2018-01-16,Senate,"Placed on suspense file",7,0,0,0,7
944427,686171,2018-01-18,Senate,"Do pass",5,0,2,0,7
944427,691050,2018-01-30,Senate,"Senate 3rd Reading SB227 De León et al",27,7,6,0,40
944427,768317,2018-06-25,Assembly,"Do pass and be re-referred to the Committee on [Education]",6,3,1,0,10
944427,768732,2018-06-27,Assembly,"Do pass as amended and be re-referred to the Committee on [Appropriations]",5,2,0,0,7
944429,604300,2017-03-15,Assembly,"Do pass and be re-referred to the Committee on [Appropriations] with recommendation: To Consent Calendar",17,0,4,0,21
944429,620079,2017-04-05,Assembly,"Do pass. To Consent Calendar",17,0,0,0,17
944429,629036,2017-04-20,Assembly,"AB 289 GRAY Consent Calendar Second Day Regular Session",74,0,6,0,80
944429,662180,2017-06-13,Senate,"Do pass, but first be re-referred to the Committee on [Appropriations] with the recommendation: To Consent Calendar",12,0,1,0,13
944429,670956,2017-07-03,Senate,"Consent Calendar 2nd AB289",33,0,7,0,40
944430,594123,2017-02-27,Assembly,"Be adopted. To third reading",10,0,1,0,11
944432,626966,2017-04-17,Assembly,"Do pass as amended and be re-referred to the Committee on [Appropriations]",10,0,0,0,10
944433,613640,2017-03-28,Assembly,"Do pass and be re-referred to the Committee on [Appropriations]",16,0,0,0,16
944433,633128,2017-04-26,Assembly,"Do pass. To Consent Calendar",16,0,1,0,17
944433,638635,2017-05-04,Assembly,"AB 290 SALAS Consent Calendar Second Day Regular Session",76,0,4,0,80
944433,669073,2017-06-26,Senate,"Do pass, but first be re-referred to the Committee on [Appropriations]",9,0,0,0,9
944433,674382,2017-08-31,Senate,"Assembly 3rd Reading AB290 Salas et al. By Galgiani",38,0,2,0,40
944433,674885,2017-09-05,Assembly,"AB 290 SALAS Concurrence in Senate Amendments",77,0,2,0,79
944433,775121,2017-08-31,Senate,,9,0,2,0,11
944434,608382,2017-03-21,Assembly,"Do pass as amended and be re-referred to the Committee on [Appropriations]",15,0,0,0,15
944436,637369,2017-05-03,Assembly,"Do pass",7,0,0,0,7
944436,643527,2017-05-11,Assembly,"AB 283 COOPER Assembly Third Reading",77,0,3,0,80
944437,631845,2017-04-25,Senate,"Do pass, but first be re-referred to the Committee on [Appropriations]",13,0,0,0,13
944437,644253,2017-05-15,Senate,"Senate 3rd Reading SB228 Dodd et al",38,1,1,0,40
944437,667048,2017-06-21,Assembly,"Do pass and be re-referred to the Committee on [Appropriations]",16,1,4,0,21
944437,669715,2017-06-28,Assembly,"Do pass",14,0,3,0,17
944437,671002,2017-07-03,Assembly,"SB 228 Dodd Senate Third Reading By AGUIAR-CURRY",66,1,13,0,80
944440,610035,2017-03-20,Assembly,"Do pass and be re-referred to the Committee on [Transportation]",3,7,0,0,10
944440,610036,2017-03-20,Assembly,Reconsideration,10,0,0,0,10
944441,603194,2017-03-13,Assembly,"Do pass as amended and be re-referred to the Committee on [Appropriations]",8,1,1,0,10
944443,631893,2017-04-25,Senate,"Do pass as amended",7,0,0,0,7
944443,635791,2017-05-01,Senate,"Senate 3rd Reading SB230 Atkins et al",37,0,3,0,40
944443,672055,2017-07-11,Assembly,"Do pass",6,1,0,0,7
944443,674966,2017-09-05,Assembly,"SB 230 Atkins Senate Third Reading By GONZALEZ FLETCHER",75,1,3,0,79
944443,675117,2017-09-07,Senate,"Special Consent Calendar # SB230",40,0,0,0,40
944444,627317,2017-04-18,Senate,"Do pass, but first be re-referred to the Committee on [Appropriations]",4,1,0,0,5
944444,640625,2017-05-08,Senate,"Senate 3rd Reading SB226 Hertzberg",34,3,3,0,40
944444,662999,2017-06-14,Assembly,"Do pass as amended and be re-referred to the Committee on [Appropriations]",5,1,1,0,7
944444,669649,2017-06-28,Assembly,"Do pass",13,1,3,0,17
944444,672720,2017-07-17,Assembly,"SB 226 Hertzberg Senate Third Reading By GALLAGHER",67,7,5,0,79
944444,673887,2017-08-21,Senate,"Unfinished Business SB226 Hertzberg Concurrence",35,3,2,0,40
944445,619887,2017-04-05,Senate,"Do pass, but first be re-referred to the Committee on [Public Safety]",7,1,1,0,9
944445,644269,2017-05-15,Senate,"Placed on suspense file",7,0,0,0,7
944447,602311,2017-03-13,Assembly,"Be adopted. To third reading",10,0,1,0,11
944447,630388,2017-04-24,Senate,"Special Consent Calendar # ACR19",37,0,3,0,40
944449,603339,2017-03-13,Assembly,"Do pass and be re-referred to the Committee on [Appropriations]",10,0,0,0,10
944449,642775,2017-05-10,Assembly,"Do pass. To Consent Calendar",17,0,0,0,17
944449,646563,2017-05-18,Assembly,"AB 280 LOW Consent Calendar Second Day Regular Session",69,0,11,0,80
944449,667170,2017-06-21,Senate,"Do pass, but first be re-referred to the Committee on [Appropriations]",7,0,0,0,7
944449,671891,2017-07-10,Senate,"Do pass",7,0,0,0,7
944449,675323,2017-09-11,Senate,"Assembly 3rd Reading AB280 Low et al. By Leyva",38,1,1,0,40
944449,675806,2017-09-13,Assembly,"AB 280 LOW Concurrence in Senate Amendments",77,0,2,0,79
944451,618566,2017-04-04,Assembly,"Do pass and be re-referred to the Committee on [Appropriations]",14,0,1,0,15
944452,627089,2017-04-18,Assembly,"Do pass and be re-referred to the Committee on [Appropriations]",6,0,1,0,7
944452,651886,2017-05-26,Assembly,"Do pass",12,0,5,0,17
944452,656837,2017-06-01,Assembly,"AB 284 MCCARTY Assembly Third Reading",45,29,6,0,80
944452,672046,2017-07-11,Senate,"Do pass, but first be re-referred to the Committee on [Appropriations]",5,2,0,0,7
944452,673760,2017-08-21,Senate,"Placed on suspense file",7,0,0,0,7
944453,629002,2017-04-19,Senate,"Do pass as amended, but first amend, and re-refer to the Committee on [Appropriations]",8,1,0,0,9
944453,644294,2017-05-15,Senate,"Placed on suspense file",7,0,0,0,7
944453,650328,2017-05-25,Senate,"Do pass",5,2,0,0,7
944453,654116,2017-05-30,Senate,"Senate 3rd Reading SB223 Atkins",31,9,0,0,40
944453,669184,2017-06-27,Assembly,"Do pass and be re-referred to the Committee on [Appropriations]",12,2,1,0,15
944453,674593,2017-09-01,Assembly,"Do pass as amended",11,5,1,0,17
944453,675815,2017-09-13,Assembly,"SB 223 Atkins Senate Third Reading By NAZARIAN",58,21,0,0,79
944453,676158,2017-09-14,Senate,"Unfinished Business SB223 Atkins Concurrence",31,8,1,0,40
944455,599051,2017-03-07,Assembly,"Do pass and be re-referred to the Committee on [Appropriations]",7,0,0,0,7
944455,652013,2017-05-26,Assembly,"Do pass",17,0,0,0,17
944455,654311,2017-05-30,Assembly,"AB 279 HOLDEN Assembly Third Reading",77,0,3,0,80
944455,669157,2017-06-27,Senate,"Do pass, but first be re-referred to the Committee on [Appropriations]",5,0,0,0,5
944455,673791,2017-08-21,Senate,"Placed on suspense file",7,0,0,0,7
944456,629507,2017-04-19,Senate,"Do pass, but first be re-referred to the Committee on [Appropriations]",8,1,0,0,9
944456,644435,2017-05-15,Senate,"Senate 3rd Reading SB220 Pan",32,7,1,0,40
944456,666215,2017-06-20,Assembly,"Do pass and be re-referred to the Committee on [Appropriations]",14,0,1,0,15
944456,669826,2017-06-28,Assembly,"Do pass",12,1,4,0,17
944456,674864,2017-09-05,Assembly,"SB 220 Pan Senate Third Reading By ARAMBULA",67,4,8,0,79
944458,628119,2017-04-19,Senate,"Do pass, but first be re-referred to the Committee on [Appropriations]",5,2,0,0,7
944458,636274,2017-05-01,Senate,"Placed on suspense file",7,0,0,0,7
944458,684856,2018-01-09,Senate,"Do pass",6,0,1,0,7
944458,686960,2018-01-22,Senate,"Senate 3rd Reading SB224 Jackson",38,0,2,0,40
944458,769705,2018-07-03,Assembly,"Do pass as amended",10,0,0,0,10
944458,773058,2018-08-28,Assembly,"SB 224 Jackson Senate Third Reading By REYES",78,0,2,0,80
944459,628001,2017-04-18,Senate,"Do pass as amended, but first amend, and re-refer to the Committee on [Appropriations] with the recommendation: To Consent Calendar",7,0,0,0,7
944459,644270,2017-05-15,Senate,"Placed on suspense file",7,0,0,0,7
944459,650671,2017-05-25,Senate,"Do pass",7,0,0,0,7
944459,656130,2017-05-31,Senate,"Special Consent Calendar # SB225",40,0,0,0,40
944459,666313,2017-06-20,Assembly,"Do pass and be re-referred to the Committee on [Appropriations] with recommendation: To Consent Calendar",11,0,0,0,11
944459,672900,2017-07-19,Assembly,"Do pass. To Consent Calendar",16,0,1,0,17
944459,674301,2017-08-31,Assembly,"SB 225 Stern Senate Third Reading By SANTIAGO",77,0,2,0,79
944459,674982,2017-09-05,Senate,"Special Consent SB225",40,0,0,0,40
944460,613639,2017-03-28,Senate,"Do pass, but first be re-referred to the Committee on [Governance and Finance] with the recommendation: To Consent Calendar",12,0,1,0,13
944460,620156,2017-04-05,Senate,"Do pass as amended, but first amend, and re-refer to the Committee on [Appropriations]",6,1,0,0,7
944460,647869,2017-05-22,Senate,"Senate 3rd Reading SB229 Wieckowski",37,0,3,0,40
944460,669873,2017-06-28,Assembly,"Do pass as amended and be re-referred to the Committee on [Local Government]",7,0,0,0,7
944460,672651,2017-07-12,Assembly,"Do pass and be re-referred to the Committee on [Appropriations]",9,0,0,0,9
944460,674031,2017-08-23,Assembly,"Do pass",15,0,2,0,17
944460,675326,2017-09-11,Assembly,"SB 229 Wieckowski Senate Third Reading By BLOOM",76,2,1,0,79
944460,676040,2017-09-14,Senate,"Special Consent Calendar SB229",40,0,0,0,40
947582,633595,2017-04-26,Assembly,"Do pass and be re-referred to the Committee on [Appropriations]",7,0,0,0,7
947582,651861,2017-05-26,Assembly,"Do pass",15,1,1,0,17
947582,655737,2017-05-31,Assembly,"AB 317 AGUIAR-CURRY Assembly Third Reading",65,11,4,0,80
947582,669140,2017-06-27,Senate,"Do pass, but first be re-referred to the Committee on [Appropriations]",12,1,0,0,13
947582,671848,2017-07-10,Senate,"Placed on suspense file",7,0,0,0,7
947582,674685,2017-09-01,Senate,"Do pass",7,0,0,0,7
947582,675595,2017-09-12,Senate,"Assembly 3rd Reading AB317 Aguiar-Curry et al. By Dodd",38,1,1,0,40
947582,675896,2017-09-13,Assembly,"AB 317 Aguiar-Curry Concurrence in Senate Amendments",61,14,4,0,79
947583,631880,2017-04-24,Assembly,"Do pass and be re-referred to the Committee on [Appropriations]",13,0,1,0,14
947583,651711,2017-05-26,Assembly,"Do pass as amended",16,0,1,0,17
947583,656237,2017-05-31,Assembly,"AB 301 RODRIGUEZ Assembly Third Reading",77,0,3,0,80
947583,672121,2017-07-11,Senate,"Do pass as amended, but first amend, and re-refer to the Committee on [Appropriations]",13,0,0,0,13
947583,673904,2017-08-21,Senate,"Placed on suspense file",7,0,0,0,7
947583,774578,2017-04-24,Assembly,?,0,0,1,0,1
947584,642782,2017-05-10,Assembly,"Do pass",12,0,1,0,13
947584,644549,2017-05-15,Assembly,"AB 295 EGGMAN Assembly Third Reading",76,0,4,0,80
947584,672813,2017-07-18,Senate,"Do pass",12,0,1,0,13
947584,674327,2017-08-31,Senate,"Special Consent Calendar # AB295",37,0,3,0,40
947584,674959,2017-09-05,Assembly,"AB 295 EGGMAN Concurrence in Senate Amendments",77,0,2,0,79
947586,634820,2017-04-27,Assembly,"Do pass and be re-referred to the Committee on [Appropriations]",20,0,1,0,21
947586,643082,2017-05-10,Assembly,"Do pass. To Consent Calendar",17,0,0,0,17
947586,646484,2017-05-18,Assembly,"AB 297 LEVINE Consent Calendar Second Day Regular Session",69,0,11,0,80
947586,669296,2017-06-27,Senate,"Do pass, but first be re-referred to the Committee on [Appropriations]",13,0,0,0,13
947586,673984,2017-08-21,Senate,"Assembly 3rd Reading AB297 Levine et al. By Dodd",39,0,1,0,40
947587,619662,2017-04-05,Assembly,"Do pass",7,0,0,0,7
947587,628993,2017-04-20,Assembly,"AB 294 GIPSON Assembly Third Reading",76,0,4,0,80
947587,658819,2017-06-06,Senate,"Do pass and be ordered to the Consent Calendar",6,0,1,0,7
947587,661587,2017-06-12,Senate,"Consent Calendar 2nd AB294",38,0,2,0,40
947589,634349,2017-04-26,Assembly,"Do pass and be re-referred to the Committee on [Appropriations]",7,0,0,0,7
947590,631898,2017-04-25,Assembly,"Do pass and be re-referred to the Committee on [Appropriations]",13,0,2,0,15
947590,651537,2017-05-26,Assembly,"Do pass",15,0,2,0,17
947590,654251,2017-05-30,Assembly,"AB 313 GRAY Assembly Third Reading",64,4,12,0,80
947590,669092,2017-06-27,Senate,"Do pass, but first be re-referred to the Committee on [Judiciary]",5,0,4,0,9
947590,672309,2017-07-11,Senate,"Do pass, but first be re-referred to the Committee on [Appropriations]",4,1,2,0,7
947590,676502,2017-09-16,Assembly,"AB 313 GRAY Concurrence in Senate Amendments",54,13,12,0,79
947590,676503,2017-09-16,Senate,"W/O REF. TO FILE AB313 Gray By Cannella",26,7,7,0,40
947591,608341,2017-03-21,Senate,"Do pass, but first be re-referred to the Committee on [Appropriations] with the recommendation: To Consent Calendar",7,0,0,0,7
947591,628867,2017-04-20,Senate,"Consent Calendar 2nd SB238 Hertzberg Urgency Clause",36,0,4,0,40
947591,662403,2017-06-13,Assembly,"Do pass and be re-referred to the Committee on [Appropriations] with recommendation: To Consent Calendar",7,0,0,0,7
947591,669559,2017-06-28,Assembly,"Do pass. To Consent Calendar",14,0,3,0,17
947591,675476,2017-09-11,Assembly,"SB 238 Hertzberg Third Reading Urgency By BLOOM",79,0,0,0,79
947591,676168,2017-09-14,Senate,"Special Consent Calendar SB238 Hertzberg Urgency Clause",40,0,0,0,40
947593,631850,2017-04-24,Senate,"Do pass, but first be re-referred to the Committee on [Judiciary]",2,6,1,0,9
947593,631851,2017-04-24,Senate,"[Second] hearing set for [04-25-2017]: Failed passage in Committee. Reconsideration granted",9,0,0,0,9
947594,615929,2017-03-29,Senate,"Do pass, but first be re-referred to the Committee on [Judiciary]",7,0,2,0,9
947594,633214,2017-04-25,Senate,"Do pass, but first be re-referred to the Committee on [Appropriations] with the recommendation: To Consent Calendar",7,0,0,0,7
947594,644453,2017-05-15,Senate,"Senate 3rd Reading SB241 Monning",39,0,1,0,40
947594,662380,2017-06-13,Assembly,"Do pass and be re-referred to the Committee on [Privacy and Consumer Protection] with recommendation: To Consent Calendar",14,0,1,0,15
947594,666256,2017-06-20,Assembly,"Do pass and be re-referred to the Committee on [Appropriations] with recommendation: To Consent Calendar",9,0,1,0,10
947594,669548,2017-06-28,Assembly,"Do pass. To Consent Calendar",14,0,3,0,17
947594,676352,2017-09-14,Assembly,"SB 241 Monning Senate Third Reading By LIMÓN",79,0,0,0,79
947594,676454,2017-09-15,Senate,"Unfinished Business SB241 Monning Concurrence",37,0,3,0,40
947595,610352,2017-03-22,Senate,"Do pass as amended, but first amend, and re-refer to the Committee on [Rules]",7,0,0,0,7
947595,631920,2017-04-25,Senate,"Do pass as amended, but first amend, and re-refer to the Committee on [Appropriations]",4,0,1,0,5
947595,644430,2017-05-15,Senate,"Placed on suspense file",7,0,0,0,7
947595,650641,2017-05-25,Senate,"Do pass as amended",7,0,0,0,7
947595,656096,2017-05-31,Senate,"Senate 3rd Reading SB233 Beall et al",39,0,1,0,40
947595,669010,2017-06-27,Assembly,"Do pass as amended and be re-referred to the Committee on [Education]",7,0,0,0,7
947595,672578,2017-07-12,Assembly,"Do pass and be re-referred to the Committee on [Appropriations] with recommendation: To Consent Calendar",7,0,0,0,7
947595,674585,2017-09-01,Assembly,"Do pass as amended",16,0,1,0,17
947595,675809,2017-09-13,Assembly,"SB 233 Beall Senate Third Reading By RUBIO",77,0,2,0,79
947595,676084,2017-09-14,Senate,"Unfinished Business SB233 Beall et al. Concurrence",40,0,0,0,40
947597,684774,2018-01-09,Assembly,"Do pass and be re-referred to the Committee on [Appropriations]",13,0,0,0,13
947597,686285,2018-01-18,Assembly,"Do pass",17,0,0,0,17
947597,689898,2018-01-29,Assembly,"AB 310 MEDINA Assembly Third Reading",76,0,1,0,77
947597,743919,2018-04-25,Senate,"Do pass, but first be re-referred to the Committee on [Appropriations]",6,0,0,0,6
947597,767933,2018-06-25,Senate,"Placed on suspense file",7,0,0,0,7
947597,771598,2018-08-16,Senate,"Do pass",7,0,0,0,7
947597,773221,2018-08-28,Senate,"Assembly 3rd Reading AB310 Medina et al. By McGuire",39,0,1,0,40
947597,773293,2018-08-29,Assembly,"AB 310 MEDINA Concurrence in Senate Amendments",79,0,1,0,80
947598,627822,2017-04-19,Senate,"Do pass as amended, but first amend, and re-refer to the Committee on [Rules]",6,1,0,0,7
947598,654525,2017-05-30,Senate,"Senate 3rd Reading SB242 Skinner",34,3,3,0,40
947598,672386,2017-07-12,Assembly,"Do pass and be re-referred to the Committee on [Banking and Finance]",8,1,0,0,9
947598,672823,2017-07-18,Assembly,"Do pass",9,0,2,0,11
947598,675167,2017-09-07,Assembly,"SB 242 Skinner Senate Third Reading By TING",77,0,2,0,79
947598,675443,2017-09-11,Senate,"Unfinished Business SB242 Skinner et al. Concurrence",35,4,1,0,40
947600,683962,2018-01-04,Assembly,"Be re-referred to the Committee on [Elections and Redistricting]",9,0,2,0,11
947600,684902,2018-01-10,Assembly,"Do pass as amended",5,2,0,0,7
947600,686211,2018-01-18,Assembly,"AB 306 GONZALEZ FLETCHER Assembly Third Reading Amend By HARPER Set #1 Motion to Lay on the Table By CALDERON",48,25,4,0,77
947600,686212,2018-01-18,Assembly,"AB 306 GONZALEZ FLETCHER Assembly Third Reading",59,3,15,0,77
947600,753318,2018-05-15,Senate,"Do pass as amended",4,1,0,0,5
947600,770274,2018-08-06,Senate,"Assembly 3rd Reading AB306 Gonzalez Fletcher By Hertzberg",26,11,2,0,39
947600,771188,2018-08-09,Assembly,"AB 306 GONZALEZ FLETCHER Concurrence in Senate Amendments",54,24,2,0,80
947602,603247,2017-03-14,Assembly,"Do pass",10,0,1,0,11
947602,606875,2017-03-20,Assembly,"AB 299 CALDERON Assembly Third Reading",71,1,8,0,80
947602,669601,2017-06-27,Senate,"Do pass",6,0,1,0,7
947602,676133,2017-09-14,Senate,"Assembly 3rd Reading AB299 Calderon By Hertzberg",40,0,0,0,40
947602,676466,2017-09-15,Assembly,"AB 299 Calderon Concurrence in Senate Amendments",70,1,8,0,79
947604,603163,2017-03-14,Assembly,"Do pass. To Consent Calendar",11,0,0,0,11
947604,606883,2017-03-20,Assembly,"AB 308 MAIENSCHEIN Consent Calendar Second Day Regular Session",76,0,4,0,80
947604,659177,2017-06-06,Senate,"Do pass and be ordered to the Consent Calendar",6,0,1,0,7
947604,661520,2017-06-12,Senate,"Consent Calendar 2nd AB308",38,0,2,0,40
947605,643480,2017-05-10,Assembly,"Do pass",5,1,1,0,7
947605,655148,2017-05-30,Assembly,"AB 318 CABALLERO Assembly Third Reading",55,21,4,0,80
947605,671385,2017-07-05,Senate,"Do pass as amended, but first amend, and re-refer to the Committee on [Appropriations]",4,2,1,0,7
947605,673915,2017-08-21,Senate,"Placed on suspense file",7,0,0,0,7
947606,632615,2017-04-25,Senate,"Do pass as amended, but first amend, and re-refer to the Committee on [Appropriations]",4,1,0,0,5
947606,644939,2017-05-15,Senate,"Placed on suspense file",7,0,0,0,7
947608,615301,2017-03-29,Senate,"Do pass, but first be re-referred to the Committee on [Appropriations]",7,0,0,0,7
947608,629178,2017-04-20,Senate,"Senate 3rd Reading SB246 Bates",40,0,0,0,40
947608,667488,2017-06-19,Assembly,"Do pass and be re-referred to the Committee on [Appropriations]",9,0,1,0,10
947608,669843,2017-06-28,Assembly,"Do pass. To Consent Calendar",14,0,3,0,17
947608,671616,2017-07-06,Assembly,"SB 246 Bates Consent Calendar Second Day Regular Session",74,0,6,0,80
947609,627079,2017-04-18,Assembly,"Do pass and be re-referred to the Committee on [Appropriations]",12,1,3,0,16
947609,651904,2017-05-26,Assembly,"Do pass",13,0,4,0,17
947609,656906,2017-06-01,Assembly,"AB 315 WOOD Assembly Third Reading",58,7,15,0,80
947609,671531,2017-07-05,Senate,"Do pass as amended, but first amend, and re-refer to the Committee on [Appropriations]",9,0,0,0,9
947609,673897,2017-08-21,Senate,"Placed on suspense file",7,0,0,0,7
947609,674529,2017-09-01,Senate,"Do pass",6,0,1,0,7
947609,773229,2018-08-28,Senate,"Assembly 3rd Reading AB315 Wood et al. By Hernandez",29,2,9,0,40
947609,773366,2018-08-29,Assembly,"AB 315 WOOD Concurrence in Senate Amendments",73,0,7,0,80
947610,633380,2017-04-25,Assembly,"Do pass as amended and be re-referred to the Committee on [Appropriations]",7,0,0,0,7
947610,651852,2017-05-26,Assembly,"Do pass",17,0,0,0,17
947610,655998,2017-05-31,Assembly,"AB 300 CABALLERO Assembly Third Reading",76,0,4,0,80
947610,667124,2017-06-21,Senate,"Do pass as amended, but first amend, and re-refer to the Committee on [Human Services]",5,0,2,0,7
947610,672502,2017-07-11,Senate,"Do pass as amended, but first amend, and re-refer to the Committee on [Appropriations]",7,0,0,0,7
947610,673950,2017-08-21,Senate,"Placed on suspense file",7,0,0,0,7
947610,674803,2017-09-01,Senate,"Do pass",7,0,0,0,7
947610,676042,2017-09-14,Senate,"Special Consent Calendar # AB300",40,0,0,0,40
947610,676298,2017-09-14,Assembly,"AB 300 Caballero Special Consent Calendar 1st Day Regular Session",79,0,0,0,79
947612,608359,2017-03-21,Senate,"Do pass and be ordered to the Consent Calendar",7,0,0,0,7
947612,615885,2017-03-30,Senate,"Consent Calendar 2nd SB237 Hertzberg",37,0,3,0,40
947612,662406,2017-06-13,Assembly,"Do pass as amended. To Consent Calendar",7,0,0,0,7
947612,669700,2017-06-28,Assembly,"Do pass. To Consent Calendar",14,0,3,0,17
947612,764252,2018-06-18,Assembly,"Be re-referred to the Committee on [Utilities and Energy]",7,0,4,0,11
947612,768838,2018-06-27,Assembly,"Do pass and be re-referred to the Committee on [Appropriations]",10,2,3,0,15
947612,771716,2018-08-16,Assembly,"Do pass as amended",11,2,4,0,17
947612,773836,2018-08-30,Assembly,"SB 237 Hertzberg Senate Third Reading By BURKE",48,17,15,0,80
947612,773973,2018-08-31,Senate,"That the Assembly amendments be concurred in",6,3,2,0,11
947612,774208,2018-08-31,Senate,"Unfinished Business SB237 Hertzberg Concurrence",22,12,6,0,40
947613,636585,2017-05-02,Assembly,"Do pass",8,0,2,0,10
947613,656939,2017-06-01,Assembly,"AB 314 MULLIN Assembly Third Reading",74,4,2,0,80
947613,672843,2017-07-18,Senate,"Do pass as amended",5,0,2,0,7
947613,675480,2017-09-11,Senate,"Assembly 3rd Reading AB314 Mullin By Hertzberg",35,0,5,0,40
947613,675933,2017-09-13,Assembly,"AB 314 MULLIN Concurrence in Senate Amendments",76,1,2,0,79
947616,636659,2017-05-02,Senate,"Do pass, but first be re-referred to the Committee on [Judiciary]",4,1,0,0,5
947616,642681,2017-05-09,Senate,"Do pass as amended",6,1,0,0,7
947616,647892,2017-05-22,Senate,"Senate 3rd Reading SB235 Allen",34,1,5,0,40
947616,669792,2017-06-28,Assembly,"Do pass as amended and be re-referred to the Committee on [Judiciary]",6,1,0,0,7
947616,672824,2017-07-18,Assembly,"Do pass",10,1,0,0,11
947616,676345,2017-09-14,Assembly,"SB 235 Allen Senate Third Reading By CUNNINGHAM",69,7,3,0,79
947616,676426,2017-09-15,Senate,"Unfinished Business SB235 Allen Concurrence",34,4,2,0,40
947617,603374,2017-03-14,Senate,"Do pass as amended, but first amend, and re-refer to the Committee on [Judiciary] with the recommendation: To Consent Calendar",8,0,1,0,9
947617,617597,2017-04-03,Senate,"Do pass",7,0,0,0,7
947617,644461,2017-05-15,Senate,"Senate 3rd Reading SB234 Berryhill",39,0,1,0,40
947617,669027,2017-06-27,Assembly,"Do pass and be re-referred to the Committee on [Appropriations]",15,0,0,0,15
947619,615072,2017-03-29,Senate,"Do pass",6,1,0,0,7
947619,617659,2017-04-03,Senate,"Senate 3rd Reading SB240 Dodd et al",35,1,4,0,40
947619,663579,2017-06-14,Assembly,"Do pass",8,0,1,0,9
947619,670346,2017-06-29,Assembly,"SB 240 Dodd Senate Third Reading By AGUIAR-CURRY",60,1,19,0,80
947621,603411,2017-03-14,Assembly,"Do pass. To Consent Calendar",11,0,0,0,11
947621,607017,2017-03-20,Assembly,"AB 307 MAIENSCHEIN Consent Calendar Second Day",76,0,4,0,80
947621,672909,2017-07-18,Senate,"Do pass and be ordered to the Consent Calendar",7,0,0,0,7
947621,674937,2017-09-05,Senate,"Assembly 3rd Reading AB307 Maienschein By Hill",40,0,0,0,40
947621,675177,2017-09-07,Assembly,"AB 307 MAIENSCHEIN Concurrence in Senate Amendments",79,0,0,0,79
947623,618638,2017-04-04,Assembly,"Do pass and be re-referred to the Committee on [Human Services]",7,0,0,0,7
947624,628348,2017-04-19,Senate,"Do pass, but first be re-referred to the Committee on [Appropriations]",2,4,1,0,7
947627,613488,2017-03-28,Assembly,"Do pass as amended and be re-referred to the Committee on [Labor and Employment]",7,0,0,0,7
947627,629025,2017-04-19,Assembly,"Do pass and be re-referred to the Committee on [Appropriations] with recommendation: To Consent Calendar",7,0,0,0,7
947628,633179,2017-04-25,Senate,"Do pass as amended, but first amend, and re-refer to the Committee on [Appropriations]",5,2,0,0,7
947628,644312,2017-05-15,Senate,"Placed on suspense file",7,0,0,0,7
947628,650683,2017-05-25,Senate,"Do pass as amended",5,2,0,0,7
947628,656751,2017-06-01,Senate,"Senate 3rd Reading SB244 Lara",27,12,1,0,40
947628,669069,2017-06-27,Assembly,"Do pass as amended and be re-referred to the Committee on [Privacy and Consumer Protection]",8,2,1,0,11
947628,672109,2017-07-11,Assembly,"Do pass as amended and be re-referred to the Committee on [Appropriations]",7,3,0,0,10
947628,674724,2017-09-01,Assembly,"Do pass as amended",11,5,1,0,17
947628,773087,2018-08-28,Assembly,"Do pass and be re-referred to the Committee on [Judiciary]",7,3,0,0,10
947628,773822,2018-08-30,Assembly,"Do pass",6,2,1,0,9
947628,774095,2018-08-31,Senate,"Unfinished Business SB244 Lara Concurrence",26,13,1,0,40
947628,774096,2018-08-31,Assembly,"SB 244 Lara Senate Third Reading By STONE",48,26,6,0,80
947629,608903,2017-03-21,Senate,"Do pass, but first be re-referred to the Committee on [Appropriations]",4,0,1,0,5
947629,626270,2017-04-17,Senate,"Placed on suspense file",7,0,0,0,7
947629,638290,2017-05-04,Senate,"Senate 3rd Reading SB243 Galgiani",39,0,1,0,40
947629,646495,2017-05-18,Assembly,"Do pass",9,0,1,0,10
947629,647951,2017-05-22,Assembly,"SB 243 Galgiani Senate Third Reading By ARAMBULA",77,0,3,0,80
947632,618289,2017-04-04,Senate,"Do pass as amended, but first amend, and re-refer to the Committee on [Judiciary]",3,1,1,0,5
947632,633301,2017-04-25,Senate,"Do pass, but first be re-referred to the Committee on [Appropriations]",6,1,0,0,7
947632,644449,2017-05-15,Senate,"Placed on suspense file",7,0,0,0,7
947632,650574,2017-05-25,Senate,"Do pass as amended",6,1,0,0,7
947632,655912,2017-05-31,Senate,"Senate 3rd Reading SB245 Leyva",28,9,3,0,40
947634,603674,2017-03-14,Assembly,"Do pass as amended. To Consent Calendar",11,0,0,0,11
947634,611131,2017-03-23,Assembly,"AB 309 MAIENSCHEIN Consent Calendar Second Day",76,0,4,0,80
947634,659469,2017-06-06,Senate,"Do pass",6,0,1,0,7
947634,661641,2017-06-12,Senate,"Assembly 3rd Reading AB309 Maienschein By Jackson",38,0,2,0,40
947635,684185,2018-01-08,Assembly,"Do pass",7,3,0,0,10
947636,613569,2017-03-28,Senate,"Do pass as amended, but first amend, and re-refer to the Committee on [Appropriations]",5,2,0,0,7
947636,630386,2017-04-24,Senate,"Placed on suspense file",7,0,0,0,7
947636,650681,2017-05-25,Senate,"Do pass as amended",5,2,0,0,7
947636,656004,2017-05-31,Senate,"Senate 3rd Reading SB239 Wiener et al",26,12,2,0,40
947636,669090,2017-06-27,Assembly,"Do pass and be re-referred to the Committee on [Public Safety]",11,3,1,0,15
947636,672076,2017-07-11,Assembly,"Do pass and be re-referred to the Committee on [Appropriations]",5,2,0,0,7
947636,674010,2017-08-23,Assembly,"Do pass",9,5,3,0,17
947636,675122,2017-09-07,Assembly,"SB 239 Wiener Senate Third Reading By GLORIA",52,19,8,0,79
947636,675421,2017-09-11,Senate,"Unfinished Business SB239 Wiener et al. Concurrence",24,12,4,0,40
947638,615870,2017-03-30,Assembly,"Be re-referred to the Committee on [Veterans Affairs]",10,0,1,0,11
947638,633064,2017-04-25,Assembly,"Do pass and be re-referred to the Committee on [Appropriations]",10,0,0,0,10
947638,651806,2017-05-26,Assembly,"Do pass as amended",16,0,1,0,17
947638,656232,2017-05-31,Assembly,"AB 296 CERVANTES Assembly Third Reading",77,0,3,0,80
947638,672125,2017-07-11,Senate,"Do pass, but first be re-referred to the Committee on [Appropriations]",6,0,1,0,7
947638,673798,2017-08-21,Senate,"Placed on suspense file",7,0,0,0,7
947638,674630,2017-09-01,Senate,"Do pass",7,0,0,0,7
947638,675149,2017-09-07,Senate,"Assembly 3rd Reading AB296 Cervantes et al. By Jackson",40,0,0,0,40
947638,675434,2017-09-11,Assembly,"AB 296 CERVANTES Concurrence in Senate Amendments",79,0,0,0,79
947640,613733,2017-03-28,Assembly,"Do pass and be re-referred to the Committee on [Appropriations]",2,5,0,0,7
950071,645501,2017-05-15,Assembly,"Do pass and be re-referred to the Committee on [Appropriations] with recommendation: To Consent Calendar",10,0,0,0,10
950071,649335,2017-05-24,Assembly,"Do pass. To Consent Calendar",17,0,0,0,17
950071,654263,2017-05-30,Assembly,"AB 327 GIPSON Consent Calendar Second Day",77,0,3,0,80
950071,767232,2018-06-20,Senate,"Do pass, but first be re-referred to the Committee on [Transportation and Housing]",5,2,0,0,7
950072,633475,2017-04-26,Senate,"Do pass as amended, but first amend, and re-refer to the Committee on [Appropriations]",7,0,0,0,7
950072,644755,2017-05-15,Senate,"Placed on suspense file",7,0,0,0,7
950072,650801,2017-05-25,Senate,"Do pass as amended",5,2,0,0,7
950072,656719,2017-06-01,Senate,"Senate 3rd Reading SB257 Lara",31,6,3,0,40
950072,672613,2017-07-12,Assembly,"Do pass and be re-referred to the Committee on [Appropriations]",6,0,1,0,7
950072,674515,2017-09-01,Assembly,"Do pass",11,5,1,0,17
950072,675599,2017-09-12,Assembly,"SB 257 Lara Senate Third Reading By REYES",61,11,7,0,79
950072,675901,2017-09-13,Senate,"Unfinished Business SB257 Lara Concurrence",31,7,2,0,40
950073,629166,2017-04-19,Assembly,"Do pass and be re-referred to the Committee on [Appropriations]",8,0,1,0,9
950073,649459,2017-05-24,Assembly,"Do pass",13,1,3,0,17
950073,655946,2017-05-31,Assembly,"AB 331 EGGMAN Assembly Third Reading By GLORIA",68,3,9,0,80
950073,669110,2017-06-27,Senate,"Do pass, but first be re-referred to the Committee on [Judiciary]",7,0,0,0,7
950073,672391,2017-07-11,Senate,"Do pass, but first be re-referred to the Committee on [Appropriations]",6,0,1,0,7
950073,675675,2017-09-12,Senate,"Assembly 3rd Reading AB331 Eggman et al. By Roth",40,0,0,0,40
950073,676383,2017-09-14,Assembly,"AB 331 EGGMAN Concurrence in Senate Amendments",67,4,8,0,79
950074,617425,2017-04-03,Assembly,"Do pass and be re-referred to the Committee on [Public Safety]",13,0,1,0,14
950075,604908,2017-03-15,Senate,"Do pass as amended, but first amend, and re-refer to the Committee on [Appropriations]",7,0,0,0,7
950075,617633,2017-04-03,Senate,"Placed on suspense file",7,0,0,0,7
950075,650697,2017-05-25,Senate,"Do pass as amended",7,0,0,0,7
950075,655858,2017-05-31,Senate,"Senate 3rd Reading SB250 Hertzberg",39,0,1,0,40
950075,667223,2017-06-21,Assembly,"Do pass as amended and be re-referred to the Committee on [Appropriations]",6,0,1,0,7
950075,674570,2017-09-01,Assembly,"Do pass as amended",16,0,1,0,17
950075,675759,2017-09-13,Assembly,"SB 250 Hertzberg Senate Third Reading By MCCARTY",77,0,2,0,79
950075,676081,2017-09-14,Senate,"Unfinished Business SB250 Hertzberg et al. Concurrence",40,0,0,0,40
950076,621182,2017-04-05,Assembly,"Do pass",9,0,0,0,9
950076,629069,2017-04-20,Assembly,"AB 332 BOCANEGRA Assembly Third Reading",77,0,3,0,80
950076,658774,2017-06-06,Senate,"Do pass and be ordered to the Consent Calendar",13,0,0,0,13
950076,661546,2017-06-12,Senate,"Consent Calendar 2nd AB332",38,0,2,0,40
950076,664156,2017-06-15,Assembly,"AB 332 BOCANEGRA Concurrence in Senate Amendments",78,0,2,0,80
950077,631843,2017-04-25,Senate,"Do pass, but first be re-referred to the Committee on [Appropriations]",13,0,0,0,13
950077,644276,2017-05-15,Senate,"Placed on suspense file",7,0,0,0,7
950077,650593,2017-05-25,Senate,"Do pass as amended",7,0,0,0,7
950077,656602,2017-06-01,Senate,"Senate 3rd Reading SB254 Portantino",39,1,0,0,40
950078,613872,2017-03-28,Senate,"Do pass, but first be re-referred to the Committee on [Appropriations]",7,0,0,0,7
950078,626110,2017-04-17,Senate,"Placed on suspense file",7,0,0,0,7
950079,633075,2017-04-26,Senate,"Do pass, but first be re-referred to the Committee on [Appropriations] with the recommendation: To Consent Calendar",9,0,0,0,9
950079,634617,2017-04-26,Senate,"Do pass, but first be re-referred to the Committee on [Health] with the recommendation: To Consent Calendar",9,0,0,0,9
950079,647825,2017-05-22,Senate,"Consent Calendar 2nd SB255 Mendoza Urgency Clause",37,0,3,0,40
950083,627885,2017-04-18,Assembly,"Do pass as amended and be re-referred to the Committee on [Appropriations]",12,0,1,0,13
950083,637616,2017-05-03,Assembly,"Do pass",12,0,5,0,17
950083,644481,2017-05-15,Assembly,"AB 343 MCCARTY Assembly Third Reading",65,0,15,0,80
950083,663062,2017-06-14,Senate,"Do pass, but first be re-referred to the Committee on [Judiciary]",7,0,0,0,7
950083,669798,2017-06-27,Senate,"Do pass, but first be re-referred to the Committee on [Appropriations]",6,0,1,0,7
950083,672690,2017-07-17,Senate,"Placed on suspense file",7,0,0,0,7
950083,674508,2017-09-01,Senate,"Do pass",7,0,0,0,7
950083,675019,2017-09-06,Senate,"Assembly 3rd Reading AB343 McCarty et al. By Pan",38,0,2,0,40
950083,675395,2017-09-11,Assembly,"AB 343 MCCARTY Concurrence in Senate Amendments",67,5,7,0,79
950084,608508,2017-03-21,Assembly,"Do pass and be re-referred to the Committee on [Appropriations]",15,0,0,0,15
950084,651644,2017-05-26,Assembly,"Do pass",17,0,0,0,17
950084,654181,2017-05-30,Assembly,"AB 340 ARAMBULA Assembly Third Reading",77,0,3,0,80
950084,669730,2017-06-28,Senate,"Do pass, but first be re-referred to the Committee on [Appropriations]",7,0,2,0,9
950084,673907,2017-08-21,Senate,"Placed on suspense file",7,0,0,0,7
950084,674632,2017-09-01,Senate,"Do pass as amended",7,0,0,0,7
950084,676073,2017-09-14,Senate,"Special Consent Calendar # AB340",40,0,0,0,40
950084,676288,2017-09-14,Assembly,"AB 340 Arambula Special Consent Calendar 1st Day Regular Session",79,0,0,0,79
950084,777392,2017-08-21,Senate,"Placedtyle=""font-weight: bold"" title=""No Votes Recorded"">No Votes Recorded:",7,0,0,0,7
950086,603220,2017-03-14,Assembly,"Do pass and be re-referred to the Committee on [Appropriations] with recommendation: To Consent Calendar",7,0,0,0,7
950086,620024,2017-04-05,Assembly,"Do pass. To Consent Calendar",17,0,0,0,17
950086,630492,2017-04-24,Assembly,"AB 335 KILEY Assembly Third Reading",76,0,4,0,80
950086,662469,2017-06-13,Senate,"Do pass, but first be re-referred to the Committee on [Appropriations]",6,0,1,0,7
950086,675696,2017-09-12,Senate,"Assembly 3rd Reading AB335 Kiley By Jackson",39,0,1,0,40
950086,675852,2017-09-13,Assembly,"AB 335 Kiley Concurrence in Senate Amendments",76,1,2,0,79
950088,603154,2017-03-14,Senate,"Do pass, but first be re-referred to the Committee on [Transportation and Housing]",7,2,0,0,9
950088,626946,2017-04-18,Senate,"Do pass, but first be re-referred to the Committee on [Appropriations]",8,2,3,0,13
950088,635809,2017-05-01,Senate,"Placed on suspense file",7,0,0,0,7
950088,650684,2017-05-25,Senate,"Do pass as amended",5,2,0,0,7
950088,656767,2017-06-01,Senate,"Senate 3rd Reading SB249 Allen",22,16,2,0,40
950088,672019,2017-07-11,Assembly,"Do pass as amended and be re-referred to the Committee on [Appropriations]",8,5,2,0,15
950088,674445,2017-09-01,Assembly,"Do pass as amended",11,0,6,0,17
950088,675772,2017-09-13,Assembly,"SB 249 Allen Senate Third Reading By EGGMAN",76,0,3,0,79
950088,676092,2017-09-14,Senate,"Unfinished Business SB249 Allen Concurrence",40,0,0,0,40
950092,643123,2017-05-10,Assembly,"Do pass. To Consent Calendar",6,0,1,0,7
950092,646450,2017-05-18,Assembly,"AB 341 FRAZIER Consent Calendar Second Day Regular Session",69,0,11,0,80
950092,663949,2017-06-14,Senate,"Do pass and be ordered to the Consent Calendar",7,0,0,0,7
950092,667936,2017-06-22,Senate,"Consent Calendar 2nd AB341",37,0,3,0,40
950093,633395,2017-04-25,Assembly,"Do pass and be re-referred to the Committee on [Appropriations]",7,0,0,0,7
950093,651935,2017-05-26,Assembly,"Do pass as amended",16,0,1,0,17
950093,656892,2017-06-01,Assembly,"AB 322 MULLIN Assembly Third Reading",79,0,1,0,80
950093,672374,2017-07-11,Senate,"Do pass, but first be re-referred to the Committee on [Appropriations] with the recommendation: To Consent Calendar",7,0,0,0,7
950093,673829,2017-08-21,Senate,"Placed on suspense file",7,0,0,0,7
950094,641820,2017-05-09,Assembly,"Do pass as amended. To Consent Calendar",7,0,0,0,7
950094,647916,2017-05-22,Assembly,"AB 323 BERMAN Consent Calendar Second Day Regular Session",77,0,3,0,80
950094,662742,2017-06-13,Senate,"Do pass",4,0,1,0,5
950094,668717,2017-06-26,Senate,"Special Consent Calendar # AB323",39,0,1,0,40
950095,612766,2017-03-27,Assembly,"Do pass",14,0,0,0,14
950095,621529,2017-04-06,Assembly,"AB 344 MELENDEZ Assembly Third Reading",80,0,0,0,80
950096,632393,2017-04-25,Assembly,"Do pass and be re-referred to the Committee on [Appropriations] with recommendation: To Consent Calendar",7,0,0,0,7
950096,651950,2017-05-26,Assembly,"Do pass",17,0,0,0,17
950096,654209,2017-05-30,Assembly,"AB 339 MATHIS Assembly Third Reading",77,0,3,0,80
950096,667250,2017-06-21,Senate,"Do pass, but first be re-referred to the Committee on [Appropriations] with the recommendation: To Consent Calendar",6,0,1,0,7
950096,671852,2017-07-10,Senate,"Placed on suspense file",7,0,0,0,7
950096,674478,2017-09-01,Senate,"Do pass",7,0,0,0,7
950096,675076,2017-09-06,Senate,"Assembly 3rd Reading AB339 Mathis By Berryhill",40,0,0,0,40
950097,631772,2017-04-25,Assembly,"Do pass as amended and be re-referred to the Committee on [Appropriations]",14,0,1,0,15
950097,638368,2017-05-04,Assembly,"AB 321 MATHIS Assembly Third Reading",75,1,4,0,80
950097,662422,2017-06-13,Senate,"Do pass",9,0,0,0,9
950097,668664,2017-06-26,Senate,"Special Consent Calendar # AB321",39,0,1,0,40
950098,603342,2017-03-14,Assembly,"Do pass as amended and be re-referred to the Committee on [Appropriations]",7,0,0,0,7
950098,620069,2017-04-05,Assembly,"Do pass",17,0,0,0,17
950098,629058,2017-04-20,Assembly,"AB 324 KILEY Assembly Third Reading",73,0,7,0,80
950098,672189,2017-07-11,Senate,"Do pass, but first be re-referred to the Committee on [Appropriations]",3,1,3,0,7
950098,672190,2017-07-11,Senate,"[Second] hearing set for [07-11-2017]: Failed passage in Committee. Reconsideration granted",7,0,0,0,7
950098,768309,2018-06-26,Senate,"Do pass, but first be re-referred to the Committee on [Appropriations]",5,0,2,0,7
950098,771387,2018-08-13,Senate,"Assembly 3rd Reading AB324 Kiley By Nguyen",34,0,6,0,40
950098,772191,2018-08-20,Assembly,"AB 324 KILEY Concurrence in Senate Amendments",80,0,0,0,80
950099,613513,2017-03-28,Senate,"Do pass, but first be re-referred to the Committee on [Governance and Finance]",7,2,0,0,9
950099,634545,2017-04-26,Senate,"Do pass as amended, but first amend, and re-refer to the Committee on [Appropriations]",4,2,1,0,7
950099,644360,2017-05-15,Senate,"Placed on suspense file",7,0,0,0,7
950099,650727,2017-05-25,Senate,"Do pass",5,2,0,0,7
950099,654502,2017-05-30,Senate,"Senate 3rd Reading SB252 Dodd",23,14,3,0,40
950099,669072,2017-06-27,Assembly,"Do pass as amended and be re-referred to the Committee on [Local Government]",9,6,0,0,15
950099,672575,2017-07-12,Assembly,"Do pass as amended and be re-referred to the Committee on [Appropriations]",6,3,0,0,9
950099,674251,2017-08-30,Assembly,"Do pass as amended",10,5,2,0,17
950099,675391,2017-09-11,Assembly,"SB 252 Dodd Senate Third Reading By FRIEDMAN",46,31,2,0,79
950099,675695,2017-09-12,Senate,"Unfinished Business SB252 Dodd Concurrence",25,14,1,0,40
950099,774591,2017-08-30,Assembly,?,6,5,2,0,13
950100,607656,2017-03-20,Assembly,"Do pass and be re-referred to the Committee on [Appropriations] with recommendation: To Consent Calendar",14,0,0,0,14
950100,652142,2017-05-26,Assembly,"Do pass",17,0,0,0,17
950100,654423,2017-05-30,Assembly,"AB 333 QUIRK Assembly Third Reading",77,0,3,0,80
950100,666295,2017-06-20,Senate,"Do pass, but first be re-referred to the Committee on [Appropriations] with the recommendation: To Consent Calendar",12,0,1,0,13
950100,671985,2017-07-10,Senate,"Placed on suspense file",7,0,0,0,7
950100,674574,2017-09-01,Senate,"Do pass",7,0,0,0,7
950100,675094,2017-09-06,Senate,"Assembly 3rd Reading AB333 Quirk et al. By Wieckowski",40,0,0,0,40
950101,613712,2017-03-28,Assembly,"Do pass and be re-referred to the Committee on [Judiciary]",16,0,0,0,16
950101,618397,2017-04-04,Assembly,"Do pass as amended and be re-referred to the Committee on [Appropriations]",11,0,0,0,11
950101,637513,2017-05-03,Assembly,"Do pass. To Consent Calendar",16,0,1,0,17
950101,643562,2017-05-11,Assembly,"AB 326 SALAS Consent Calendar Second Day Regular Session",77,0,3,0,80
950101,665491,2017-06-19,Senate,"Do pass as amended, but first amend, and re-refer to the Committee on [Appropriations]",9,0,0,0,9
950101,674890,2017-09-05,Senate,"Assembly 3rd Reading AB326 Salas et al. By Jackson",40,0,0,0,40
950101,675211,2017-09-07,Assembly,"AB 326 SALAS Concurrence in Senate Amendments",78,0,1,0,79
950102,626999,2017-04-18,Assembly,"Do pass and be re-referred to the Committee on [Transportation]",6,4,0,0,10
950103,608303,2017-03-21,Assembly,"Do pass as amended, and be re-referred to the Committee on [Judiciary] with recommendation: To Consent Calendar",7,0,0,0,7
950103,631955,2017-04-25,Assembly,"Do pass as amended and be re-referred to the Committee on [Appropriations]",11,0,0,0,11
950103,645908,2017-05-17,Assembly,"Do pass",17,0,0,0,17
950103,651436,2017-05-26,Assembly,"AB 334 COOPER Assembly Third Reading",76,0,4,0,80
950103,669845,2017-06-27,Senate,"Do pass, but first be re-referred to the Committee on [Public Safety]",6,0,1,0,7
952787,631743,2017-04-25,Senate,"Do pass, but first be re-referred to the Committee on [Appropriations]",13,0,0,0,13
952787,644366,2017-05-15,Senate,"Placed on suspense file",7,0,0,0,7
952787,650570,2017-05-25,Senate,"Do pass",7,0,0,0,7
952787,655775,2017-05-31,Senate,"Special Consent Calendar # SB265",40,0,0,0,40
952787,667109,2017-06-21,Assembly,"Do pass as amended and be re-referred to the Committee on [Appropriations]",17,0,4,0,21
952788,603586,2017-03-14,Assembly,"Amend, and be adopted as amended and re-refer to the Committee on [Appropriations] with the recommendation: To Consent Calendar",11,0,0,0,11
952788,620274,2017-04-05,Assembly,"Be adopted. To Consent Calendar",17,0,0,0,17
952788,629199,2017-04-20,Assembly,"ACR 21 KILEY Assembly Third Reading",76,0,4,0,80
952788,660467,2017-06-07,Senate,"Be adopted, but first be re-referred to the Committee on [Judiciary] with recommendation: To Consent Calendar",7,0,0,0,7
952788,666680,2017-06-20,Senate,"Be adopted, but first be re-referred to the Committee on [Appropriations] with recommendation: To Consent Calendar",7,0,0,0,7
952788,672574,2017-07-13,Senate,"Consent Calendar 2nd ACR21",39,0,1,0,40
952789,618301,2017-04-03,Assembly,"Do pass and be re-referred to the Committee on [Appropriations]",10,0,0,0,10
952789,651928,2017-05-26,Assembly,"Do pass",17,0,0,0,17
952789,654160,2017-05-30,Assembly,"AB 362 WOOD Assembly Third Reading",77,0,3,0,80
952789,669167,2017-06-27,Senate,"Do pass, but first be re-referred to the Committee on [Appropriations] with the recommendation: To Consent Calendar",8,0,1,0,9
952789,671929,2017-07-10,Senate,"Placed on suspense file",7,0,0,0,7
952791,636733,2017-05-02,Assembly,"Do pass as amended. To Consent Calendar",11,0,0,0,11
952791,643564,2017-05-11,Assembly,"AB 360 MURATSUCHI Consent Calendar Second Day",77,0,3,0,80
952791,672878,2017-07-18,Senate,"Do pass",7,0,0,0,7
952791,674267,2017-08-31,Senate,"Special Consent Calendar # AB360",37,0,3,0,40
952792,642297,2017-05-08,Assembly,"Do pass as amended and be re-referred to the Committee on [Appropriations]",8,0,2,0,10
952794,642657,2017-05-10,Assembly,"Do pass as amended",5,3,1,0,9
952794,656929,2017-06-01,Assembly,"AB 345 RIDLEY-THOMAS Assembly Third Reading",47,29,4,0,80
952794,672362,2017-07-12,Senate,"Do pass as amended",5,1,1,0,7
952794,766968,2018-06-20,Senate,"Do pass, but first be re-referred to the Committee on [Transportation and Housing]",3,3,1,0,7
952794,766969,2018-06-20,Senate,"[06-21-2018] hearing: Motion to Reconsider. [Reconsideration Granted.]",7,0,0,0,7
952796,608340,2017-03-21,Assembly,"Do pass",6,0,1,0,7
952796,656887,2017-06-01,Assembly,"AB 359 JONES-SAWYER Assembly Third Reading",59,12,9,0,80
952796,669018,2017-06-27,Senate,"Do pass",5,2,0,0,7
952797,608389,2017-03-21,Assembly,"Do pass as amended",14,0,1,0,15
952797,621360,2017-04-06,Assembly,"AB 366 OBERNOLTE Assembly Third Reading",74,3,3,0,80
952797,774571,2017-03-21,Assembly,,0,0,1,0,1
952798,621053,2017-04-06,Assembly,"Be re-referred to the Committees on [Veterans Affairs] and [Public Employees, Retirement, and Social Security]",9,0,2,0,11
952798,634378,2017-04-27,Assembly,"Do pass and be re-referred to the Committee on [Appropriations]",4,0,3,0,7
952798,642794,2017-05-10,Assembly,"Do pass",12,5,0,0,17
952798,644386,2017-05-15,Assembly,"AB 349 MCCARTY Assembly Third Reading",41,30,9,0,80
952798,661639,2017-06-12,Senate,"Do pass as amended, but first amend, and re-refer to the Committee on [Judiciary]",4,1,0,0,5
952798,768735,2018-06-27,Senate,"Do pass, but first be re-referred to the Committee on [Appropriations]",9,0,0,0,9
952798,772215,2018-08-20,Senate,"Assembly 3rd Reading AB349 McCarty By Pan",39,0,1,0,40
952798,772851,2018-08-27,Assembly,"With recommendation: That Senate amendments be concurred in",12,0,3,0,15
952798,773344,2018-08-29,Assembly,"AB 349 MCCARTY Concurrence in Senate Amendments",79,0,1,0,80
952799,626093,2017-04-17,Assembly,"Do pass and be re-referred to the Committee on [Veterans Affairs]",13,0,1,0,14
952799,633626,2017-04-25,Assembly,"Do pass and be re-referred to the Committee on [Appropriations]",9,0,1,0,10
952799,652177,2017-05-26,Assembly,"Do pass",17,0,0,0,17
952799,654444,2017-05-30,Assembly,"AB 363 QUIRK-SILVA Assembly Third Reading",77,0,3,0,80
952799,666289,2017-06-20,Senate,"Do pass, but first be re-referred to the Committee on [Appropriations] with the recommendation: To Consent Calendar",12,0,1,0,13
952799,671875,2017-07-10,Senate,"Placed on suspense file",7,0,0,0,7
952799,674814,2017-09-01,Senate,"Do pass as amended",5,0,2,0,7
952799,676086,2017-09-14,Senate,"Special Consent Calendar # AB363",40,0,0,0,40
952799,676357,2017-09-14,Assembly,"AB 363 Quirk-Silva Special Consent Calendar 1st Day Regular Session",79,0,0,0,79
952800,627472,2017-04-18,Assembly,"Do pass and be re-referred to the Committee on [Appropriations]",10,0,0,0,10
952800,637768,2017-05-03,Assembly,"Do pass",16,0,1,0,17
952800,640600,2017-05-08,Assembly,"AB 347 CHAU Assembly Third Reading",77,0,3,0,80
952800,767937,2018-06-25,Senate,"Do pass, but first be re-referred to the Committee on [Appropriations]",9,0,0,0,9
952800,770379,2018-08-06,Senate,"Do pass",7,0,0,0,7
952800,772815,2018-08-27,Senate,"Assembly 3rd Reading AB347 Chau By Hill",35,4,1,0,40
952800,773412,2018-08-29,Assembly,"AB 347 CHAU Concurrence in Senate Amendments",76,2,2,0,80
952801,633427,2017-04-26,Senate,"Do pass, but first be re-referred to the Committee on [Appropriations] with the recommendation: To Consent Calendar",9,0,0,0,9
952801,644352,2017-05-15,Senate,"Consent Calendar 2nd SB261",39,0,1,0,40
952801,672520,2017-07-12,Assembly,"Do pass and be re-referred to the Committee on [Appropriations] with recommendation: To Consent Calendar",12,0,1,0,13
952801,674055,2017-08-23,Assembly,"Do pass. To Consent Calendar",15,0,2,0,17
952801,773647,2018-08-29,Assembly,"SB 261 Roth Senate Third Reading By CERVANTES",80,0,0,0,80
952801,773728,2018-08-30,Senate,"Unfinished Business SB261 Roth Concurrence",39,0,1,0,40
952802,603302,2017-03-14,Assembly,"Do pass. To Consent Calendar",7,0,0,0,7
952802,611054,2017-03-23,Assembly,"AB 356 BIGELOW Consent Calendar Second Day Regular Session",76,0,4,0,80
952802,663086,2017-06-14,Senate,"Do pass as amended, but first amend, and re-refer to the Committee on [Business, Professions and Economic Development] with the recommendation: To Consent Calendar",9,0,0,0,9
952802,670977,2017-07-03,Senate,"Do pass and be ordered to the Consent Calendar",6,0,3,0,9
952802,671897,2017-07-10,Senate,"Consent Calendar 2nd AB356",40,0,0,0,40
952802,672570,2017-07-10,Senate,"Consent Calendar 2nd AB356 Bigelow",40,0,0,0,40
952802,674102,2017-08-24,Assembly,"AB 356 BIGELOW Concurrence in Senate Amendments",77,0,2,0,79
952803,621520,2017-04-05,Assembly,"Do pass as amended, and be re-referred to the Committee on [Appropriations] with recommendation: To Consent Calendar",7,0,0,0,7
952803,633474,2017-04-26,Assembly,"Do pass. To Consent Calendar",16,0,1,0,17
952803,638582,2017-05-04,Assembly,"AB 365 MURATSUCHI Consent Calendar Second Day Regular Session",76,0,4,0,80
952803,660389,2017-06-07,Senate,"Do pass, but first be re-referred to the Committee on [Appropriations] with the recommendation: To Consent Calendar",7,0,0,0,7
952803,668707,2017-06-26,Senate,"Placed on suspense file",7,0,0,0,7
952803,674721,2017-09-01,Senate,"Do pass",7,0,0,0,7
952803,675527,2017-09-11,Senate,"Assembly 3rd Reading AB365 Muratsuchi By Newman",40,0,0,0,40
952804,641486,2017-05-09,Assembly,"Do pass",14,0,1,0,15
952804,644434,2017-05-15,Assembly,"AB 350 SALAS Assembly Third Reading",78,0,2,0,80
952804,661586,2017-06-12,Senate,"Do pass",9,0,0,0,9
952804,675856,2017-09-13,Senate,"Assembly 3rd Reading AB350 Salas By Stern",36,3,1,0,40
952804,676191,2017-09-14,Assembly,"AB 350 Salas Concurrence in Senate Amendments",76,0,3,0,79
952805,626061,2017-04-17,Assembly,"Do pass and be re-referred to the Committee on [Housing and Community Development]",8,3,0,0,11
952805,633307,2017-04-26,Assembly,"Do pass as amended and be re-referred to the Committee on [Appropriations]",5,2,0,0,7
952805,651939,2017-05-26,Assembly,"Do pass",12,5,0,0,17
952805,655769,2017-05-31,Assembly,"AB 354 CALDERON Assembly Third Reading",52,23,5,0,80
952805,672280,2017-07-12,Senate,"Do pass as amended, but first amend, and re-refer to the Committee on [Appropriations]",5,3,5,0,13
952805,672281,2017-07-12,Senate,"[Second] hearing set for [07-12-2017]: Failed passage in Committee. Reconsideration granted",10,0,3,0,13
952805,766304,2018-06-20,Senate,"Do pass as amended, but first amend, and re-refer to the Committee on [Appropriations]",4,2,1,0,7
952805,770393,2018-08-06,Senate,"Placed on suspense file",7,0,0,0,7
952805,771630,2018-08-16,Senate,"Do pass as amended",5,2,0,0,7
952805,773287,2018-08-29,Senate,"Assembly 3rd Reading AB354 Calderon By Galgiani",25,14,1,0,40
952805,773756,2018-08-30,Assembly,"AB 354 CALDERON Concurrence in Senate Amendments",56,23,1,0,80
952806,619898,2017-04-04,Assembly,"Do pass and be re-referred to the Committee on [Appropriations]",6,0,1,0,7
952806,633963,2017-04-26,Assembly,"Do pass",16,0,1,0,17
952806,641353,2017-05-08,Assembly,"AB 355 CHU Assembly Third Reading",72,2,6,0,80
952806,667229,2017-06-21,Senate,"Do pass, but first be re-referred to the Committee on [Appropriations]",6,0,1,0,7
952806,671997,2017-07-10,Senate,"Placed on suspense file",7,0,0,0,7
952806,674775,2017-09-01,Senate,"Do pass",7,0,0,0,7
952806,675857,2017-09-13,Senate,"Assembly 3rd Reading AB355 Chu By Wieckowski",39,0,1,0,40
952806,676273,2017-09-14,Assembly,"AB 355 Chu Concurrence in Senate Amendments",74,1,4,0,79
952807,641456,2017-05-09,Senate,"Do pass, but first be re-referred to the Committee on [Appropriations]",7,3,3,0,13
952807,647958,2017-05-22,Senate,"Placed on suspense file",7,0,0,0,7
952807,650703,2017-05-25,Senate,"Do pass as amended",5,2,0,0,7
952807,655867,2017-05-31,Senate,"Senate 3rd Reading SB268 Mendoza",22,12,6,0,40
952808,603329,2017-03-14,Assembly,"Do pass",7,0,0,0,7
952808,606943,2017-03-20,Assembly,"AB 368 MURATSUCHI Assembly Third Reading",77,0,3,0,80
952808,662439,2017-06-13,Senate,"Do pass, but first be re-referred to the Committee on [Appropriations]",7,0,0,0,7
952808,668679,2017-06-26,Senate,"Placed on suspense file",7,0,0,0,7
952808,674485,2017-09-01,Senate,"Do pass",7,0,0,0,7
952808,675408,2017-09-11,Senate,"Assembly 3rd Reading AB368 Muratsuchi et al. By Stern",40,0,0,0,40
952809,633031,2017-04-26,Senate,"Do pass as amended, but first amend, and re-refer to the Committee on [Appropriations] with the recommendation: To Consent Calendar",8,0,1,0,9
952809,647947,2017-05-22,Senate,"Consent Calendar 2nd SB272",37,0,3,0,40
952809,672464,2017-07-12,Assembly,"Do pass and be re-referred to the Committee on [Appropriations] with recommendation: To Consent Calendar",12,0,1,0,13
952809,674024,2017-08-23,Assembly,"Do pass. To Consent Calendar",15,0,2,0,17
952809,675262,2017-09-07,Assembly,"SB 272 Mendoza Senate Third Reading By COOLEY",76,0,3,0,79
952809,676223,2017-09-14,Senate,"Special Consent SB272",40,0,0,0,40
952810,620028,2017-04-05,Senate,"Do pass, but first be re-referred to the Committee on [Appropriations]",7,0,0,0,7
952810,629107,2017-04-20,Senate,"Senate 3rd Reading SB266 Dodd",40,0,0,0,40
952810,671949,2017-07-10,Assembly,"Do pass and be re-referred to the Committee on [Appropriations] with recommendation: To Consent Calendar",7,0,4,0,11
952810,674057,2017-08-23,Assembly,"Do pass. To Consent Calendar",15,0,2,0,17
952810,676304,2017-09-14,Assembly,"SB 266 Dodd Senate Third Reading By IRWIN",79,0,0,0,79
952810,676540,2017-09-15,Senate,"Unfinished Business SB266 Dodd Concurrence",38,0,2,0,40
952811,627944,2017-04-19,Assembly,"Do pass as amended and be re-referred to the Committee on [Local Government]",7,0,0,0,7
952811,637357,2017-05-03,Assembly,"Do pass",8,0,1,0,9
952811,643466,2017-05-11,Assembly,"AB 346 DALY Assembly Third Reading",75,0,5,0,80
952811,658849,2017-06-06,Senate,"Do pass and be ordered to the Consent Calendar",13,0,0,0,13
952811,661603,2017-06-12,Senate,"Consent Calendar 2nd AB346",38,0,2,0,40
952813,619728,2017-04-05,Senate,"Do pass, but first be re-referred to the Committee on [Natural Resources and Water]",5,2,0,0,7
952813,631599,2017-04-25,Senate,"Do pass as amended, but first amend, and re-refer to the Committee on [Appropriations]",7,2,0,0,9
952813,644418,2017-05-15,Senate,"Placed on suspense file",7,0,0,0,7
952815,591890,2017-02-23,Senate,"Senate 3rd Reading SR18 Cannella",40,0,0,0,40
952816,603307,2017-03-14,Senate,"Do pass, but first be re-referred to the Committee on [Appropriations]",7,2,0,0,9
952816,617494,2017-04-03,Senate,"Placed on suspense file",7,0,0,0,7
952816,650777,2017-05-25,Senate,"Do pass",5,2,0,0,7
952816,655921,2017-05-31,Senate,"Senate 3rd Reading SB269 McGuire",27,12,1,0,40
952816,768302,2018-06-26,Assembly,"Do pass and be re-referred to the Committee on [Appropriations]",14,0,1,0,15
952816,771102,2018-08-08,Assembly,"Do pass. To Consent Calendar",17,0,0,0,17
952816,771600,2018-08-16,Assembly,"SB 269 McGuire Consent Calendar Second Day Regular Session",76,0,4,0,80
952816,772474,2018-08-22,Senate,"That the Assembly amendments be concurred in",6,0,3,0,9
952816,772728,2018-08-24,Senate,"Unfinished Business SB269 McGuire Concurrence",39,0,1,0,40
952817,610001,2017-03-21,Assembly,"Do pass and be re-referred to the Committee on [Labor and Employment] with recommendation: To Consent Calendar",10,0,0,0,10
952817,629101,2017-04-19,Assembly,"Do pass and be re-referred to the Committee on [Appropriations]",5,0,2,0,7
952817,652182,2017-05-26,Assembly,"Do pass",17,0,0,0,17
952817,654322,2017-05-30,Assembly,"AB 353 VOEPEL Assembly Third Reading",74,0,6,0,80
952817,672431,2017-07-11,Senate,"Do pass, but first be re-referred to the Committee on [Appropriations]",3,2,2,0,7
952817,672432,2017-07-11,Senate,"[First] hearing set for [07-12-2017]: Failed passage in Committee. Reconsideration granted",7,0,0,0,7
952817,777401,2017-04-19,Assembly,,10,0,2,0,12
952818,631936,2017-04-25,Senate,"Do pass, but first be re-referred to the Committee on [Appropriations]",11,2,0,0,13
952818,644462,2017-05-15,Senate,"Placed on suspense file",7,0,0,0,7
952819,605368,2017-03-16,Senate,"Senate 3rd Reading SCR19 Nguyen",38,0,2,0,40
952819,611081,2017-03-23,Assembly,"Be adopted. To Consent Calendar",9,0,2,0,11
952819,615995,2017-03-30,Assembly,"SCR 19 Nguyen Consent Calendar Second Day Regular Session",74,0,6,0,80
952821,613975,2017-03-28,Assembly,"Do pass and be re-referred to the Committee on [Appropriations]",10,0,0,0,10
952822,615099,2017-03-29,Senate,"Do pass, but first be re-referred to the Committee on [Appropriations] with the recommendation: To Consent Calendar",7,0,0,0,7
952822,629020,2017-04-20,Senate,"Consent Calendar 2nd SB262",36,0,4,0,40
952822,761767,2018-06-11,Assembly,"Do pass as amended and be re-referred to the Committee on [Appropriations]",9,1,0,0,10
952823,614564,2017-03-28,Senate,"Do pass, but first be re-referred to the Committee on [Judiciary]",6,1,6,0,13
952823,614565,2017-03-28,Senate,"[First] hearing set for [03-28-2017]: Failed passage in Committee. Reconsideration granted",11,0,2,0,13
952824,609370,2017-03-21,Assembly,"Do pass",14,0,1,0,15
952824,621289,2017-04-06,Assembly,"AB 367 OBERNOLTE Assembly Third Reading",79,0,1,0,80
952824,671351,2017-07-05,Senate,"Do pass",5,1,1,0,7
952824,674416,2017-08-31,Senate,"Assembly 3rd Reading AB367 Obernolte By Fuller",36,1,3,0,40
952826,627919,2017-04-18,Senate,"Do pass, but first be re-referred to the Committee on [Appropriations] with the recommendation: To Consent Calendar",7,0,0,0,7
952826,636111,2017-05-01,Senate,"Placed on suspense file",7,0,0,0,7
952827,614752,2017-03-29,Senate,"Do pass, but first be re-referred to the Committee on [Labor and Industrial Relations]",5,2,0,0,7
952827,633530,2017-04-26,Senate,"Do pass, but first be re-referred to the Committee on [Appropriations]",4,1,0,0,5
952827,644424,2017-05-15,Senate,"Placed on suspense file",7,0,0,0,7
952827,650674,2017-05-25,Senate,"Do pass",5,2,0,0,7
952827,654443,2017-05-30,Senate,"Senate 3rd Reading SB258 Lara",22,15,3,0,40
952827,671292,2017-07-05,Assembly,"Do pass and be re-referred to the Committee on [Environmental Safety and Toxic Materials]",5,1,1,0,7
952827,672032,2017-07-11,Assembly,"Do pass as amended and be re-referred to the Committee on [Appropriations]",4,0,3,0,7
952827,674259,2017-08-30,Assembly,"Do pass",10,4,3,0,17
952827,675631,2017-09-12,Assembly,"SB 258 Lara Senate Third Reading By ARAMBULA",55,15,9,0,79
952827,675944,2017-09-13,Senate,"Unfinished Business SB258 Lara Concurrence",27,13,0,0,40
952828,619025,2017-04-04,Senate,"Do pass, but first be re-referred to the Committee on [Appropriations]",4,0,1,0,5
952828,634514,2017-04-27,Senate,"Senate 3rd Reading SB267 Pan et al. Urgency Clause",37,0,3,0,40
952828,663363,2017-06-14,Assembly,"Do pass as amended, and be re-referred to the Committee on [Local Government] with recommendation: To Consent Calendar",6,0,1,0,7
952828,672632,2017-07-12,Assembly,"Do pass and be re-referred to the Committee on [Appropriations]",9,0,0,0,9
952828,674049,2017-08-23,Assembly,"Do pass. To Consent Calendar",15,0,2,0,17
952828,674424,2017-08-31,Assembly,"SB 267 Pan Consent Calendar Second Day Regular Session",73,0,6,0,79
952828,674871,2017-09-05,Senate,"Special Consent SB267 Pan et al. Urgency Clause",40,0,0,0,40
952829,620006,2017-04-05,Assembly,"Do pass as amended and be re-referred to the Committee on [Local Government]",7,0,0,0,7
952829,637544,2017-05-03,Assembly,"Do pass",9,0,0,0,9
952829,643484,2017-05-11,Assembly,"AB 352 SANTIAGO Assembly Third Reading",76,0,4,0,80
952829,658800,2017-06-06,Senate,"Do pass, but first be re-referred to the Committee on [Governance and Finance] with the recommendation: To Consent Calendar",13,0,0,0,13
952829,672330,2017-07-12,Senate,"Do pass as amended, but first amend, and re-refer to the Committee on [Appropriations]",7,0,0,0,7
952829,674374,2017-08-31,Senate,"Special Consent Calendar # AB352",37,0,3,0,40
952829,674868,2017-09-05,Assembly,"AB 352 SANTIAGO Concurrence in Senate Amendments",77,0,2,0,79
956611,626876,2017-04-18,Senate,"Do pass",7,1,5,0,13
956611,656620,2017-06-01,Senate,"Senate 3rd Reading SB277 Bradford",22,15,3,0,40
956611,670207,2017-06-28,Assembly,"Do pass and be re-referred to the Committee on [Housing and Community Development]",5,2,2,0,9
956611,672321,2017-07-12,Assembly,"Do pass as amended",5,2,0,0,7
956612,610689,2017-03-22,Senate,"Do pass, but first be re-referred to the Committee on [Judiciary]",4,1,0,0,5
956612,620790,2017-04-04,Senate,"Do pass as amended, but first amend, and re-refer to the Committee on [Appropriations]",5,0,2,0,7
956612,630550,2017-04-24,Senate,"Placed on suspense file",7,0,0,0,7
956612,650871,2017-05-25,Senate,"Do pass",5,2,0,0,7
956612,654483,2017-05-30,Senate,"Senate 3rd Reading SB295 Monning et al",30,9,1,0,40
956612,667674,2017-06-21,Assembly,"Do pass and be re-referred to the Committee on [Judiciary]",5,2,0,0,7
956612,672175,2017-07-11,Assembly,"Do pass and be re-referred to the Committee on [Appropriations]",9,2,0,0,11
956612,674681,2017-09-01,Assembly,"Do pass as amended",11,5,1,0,17
956612,675891,2017-09-13,Assembly,"SB 295 Monning Senate Third Reading By MEDINA",55,21,3,0,79
956612,676125,2017-09-14,Senate,"Unfinished Business SB295 Monning et al. Concurrence",30,10,0,0,40
956613,618477,2017-04-04,Senate,"Do pass, but first be re-referred to the Committee on [Appropriations]",4,0,1,0,5
956613,629092,2017-04-20,Senate,"Senate 3rd Reading SB286 Stern",28,12,0,0,40
956613,672402,2017-07-12,Assembly,"Do pass and be re-referred to the Committee on [Appropriations]",4,2,1,0,7
956613,674053,2017-08-23,Assembly,"Do pass",10,5,2,0,17
956613,675535,2017-09-11,Assembly,"SB 286 Stern Senate Third Reading By BERMAN",54,24,1,0,79
956613,675727,2017-09-12,Senate,"Unfinished Business SB286 Stern et al. Concurrence",28,12,0,0,40
956615,603682,2017-03-14,Assembly,"Do pass. To Consent Calendar",11,0,0,0,11
956615,606903,2017-03-20,Assembly,"AB 369 WALDRON Consent Calendar Second Day Regular Session",76,0,4,0,80
956615,662284,2017-06-13,Senate,"Do pass and be ordered to the Consent Calendar",7,0,0,0,7
956615,665119,2017-06-19,Senate,"Consent Calendar 2nd AB369",33,0,7,0,40
956615,668680,2017-06-26,Assembly,"AB 369 WALDRON Concurrence in Senate Amendments",75,0,5,0,80
956616,626938,2017-04-18,Assembly,"Do pass and be re-referred to the Committee on [Appropriations]",11,0,4,0,15
956616,651933,2017-05-26,Assembly,"Do pass as amended",13,3,1,0,17
956616,655808,2017-05-31,Assembly,"AB 391 CHIU Assembly Third Reading",61,11,8,0,80
956616,671560,2017-07-05,Senate,"Do pass as amended, but first amend, and re-refer to the Committee on [Appropriations]",9,0,0,0,9
956616,673923,2017-08-21,Senate,"Placed on suspense file",7,0,0,0,7
956616,674457,2017-09-01,Senate,"Do pass",7,0,0,0,7
956616,675616,2017-09-12,Senate,"Assembly 3rd Reading AB391 Chiu et al. By Hernandez",38,1,1,0,40
956616,675924,2017-09-13,Assembly,"AB 391 Chiu Concurrence in Senate Amendments",74,2,3,0,79
956617,619888,2017-04-05,Assembly,"Do pass and be re-referred to the Committee on [Transportation]",6,0,1,0,7
956617,683964,2018-01-04,Assembly,"Be re-referred to the Committee on [Jobs, Economic Development, and the Economy]",9,0,2,0,11
956617,684748,2018-01-09,Assembly,"Do pass as amended and be re-referred to the Committee on [Appropriations]",6,0,0,0,6
956617,686180,2018-01-18,Assembly,"Do pass",17,0,0,0,17
956617,690062,2018-01-29,Assembly,"AB 427 MURATSUCHI Assembly Third Reading",75,0,2,0,77
956617,750036,2018-05-07,Senate,"Do pass as amended, but first amend, and re-refer to the Committee on [Judiciary]",8,0,1,0,9
956617,770253,2018-08-06,Senate,"Placed on suspense file",7,0,0,0,7
956617,771525,2018-08-16,Senate,"Do pass as amended",7,0,0,0,7
956617,772345,2018-08-21,Senate,"Assembly 3rd Reading AB427 Muratsuchi et al. By Allen",39,0,1,0,40
956617,772963,2018-08-27,Assembly,"AB 427 MURATSUCHI Concurrence in Senate Amendments",79,0,1,0,80
956618,621153,2017-04-05,Assembly,"Do pass and be re-referred to the Committee on [Appropriations]",7,0,0,0,7
956618,633394,2017-04-26,Assembly,"Do pass",16,0,1,0,17
956618,640594,2017-05-08,Assembly,"AB 385 CHU Assembly Third Reading",75,0,5,0,80
956618,663096,2017-06-14,Senate,"Do pass as amended, but first amend, and re-refer to the Committee on [Appropriations]",7,0,0,0,7
956618,671841,2017-07-10,Senate,"Placed on suspense file",7,0,0,0,7
956619,605370,2017-03-15,Assembly,"Do pass and be re-referred to the Committee on [Appropriations]",7,0,0,0,7
956620,614653,2017-03-28,Assembly,"Do pass as amended and be re-referred to the Committee on [Appropriations]",12,0,1,0,13
956620,633852,2017-04-26,Assembly,"Do pass. To Consent Calendar",16,0,1,0,17
956620,638636,2017-05-04,Assembly,"AB 394 MEDINA Consent Calendar Second Day Regular Session",76,0,4,0,80
956620,659927,2017-06-07,Senate,"Do pass, but first be re-referred to the Committee on [Appropriations]",7,0,0,0,7
956620,676206,2017-09-14,Senate,"Assembly 3rd Reading AB394 Mathis et al. By Vidak Urgency Clause",40,0,0,0,40
956620,676573,2017-09-15,Assembly,"AB 394 Mathis Concurrence - Urgency Added",77,0,2,0,79
956621,613868,2017-03-28,Senate,"Do pass, but first be re-referred to the Committee on [Appropriations]",2,4,1,0,7
956623,632156,2017-04-25,Assembly,"Do pass as amended, and be re-referred to the Committee on [Appropriations] with recommendation: To Consent Calendar",15,0,0,0,15
956623,637509,2017-05-03,Assembly,"Do pass. To Consent Calendar",16,0,1,0,17
956623,643383,2017-05-11,Assembly,"AB 417 WOOD Consent Calendar Second Day Regular Session",77,0,3,0,80
956623,672572,2017-07-12,Senate,"Do pass, but first be re-referred to the Committee on [Appropriations] with the recommendation: To Consent Calendar",8,0,1,0,9
956623,722858,2018-03-14,Senate,"Do pass, but first be re-referred to the Committee on [Appropriations]",9,0,0,0,9
956623,724824,2018-03-19,Senate,"Assembly 3rd Reading AB417 Limón et al. By Jackson Urgency Clause",38,0,1,0,39
956623,725627,2018-03-20,Assembly,"With recommendation: That Senate amendments be concurred in",15,0,0,0,15
956623,727685,2018-03-22,Assembly,"AB 417 LIMÓN Concurrence - Urgency Added",69,0,8,0,77
956624,612885,2017-03-27,Assembly,"Do pass and be re-referred to the Committee on [Appropriations] with recommendation: To Consent Calendar",14,0,0,0,14
956624,652070,2017-05-26,Assembly,"Do pass as amended",16,0,1,0,17
956624,655827,2017-05-31,Assembly,"AB 382 VOEPEL Assembly Third Reading",75,2,3,0,80
956624,768284,2018-06-26,Senate,"[First] hearing set for [06-26-2018]: Failed passage in Committee. Reconsideration granted",3,7,3,0,13
956624,769811,2018-06-26,Senate,"Do pass, but first be re-referred to the Committee on [Rules]",3,7,3,0,13
956624,769812,2018-06-26,Senate,"[First] hearing set for [07-06-2018]: Failed passage in Committee. Reconsideration granted",12,0,1,0,13
956625,608194,2017-03-21,Assembly,"Do pass and be re-referred to the Committee on [Appropriations]",5,2,0,0,7
956626,603284,2017-03-14,Assembly,"Do pass as amended",11,0,0,0,11
956626,611070,2017-03-23,Assembly,"AB 383 CHAU Assembly Third Reading",76,0,4,0,80
956626,666309,2017-06-20,Senate,"Do pass as amended, and be ordered to the Consent Calendar",7,0,0,0,7
956626,672689,2017-07-17,Senate,"Assembly 3rd Reading AB383 Chau By Jackson",40,0,0,0,40
956626,673741,2017-08-21,Assembly,"AB 383 CHAU Concurrence in Senate Amendments",78,0,1,0,79
956631,603311,2017-03-14,Assembly,"Do pass as amended and be re-referred to the Committee on [Appropriations]",8,1,2,0,11
956631,619690,2017-04-05,Assembly,"Do pass as amended",12,2,3,0,17
956631,640633,2017-05-08,Assembly,"AB 386 GONZALEZ FLETCHER Assembly Third Reading",69,0,11,0,80
956631,662388,2017-06-13,Senate,"Do pass, but first be re-referred to the Committee on [Judiciary]",4,0,1,0,5
956631,672371,2017-07-11,Senate,"Do pass, but first be re-referred to the Committee on [Appropriations]",7,0,0,0,7
956631,673823,2017-08-21,Senate,"Placed on suspense file",7,0,0,0,7
956631,674735,2017-09-01,Senate,"Do pass",5,0,2,0,7
956631,768920,2018-06-27,Senate,"Do pass as amended, but first amend, and re-refer to the Committee on [Appropriations]",7,0,0,0,7
956631,770548,2018-08-06,Senate,"Placed on suspense file",7,0,0,0,7
956636,631559,2017-04-25,Senate,"Do pass as amended, but first amend, and re-refer to the Committee on [Appropriations]",4,0,1,0,5
956636,644327,2017-05-15,Senate,"Placed on suspense file",7,0,0,0,7
956636,650869,2017-05-25,Senate,"Do pass as amended",7,0,0,0,7
956636,656053,2017-05-31,Senate,"Senate 3rd Reading SB278 Wiener",39,0,1,0,40
956636,672324,2017-07-11,Assembly,"Do pass as amended and be re-referred to the Committee on [Appropriations]",7,0,0,0,7
956636,674050,2017-08-23,Assembly,"Do pass. To Consent Calendar",15,0,2,0,17
956636,674951,2017-09-05,Assembly,"SB 278 Wiener Senate Third Reading By STONE",75,1,3,0,79
956636,675189,2017-09-07,Senate,"Special Consent Calendar # SB278",40,0,0,0,40
956638,634658,2017-04-26,Senate,"Do pass as amended, but first amend, and re-refer to the Committee on [Appropriations] with the recommendation: To Consent Calendar",9,0,0,0,9
956638,647912,2017-05-22,Senate,"Consent Calendar 2nd SB288",37,0,3,0,40
956638,672195,2017-07-11,Assembly,"Do pass and be re-referred to the Committee on [Appropriations] with recommendation: To Consent Calendar",15,0,0,0,15
956638,672862,2017-07-19,Assembly,"Do pass. To Consent Calendar",16,0,1,0,17
956640,636473,2017-05-02,Assembly,"Do pass. To Consent Calendar",10,0,0,0,10
956640,643592,2017-05-11,Assembly,"AB 375 CHAU Consent Calendar Second Day Regular Session",77,0,3,0,80
956640,672822,2017-07-18,Senate,"Do pass, but first be re-referred to the Committee on [Judiciary]",9,1,1,0,11
956640,672845,2017-07-18,Senate,"Do pass, but first be re-referred to the Committee on [Rules]",5,2,0,0,7
956640,768151,2018-06-26,Senate,"Pursuant to Senate Rule 29.10, that the measure be re-referred to the Committee on Appropriations pursuant to Joint Rule 10.5",5,0,2,0,7
956640,769249,2018-06-28,Senate,"That the measure be returned to Senate Floor for consideration. Ordered to third reading",6,1,0,0,7
956640,769250,2018-06-28,Senate,"Assembly 3rd Reading AB375 Chau et al. By Hertzberg",36,0,3,0,39
956640,769251,2018-06-28,Assembly,"AB 375 CHAU Concurrence in Senate Amendments",73,0,7,0,80
956641,633317,2017-04-25,Assembly,"Do pass and be re-referred to the Committee on [Judiciary] with recommendation: To Consent Calendar",7,0,0,0,7
956641,634441,2017-04-27,Assembly,"Do pass and be re-referred to the Committee on [Appropriations] with recommendation: To Consent Calendar",11,0,0,0,11
956641,649341,2017-05-24,Assembly,"Do pass. To Consent Calendar",17,0,0,0,17
956641,653983,2017-05-30,Assembly,"AB 404 STONE Consent Calendar Second Day Regular Session",77,0,3,0,80
956641,668973,2017-06-27,Senate,"Do pass as amended, but first amend, and re-refer to the Committee on [Judiciary]",5,0,0,0,5
956641,672297,2017-07-11,Senate,"Do pass as amended, but first amend, and re-refer to the Committee on [Appropriations] with the recommendation: To Consent Calendar",7,0,0,0,7
956641,673805,2017-08-21,Senate,"Placed on suspense file",7,0,0,0,7
956641,674580,2017-09-01,Senate,"Do pass as amended",7,0,0,0,7
956641,675938,2017-09-13,Senate,"Assembly 3rd Reading AB404 Mark Stone By Wiener",40,0,0,0,40
956641,676529,2017-09-15,Assembly,"AB 404 STONE Concurrence in Senate Amendments",77,0,2,0,79
956642,605395,2017-03-15,Assembly,"Do pass and be re-referred to the Committee on [Appropriations]",6,1,0,0,7
956642,652179,2017-05-26,Assembly,"Do pass",12,5,0,0,17
956642,655806,2017-05-31,Assembly,"AB 410 CERVANTES Assembly Third Reading",64,13,3,0,80
956642,669634,2017-06-28,Senate,"Do pass, but first be re-referred to the Committee on [Appropriations]",7,0,0,0,7
956642,671958,2017-07-10,Senate,"Placed on suspense file",7,0,0,0,7
956643,633522,2017-04-25,Assembly,"Do pass and be re-referred to the Committee on [Appropriations] with recommendation: To Consent Calendar",7,0,0,0,7
956643,649444,2017-05-24,Assembly,"Do pass. To Consent Calendar",17,0,0,0,17
956643,654494,2017-05-30,Assembly,"AB 415 CHIU Consent Calendar Second Day Regular Session",77,0,3,0,80
956643,668947,2017-06-27,Senate,"Do pass as amended, but first amend, and re-refer to the Committee on [Appropriations] with the recommendation: To Consent Calendar",5,0,0,0,5
956643,672995,2017-07-20,Senate,"Consent Calendar 2nd AB415",38,0,2,0,40
956643,675039,2017-09-06,Senate,"Assembly 3rd Reading AB415 Chiu et al. By Leyva",40,0,0,0,40
956643,675462,2017-09-11,Assembly,"AB 415 CHIU Concurrence in Senate Amendments",78,0,1,0,79
956644,604347,2017-03-15,Assembly,"Do pass and be re-referred to the Committee on [Appropriations]",6,1,0,0,7
956644,620091,2017-04-05,Assembly,"Do pass",12,5,0,0,17
956644,654070,2017-05-30,Assembly,"AB 402 THURMOND Assembly Third Reading",55,21,4,0,80
956644,669579,2017-06-28,Senate,"Do pass, but first be re-referred to the Committee on [Appropriations]",3,1,1,0,5
956644,671847,2017-07-10,Senate,"Placed on suspense file",7,0,0,0,7
956644,674453,2017-09-01,Senate,"Do pass",5,2,0,0,7
956644,675393,2017-09-11,Senate,"Assembly 3rd Reading AB402 Thurmond By Hernandez",28,12,0,0,40
956645,603534,2017-03-14,Assembly,"Do pass and be re-referred to the Committee on [Rules] with recommendation: To Consent Calendar",11,0,0,0,11
956645,630387,2017-04-24,Assembly,"Do pass and be re-referred to the Committee on [Appropriations]",11,0,0,0,11
956645,637557,2017-05-03,Assembly,"Do pass. To Consent Calendar",16,0,1,0,17
956645,643661,2017-05-11,Assembly,"AB 403 MELENDEZ Consent Calendar Second Day Regular Session",77,0,3,0,80
956645,662396,2017-06-13,Senate,"Do pass, but first be re-referred to the Committee on [Appropriations] with the recommendation: To Consent Calendar",7,0,0,0,7
956645,668629,2017-06-26,Senate,"Placed on suspense file",7,0,0,0,7
956645,692725,2018-02-01,Senate,"Assembly 3rd Reading AB403 Melendez et al. By Bates Urgency Clause",38,0,2,0,40
956645,694747,2018-02-05,Assembly,"AB 403 MELENDEZ Concurrence - Urgency Added",75,0,2,0,77
956647,616009,2017-03-29,Assembly,"Do pass and be re-referred to the Committee on [Appropriations]",5,2,0,0,7
956647,651818,2017-05-26,Assembly,"Do pass as amended",10,7,0,0,17
956648,627797,2017-04-19,Assembly,"Do pass",19,0,2,0,21
956648,634647,2017-04-27,Assembly,"AB 400 COOPER Assembly Third Reading",75,0,5,0,80
956648,662432,2017-06-13,Senate,"Do pass, but first be re-referred to the Committee on [Public Safety]",12,0,1,0,13
956648,669195,2017-06-27,Senate,"Do pass and be ordered to the Consent Calendar",7,0,0,0,7
956648,673888,2017-08-21,Senate,"Assembly 3rd Reading AB400 Cooper By Pan Urgency Clause",39,0,1,0,40
956648,674062,2017-08-24,Assembly,"AB 400 COOPER Concurrence - Urgency Added",78,0,1,0,79
956649,608383,2017-03-21,Assembly,"Do pass and be re-referred to the Committee on [Appropriations]",11,0,0,0,11
956649,620005,2017-04-05,Assembly,"Do pass. To Consent Calendar",17,0,0,0,17
956649,628997,2017-04-20,Assembly,"AB 414 MEDINA Consent Calendar Second Day Regular Session",74,0,6,0,80
956653,631838,2017-04-25,Assembly,"Do pass and be re-referred to the Committee on [Appropriations]",15,0,1,0,16
956653,637621,2017-05-03,Assembly,"Do pass. To Consent Calendar",16,0,1,0,17
956653,643353,2017-05-11,Assembly,"AB 389 SALAS Consent Calendar Second Day Regular Session",77,0,3,0,80
956653,661626,2017-06-12,Senate,"Do pass, but first be re-referred to the Committee on [Appropriations]",9,0,0,0,9
956653,673906,2017-08-21,Senate,"Placed on suspense file",7,0,0,0,7
956653,774586,2017-04-25,Assembly,?,0,0,1,0,1
956654,619787,2017-04-05,Assembly,"Do pass",4,3,0,0,7
956654,643549,2017-05-11,Assembly,"AB 423 BONTA Assembly Third Reading",22,34,24,0,80
956655,615171,2017-03-29,Senate,"Do pass as amended, but first amend, and re-refer to the Committee on [Appropriations]",7,0,0,0,7
956655,626269,2017-04-17,Senate,"Placed on suspense file",7,0,0,0,7
956655,650521,2017-05-25,Senate,"Do pass",7,0,0,0,7
956655,655966,2017-05-31,Senate,"Special Consent Calendar # SB289",40,0,0,0,40
956655,669379,2017-06-26,Assembly,"Do pass and be re-referred to the Committee on [Appropriations]",9,0,1,0,10
956655,674648,2017-09-01,Assembly,"Do pass",15,0,2,0,17
956655,675694,2017-09-12,Assembly,"SB 289 McGuire Senate Third Reading By GONZALEZ FLETCHER",77,0,2,0,79
956656,619668,2017-04-04,Assembly,"Do pass and be re-referred to the Committee on [Judiciary]",4,2,1,0,7
956657,615183,2017-03-29,Senate,"Do pass as amended, but first amend, and re-refer to the Committee on [Public Safety]",6,0,1,0,7
956657,633707,2017-04-25,Senate,"Do pass, but first be re-referred to the Committee on [Appropriations] with the recommendation: To Consent Calendar",7,0,0,0,7
956657,644575,2017-05-15,Senate,"Placed on suspense file",7,0,0,0,7
956657,650656,2017-05-25,Senate,"Do pass",7,0,0,0,7
956657,655863,2017-05-31,Senate,"Special Consent Calendar # SB292",40,0,0,0,40
956657,670391,2017-06-28,Assembly,"Do pass and be re-referred to the Committee on [Appropriations] with recommendation: To Consent Calendar",9,0,0,0,9
956658,642730,2017-05-10,Assembly,"Do pass",9,0,0,0,9
956658,651429,2017-05-26,Assembly,"AB 428 RIDLEY-THOMAS Assembly Third Reading",76,0,4,0,80
956658,670053,2017-06-28,Senate,"Do pass",7,0,0,0,7
956658,672713,2017-07-17,Senate,"Special Consent Calendar # AB428",38,0,2,0,40
956659,613796,2017-03-28,Senate,"Do pass, but first be re-referred to the Committee on [Appropriations]",4,0,1,0,5
956659,644292,2017-05-15,Senate,"Placed on suspense file",7,0,0,0,7
956660,613532,2017-03-28,Assembly,"Do pass and be re-referred to the Committee on [Appropriations]",14,0,1,0,15
956660,633237,2017-04-26,Assembly,"Do pass. To Consent Calendar",16,0,1,0,17
956660,638652,2017-05-04,Assembly,"AB 395 BOCANEGRA Consent Calendar Second Day Regular Session",76,0,4,0,80
956660,660167,2017-06-07,Senate,"Do pass as amended, but first amend, and re-refer to the Committee on [Appropriations]",9,0,0,0,9
956660,668540,2017-06-26,Senate,"Do pass",6,0,1,0,7
956660,673890,2017-08-21,Senate,"Assembly 3rd Reading AB395 Bocanegra By Beall",37,1,2,0,40
956660,674087,2017-08-24,Assembly,"AB 395 BOCANEGRA Concurrence in Senate Amendments",78,0,1,0,79
956661,603198,2017-03-14,Assembly,"Do pass",7,0,0,0,7
956661,634588,2017-04-27,Assembly,"AB 411 BLOOM Assembly Third Reading",74,0,6,0,80
956661,669199,2017-06-27,Senate,"Do pass as amended",7,0,0,0,7
956661,675519,2017-09-11,Senate,"Assembly 3rd Reading AB411 Bloom et al. By Mitchell",39,0,1,0,40
956661,675885,2017-09-13,Assembly,"AB 411 BLOOM Concurrence in Senate Amendments",79,0,0,0,79
956663,603169,2017-03-14,Assembly,"Do pass and be re-referred to the Committee on [Appropriations]",7,0,0,0,7
956663,651936,2017-05-26,Assembly,"Do pass",17,0,0,0,17
956663,654230,2017-05-30,Assembly,"AB 371 COOLEY Assembly Third Reading",77,0,3,0,80
956663,666334,2017-06-20,Senate,"Do pass, but first be re-referred to the Committee on [Appropriations]",7,0,0,0,7
956663,672733,2017-07-17,Senate,"Placed on suspense file",7,0,0,0,7
956664,626858,2017-04-18,Assembly,"Do pass and be re-referred to the Committee on [Appropriations]",15,0,1,0,16
956664,637491,2017-05-03,Assembly,"Do pass. To Consent Calendar",16,0,1,0,17
956664,643533,2017-05-11,Assembly,"AB 420 WOOD Consent Calendar Second Day Regular Session",77,0,3,0,80
956664,672306,2017-07-12,Senate,"Do pass as amended, but first amend, and re-refer to the Committee on [Appropriations]",6,1,0,0,7
956664,673755,2017-08-21,Senate,"Placed on suspense file",7,0,0,0,7
956664,774529,2017-04-18,Assembly,,0,0,1,0,1
956665,627431,2017-04-17,Assembly,"Do pass as amended, and be re-referred to the Committee on [Appropriations] with recommendation: To Consent Calendar",10,0,0,0,10
956665,637568,2017-05-03,Assembly,"Do pass. To Consent Calendar",16,0,1,0,17
956665,643629,2017-05-11,Assembly,"AB 384 IRWIN Consent Calendar Second Day Regular Session",77,0,3,0,80
956665,672429,2017-07-12,Senate,"Do pass, but first be re-referred to the Committee on [Appropriations]",7,0,0,0,7
956665,673955,2017-08-21,Senate,"Placed on suspense file",7,0,0,0,7
956665,674798,2017-09-01,Senate,"Do pass",7,0,0,0,7
956665,676160,2017-09-14,Senate,"Special Consent Calendar # AB384",40,0,0,0,40
956665,676384,2017-09-14,Assembly,"AB 384 Irwin Special Consent Calendar 1st Day Regular Session",79,0,0,0,79
956666,603479,2017-03-14,Assembly,"Do pass",10,0,0,0,10
956666,621411,2017-04-06,Assembly,"AB 380 DABABNEH Assembly Third Reading Amend By DABABNEH Set #1",80,0,0,0,80
956666,635964,2017-05-01,Assembly,"AB 380 DABABNEH Assembly Third Reading",74,0,6,0,80
956667,604279,2017-03-15,Assembly,"Do pass and be re-referred to the Committee on [Veterans Affairs] with recommendation: To Consent Calendar",7,0,0,0,7
956667,619847,2017-04-04,Assembly,"Do pass and be re-referred to the Committee on [Appropriations]",10,0,0,0,10
956667,633460,2017-04-26,Assembly,"Do pass. To Consent Calendar",16,0,1,0,17
956667,638542,2017-05-04,Assembly,"AB 376 CHÁVEZ Consent Calendar Second Day Regular Session",76,0,4,0,80
956667,662099,2017-06-13,Senate,"Do pass, but first be re-referred to the Committee on [Agriculture] with the recommendation: To Consent Calendar",7,0,0,0,7
956667,666262,2017-06-20,Senate,"Do pass, but first be re-referred to the Committee on [Appropriations] with the recommendation: To Consent Calendar",5,0,0,0,5
956667,672624,2017-07-13,Senate,"Consent Calendar 2nd AB376",39,0,1,0,40
956667,673784,2017-08-21,Assembly,"AB 376 CHÁVEZ Concurrence in Senate Amendments",78,0,1,0,79
956668,603230,2017-03-14,Assembly,"Do pass as amended",7,0,0,0,7
956668,615954,2017-03-30,Assembly,"AB 413 EGGMAN Assembly Third Reading",74,0,6,0,80
956668,658786,2017-06-06,Senate,"Do pass, but first be re-referred to the Committee on [Appropriations]",7,0,0,0,7
956668,672759,2017-07-17,Senate,"Assembly 3rd Reading AB413 Eggman et al. By Skinner",37,0,3,0,40
956668,673802,2017-08-21,Assembly,"AB 413 EGGMAN Concurrence in Senate Amendments",77,0,2,0,79
956670,603188,2017-03-14,Assembly,"Do pass and be re-referred to the Committee on [Appropriations]",2,5,0,0,7
956670,603189,2017-03-14,Assembly,Reconsideration,7,0,0,0,7
956671,640679,2017-05-08,Assembly,"Do pass",13,1,0,0,14
956671,643514,2017-05-11,Assembly,"AB 390 SANTIAGO Assembly Third Reading",76,1,3,0,80
956671,672078,2017-07-11,Senate,"Do pass as amended, but first amend, and re-refer to the Committee on [Appropriations]",13,0,0,0,13
956671,674188,2017-08-28,Senate,"Placed on suspense file",7,0,0,0,7
956671,674489,2017-09-01,Senate,"Do pass",7,0,0,0,7
956671,675118,2017-09-07,Senate,"Assembly 3rd Reading AB390 Santiago et al. By Beall",40,0,0,0,40
956671,675454,2017-09-11,Assembly,"AB 390 SANTIAGO Concurrence in Senate Amendments",79,0,0,0,79
956672,643423,2017-05-10,Assembly,"Do pass as amended",5,2,0,0,7
956672,656142,2017-05-31,Assembly,"AB 406 MCCARTY Assembly Third Reading",50,24,6,0,80
956672,766014,2018-06-20,Senate,"Do pass as amended",7,0,0,0,7
956672,769584,2018-07-02,Senate,"Assembly 3rd Reading AB406 McCarty By Allen",28,7,4,0,39
956672,772535,2018-08-23,Assembly,"AB 406 MCCARTY Concurrence in Senate Amendments",60,16,4,0,80
956673,627792,2017-04-18,Assembly,"Do pass and be re-referred to the Committee on [Appropriations]",13,0,0,0,13
956674,628075,2017-04-18,Assembly,"Do pass and be re-referred to the Committee on [Appropriations]",9,4,0,0,13
956675,603229,2017-03-14,Assembly,"Do pass and be re-referred to the Committee on [Appropriations]",5,2,0,0,7
956675,619989,2017-04-05,Assembly,"Do pass",11,6,0,0,17
956675,647883,2017-05-22,Assembly,"AB 424 MCCARTY Assembly Third Reading",48,28,4,0,80
956675,669029,2017-06-27,Senate,"Do pass, but first be re-referred to the Committee on [Appropriations]",5,2,0,0,7
956675,675056,2017-09-06,Senate,"Assembly 3rd Reading AB424 McCarty et al. By Skinner",25,13,2,0,40
956675,675461,2017-09-11,Assembly,"AB 424 MCCARTY Concurrence in Senate Amendments",44,27,8,0,79
956676,630297,2017-04-24,Senate,"Do pass, but first be re-referred to the Committee on [Appropriations]",3,1,1,0,5
956676,644268,2017-05-15,Senate,"Senate 3rd Reading SB285 Atkins",29,10,1,0,40
956676,667428,2017-06-21,Assembly,"Do pass and be re-referred to the Committee on [Appropriations]",5,1,1,0,7
956676,672942,2017-07-19,Assembly,"Do pass",12,4,1,0,17
956676,674151,2017-08-24,Assembly,"SB 285 Atkins Senate Third Reading By COOPER",52,19,8,0,79
956677,613992,2017-03-28,Assembly,"Do pass and be re-referred to the Committee on [Appropriations]",12,0,1,0,13
956678,609853,2017-03-20,Assembly,"Do pass as amended and be re-referred to the Committee on [Appropriations]",9,0,1,0,10
956678,620085,2017-04-05,Assembly,"Do pass",17,0,0,0,17
956678,634547,2017-04-27,Assembly,"AB 388 MULLIN Assembly Third Reading",73,0,7,0,80
956678,667316,2017-06-21,Senate,"Do pass as amended, but first amend, and re-refer to the Committee on [Natural Resources and Water]",6,0,1,0,7
956678,672072,2017-07-11,Senate,"Do pass, but first be re-referred to the Committee on [Appropriations]",9,0,0,0,9
956678,673928,2017-08-21,Senate,"Placed on suspense file",7,0,0,0,7
956679,642827,2017-05-09,Senate,"Do pass as amended, but first amend, and re-refer to the Committee on [Appropriations]",7,0,0,0,7
956679,647922,2017-05-22,Senate,"Placed on suspense file",7,0,0,0,7
956679,650878,2017-05-25,Senate,"Do pass as amended",7,0,0,0,7
956679,655763,2017-05-31,Senate,"Senate 3rd Reading SB273 Hill",40,0,0,0,40
956679,669148,2017-06-27,Assembly,"Do pass and be re-referred to the Committee on [Appropriations]",11,0,0,0,11
956679,674674,2017-09-01,Assembly,"Do pass as amended",11,0,6,0,17
956679,773137,2018-08-28,Assembly,"SB 273 Hill Senate Third Reading By GONZALEZ FLETCHER",73,0,7,0,80
956679,773503,2018-08-29,Senate,"Unfinished Business SB273 Hill et al. Concurrence",38,0,2,0,40
956680,606889,2017-03-20,Assembly,"Do pass and be re-referred to the Committee on [Appropriations]",14,0,0,0,14
956680,651907,2017-05-26,Assembly,"Do pass",17,0,0,0,17
956680,654047,2017-05-30,Assembly,"AB 381 CALDERON Assembly Third Reading",76,0,4,0,80
956680,666199,2017-06-20,Senate,"Do pass, but first be re-referred to the Committee on [Appropriations]",10,1,2,0,13
956680,671890,2017-07-10,Senate,"Placed on suspense file",7,0,0,0,7
956680,674486,2017-09-01,Senate,"Do pass as amended",7,0,0,0,7
956680,676143,2017-09-14,Senate,"Assembly 3rd Reading AB381 Calderon et al. By McGuire",30,4,6,0,40
956680,676514,2017-09-15,Assembly,"AB 381 Calderon Concurrence in Senate Amendments",76,0,3,0,79
956682,618234,2017-04-04,Assembly,"Do pass and be re-referred to the Committee on [Appropriations]",15,0,1,0,16
956682,651916,2017-05-26,Assembly,"Do pass",17,0,0,0,17
956682,656215,2017-05-31,Assembly,"AB 401 AGUIAR-CURRY Assembly Third Reading",76,0,4,0,80
956682,671885,2017-07-10,Senate,"Do pass, but first be re-referred to the Committee on [Appropriations]",9,0,0,0,9
956682,673789,2017-08-21,Senate,"Placed on suspense file",7,0,0,0,7
956682,674620,2017-09-01,Senate,"Do pass as amended",7,0,0,0,7
956682,675688,2017-09-12,Senate,"Assembly 3rd Reading AB401 Aguiar-Curry By Pan",40,0,0,0,40
956682,675821,2017-09-13,Assembly,"AB 401 Aguiar-Curry Concurrence in Senate Amendments",76,0,3,0,79
956683,612710,2017-03-27,Senate,"Do pass, but first be re-referred to the Committee on [Appropriations]",5,0,0,0,5
956683,635889,2017-05-01,Senate,"Placed on suspense file",7,0,0,0,7
956684,633223,2017-04-25,Assembly,"Do pass as amended and be re-referred to the Committee on [Appropriations]",7,0,0,0,7
956684,651751,2017-05-26,Assembly,"Do pass",17,0,0,0,17
956684,654577,2017-05-30,Assembly,"AB 377 FRAZIER Assembly Third Reading",77,0,3,0,80
956684,667293,2017-06-21,Senate,"Do pass as amended, but first amend, and re-refer to the Committee on [Human Services]",5,0,2,0,7
956684,672283,2017-07-11,Senate,"Do pass as amended, but first amend, and re-refer to the Committee on [Appropriations]",7,0,0,0,7
956684,673876,2017-08-21,Senate,"Placed on suspense file",7,0,0,0,7
956684,674563,2017-09-01,Senate,"Do pass",7,0,0,0,7
956684,676186,2017-09-14,Senate,"Special Consent Calendar # AB377",40,0,0,0,40
956684,676187,2017-09-14,Assembly,"AB 377 Frazier Special Consent Calendar 1st Day Regular Session",79,0,0,0,79
956685,608794,2017-03-21,Senate,"Do pass, but first be re-referred to the Committee on [Environmental Quality]",4,0,1,0,5
956685,628179,2017-04-19,Senate,"Do pass as amended, but first amend, and re-refer to the Committee on [Appropriations]",7,0,0,0,7
956685,644602,2017-05-15,Senate,"Placed on suspense file",7,0,0,0,7
956686,618715,2017-04-03,Assembly,"Do pass as amended and be re-referred to the Committee on [Appropriations]",10,0,0,0,10
956686,651670,2017-05-26,Assembly,"Do pass as amended",16,0,1,0,17
956686,656867,2017-06-01,Assembly,"AB 398 GARCIA, E. Assembly Third Reading",75,0,5,0,80
956686,672553,2017-07-13,Senate,"Do pass, but first be re-referred to the Committee on [Appropriations]",5,2,0,0,7
956686,672750,2017-07-17,Senate,"Do pass",5,2,0,0,7
956686,672751,2017-07-17,Senate,"Assembly 3rd Reading AB398 Eduardo Garcia By De León Urgency Clause",28,12,0,0,40
956686,672752,2017-07-17,Assembly,"AB 398 GARCIA, E. Concurrence - Urgency Added",55,22,2,0,79
956687,632066,2017-04-25,Senate,"Do pass as amended, but first amend, and re-refer to the Committee on [Appropriations]",7,2,0,0,9
956687,644452,2017-05-15,Senate,"Placed on suspense file",7,0,0,0,7
956687,650786,2017-05-25,Senate,"Do pass",6,1,0,0,7
956687,654557,2017-05-30,Senate,"Senate 3rd Reading SB290 Jackson et al",31,9,0,0,40
956687,668991,2017-06-27,Assembly,"Do pass and be re-referred to the Committee on [Appropriations]",10,4,1,0,15
956687,674645,2017-09-01,Assembly,"Do pass",11,5,1,0,17
956687,675228,2017-09-07,Assembly,"SB 290 Jackson Senate Third Reading By GLORIA",60,15,4,0,79
956688,613837,2017-03-28,Senate,"Do pass, but first be re-referred to the Committee on [Governance and Finance] with the recommendation: To Consent Calendar",12,0,1,0,13
956688,642434,2017-05-10,Senate,"Do pass, but first be re-referred to the Committee on [Appropriations] with the recommendation: To Consent Calendar",6,0,1,0,7
956688,651487,2017-05-26,Senate,"Consent Calendar 2nd SB275",37,0,3,0,40
956688,744815,2018-04-26,Assembly,"Be re-referred to the Committee on [Health]",8,0,3,0,11
956688,768213,2018-06-26,Assembly,"Do pass as amended and be re-referred to the Committee on [Appropriations]",15,0,0,0,15
956688,771595,2018-08-16,Assembly,"Do pass as amended",12,0,5,0,17
956688,773530,2018-08-29,Assembly,"SB 275 Portantino Senate Third Reading By WOOD",80,0,0,0,80
956688,773855,2018-08-30,Senate,"That the Assembly amendments be concurred in",9,0,0,0,9
956688,773992,2018-08-31,Senate,"Unfinished Business SB275 Portantino et al. Concurrence",39,0,1,0,40
956689,632006,2017-04-24,Assembly,"Do pass and be re-referred to the Committee on [Appropriations]",7,3,0,0,10
956689,651634,2017-05-26,Assembly,"Do pass as amended",11,6,0,0,17
956689,656846,2017-06-01,Assembly,"AB 378 GARCIA, C. Assembly Third Reading",35,39,6,0,80
956690,626985,2017-04-18,Assembly,"Do pass. To Consent Calendar",7,0,0,0,7
956690,644305,2017-05-15,Assembly,"AB 372 STONE Assembly Third Reading",78,0,2,0,80
956690,765149,2018-06-19,Senate,"Do pass, but first be re-referred to the Committee on [Appropriations]",7,0,0,0,7
956690,772335,2018-08-21,Senate,"Assembly 3rd Reading AB372 Mark Stone By Dodd",39,0,1,0,40
956690,772788,2018-08-27,Assembly,"AB 372 STONE Concurrence in Senate Amendments",80,0,0,0,80
956691,614733,2017-03-28,Senate,"Do pass, but first be re-referred to the Committee on [Appropriations]",7,1,1,0,9
956691,630800,2017-04-24,Senate,"Placed on suspense file",7,0,0,0,7
956692,626890,2017-04-17,Assembly,"Do pass as amended and be re-referred to the Committee on [Appropriations]",10,0,0,0,10
956692,637931,2017-05-03,Assembly,"Do pass. To Consent Calendar",16,0,1,0,17
956692,643669,2017-05-11,Assembly,"AB 419 SALAS Consent Calendar Second Day Regular Session",77,0,3,0,80
956693,615501,2017-03-29,Assembly,"Do pass. To Consent Calendar",12,0,1,0,13
956693,621485,2017-04-06,Assembly,"AB 407 BIGELOW Consent Calendar Second Day Regular Session",77,0,3,0,80
956693,669753,2017-06-28,Senate,"Do pass",9,0,4,0,13
956693,672699,2017-07-17,Senate,"Special Consent Calendar # AB407",38,0,2,0,40
956693,674138,2017-08-24,Assembly,"AB 407 BIGELOW Concurrence in Senate Amendments",78,0,1,0,79
956694,620161,2017-04-05,Senate,"Do pass, but first be re-referred to the Committee on [Appropriations]",9,0,0,0,9
956694,630522,2017-04-24,Senate,"Placed on suspense file",7,0,0,0,7
956694,650421,2017-05-25,Senate,"Do pass as amended",6,0,1,0,7
956694,656157,2017-05-31,Senate,"Senate 3rd Reading SB294 Hernandez et al",37,0,3,0,40
956694,666325,2017-06-20,Assembly,"Do pass and be re-referred to the Committee on [Appropriations]",15,0,0,0,15
956694,669745,2017-06-28,Assembly,"Do pass. To Consent Calendar",14,0,3,0,17
956694,671533,2017-07-06,Assembly,"SB 294 Hernandez Consent Calendar Second Day Regular Session",74,0,6,0,80
956694,675493,2017-09-11,Assembly,"SB 294 Hernandez Senate Third Reading By WALDRON",78,0,1,0,79
956694,675928,2017-09-13,Senate,"Unfinished Business SB294 Hernandez et al. Concurrence",40,0,0,0,40
956695,614105,2017-03-28,Senate,"Do pass, but first be re-referred to the Committee on [Appropriations]",4,0,1,0,5
956695,626125,2017-04-17,Senate,"Placed on suspense file",7,0,0,0,7
956695,650838,2017-05-25,Senate,"Do pass as amended",7,0,0,0,7
956695,655979,2017-05-31,Senate,"Senate 3rd Reading SB282 Wiener",39,0,1,0,40
956695,669264,2017-06-27,Assembly,"Do pass and be re-referred to the Committee on [Appropriations] with recommendation: To Consent Calendar",7,0,0,0,7
956695,674040,2017-08-23,Assembly,"Do pass. To Consent Calendar",15,0,2,0,17
956695,675498,2017-09-11,Assembly,"SB 282 Wiener Senate Third Reading By ARAMBULA",77,0,2,0,79
956695,676060,2017-09-14,Senate,"Special Consent Calendar SB282",40,0,0,0,40
956696,603176,2017-03-14,Assembly,"Do pass and be re-referred to the Committee on [Appropriations]",12,1,0,0,13
956696,651620,2017-05-26,Assembly,"Do pass",17,0,0,0,17
956696,654241,2017-05-30,Assembly,"AB 422 ARAMBULA Assembly Third Reading",76,1,3,0,80
956696,669838,2017-06-28,Senate,"Do pass, but first be re-referred to the Committee on [Appropriations]",7,0,0,0,7
956696,671938,2017-07-10,Senate,"Placed on suspense file",7,0,0,0,7
956696,674647,2017-09-01,Senate,"Do pass",7,0,0,0,7
956696,675179,2017-09-07,Senate,"Assembly 3rd Reading AB422 Arambula et al. By Newman",39,1,0,0,40
956697,627584,2017-04-17,Assembly,"Do pass and be re-referred to the Committee on [Appropriations]",10,0,0,0,10
956697,652127,2017-05-26,Assembly,"Do pass",17,0,0,0,17
956697,654089,2017-05-30,Assembly,"AB 425 CABALLERO Assembly Third Reading",75,1,4,0,80
956697,669297,2017-06-27,Senate,"Do pass, but first be re-referred to the Committee on [Appropriations]",7,0,2,0,9
956697,672003,2017-07-10,Senate,"Placed on suspense file",7,0,0,0,7
956697,674783,2017-09-01,Senate,"Do pass",7,0,0,0,7
956698,603345,2017-03-14,Senate,"Do pass, but first be re-referred to the Committee on [Appropriations] with the recommendation: To Consent Calendar",11,0,2,0,13
956698,617645,2017-04-03,Senate,"Do pass",7,0,0,0,7
956698,630538,2017-04-24,Senate,"Senate 3rd Reading SB274 Glazer et al",36,0,4,0,40
956698,763650,2018-06-14,Assembly,"Be re-referred to the Committee on [Revenue and Taxation]",7,0,4,0,11
956698,768389,2018-06-25,Assembly,"Do pass as amended and be re-referred to the Committee on [Appropriations]",9,0,1,0,10
956698,771829,2018-08-16,Assembly,"Do pass",17,0,0,0,17
956698,772825,2018-08-27,Assembly,"SB 274 Glazer Third Reading Urgency By BURKE",80,0,0,0,80
956698,773772,2018-08-30,Senate,"That the Assembly amendments be concurred in",7,0,0,0,7
956698,774023,2018-08-31,Senate,"Unfinished Business SB274 Glazer et al. Urgency Clause Concurrence",39,0,1,0,40
959333,626794,2017-04-18,Assembly,"Do pass and be re-referred to the Committee on [Judiciary] with recommendation: To Consent Calendar",10,0,0,0,10
959333,631899,2017-04-25,Assembly,"Do pass as amended, and be re-referred to the Committee on [Appropriations] with recommendation: To Consent Calendar",11,0,0,0,11
959333,642717,2017-05-10,Assembly,"Do pass. To Consent Calendar",17,0,0,0,17
959333,646566,2017-05-18,Assembly,"AB 459 CHAU Consent Calendar Second Day Regular Session",69,0,11,0,80
959333,669661,2017-06-27,Senate,"Do pass, but first be re-referred to the Committee on [Public Safety] with the recommendation: To Consent Calendar",6,0,1,0,7
959333,672094,2017-07-11,Senate,"Do pass, but first be re-referred to the Committee on [Appropriations] with the recommendation: To Consent Calendar",7,0,0,0,7
959333,674954,2017-09-05,Senate,"Assembly 3rd Reading AB459 Chau By Wieckowski",40,0,0,0,40
959333,675212,2017-09-07,Assembly,"AB 459 CHAU Concurrence in Senate Amendments",79,0,0,0,79
959336,609037,2017-03-21,Assembly,"Do pass and be re-referred to the Committee on [Appropriations]",13,0,2,0,15
959344,618550,2017-04-04,Assembly,"Do pass and be re-referred to the Committee on [Appropriations]",14,1,0,0,15
959344,651629,2017-05-26,Assembly,"Do pass",14,3,0,0,17
959344,656126,2017-05-31,Assembly,"AB 470 ARAMBULA Assembly Third Reading",72,5,3,0,80
959344,667236,2017-06-21,Senate,"Do pass, but first be re-referred to the Committee on [Appropriations]",9,0,0,0,9
959344,673756,2017-08-21,Senate,"Placed on suspense file",7,0,0,0,7
959344,674550,2017-09-01,Senate,"Do pass as amended",6,0,1,0,7
959344,675178,2017-09-07,Senate,"Assembly 3rd Reading AB470 Arambula By Pan",39,0,1,0,40
959344,675470,2017-09-11,Assembly,"AB 470 ARAMBULA Concurrence in Senate Amendments",77,0,2,0,79
959346,634301,2017-04-25,Assembly,"Do pass as amended and be re-referred to the Committee on [Appropriations]",6,1,0,0,7
959346,651987,2017-05-26,Assembly,"Do pass",13,4,0,0,17
959346,655829,2017-05-31,Assembly,"AB 480 GONZALEZ FLETCHER Assembly Third Reading",71,1,8,0,80
959346,669230,2017-06-27,Senate,"Do pass, but first be re-referred to the Committee on [Appropriations]",5,0,0,0,5
959346,671843,2017-07-10,Senate,"Placed on suspense file",7,0,0,0,7
959346,674790,2017-09-01,Senate,"Do pass as amended",7,0,0,0,7
959346,675906,2017-09-13,Senate,"Assembly 3rd Reading AB480 Gonzalez Fletcher By Pan",38,0,2,0,40
959346,676362,2017-09-14,Assembly,"AB 480 Gonzalez Fletcher Concurrence in Senate Amendments",72,2,5,0,79
959356,637448,2017-05-03,Assembly,"Do pass. To Consent Calendar",9,0,0,0,9
959356,643614,2017-05-11,Assembly,"AB 464 GALLAGHER Consent Calendar Second Day Regular Session",77,0,3,0,80
959356,663037,2017-06-14,Senate,"Do pass and be ordered to the Consent Calendar",6,0,1,0,7
959356,667911,2017-06-22,Senate,"Consent Calendar 2nd AB464 Gallagher et al",37,0,3,0,40
959360,608400,2017-03-21,Assembly,"Do pass. To Consent Calendar",11,0,0,0,11
959360,615915,2017-03-30,Assembly,"AB 452 BLOOM Consent Calendar Second Day",74,0,6,0,80
959360,658895,2017-06-06,Senate,"Do pass and be ordered to the Consent Calendar",6,0,1,0,7
959360,661600,2017-06-12,Senate,"Consent Calendar 2nd AB452",38,0,2,0,40
959363,628209,2017-04-19,Assembly,"Do pass and be re-referred to the Committee on [Appropriations] with recommendation: To Consent Calendar",20,0,1,0,21
959363,633311,2017-04-26,Assembly,"Do pass. To Consent Calendar",16,0,1,0,17
959363,638573,2017-05-04,Assembly,"AB 460 BIGELOW Consent Calendar Second Day Regular Session",76,0,4,0,80
959363,672086,2017-07-11,Senate,"Do pass, but first be re-referred to the Committee on [Appropriations] with the recommendation: To Consent Calendar",13,0,0,0,13
959363,674945,2017-09-05,Senate,"Assembly 3rd Reading AB460 Bigelow et al. By Glazer",38,1,1,0,40
959363,675968,2017-09-13,Assembly,"With recommendation: That Senate amendments be concurred in",16,0,5,0,21
959363,676271,2017-09-14,Assembly,"AB 460 BIGELOW Concurrence in Senate Amendments",79,0,0,0,79
959370,613846,2017-03-28,Assembly,"Do pass and be re-referred to the Committee on [Appropriations] with recommendation: To Consent Calendar",14,0,1,0,15
959370,619850,2017-04-05,Assembly,"Do pass. To Consent Calendar",17,0,0,0,17
959370,629160,2017-04-20,Assembly,"AB 462 THURMOND Consent Calendar Second Day Regular Session",74,0,6,0,80
959370,660215,2017-06-07,Senate,"Do pass, but first be re-referred to the Committee on [Appropriations] with the recommendation: To Consent Calendar",9,0,0,0,9
959370,675080,2017-09-06,Senate,"Assembly 3rd Reading AB462 Thurmond By Beall",40,0,0,0,40
959370,675481,2017-09-11,Assembly,"AB 462 THURMOND Concurrence in Senate Amendments",77,0,2,0,79
959376,621073,2017-04-05,Assembly,"Do pass and be re-referred to the Committee on [Appropriations]",7,0,0,0,7
959379,613889,2017-03-27,Assembly,"Do pass as amended and be re-referred to the Committee on [Appropriations]",10,0,0,0,10
959390,627112,2017-04-18,Assembly,"Do pass and be re-referred to the Committee on [Appropriations]",6,1,0,0,7
959394,618643,2017-04-04,Assembly,"Do pass and be re-referred to the Committee on [Appropriations]",15,0,1,0,16
959394,633245,2017-04-26,Assembly,"Do pass. To Consent Calendar",16,0,1,0,17
959394,638568,2017-05-04,Assembly,"AB 456 THURMOND Consent Calendar Second Day Regular Session",76,0,4,0,80
959394,732518,2018-04-02,Senate,"Do pass, but first be re-referred to the Committee on [Appropriations]",9,0,0,0,9
959394,769530,2018-07-02,Senate,"Assembly 3rd Reading AB456 Thurmond By Hill",37,0,2,0,39
959394,770943,2018-08-06,Assembly,"AB 456 THURMOND Concurrence in Senate Amendments",76,0,4,0,80
959404,631744,2017-04-24,Assembly,"Do pass and be re-referred to the Committee on [Appropriations]",13,0,1,0,14
959404,637555,2017-05-03,Assembly,"Do pass. To Consent Calendar",16,0,1,0,17
959404,643536,2017-05-11,Assembly,"AB 458 FRAZIER Consent Calendar Second Day Regular Session",77,0,3,0,80
959404,672018,2017-07-11,Senate,"Do pass, but first be re-referred to the Committee on [Appropriations] with the recommendation: To Consent Calendar",11,0,2,0,13
959404,673862,2017-08-21,Senate,"Placed on suspense file",7,0,0,0,7
959404,674751,2017-09-01,Senate,"Do pass",7,0,0,0,7
959404,675504,2017-09-11,Senate,"Assembly 3rd Reading AB458 Frazier By Hernandez",39,0,1,0,40
959404,675953,2017-09-13,Assembly,"AB 458 FRAZIER Concurrence in Senate Amendments",78,0,1,0,79
959410,634604,2017-04-26,Assembly,"Do pass and be re-referred to the Committee on [Appropriations]",7,0,2,0,9
959410,649462,2017-05-24,Assembly,"Do pass",14,0,3,0,17
959410,654560,2017-05-30,Assembly,"AB 448 DALY Assembly Third Reading",68,2,10,0,80
959410,766311,2018-06-20,Senate,"Do pass, but first be re-referred to the Committee on [Rules]",7,0,0,0,7
959410,768212,2018-06-26,Senate,"Do pass as amended",12,0,1,0,13
959410,770258,2018-08-06,Senate,"Assembly 3rd Reading AB448 Daly et al. By Moorlach",37,0,2,0,39
959410,772309,2018-08-20,Assembly,"With recommendation: That Senate amendments be concurred in",9,0,0,0,9
959410,772539,2018-08-23,Assembly,"AB 448 DALY Concurrence in Senate Amendments",76,0,4,0,80
959414,641524,2017-05-08,Assembly,"Do pass and be re-referred to the Committee on [Governmental Organization]",1,6,3,0,10
959414,641525,2017-05-08,Assembly,Reconsideration,9,0,1,0,10
959414,683963,2018-01-04,Assembly,"Be re-referred to the Committee on [Insurance]",9,0,2,0,11
959414,685121,2018-01-10,Assembly,"Do pass and be re-referred to the Committee on [Appropriations]",11,0,2,0,13
959414,686228,2018-01-18,Assembly,"Do pass. To Consent Calendar",17,0,0,0,17
959414,689884,2018-01-29,Assembly,"AB 479 GONZALEZ FLETCHER Consent Calendar Second Day Regular Session",75,0,2,0,77
959414,765131,2018-06-19,Senate,"Do pass, but first be re-referred to the Committee on [Appropriations]",5,0,0,0,5
959414,771341,2018-08-13,Senate,"Assembly 3rd Reading AB479 Gonzalez Fletcher et al. By Lara",37,0,3,0,40
959414,772178,2018-08-20,Assembly,"AB 479 GONZALEZ FLETCHER Concurrence in Senate Amendments",79,0,1,0,80
959421,627102,2017-04-18,Assembly,"Do pass and be re-referred to the Committee on [Health] with recommendation: To Consent Calendar",7,0,0,0,7
959421,631891,2017-04-25,Assembly,"Do pass as amended and be re-referred to the Committee on [Appropriations]",15,0,0,0,15
959429,632401,2017-04-25,Assembly,"Do pass and be re-referred to the Committee on [Appropriations]",6,0,1,0,7
959429,652165,2017-05-26,Assembly,"Do pass",17,0,0,0,17
959429,654450,2017-05-30,Assembly,"AB 444 TING Assembly Third Reading",77,0,3,0,80
959429,777185,2017-04-25,Assembly,,0,0,1,0,1
959432,608260,2017-03-21,Assembly,"Do pass and be re-referred to the Committee on [Appropriations] with recommendation: To Consent Calendar",7,0,0,0,7
959432,651699,2017-05-26,Assembly,"Do pass",17,0,0,0,17
959432,654261,2017-05-30,Assembly,"AB 474 GARCIA, E. Assembly Third Reading",77,0,3,0,80
959432,667307,2017-06-21,Senate,"Do pass as amended, but first amend, and re-refer to the Committee on [Appropriations]",6,0,1,0,7
959432,671835,2017-07-10,Senate,"Placed on suspense file",7,0,0,0,7
959432,674818,2017-09-01,Senate,"Do pass",7,0,0,0,7
959432,675024,2017-09-06,Senate,"Assembly 3rd Reading AB474 Eduardo Garcia By Hill",40,0,0,0,40
959432,675384,2017-09-11,Assembly,"AB 474 GARCIA, E. Concurrence in Senate Amendments",78,0,1,0,79
959438,633452,2017-04-25,Assembly,"Do pass as amended and be re-referred to the Committee on [Appropriations]",7,0,0,0,7
959438,651853,2017-05-26,Assembly,"Do pass",17,0,0,0,17
959438,654208,2017-05-30,Assembly,"AB 435 THURMOND Assembly Third Reading",77,0,3,0,80
959438,667561,2017-06-21,Senate,"Do pass as amended, but first amend, and re-refer to the Committee on [Human Services]",5,0,2,0,7
959438,672505,2017-07-11,Senate,"Do pass as amended, but first amend, and re-refer to the Committee on [Appropriations]",7,0,0,0,7
959438,673808,2017-08-21,Senate,"Placed on suspense file",7,0,0,0,7
959438,674752,2017-09-01,Senate,"Do pass",7,0,0,0,7
959438,676104,2017-09-14,Senate,"Special Consent Calendar # AB435",40,0,0,0,40
959438,676375,2017-09-14,Assembly,"AB 435 Thurmond Special Consent Calendar 1st Day Regular Session",79,0,0,0,79
959445,631664,2017-04-25,Assembly,"Do pass as amended and be re-referred to the Committee on [Appropriations]",12,0,4,0,16
959445,649416,2017-05-24,Assembly,"Do pass",17,0,0,0,17
959445,654428,2017-05-30,Assembly,"AB 443 SALAS Assembly Third Reading",74,0,6,0,80
959445,671932,2017-07-10,Senate,"Do pass, but first be re-referred to the Committee on [Appropriations]",9,0,0,0,9
959445,675950,2017-09-13,Senate,"Assembly 3rd Reading AB443 Salas By Hill",40,0,0,0,40
959445,676532,2017-09-16,Assembly,"AB 443 SALAS Concurrence in Senate Amendments",75,0,4,0,79
959468,610182,2017-03-21,Assembly,"Do pass and be re-referred to the Committee on [Appropriations]",10,0,0,0,10
959468,619925,2017-04-05,Assembly,"Do pass. To Consent Calendar",17,0,0,0,17
959468,629150,2017-04-20,Assembly,"AB 431 BIGELOW Consent Calendar Second Day Regular Session",74,0,6,0,80
959468,662228,2017-06-13,Senate,"Do pass, but first be re-referred to the Committee on [Appropriations] with the recommendation: To Consent Calendar",7,0,0,0,7
959468,670986,2017-07-03,Senate,"Consent Calendar 2nd AB431",33,0,7,0,40
959468,671569,2017-07-06,Assembly,"AB 431 BIGELOW Concurrence in Senate Amendments",75,0,5,0,80
959471,632799,2017-04-25,Assembly,"Do pass and be re-referred to the Committee on [Appropriations]",15,0,0,0,15
959471,652157,2017-05-26,Assembly,"Do pass as amended",16,0,1,0,17
959471,655835,2017-05-31,Assembly,"AB 457 CUNNINGHAM Assembly Third Reading",77,0,3,0,80
959474,633067,2017-04-25,Assembly,"Do pass as amended and be re-referred to the Committee on [Appropriations]",12,0,1,0,13
959474,651937,2017-05-26,Assembly,"Do pass as amended",16,0,1,0,17
959474,655999,2017-05-31,Assembly,"AB 453 LIMÓN Assembly Third Reading",75,1,4,0,80
959480,627991,2017-04-18,Assembly,"Do pass and be re-referred to the Committee on [Appropriations]",13,0,0,0,13
959482,613812,2017-03-27,Assembly,"Do pass as amended, and be re-referred to the Committee on [Appropriations] with recommendation: To Consent Calendar",10,0,0,0,10
959482,651881,2017-05-26,Assembly,"Do pass as amended",16,0,1,0,17
959482,656156,2017-05-31,Assembly,"AB 461 MURATSUCHI Assembly Third Reading",76,0,4,0,80
959482,671383,2017-07-05,Senate,"Do pass, but first be re-referred to the Committee on [Appropriations]",7,0,0,0,7
959482,672758,2017-07-17,Senate,"Placed on suspense file",7,0,0,0,7
959482,674516,2017-09-01,Senate,"Do pass",7,0,0,0,7
959482,676071,2017-09-14,Senate,"Special Consent Calendar # AB461",40,0,0,0,40
959489,619755,2017-04-04,Assembly,"Do pass and be re-referred to the Committee on [Appropriations]",7,0,0,0,7
959489,651614,2017-05-26,Assembly,"Do pass",17,0,0,0,17
959489,654391,2017-05-30,Assembly,"AB 432 THURMOND Assembly Third Reading",75,0,5,0,80
959489,672314,2017-07-11,Senate,"Do pass as amended, but first amend, and re-refer to the Committee on [Appropriations] with the recommendation: To Consent Calendar",7,0,0,0,7
959489,673924,2017-08-21,Senate,"Placed on suspense file",7,0,0,0,7
959489,674621,2017-09-01,Senate,"Do pass",6,0,1,0,7
959489,675943,2017-09-13,Senate,"That the measure be returned to Senate Floor for consideration. Ordered to third reading",4,0,3,0,7
959489,676072,2017-09-14,Senate,"Assembly 3rd Reading AB432 Thurmond By Mendoza",39,0,1,0,40
959489,676523,2017-09-15,Assembly,"AB 432 Thurmond Concurrence in Senate Amendments",75,1,3,0,79
959495,642732,2017-05-10,Assembly,"Do pass as amended",6,0,1,0,7
959495,647872,2017-05-22,Assembly,"AB 469 COOPER Assembly Third Reading",62,8,10,0,80
959495,666246,2017-06-20,Senate,"Do pass",4,1,0,0,5
959495,675194,2017-09-07,Senate,"Assembly 3rd Reading AB469 Cooper By Allen Urgency Clause",30,10,0,0,40
959495,675463,2017-09-11,Assembly,"AB 469 COOPER Concurrence - Urgency Added",60,11,8,0,79
959498,627103,2017-04-18,Assembly,"Do pass and be re-referred to the Committee on [Accountability and Administrative Review] with recommendation: To Consent Calendar",10,0,0,0,10
959498,633212,2017-04-26,Assembly,"Do pass and be re-referred to the Committee on [Appropriations] with recommendation: To Consent Calendar",7,0,0,0,7
959498,651599,2017-05-26,Assembly,"Do pass",17,0,0,0,17
959498,654392,2017-05-30,Assembly,"AB 434 BAKER Assembly Third Reading",76,0,4,0,80
959498,672169,2017-07-11,Senate,"Do pass, but first be re-referred to the Committee on [Appropriations]",13,0,0,0,13
959498,675685,2017-09-12,Senate,"Assembly 3rd Reading AB434 Baker et al. By Hertzberg",39,0,1,0,40
959498,675817,2017-09-13,Assembly,"AB 434 Baker Concurrence in Senate Amendments",78,0,1,0,79
959502,621510,2017-04-05,Assembly,"Do pass as amended and be re-referred to the Committee on [Elections and Redistricting]",9,0,0,0,9
959502,642694,2017-05-10,Assembly,"Do pass as amended",6,1,0,0,7
959502,647994,2017-05-22,Assembly,"AB 467 MULLIN Assembly Third Reading",52,23,5,0,80
959502,666292,2017-06-20,Senate,"Do pass, but first be re-referred to the Committee on [Elections and Constitutional Amendments]",10,2,1,0,13
959502,672659,2017-07-12,Senate,"Do pass",4,1,0,0,5
959502,675006,2017-09-05,Senate,"Assembly 3rd Reading AB467 Mullin By Hertzberg",29,11,0,0,40
959502,675317,2017-09-11,Assembly,"AB 467 MULLIN Concurrence in Senate Amendments",55,22,2,0,79
959506,608489,2017-03-21,Assembly,"Do pass and be re-referred to the Committee on [Appropriations]",13,0,2,0,15
959506,652181,2017-05-26,Assembly,"Do pass",15,2,0,0,17
959506,655793,2017-05-31,Assembly,"AB 466 BOCANEGRA Assembly Third Reading",75,1,4,0,80
959506,672199,2017-07-11,Senate,"Do pass, but first be re-referred to the Committee on [Appropriations]",9,0,0,0,9
959506,673951,2017-08-21,Senate,"Placed on suspense file",7,0,0,0,7
959506,674531,2017-09-01,Senate,"Do pass as amended",7,0,0,0,7
959506,675110,2017-09-07,Senate,"Assembly 3rd Reading AB466 Bocanegra et al. By Hertzberg",39,0,1,0,40
959506,675478,2017-09-11,Assembly,"AB 466 BOCANEGRA Concurrence in Senate Amendments",78,0,1,0,79
959513,613805,2017-03-28,Assembly,"Do pass and be re-referred to the Committee on [Appropriations]",6,0,1,0,7
959513,633532,2017-04-26,Assembly,"Do pass",16,0,1,0,17
959513,638633,2017-05-04,Assembly,"AB 484 CUNNINGHAM Assembly Third Reading",74,1,5,0,80
959513,662370,2017-06-13,Senate,"Do pass, but first be re-referred to the Committee on [Appropriations]",7,0,0,0,7
959513,668617,2017-06-26,Senate,"Placed on suspense file",7,0,0,0,7
959513,674548,2017-09-01,Senate,"Do pass",6,1,0,0,7
959513,675639,2017-09-12,Senate,"Assembly 3rd Reading AB484 Cunningham By Allen",40,0,0,0,40
959513,676293,2017-09-14,Assembly,"AB 484 CUNNINGHAM Concurrence in Senate Amendments",78,1,0,0,79
959522,610052,2017-03-22,Assembly,"Do pass and be re-referred to the Committee on [Appropriations] with recommendation: To Consent Calendar",7,0,0,0,7
959522,620601,2017-04-05,Assembly,"Do pass. To Consent Calendar",17,0,0,0,17
959522,629332,2017-04-20,Assembly,"AB 446 BIGELOW Consent Calendar Second Day Regular Session",74,0,6,0,80
959522,660604,2017-06-07,Senate,"Do pass as amended, but first amend, and re-refer to the Committee on [Appropriations] with the recommendation: To Consent Calendar",7,0,0,0,7
959522,671008,2017-07-03,Senate,"Consent Calendar 2nd AB446",33,0,7,0,40
959522,671610,2017-07-06,Assembly,"AB 446 BIGELOW Concurrence in Senate Amendments",76,0,4,0,80
959527,608588,2017-03-21,Assembly,"Do pass as amended",11,0,0,0,11
959527,617444,2017-04-03,Assembly,"AB 430 IRWIN Third Reading Urgency",76,0,4,0,80
959527,662305,2017-06-13,Senate,"Do pass and be ordered to the Consent Calendar",7,0,0,0,7
959527,665054,2017-06-19,Senate,"Consent Calendar 2nd AB430 Irwin et al. Urgency Clause",33,0,7,0,40
959531,630437,2017-04-24,Assembly,"Be re-referred to the Committee on [Privacy and Consumer Protection]",11,0,0,0,11
959531,631484,2017-04-25,Assembly,"Do pass and be re-referred to the Committee on [Appropriations]",10,0,0,0,10
959531,642616,2017-05-10,Assembly,"Do pass. To Consent Calendar",17,0,0,0,17
959531,646492,2017-05-18,Assembly,"AB 475 CHAU Consent Calendar Second Day Regular Session",69,0,11,0,80
959531,669060,2017-06-27,Senate,"Do pass, but first be re-referred to the Committee on [Appropriations] with the recommendation: To Consent Calendar",13,0,0,0,13
959531,672583,2017-07-13,Senate,"Consent Calendar 2nd AB475",39,0,1,0,40
959531,673877,2017-08-21,Assembly,"AB 475 CHAU Concurrence in Senate Amendments",78,0,1,0,79
959537,618501,2017-04-03,Assembly,"Do pass and be re-referred to the Committee on [Environmental Safety and Toxic Materials]",7,1,2,0,10
959541,618293,2017-04-04,Assembly,"Do pass as amended and be re-referred to the Committee on [Appropriations]",14,1,0,0,15
959541,637525,2017-05-03,Assembly,"Do pass",13,2,2,0,17
959541,644485,2017-05-15,Assembly,"AB 451 ARAMBULA Assembly Third Reading",68,7,5,0,80
959541,669811,2017-06-28,Senate,"Do pass as amended, but first amend, and re-refer to the Committee on [Appropriations]",7,0,2,0,9
959541,673776,2017-08-21,Senate,"Placed on suspense file",7,0,0,0,7
959548,610224,2017-03-22,Assembly,"Do pass and be re-referred to the Committee on [Local Government]",10,0,0,0,10
959548,629200,2017-04-19,Assembly,"Do pass and be re-referred to the Committee on [Appropriations]",9,0,0,0,9
959548,651874,2017-05-26,Assembly,"Do pass",13,4,0,0,17
959548,655733,2017-05-31,Assembly,"AB 465 TING Assembly Third Reading",71,1,8,0,80
959548,669939,2017-06-28,Senate,"Do pass, but first be re-referred to the Committee on [Appropriations]",7,0,0,0,7
959548,672007,2017-07-10,Senate,"Placed on suspense file",7,0,0,0,7
959548,674664,2017-09-01,Senate,"Do pass as amended",7,0,0,0,7
959548,675214,2017-09-07,Senate,"Assembly 3rd Reading AB465 Ting By Beall",40,0,0,0,40
959548,675485,2017-09-11,Assembly,"AB 465 TING Concurrence in Senate Amendments",67,7,5,0,79
959551,618626,2017-04-04,Assembly,"Do pass and be re-referred to the Committee on [Appropriations]",13,0,2,0,15
959551,652135,2017-05-26,Assembly,"Do pass",17,0,0,0,17
959551,655726,2017-05-31,Assembly,"AB 472 FRAZIER Assembly Third Reading",76,0,4,0,80
959551,672028,2017-07-11,Senate,"Do pass, but first be re-referred to the Committee on [Appropriations]",4,1,4,0,9
959551,673997,2017-08-22,Senate,"[08-22-2017] hearing: Motion to Reconsider. [Reconsideration Granted.]",9,0,0,0,9
959557,629093,2017-04-19,Assembly,"Do pass and be re-referred to the Committee on [Judiciary]",5,2,0,0,7
959557,631980,2017-04-25,Assembly,"Do pass as amended and be re-referred to the Committee on [Appropriations]",8,3,0,0,11
959557,651757,2017-05-26,Assembly,"Do pass as amended",10,6,1,0,17
959557,655915,2017-05-31,Assembly,"AB 450 CHIU Assembly Third Reading",50,24,6,0,80
959557,669709,2017-06-28,Senate,"Do pass, but first be re-referred to the Committee on [Judiciary]",3,1,1,0,5
959557,672417,2017-07-11,Senate,"Do pass as amended, but first amend, and re-refer to the Committee on [Appropriations]",5,2,0,0,7
959557,673739,2017-08-21,Senate,"Placed on suspense file",7,0,0,0,7
959557,674462,2017-09-01,Senate,"Do pass as amended",5,2,0,0,7
959557,675644,2017-09-12,Senate,"Assembly 3rd Reading AB450 Chiu et al. By Lara",27,10,3,0,40
959557,675762,2017-09-13,Assembly,"AB 450 Chiu Concurrence in Senate Amendments",53,22,4,0,79
959557,775406,2017-09-12,Senate,"Assembly 3rd Reading AB450 Chi""2""> ?",5,10,3,0,18
959564,619309,2017-04-04,Assembly,"Do pass and be re-referred to the Committee on [Appropriations] with recommendation: To Consent Calendar",13,0,2,0,15
959564,633564,2017-04-26,Assembly,"Do pass",16,0,1,0,17
959564,635826,2017-05-01,Assembly,"AB 436 STONE Assembly Third Reading",74,0,6,0,80
959564,662607,2017-06-13,Senate,"Do pass, but first be re-referred to the Committee on [Appropriations] with the recommendation: To Consent Calendar",9,0,0,0,9
959564,672999,2017-07-20,Senate,"Consent Calendar 2nd AB436",38,0,2,0,40
959567,632163,2017-04-24,Assembly,"Do pass as amended and be re-referred to the Committee on [Appropriations]",10,0,0,0,10
959570,627948,2017-04-19,Assembly,"Do pass as amended and be re-referred to the Committee on [Appropriations]",18,0,3,0,21
959570,637594,2017-05-03,Assembly,"Do pass. To Consent Calendar",16,0,1,0,17
959570,643412,2017-05-11,Assembly,"AB 471 TING Consent Calendar Second Day Regular Session",77,0,3,0,80
959570,672053,2017-07-11,Senate,"Do pass, but first be re-referred to the Committee on [Appropriations]",13,0,0,0,13
959570,674412,2017-08-31,Senate,"Assembly 3rd Reading AB471 Ting et al. By Dodd",38,0,2,0,40
959570,675999,2017-09-13,Assembly,"With recommendation: That Senate amendments be concurred in",16,0,5,0,21
959570,676259,2017-09-14,Assembly,"AB 471 TING Concurrence in Senate Amendments",79,0,0,0,79
959577,631689,2017-04-24,Assembly,"Do pass as amended and be re-referred to the Committee on [Appropriations]",7,3,4,0,14
959577,631690,2017-04-24,Assembly,Reconsideration,14,0,0,0,14
959583,613916,2017-03-27,Assembly,"Do pass and be re-referred to the Committee on [Appropriations] with recommendation: To Consent Calendar",10,0,0,0,10
959583,619963,2017-04-05,Assembly,"Do pass. To Consent Calendar",17,0,0,0,17
959583,629152,2017-04-20,Assembly,"AB 454 RIDLEY-THOMAS Consent Calendar Second Day Regular Session",74,0,6,0,80
959583,669841,2017-06-28,Senate,"Do pass as amended, but first amend, and re-refer to the Committee on [Appropriations]",7,0,0,0,7
959583,672792,2017-07-17,Senate,"Placed on suspense file",7,0,0,0,7
959583,674819,2017-09-01,Senate,"Do pass",7,0,0,0,7
959583,676037,2017-09-14,Senate,"Special Consent Calendar # AB454",40,0,0,0,40
959583,676316,2017-09-14,Assembly,"AB 454 Ridley-Thomas Special Consent Calendar 1st Day Regular Session",79,0,0,0,79
959589,640558,2017-05-08,Assembly,"Do pass",14,0,0,0,14
959589,643515,2017-05-11,Assembly,"AB 468 SANTIAGO Assembly Third Reading",77,0,3,0,80
959589,666206,2017-06-20,Senate,"Do pass",12,0,1,0,13
959589,672703,2017-07-17,Senate,"Special Consent Calendar # AB468",38,0,2,0,40
959589,673927,2017-08-21,Assembly,"AB 468 SANTIAGO Concurrence in Senate Amendments",78,0,1,0,79
959591,631976,2017-04-25,Assembly,"Do pass as amended and be re-referred to the Committee on [Appropriations]",15,0,0,0,15
959591,651603,2017-05-26,Assembly,"Do pass as amended",16,0,1,0,17
959591,656265,2017-05-31,Assembly,"AB 447 GRAY Assembly Third Reading",77,0,3,0,80
959591,671592,2017-07-05,Senate,"Do pass as amended, but first amend, and re-refer to the Committee on [Appropriations]",9,0,0,0,9
959591,673800,2017-08-21,Senate,"Placed on suspense file",7,0,0,0,7
959591,674812,2017-09-01,Senate,"Do pass",7,0,0,0,7
959591,675040,2017-09-06,Senate,"Assembly 3rd Reading AB447 Gray et al. By Pan",38,0,2,0,40
959591,675348,2017-09-11,Assembly,"AB 447 GRAY Concurrence in Senate Amendments",78,0,1,0,79
959789,628146,2017-04-19,Assembly,"Do pass and be re-referred to the Committee on [Appropriations]",20,0,1,0,21
959789,637942,2017-05-03,Assembly,"Do pass. To Consent Calendar",16,0,1,0,17
959789,643493,2017-05-11,Assembly,"AB 522 CUNNINGHAM Consent Calendar Second Day Regular Session",77,0,3,0,80
959789,669402,2017-06-27,Senate,"Do pass, but first be re-referred to the Committee on [Appropriations]",13,0,0,0,13
959789,674437,2017-08-31,Senate,"Assembly 3rd Reading AB522 Cunningham By Cannella",39,0,1,0,40
959789,674856,2017-09-05,Assembly,"AB 522 CUNNINGHAM Concurrence in Senate Amendments",77,0,2,0,79
959792,613529,2017-03-28,Assembly,"Do pass as amended",6,0,1,0,7
959792,625991,2017-04-17,Assembly,"AB 539 ACOSTA Assembly Third Reading",73,0,7,0,80
959792,662450,2017-06-13,Senate,"Do pass as amended, but first amend, and re-refer to the Committee on [Appropriations]",6,1,0,0,7
959792,675654,2017-09-12,Senate,"Assembly 3rd Reading AB539 Acosta By Nguyen",36,2,2,0,40
959792,676243,2017-09-14,Assembly,"AB 539 ACOSTA Concurrence in Senate Amendments",76,0,3,0,79
959793,610301,2017-03-22,Assembly,"Do pass as amended and be re-referred to the Committee on [Appropriations]",7,0,0,0,7
959793,652170,2017-05-26,Assembly,"Do pass",15,0,2,0,17
959793,655813,2017-05-31,Assembly,"AB 491 MURATSUCHI Assembly Third Reading",73,0,7,0,80
959793,672379,2017-07-12,Senate,"Do pass, but first be re-referred to the Committee on [Appropriations]",6,1,0,0,7
959793,673775,2017-08-21,Senate,"Placed on suspense file",7,0,0,0,7
959793,674824,2017-09-01,Senate,"Do pass as amended",5,2,0,0,7
959793,675511,2017-09-11,Senate,"Assembly 3rd Reading AB491 Muratsuchi By Pan",28,10,2,0,40
959793,675956,2017-09-13,Assembly,"AB 491 MURATSUCHI Concurrence in Senate Amendments",62,11,6,0,79
959794,629554,2017-04-19,Senate,"Do pass as amended, but first amend, and re-refer to the Committee on [Appropriations] with the recommendation: To Consent Calendar",9,0,0,0,9
959794,644732,2017-05-15,Senate,"Placed on suspense file",7,0,0,0,7
959794,650879,2017-05-25,Senate,"Do pass",7,0,0,0,7
959794,656320,2017-05-31,Senate,"Special Consent Calendar # SB323",40,0,0,0,40
959794,666248,2017-06-20,Assembly,"Do pass and be re-referred to the Committee on [Appropriations] with recommendation: To Consent Calendar",15,0,0,0,15
959794,674686,2017-09-01,Assembly,"Do pass as amended",11,0,6,0,17
959794,675919,2017-09-13,Assembly,"SB 323 Mitchell Senate Third Reading By WOOD",78,0,1,0,79
959794,676164,2017-09-14,Senate,"Unfinished Business SB323 Mitchell Concurrence",40,0,0,0,40
959796,610151,2017-03-21,Assembly,"Do pass and be re-referred to the Committee on [Appropriations]",7,0,0,0,7
959796,651949,2017-05-26,Assembly,"Do pass as amended",16,0,1,0,17
959796,656132,2017-05-31,Assembly,"AB 507 RUBIO Assembly Third Reading",76,0,4,0,80
959796,672407,2017-07-11,Senate,"Do pass as amended, but first amend, and re-refer to the Committee on [Appropriations] with the recommendation: To Consent Calendar",7,0,0,0,7
959796,673916,2017-08-21,Senate,"Placed on suspense file",7,0,0,0,7
959796,674497,2017-09-01,Senate,"Do pass",7,0,0,0,7
959796,676069,2017-09-14,Senate,"Special Consent Calendar # AB507",40,0,0,0,40
959796,676284,2017-09-14,Assembly,"AB 507 Rubio Special Consent Calendar 1st Day Regular Session",79,0,0,0,79
959800,626003,2017-04-17,Senate,"Do pass",6,0,3,0,9
959800,635764,2017-05-01,Senate,"Senate 3rd Reading SB315 Nguyen",36,0,4,0,40
959800,668971,2017-06-27,Assembly,"Do pass",16,0,0,0,16
959800,671514,2017-07-06,Assembly,"SB 315 Nguyen Senate Third Reading By CHIU",75,0,5,0,80
959801,637926,2017-05-02,Senate,"Do pass as amended",4,2,1,0,7
959801,648007,2017-05-22,Senate,"Senate 3rd Reading SB298 Wieckowski",22,12,6,0,40
959801,669292,2017-06-27,Assembly,"Do pass as amended",6,3,2,0,11
959801,676557,2017-09-16,Assembly,"SB 298 Wieckowski Senate Third Reading By WEBER",28,29,22,0,79
959801,771501,2018-08-15,Assembly,"Do pass",12,5,0,0,17
959801,773738,2018-08-30,Assembly,"SB 298 Wieckowski Senate Third Reading By WEBER",27,31,22,0,80
959801,777233,2018-08-15,Assembly,,28,5,0,0,33
959803,618335,2017-04-03,Assembly,"Do pass as amended and be re-referred to the Committee on [Appropriations]",6,2,2,0,10
959803,647839,2017-05-22,Assembly,"Do pass and be re-referred to the Committee on [Appropriations]",14,0,1,0,15
959803,669688,2017-06-28,Assembly,"Do pass",14,0,3,0,17
959803,671615,2017-07-06,Assembly,"AB 524 BIGELOW Third Reading Urgency",75,0,5,0,80
959803,673998,2017-08-22,Senate,"Do pass as amended, but first amend, and re-refer to the Committee on [Energy, Utilities and Communications]",8,0,1,0,9
959803,674222,2017-08-29,Senate,"Do pass, but first be re-referred to the Committee on [Appropriations]",10,0,1,0,11
959803,674513,2017-09-01,Senate,"Placed on suspense file",7,0,0,0,7
959803,674514,2017-09-01,Senate,"Do pass",7,0,0,0,7
959803,675087,2017-09-06,Senate,"Assembly 3rd Reading AB524 Bigelow et al. By Berryhill Urgency Clause",39,0,1,0,40
959803,675316,2017-09-11,Assembly,"AB 524 BIGELOW Concurrence in Senate Amendments",79,0,0,0,79
959804,613526,2017-03-28,Assembly,"Do pass and be re-referred to the Committee on [Appropriations]",2,5,0,0,7
959804,613527,2017-03-28,Assembly,Reconsideration,7,0,0,0,7
959807,627049,2017-04-18,Senate,"Do pass, but first be re-referred to the Committee on [Appropriations]",11,0,2,0,13
959807,654540,2017-05-30,Senate,"Senate 3rd Reading SB329 Leyva",40,0,0,0,40
959807,669585,2017-06-28,Assembly,"Do pass as amended and be re-referred to the Committee on [Appropriations]",7,0,0,0,7
959807,672943,2017-07-19,Assembly,"Do pass",16,0,1,0,17
959807,675144,2017-09-07,Assembly,"SB 329 Leyva Senate Third Reading By REYES",78,0,1,0,79
959807,675887,2017-09-13,Senate,"Unfinished Business SB329 Leyva Concurrence",40,0,0,0,40
959808,613566,2017-03-27,Assembly,"Do pass as amended, and be re-referred to the Committee on [Appropriations] with recommendation: To Consent Calendar",10,0,0,0,10
959808,651898,2017-05-26,Assembly,"Do pass as amended",16,0,1,0,17
959808,655786,2017-05-31,Assembly,"AB 490 QUIRK-SILVA Assembly Third Reading",77,0,3,0,80
959808,667252,2017-06-21,Senate,"Do pass as amended, but first amend, and re-refer to the Committee on [Appropriations]",7,0,0,0,7
959808,671921,2017-07-10,Senate,"Placed on suspense file",7,0,0,0,7
959808,674609,2017-09-01,Senate,"Do pass",7,0,0,0,7
959808,675022,2017-09-06,Senate,"Assembly 3rd Reading AB490 Quirk-Silva By Leyva",39,0,1,0,40
959808,675358,2017-09-11,Assembly,"AB 490 QUIRK-SILVA Concurrence in Senate Amendments",77,0,2,0,79
959810,632093,2017-04-25,Senate,"Do pass as amended, but first amend, and re-refer to the Committee on [Appropriations]",13,0,0,0,13
959810,644805,2017-05-15,Senate,"Placed on suspense file",7,0,0,0,7
959811,642725,2017-05-09,Senate,"Do pass as amended",5,2,0,0,7
959811,686931,2018-01-22,Senate,"Senate 3rd Reading SB327 Jackson",28,9,3,0,40
959811,769709,2018-07-03,Assembly,"Do pass as amended and be re-referred to the Committee on [Appropriations]",8,2,0,0,10
959811,771491,2018-08-15,Assembly,"Do pass",12,5,0,0,17
959811,773076,2018-08-28,Assembly,"SB 327 Jackson Senate Third Reading By IRWIN",53,22,5,0,80
959811,773356,2018-08-29,Senate,"Unfinished Business SB327 Jackson et al. Concurrence",28,9,3,0,40
959814,609436,2017-03-21,Assembly,"Do pass as amended and be re-referred to the Committee on [Appropriations]",11,0,0,0,11
959814,633521,2017-04-26,Assembly,"Do pass. To Consent Calendar",16,0,1,0,17
959814,638677,2017-05-04,Assembly,"AB 492 GRAYSON Consent Calendar Second Day Regular Session",76,0,4,0,80
959814,669741,2017-06-27,Senate,"Do pass, but first be re-referred to the Committee on [Appropriations]",5,1,1,0,7
959814,674292,2017-08-31,Senate,"Assembly 3rd Reading AB492 Grayson et al. By Jackson",38,1,1,0,40
959814,674879,2017-09-05,Assembly,"AB 492 GRAYSON Concurrence in Senate Amendments",73,3,3,0,79
959814,777389,2017-08-31,Senate,,5,1,1,0,7
959815,619816,2017-04-05,Assembly,"Do pass as amended and be re-referred to the Committee on [Judiciary]",7,0,0,0,7
959815,627091,2017-04-18,Assembly,"Do pass as amended. To Consent Calendar",11,0,0,0,11
959815,634691,2017-04-27,Assembly,"AB 534 GALLAGHER Consent Calendar Second Day",75,0,5,0,80
959815,662433,2017-06-13,Senate,"Do pass and be ordered to the Consent Calendar",7,0,0,0,7
959815,665003,2017-06-19,Senate,"Consent Calendar 2nd AB534",33,0,7,0,40
959816,614185,2017-03-28,Assembly,"Do pass and be re-referred to the Committee on [Local Government] with recommendation: To Consent Calendar",14,0,1,0,15
959816,637582,2017-05-03,Assembly,"Do pass. To Consent Calendar",9,0,0,0,9
959816,643380,2017-05-11,Assembly,"AB 545 BIGELOW Consent Calendar Second Day Regular Session",77,0,3,0,80
959816,663297,2017-06-14,Senate,"Do pass, but first be re-referred to the Committee on [Health] with the recommendation: To Consent Calendar",6,0,1,0,7
959816,669824,2017-06-28,Senate,"Do pass and be ordered to the Consent Calendar",7,0,2,0,9
959816,671908,2017-07-10,Senate,"Consent Calendar 2nd AB545",40,0,0,0,40
959816,672648,2017-07-10,Senate,"Consent Calendar 2nd AB545 Bigelow et al",40,0,0,0,40
959818,613700,2017-03-27,Assembly,"Do pass as amended and be re-referred to the Committee on [Aging and Long-Term Care]",9,0,1,0,10
959818,628010,2017-04-18,Assembly,"Do pass and be re-referred to the Committee on [Appropriations]",7,0,0,0,7
959818,642766,2017-05-10,Assembly,"Do pass as amended",17,0,0,0,17
959818,647811,2017-05-22,Assembly,"AB 519 LEVINE Assembly Third Reading",77,0,3,0,80
959818,667308,2017-06-21,Senate,"Do pass, but first be re-referred to the Committee on [Appropriations]",7,0,0,0,7
959818,671939,2017-07-10,Senate,"Do pass",7,0,0,0,7
959818,675579,2017-09-12,Senate,"Assembly 3rd Reading AB519 Levine et al. By McGuire",40,0,0,0,40
959818,676219,2017-09-14,Assembly,"AB 519 LEVINE Concurrence in Senate Amendments",79,0,0,0,79
959819,626782,2017-04-18,Senate,"Do pass, but first be re-referred to the Committee on [Appropriations]",5,0,0,0,5
959819,638615,2017-05-04,Senate,"Senate 3rd Reading SB335 Cannella",39,0,1,0,40
959819,670024,2017-06-28,Assembly,"Do pass and be re-referred to the Committee on [Appropriations] with recommendation: To Consent Calendar",9,0,1,0,10
959819,672938,2017-07-19,Assembly,"Do pass. To Consent Calendar",16,0,1,0,17
959819,674118,2017-08-24,Assembly,"SB 335 Cannella Consent Calendar Second Day Regular Session",76,0,3,0,79
959821,627941,2017-04-19,Senate,"Do pass, but first be re-referred to the Committee on [Appropriations]",6,0,1,0,7
959821,635787,2017-05-01,Senate,"Placed on suspense file",7,0,0,0,7
959823,614967,2017-03-29,Assembly,"Do pass and be re-referred to the Committee on [Appropriations]",7,0,0,0,7
959823,651520,2017-05-26,Assembly,"Do pass",17,0,0,0,17
959823,654250,2017-05-30,Assembly,"AB 512 RODRIGUEZ Assembly Third Reading",76,0,4,0,80
959823,668676,2017-06-26,Senate,"Do pass, but first be re-referred to the Committee on [Appropriations] with the recommendation: To Consent Calendar",5,0,0,0,5
959823,671883,2017-07-10,Senate,"Placed on suspense file",7,0,0,0,7
959823,674652,2017-09-01,Senate,"Do pass",7,0,0,0,7
959823,676122,2017-09-14,Senate,"Special Consent Calendar # AB512",40,0,0,0,40
959823,676355,2017-09-14,Assembly,"AB 512 Rodriguez Special Consent Calendar 1st Day Regular Session",79,0,0,0,79
959826,632056,2017-04-24,Assembly,"Do pass as amended and be re-referred to the Committee on [Appropriations]",11,3,0,0,14
959826,651687,2017-05-26,Assembly,"Do pass as amended",12,5,0,0,17
959826,656974,2017-06-01,Assembly,"AB 544 BLOOM Assembly Third Reading",63,9,8,0,80
959826,672118,2017-07-11,Senate,"Do pass, but first be re-referred to the Committee on [Appropriations]",12,0,1,0,13
959826,673899,2017-08-21,Senate,"Placed on suspense file",7,0,0,0,7
959826,674455,2017-09-01,Senate,"Do pass as amended",5,2,0,0,7
959826,675674,2017-09-12,Senate,"Assembly 3rd Reading AB544 Bloom By Wieckowski",32,5,3,0,40
959826,675771,2017-09-13,Assembly,"AB 544 Bloom Concurrence in Senate Amendments",62,15,2,0,79
959827,631837,2017-04-25,Senate,"Do pass, but first be re-referred to the Committee on [Appropriations]",6,1,0,0,7
959827,644480,2017-05-15,Senate,"Placed on suspense file",7,0,0,0,7
959827,650726,2017-05-25,Senate,"Do pass",5,2,0,0,7
959827,655825,2017-05-31,Senate,"Senate 3rd Reading SB312 Skinner",32,8,0,0,40
959827,669193,2017-06-27,Assembly,"Do pass and be re-referred to the Committee on [Appropriations]",4,2,1,0,7
959827,672877,2017-07-19,Assembly,"Do pass",11,4,2,0,17
959827,675515,2017-09-11,Assembly,"SB 312 Skinner Senate Third Reading By BOCANEGRA",53,21,5,0,79
959827,675588,2017-09-12,Assembly,"SB 312 Skinner Motion to Reconsider By BOCANEGRA",53,19,7,0,79
959827,675589,2017-09-12,Assembly,"SB 312 Skinner Senate Third Reading By BOCANEGRA",54,23,2,0,79
959827,675780,2017-09-13,Senate,"Unfinished Business SB312 Skinner et al. Concurrence",33,7,0,0,40
959829,633482,2017-04-26,Senate,"Do pass as amended, but first amend, and re-refer to the Committee on [Appropriations] with the recommendation: To Consent Calendar",7,0,0,0,7
959829,644893,2017-05-15,Senate,"Placed on suspense file",7,0,0,0,7
959829,650845,2017-05-25,Senate,"Do pass",7,0,0,0,7
959829,655821,2017-05-31,Senate,"Special Consent Calendar # SB307",40,0,0,0,40
959829,672041,2017-07-11,Assembly,"Do pass and be re-referred to the Committee on [Appropriations]",13,0,0,0,13
959832,618506,2017-04-04,Assembly,"Do pass and be re-referred to the Committee on [Appropriations]",9,0,6,0,15
959832,637554,2017-05-03,Assembly,"Do pass",14,0,3,0,17
959832,643605,2017-05-11,Assembly,"AB 511 ARAMBULA Assembly Third Reading",62,0,18,0,80
959832,774550,2017-04-04,Assembly,?,0,0,6,0,6
959833,630503,2017-04-24,Senate,"Do pass, but first be re-referred to the Committee on [Appropriations]",5,0,0,0,5
959833,645012,2017-05-15,Senate,"Placed on suspense file",7,0,0,0,7
959833,650826,2017-05-25,Senate,"Do pass",7,0,0,0,7
959833,655895,2017-05-31,Senate,"Special Consent Calendar # SB334",40,0,0,0,40
959833,667317,2017-06-21,Assembly,"Do pass and be re-referred to the Committee on [Appropriations]",6,0,1,0,7
959833,674692,2017-09-01,Assembly,"Do pass",16,0,1,0,17
959833,675641,2017-09-12,Assembly,"SB 334 Dodd Senate Third Reading By BOCANEGRA",77,0,2,0,79
959834,637511,2017-05-03,Assembly,"Do pass",7,0,0,0,7
959834,640631,2017-05-08,Assembly,"AB 526 COOPER Assembly Third Reading",76,0,4,0,80
959836,619788,2017-04-05,Senate,"Do pass, but first be re-referred to the Committee on [Appropriations]",4,2,1,0,7
959836,630266,2017-04-24,Senate,"Placed on suspense file",7,0,0,0,7
959836,650761,2017-05-25,Senate,"Do pass as amended",5,2,0,0,7
959836,656658,2017-06-01,Senate,"Senate 3rd Reading SB318 Portantino et al",25,12,3,0,40
959836,672100,2017-07-11,Assembly,"Do pass and be re-referred to the Committee on [Appropriations]",8,4,1,0,13
959836,674595,2017-09-01,Assembly,"Do pass as amended",11,5,1,0,17
959836,675925,2017-09-13,Assembly,"SB 318 Portantino Senate Third Reading By BOCANEGRA",48,24,7,0,79
959836,676079,2017-09-14,Senate,"Unfinished Business SB318 Portantino et al. Concurrence",26,11,3,0,40
959837,632878,2017-04-25,Senate,"Do pass as amended, but first amend, and re-refer to the Committee on [Appropriations]",10,3,0,0,13
959837,644872,2017-05-15,Senate,"Placed on suspense file",7,0,0,0,7
959837,650851,2017-05-25,Senate,"Do pass",5,2,0,0,7
959837,653987,2017-05-30,Senate,"Senate 3rd Reading SB309 Jackson et al",28,12,0,0,40
959837,668714,2017-06-26,Assembly,"Do pass and be re-referred to the Committee on [Appropriations]",11,3,0,0,14
959840,608238,2017-03-21,Assembly,"Do pass and be re-referred to the Committee on [Appropriations]",7,0,0,0,7
959841,618563,2017-04-04,Senate,"Do pass, but first be re-referred to the Committee on [Appropriations] with the recommendation: To Consent Calendar",6,0,1,0,7
959841,630501,2017-04-24,Senate,"Placed on suspense file",7,0,0,0,7
959841,650356,2017-05-25,Senate,"Do pass as amended",7,0,0,0,7
959841,655772,2017-05-31,Senate,"Senate 3rd Reading SB336 Anderson et al",39,0,1,0,40
959841,669130,2017-06-27,Assembly,"Do pass and be re-referred to the Committee on [Appropriations] with recommendation: To Consent Calendar",6,0,1,0,7
959841,672889,2017-07-19,Assembly,"Do pass. To Consent Calendar",16,0,1,0,17
959841,674376,2017-08-31,Assembly,"SB 336 Anderson Senate Third Reading By LACKEY",77,0,2,0,79
959841,674973,2017-09-05,Senate,"Special Consent SB336",40,0,0,0,40
959844,620060,2017-04-05,Assembly,"Do pass and be re-referred to the Committee on [Local Government]",7,0,0,0,7
959844,629120,2017-04-19,Assembly,"Do pass and be re-referred to the Committee on [Appropriations]",8,0,1,0,9
959844,637559,2017-05-03,Assembly,"Do pass",16,0,1,0,17
959844,640663,2017-05-08,Assembly,"AB 494 BLOOM Assembly Third Reading",78,0,2,0,80
959844,666345,2017-06-20,Senate,"Do pass, but first be re-referred to the Committee on [Governance and Finance] with the recommendation: To Consent Calendar",12,0,1,0,13
959844,672353,2017-07-12,Senate,"Do pass, but first be re-referred to the Committee on [Appropriations] with the recommendation: To Consent Calendar",7,0,0,0,7
959844,675682,2017-09-12,Senate,"Assembly 3rd Reading AB494 Bloom By Wieckowski",40,0,0,0,40
959844,676365,2017-09-14,Assembly,"AB 494 BLOOM Concurrence in Senate Amendments",76,1,2,0,79
959845,634582,2017-04-27,Assembly,"Be adopted. To third reading",9,0,2,0,11
959847,613536,2017-03-28,Assembly,"Do pass and be re-referred to the Committee on [Appropriations]",2,3,2,0,7
959848,633156,2017-04-25,Senate,"Do pass as amended, but first amend, and re-refer to the Committee on [Appropriations]",5,2,0,0,7
959848,654448,2017-05-30,Senate,"Senate 3rd Reading SB316 Wieckowski",27,12,1,0,40
959848,672193,2017-07-11,Assembly,"Do pass as amended and be re-referred to the Committee on [Appropriations]",8,1,2,0,11
959849,610096,2017-03-22,Senate,"Do pass, but first be re-referred to the Committee on [Public Safety]",6,1,0,0,7
959849,627075,2017-04-18,Senate,"Do pass, but first be re-referred to the Committee on [Appropriations]",5,2,0,0,7
959849,635719,2017-05-01,Senate,"Placed on suspense file",7,0,0,0,7
959849,650572,2017-05-25,Senate,"Do pass",5,2,0,0,7
959849,654146,2017-05-30,Senate,"Senate 3rd Reading SB304 Portantino",29,9,2,0,40
959849,667144,2017-06-21,Assembly,"Do pass as amended and be re-referred to the Committee on [Appropriations]",5,1,1,0,7
959849,674578,2017-09-01,Assembly,"Do pass as amended",12,4,1,0,17
959849,675883,2017-09-13,Assembly,"SB 304 Portantino Senate Third Reading By BOCANEGRA",55,20,4,0,79
959849,676055,2017-09-14,Senate,"Unfinished Business SB304 Portantino et al. Concurrence",29,9,2,0,40
959851,619762,2017-04-05,Senate,"Be adopted, but first be re-referred to the Committee on [Transportation and Housing]",5,2,0,0,7
959851,641794,2017-05-09,Senate,"Be adopted",8,3,2,0,13
959851,647966,2017-05-22,Senate,"Placed on suspense file",7,0,0,0,7
959852,629080,2017-04-19,Senate,"Do pass, but first be re-referred to the Committee on [Education]",6,2,1,0,9
959852,629776,2017-04-19,Senate,"Do pass as amended, but first amend, and re-refer to the Committee on [Education]",6,2,1,0,9
959852,684907,2018-01-10,Senate,"Do pass as amended, but first amend, and re-refer to the Committee on [Appropriations]",4,2,1,0,7
959852,685442,2018-01-16,Senate,"Placed on suspense file",7,0,0,0,7
959852,686191,2018-01-18,Senate,"Do pass",5,2,0,0,7
959852,690081,2018-01-29,Senate,"Senate 3rd Reading SB320 Leyva",25,13,2,0,40
959852,762075,2018-06-12,Assembly,"Do pass and be re-referred to the Committee on [Higher Education]",10,4,1,0,15
959852,768908,2018-06-26,Assembly,"Do pass and be re-referred to the Committee on [Appropriations]",8,3,2,0,13
959852,771594,2018-08-16,Assembly,"Do pass as amended",12,5,0,0,17
959852,773552,2018-08-29,Assembly,"SB 320 Leyva Senate Third Reading By CARRILLO",52,25,3,0,80
959852,773817,2018-08-30,Senate,"Unfinished Business SB320 Leyva et al. Concurrence",26,13,1,0,40
959856,628008,2017-04-19,Senate,"Do pass, but first be re-referred to the Committee on [Appropriations]",7,0,0,0,7
959856,635741,2017-05-01,Senate,"Placed on suspense file",7,0,0,0,7
959858,618351,2017-04-04,Assembly,"Do pass and be re-referred to the Committee on [Appropriations]",12,1,2,0,15
959858,637242,2017-05-03,Assembly,"Do pass as amended",13,1,3,0,17
959858,656414,2017-05-31,Assembly,"AB 521 FRAZIER Assembly Third Reading",67,4,9,0,80
959858,672224,2017-07-11,Senate,"Do pass, but first be re-referred to the Committee on [Appropriations]",3,2,4,0,9
959859,627815,2017-04-19,Assembly,"Do pass and be re-referred to the Committee on [Appropriations]",5,1,1,0,7
959859,651558,2017-05-26,Assembly,"Do pass",12,3,2,0,17
959859,656143,2017-05-31,Assembly,"AB 530 COOPER Assembly Third Reading",56,15,9,0,80
959859,671909,2017-07-10,Senate,"Do pass, but first be re-referred to the Committee on [Appropriations]",3,1,1,0,5
959859,672742,2017-07-17,Senate,"Placed on suspense file",7,0,0,0,7
959859,674509,2017-09-01,Senate,"Do pass",5,2,0,0,7
959859,675079,2017-09-06,Senate,"Assembly 3rd Reading AB530 Cooper et al. By Mendoza",30,10,0,0,40
959859,675426,2017-09-11,Assembly,"AB 530 COOPER Concurrence in Senate Amendments",58,16,5,0,79
959861,631969,2017-04-25,Assembly,"Do pass and be re-referred to the Committee on [Appropriations] with recommendation: To Consent Calendar",15,0,1,0,16
959861,652144,2017-05-26,Assembly,"Do pass",17,0,0,0,17
959861,655764,2017-05-31,Assembly,"AB 505 CABALLERO Assembly Third Reading",77,0,3,0,80
959861,767947,2018-06-25,Senate,"Do pass as amended",9,0,0,0,9
959861,772253,2018-08-20,Senate,"Assembly 3rd Reading AB505 Caballero By Glazer",39,0,1,0,40
959861,773088,2018-08-28,Assembly,"With recommendation: That Senate amendments be concurred in",18,0,1,0,19
959861,773379,2018-08-29,Assembly,"AB 505 CABALLERO Concurrence in Senate Amendments",78,0,2,0,80
959863,627942,2017-04-18,Senate,"Do pass, but first be re-referred to the Committee on [Labor and Industrial Relations]",5,1,1,0,7
959863,633155,2017-04-26,Senate,"Do pass, but first be re-referred to the Committee on [Appropriations]",4,1,0,0,5
959863,644281,2017-05-15,Senate,"Placed on suspense file",7,0,0,0,7
959863,650263,2017-05-25,Senate,"Do pass",5,2,0,0,7
959863,654233,2017-05-30,Senate,"Senate 3rd Reading SB306 Hertzberg",25,14,1,0,40
959863,666279,2017-06-20,Assembly,"Do pass and be re-referred to the Committee on [Labor and Employment]",8,2,1,0,11
959863,671360,2017-07-05,Assembly,"Do pass and be re-referred to the Committee on [Appropriations]",5,2,0,0,7
959863,674588,2017-09-01,Assembly,"Do pass",11,5,1,0,17
959863,675604,2017-09-12,Assembly,"SB 306 Hertzberg Senate Third Reading By GONZALEZ FLETCHER",45,29,5,0,79
959863,675907,2017-09-13,Senate,"Unfinished Business SB306 Hertzberg et al. Concurrence",25,14,1,0,40
959866,612566,2017-03-27,Senate,"Do pass, but first be re-referred to the Committee on [Appropriations]",9,0,0,0,9
959866,629075,2017-04-20,Senate,"Senate 3rd Reading SB311 Pan",34,6,0,0,40
959866,768111,2018-06-26,Assembly,"Do pass as amended",19,0,0,0,19
959866,771852,2018-08-16,Assembly,"SB 311 Pan Third Reading Urgency By LOW",70,1,9,0,80
959866,772437,2018-08-22,Senate,"That the Assembly amendments be concurred in",8,0,1,0,9
959866,772560,2018-08-23,Senate,"Unfinished Business SB311 Pan Urgency Clause Concurrence",32,6,2,0,40
959867,618865,2017-04-04,Assembly,"Do pass and be re-referred to the Committee on [Higher Education]",14,0,2,0,16
959867,627945,2017-04-18,Assembly,"Do pass and be re-referred to the Committee on [Appropriations]",12,0,1,0,13
959867,633368,2017-04-26,Assembly,"Do pass. To Consent Calendar",16,0,1,0,17
959867,638444,2017-05-04,Assembly,"AB 508 SANTIAGO Consent Calendar Second Day Regular Session",76,0,4,0,80
959867,658623,2017-06-05,Senate,"Do pass, but first be re-referred to the Committee on [Appropriations]",9,0,0,0,9
959867,673967,2017-08-21,Senate,"Assembly 3rd Reading AB508 Santiago By Pan",35,2,3,0,40
959868,613690,2017-03-28,Assembly,"Do pass and be re-referred to the Committee on [Appropriations]",5,1,1,0,7
959868,633484,2017-04-26,Assembly,"Do pass",11,4,2,0,17
959868,635751,2017-05-01,Assembly,"AB 529 STONE Assembly Third Reading",47,22,11,0,80
959868,658843,2017-06-06,Senate,"Do pass as amended, but first amend, and re-refer to the Committee on [Appropriations]",6,1,0,0,7
959868,672706,2017-07-17,Senate,"Placed on suspense file",7,0,0,0,7
959868,674618,2017-09-01,Senate,"Do pass as amended",5,2,0,0,7
959868,675638,2017-09-12,Senate,"Assembly 3rd Reading AB529 Mark Stone By Wiener",32,5,3,0,40
959868,676340,2017-09-14,Assembly,"AB 529 STONE Concurrence in Senate Amendments",49,26,4,0,79
959870,628150,2017-04-19,Senate,"Do pass as amended, but first amend, and re-refer to the Committee on [Appropriations]",5,2,0,0,7
959870,644330,2017-05-15,Senate,"Placed on suspense file",7,0,0,0,7
959870,650820,2017-05-25,Senate,"Do pass",5,2,0,0,7
959870,654396,2017-05-30,Senate,"Senate 3rd Reading SB328 Portantino et al",25,13,2,0,40
959870,672566,2017-07-12,Assembly,"Do pass and be re-referred to the Committee on [Appropriations]",5,2,0,0,7
959870,674461,2017-09-01,Assembly,"Do pass as amended",12,4,1,0,17
959870,676314,2017-09-14,Assembly,"SB 328 Portantino Senate Third Reading By GLORIA",26,30,23,0,79
959870,774008,2018-08-31,Senate,"Unfinished Business SB328 Portantino et al. Concurrence",23,14,3,0,40
959870,774009,2018-08-31,Assembly,"SB 328 Portantino Senate Third Reading By GLORIA",41,34,5,0,80
959871,608244,2017-03-21,Assembly,"Do pass",7,0,0,0,7
959871,621503,2017-04-06,Assembly,"AB 493 JONES-SAWYER Assembly Third Reading",69,1,10,0,80
959871,658677,2017-06-06,Senate,"Do pass",6,0,1,0,7
959871,671888,2017-07-10,Senate,"Assembly 3rd Reading AB493 Jones-Sawyer By Lara",35,0,5,0,40
959871,671889,2017-07-10,Senate,"Assembly 3rd Reading AB493 Jones-Sawyer By Lara Reconsider",40,0,0,0,40
959871,672551,2017-07-13,Senate,"Assembly 3rd Reading AB493 Jones-Sawyer By Lara",35,0,5,0,40
959871,673854,2017-08-21,Assembly,"AB 493 JONES-SAWYER Concurrence in Senate Amendments",68,0,11,0,79
959873,608435,2017-03-21,Assembly,"Do pass",8,3,0,0,11
959875,613855,2017-03-28,Senate,"Do pass as amended, but first amend, and re-refer to the Committee on [Judiciary]",5,2,0,0,7
959875,627902,2017-04-18,Senate,"Do pass, but first be re-referred to the Committee on [Appropriations]",5,2,0,0,7
959875,635779,2017-05-01,Senate,"Placed on suspense file",7,0,0,0,7
959875,650390,2017-05-25,Senate,"Do pass as amended",5,2,0,0,7
959875,655817,2017-05-31,Senate,"Senate 3rd Reading SB310 Atkins et al",26,13,1,0,40
959875,669138,2017-06-27,Assembly,"Do pass and be re-referred to the Committee on [Public Safety]",9,2,0,0,11
959875,672113,2017-07-11,Assembly,"Do pass and be re-referred to the Committee on [Appropriations]",5,2,0,0,7
959875,674583,2017-09-01,Assembly,"Do pass as amended",11,5,1,0,17
959875,675777,2017-09-13,Assembly,"SB 310 Atkins Senate Third Reading By STONE",51,22,6,0,79
959875,676111,2017-09-14,Senate,"Unfinished Business SB310 Atkins et al. Concurrence",27,13,0,0,40
959877,608357,2017-03-21,Senate,"Do pass as amended, but first amend, and re-refer to the Committee on [Appropriations]",7,0,0,0,7
959877,626112,2017-04-17,Senate,"Placed on suspense file",7,0,0,0,7
959880,626919,2017-04-18,Assembly,"Do pass and be re-referred to the Committee on [Appropriations]",10,1,5,0,16
959880,645972,2017-05-17,Assembly,"Do pass",10,4,3,0,17
959880,654074,2017-05-30,Assembly,"AB 485 O'DONNELL Assembly Third Reading",55,11,14,0,80
959880,672740,2017-07-17,Senate,"Do pass as amended",7,1,1,0,9
959880,675591,2017-09-12,Senate,"Assembly 3rd Reading AB485 O'Donnell et al. By Galgiani",38,0,2,0,40
959880,676311,2017-09-14,Assembly,"AB 485 O'DONNELL Concurrence in Senate Amendments",65,3,11,0,79
959881,641523,2017-05-09,Assembly,"Do pass",2,7,2,0,11
959882,608427,2017-03-21,Assembly,"Do pass and be re-referred to the Committee on [Aging and Long-Term Care]",7,0,0,0,7
959882,619634,2017-04-04,Assembly,"Do pass and be re-referred to the Committee on [Appropriations]",7,0,0,0,7
959884,631795,2017-04-24,Assembly,"Do pass and be re-referred to the Committee on [Appropriations]",11,2,1,0,14
959884,637520,2017-05-03,Assembly,"Do pass",11,2,4,0,17
959884,643461,2017-05-11,Assembly,"AB 533 HOLDEN Assembly Third Reading",57,15,8,0,80
959884,775170,2017-05-03,Assembly,"d colspan=""5"" headers=""noes 05/03/17"" class=""columnField"" style=""text-align:left"">",11,2,4,0,17
959885,620623,2017-04-05,Senate,"Do pass, but first be re-referred to the Committee on [Insurance] with the recommendation: To Consent Calendar",7,0,0,0,7
959885,633669,2017-04-26,Senate,"Do pass, but first be re-referred to the Committee on [Appropriations] with the recommendation: To Consent Calendar",9,0,0,0,9
959885,644821,2017-05-15,Senate,"Placed on suspense file",7,0,0,0,7
959885,650581,2017-05-25,Senate,"Do pass",7,0,0,0,7
959885,655957,2017-05-31,Senate,"Special Consent Calendar # SB325 Mendoza Urgency Clause",40,0,0,0,40
959888,632064,2017-04-25,Assembly,"Do pass and be re-referred to the Committee on [Appropriations]",10,0,0,0,10
959888,651534,2017-05-26,Assembly,"Do pass",17,0,0,0,17
959888,654505,2017-05-30,Assembly,"AB 531 IRWIN Assembly Third Reading",77,0,3,0,80
959888,669342,2017-06-27,Senate,"Do pass, but first be re-referred to the Committee on [Appropriations]",13,0,0,0,13
959888,671971,2017-07-10,Senate,"Placed on suspense file",7,0,0,0,7
959888,674799,2017-09-01,Senate,"Do pass",7,0,0,0,7
959888,675394,2017-09-11,Senate,"Assembly 3rd Reading AB531 Irwin By Lara",40,0,0,0,40
959888,675864,2017-09-13,Assembly,"AB 531 IRWIN Concurrence in Senate Amendments",79,0,0,0,79
959889,610837,2017-03-22,Assembly,"Do pass and be re-referred to the Committee on [Privacy and Consumer Protection]",7,1,2,0,10
959889,627665,2017-04-18,Assembly,"Do pass as amended and be re-referred to the Committee on [Appropriations]",8,0,2,0,10
959889,637361,2017-05-03,Assembly,"Do pass",10,0,7,0,17
959889,644568,2017-05-15,Assembly,"AB 527 CABALLERO Assembly Third Reading",57,18,5,0,80
959889,667536,2017-06-21,Senate,"Do pass as amended, but first amend, and re-refer to the Committee on [Agriculture]",6,0,1,0,7
959889,675805,2017-09-13,Senate,"Assembly 3rd Reading AB527 Caballero By Wieckowski",38,2,0,0,40
959889,676386,2017-09-14,Assembly,"AB 527 Caballero Concurrence in Senate Amendments",57,17,5,0,79
959895,626756,2017-04-17,Assembly,"Do pass and be re-referred to the Committee on [Appropriations]",13,0,1,0,14
959895,651618,2017-05-26,Assembly,"Do pass as amended",16,0,1,0,17
959895,656097,2017-05-31,Assembly,"AB 503 LACKEY Assembly Third Reading",77,0,3,0,80
959895,672152,2017-07-11,Senate,"Do pass as amended, but first amend, and re-refer to the Committee on [Appropriations]",12,0,1,0,13
959895,674208,2017-08-28,Senate,"Placed on suspense file",7,0,0,0,7
959895,674488,2017-09-01,Senate,"Do pass as amended",5,0,2,0,7
959895,675707,2017-09-12,Senate,"Assembly 3rd Reading AB503 Lackey et al. By Hertzberg",39,0,1,0,40
959895,675870,2017-09-13,Assembly,"AB 503 Lackey Concurrence in Senate Amendments",78,0,1,0,79
959896,626990,2017-04-17,Assembly,"Do pass as amended and be re-referred to the Committee on [Appropriations]",7,3,0,0,10
959896,652176,2017-05-26,Assembly,"Do pass",11,6,0,0,17
959896,656068,2017-05-31,Assembly,"AB 509 FRAZIER Assembly Third Reading",45,30,5,0,80
959896,671352,2017-07-05,Senate,"Do pass, but first be re-referred to the Committee on [Appropriations]",5,2,0,0,7
959896,672686,2017-07-17,Senate,"Placed on suspense file",7,0,0,0,7
959897,627613,2017-04-18,Assembly,"Do pass and be re-referred to the Committee on [Public Safety]",14,0,1,0,15
959897,631975,2017-04-25,Assembly,"Do pass as amended, and be re-referred to the Committee on [Appropriations] with recommendation: To Consent Calendar",7,0,0,0,7
959897,652183,2017-05-26,Assembly,"Do pass as amended",16,0,1,0,17
959897,656152,2017-05-31,Assembly,"AB 532 WALDRON Assembly Third Reading",76,0,4,0,80
959897,669861,2017-06-28,Senate,"Do pass, but first be re-referred to the Committee on [Public Safety]",7,0,2,0,9
959897,672273,2017-07-11,Senate,"Do pass, but first be re-referred to the Committee on [Appropriations] with the recommendation: To Consent Calendar",7,0,0,0,7
959897,674402,2017-08-31,Senate,"Assembly 3rd Reading AB532 Waldron et al. By Beall",38,0,2,0,40
959897,674984,2017-09-05,Assembly,"AB 532 WALDRON Concurrence in Senate Amendments",77,0,2,0,79
959899,620014,2017-04-05,Senate,"Do pass, but first be re-referred to the Committee on [Appropriations]",7,0,0,0,7
959899,635768,2017-05-01,Senate,"Placed on suspense file",7,0,0,0,7
959900,632594,2017-04-25,Assembly,"Do pass and be re-referred to the Committee on [Appropriations]",7,0,0,0,7
959900,649474,2017-05-24,Assembly,"Do pass. To Consent Calendar",17,0,0,0,17
959900,654195,2017-05-30,Assembly,"AB 514 SALAS Consent Calendar Second Day Regular Session",77,0,3,0,80
959900,768313,2018-06-26,Senate,"Do pass as amended, but first amend, and re-refer to the Committee on [Appropriations]",6,0,1,0,7
959900,770569,2018-08-06,Senate,"Placed on suspense file",7,0,0,0,7
959900,771704,2018-08-16,Senate,"Do pass",7,0,0,0,7
959900,773210,2018-08-28,Senate,"Assembly 3rd Reading AB514 Salas By Jackson",36,0,4,0,40
959900,773682,2018-08-30,Assembly,"With recommendation: That Senate amendments be concurred in",7,0,0,0,7
959900,774124,2018-08-31,Assembly,"AB 514 SALAS Concurrence in Senate Amendments",80,0,0,0,80
959902,593795,2017-02-27,Senate,"Senate 3rd Reading SCR20 Morrell",38,0,2,0,40
959902,598318,2017-03-06,Assembly,"Be adopted. To Consent Calendar",11,0,0,0,11
959902,600632,2017-03-09,Assembly,"SCR 20 Morrell Consent Calendar Second Day Regular Session",76,0,4,0,80
959903,628105,2017-04-18,Assembly,"Do pass and be re-referred to the Committee on [Appropriations]",13,0,0,0,13
959903,633649,2017-04-26,Assembly,"Do pass. To Consent Calendar",16,0,1,0,17
959903,638349,2017-05-04,Assembly,"AB 504 MEDINA Consent Calendar Second Day Regular Session",76,0,4,0,80
959903,663209,2017-06-14,Senate,"Do pass, but first be re-referred to the Committee on [Appropriations] with the recommendation: To Consent Calendar",7,0,0,0,7
959903,670999,2017-07-03,Senate,"Consent Calendar 2nd AB504",33,0,7,0,40
959903,671591,2017-07-06,Assembly,"AB 504 MEDINA Concurrence in Senate Amendments",75,0,5,0,80
959903,675729,2017-09-12,Senate,"Assembly 3rd Reading AB504 Medina et al. By Hill",40,0,0,0,40
959903,675768,2017-09-13,Assembly,"AB 504 Medina Concurrence in Senate Amendments",77,0,2,0,79
959904,615338,2017-03-29,Assembly,"Do pass as amended and be re-referred to the Committee on [Appropriations]",9,3,3,0,15
959904,633137,2017-04-26,Assembly,"Do pass",12,4,1,0,17
959904,646449,2017-05-18,Assembly,"AB 523 REYES Assembly Third Reading Amend By REYES Set #1",45,25,10,0,80
959904,654520,2017-05-30,Assembly,"AB 523 REYES Assembly Third Reading",51,20,9,0,80
959904,666375,2017-06-20,Senate,"Do pass as amended, but first amend, and re-refer to the Committee on [Appropriations]",9,0,2,0,11
959904,671970,2017-07-10,Senate,"Placed on suspense file",7,0,0,0,7
959904,674739,2017-09-01,Senate,"Do pass as amended",5,2,0,0,7
959904,675337,2017-09-11,Senate,"Assembly 3rd Reading AB523 Reyes et al. By Lara",31,9,0,0,40
959904,675877,2017-09-13,Assembly,"AB 523 REYES Concurrence in Senate Amendments",40,26,13,0,79
959904,676309,2017-09-14,Assembly,"AB 523 REYES Concurrence in Senate Amendments",51,24,4,0,79
959906,607021,2017-03-20,Assembly,"Do pass and be re-referred to the Committee on [Appropriations]",12,0,2,0,14
959906,642519,2017-05-10,Assembly,"Do pass. To Consent Calendar",17,0,0,0,17
959906,646535,2017-05-18,Assembly,"AB 515 FRAZIER Consent Calendar Second Day Regular Session",69,0,11,0,80
959906,669227,2017-06-27,Senate,"Do pass, but first be re-referred to the Committee on [Appropriations]",12,1,0,0,13
959906,674287,2017-08-31,Senate,"Assembly 3rd Reading AB515 Frazier By Beall",37,2,1,0,40
959906,674920,2017-09-05,Assembly,"AB 515 FRAZIER Concurrence in Senate Amendments",75,1,3,0,79
959907,600066,2017-03-08,Assembly,"Be adopted. To third reading",5,1,1,0,7
959907,639567,2017-05-04,Assembly,"AJR 4 CERVANTES Assembly Third Reading",67,0,13,0,80
959907,666308,2017-06-20,Senate,"Be adopted. Ordered to third reading",11,0,2,0,13
959907,675741,2017-09-12,Senate,"Assembly 3rd Reading AJR4 Cervantes et al. By Newman",39,0,1,0,40
959908,642847,2017-05-10,Senate,"Do pass",5,1,1,0,7
959908,648095,2017-05-22,Senate,"Senate 3rd Reading SB302 Mendoza",31,3,6,0,40
959908,672650,2017-07-12,Assembly,"Do pass",6,2,1,0,9
959908,675543,2017-09-11,Assembly,"SB 302 Mendoza Senate Third Reading By DALY",52,24,3,0,79
959908,675646,2017-09-12,Senate,"Unfinished Business SB302 Mendoza Concurrence",33,5,2,0,40
959910,608352,2017-03-21,Senate,"Do pass, but first be re-referred to the Committee on [Judiciary]",7,0,0,0,7
959910,642507,2017-05-09,Senate,"Do pass as amended, and be ordered to the Consent Calendar",7,0,0,0,7
959910,647949,2017-05-22,Senate,"Consent Calendar 2nd SB331",37,0,3,0,40
959910,662329,2017-06-13,Assembly,"Do pass and be re-referred to the Committee on [Public Safety] with recommendation: To Consent Calendar",11,0,0,0,11
959910,672168,2017-07-11,Assembly,"Do pass. To Consent Calendar",7,0,0,0,7
959910,672950,2017-07-20,Assembly,"SB 331 Jackson Consent Calendar Second Day",67,0,12,0,79
959911,633605,2017-04-26,Senate,"Do pass, but first be re-referred to the Committee on [Appropriations]",7,0,0,0,7
959911,644492,2017-05-15,Senate,"Placed on suspense file",7,0,0,0,7
959911,650679,2017-05-25,Senate,"Do pass",7,0,0,0,7
959911,655942,2017-05-31,Senate,"Special Consent Calendar # SB317",40,0,0,0,40
959915,631669,2017-04-25,Senate,"Do pass as amended, but first amend, and re-refer to the Committee on [Appropriations] with the recommendation: To Consent Calendar",5,0,0,0,5
959915,647827,2017-05-22,Senate,"Consent Calendar 2nd SB332",37,0,3,0,40
959915,663182,2017-06-13,Assembly,"Do pass and be re-referred to the Committee on [Appropriations]",6,0,1,0,7
959915,669563,2017-06-28,Assembly,"Do pass",14,0,3,0,17
959915,672719,2017-07-17,Assembly,"SB 332 Stern Senate Third Reading By STONE",74,0,5,0,79
959918,614008,2017-03-27,Assembly,"Do pass as amended, and be re-referred to the Committee on [Appropriations] with recommendation: To Consent Calendar",10,0,0,0,10
959919,618261,2017-04-04,Senate,"Do pass, but first be re-referred to the Committee on [Appropriations]",5,1,1,0,7
959919,630517,2017-04-24,Senate,"Placed on suspense file",7,0,0,0,7
959922,626921,2017-04-18,Senate,"Do pass and be ordered to the Consent Calendar",7,0,0,0,7
959922,634650,2017-04-27,Senate,"Consent Calendar 2nd SB324 Roth",36,0,4,0,40
959922,662361,2017-06-13,Assembly,"Do pass. To Consent Calendar",7,0,0,0,7
959922,665298,2017-06-19,Assembly,"SB 324 Roth Consent Calendar Second Day Regular Session",74,0,6,0,80
959922,670253,2017-06-29,Senate,"Unfinished Business SB324 Roth Concurrence",36,0,4,0,40
959925,613775,2017-03-28,Senate,"Do pass, but first be re-referred to the Committee on [Veterans Affairs] with the recommendation: To Consent Calendar",12,0,1,0,13
959925,631614,2017-04-25,Senate,"Do pass, but first be re-referred to the Committee on [Appropriations]",6,0,1,0,7
959925,644532,2017-05-15,Senate,"Senate 3rd Reading SB330 Berryhill",39,0,1,0,40
959925,670302,2017-06-28,Assembly,"Do pass as amended and be re-referred to the Committee on [Veterans Affairs]",9,0,0,0,9
959925,672444,2017-07-11,Assembly,"Do pass and be re-referred to the Committee on [Appropriations]",9,0,1,0,10
959925,672844,2017-07-19,Assembly,"Do pass. To Consent Calendar",16,0,1,0,17
959925,674119,2017-08-24,Assembly,"SB 330 Berryhill, T. Consent Calendar Second Day Regular Session",76,0,3,0,79
959925,674329,2017-08-31,Senate,"Special Consent Calendar # SB330",37,0,3,0,40
959929,633471,2017-04-26,Assembly,"Do pass and be re-referred to the Committee on [Appropriations]",5,2,0,0,7
959929,652147,2017-05-26,Assembly,"Do pass",12,5,0,0,17
959929,656125,2017-05-31,Assembly,"AB 510 QUIRK-SILVA Assembly Third Reading",55,22,3,0,80
959929,669481,2017-06-27,Senate,"Do pass as amended, but first amend, and re-refer to the Committee on [Appropriations]",6,2,1,0,9
959929,673980,2017-08-21,Senate,"Placed on suspense file",7,0,0,0,7
959932,616023,2017-03-30,Assembly,"Be re-referred to the Committee on [Transportation]",10,0,1,0,11
959932,626016,2017-04-17,Assembly,"Do pass as amended and be re-referred to the Committee on [Appropriations]",13,0,1,0,14
959933,614880,2017-03-28,Senate,"Do pass as amended",6,0,1,0,7
959933,628961,2017-04-20,Senate,"Senate 3rd Reading SB313 Hertzberg et al",34,4,2,0,40
959933,672821,2017-07-18,Assembly,"Do pass as amended",10,0,0,0,10
959933,676204,2017-09-14,Assembly,"SB 313 Hertzberg Senate Third Reading By DABABNEH",78,0,1,0,79
959933,676464,2017-09-15,Senate,"Unfinished Business SB313 Hertzberg et al. Concurrence",38,0,2,0,40
959935,642449,2017-05-10,Assembly,"Do pass. To Consent Calendar",6,0,1,0,7
959935,646602,2017-05-18,Assembly,"AB 500 GOMEZ Consent Calendar Second Day Regular Session",69,0,11,0,80
959935,663193,2017-06-14,Senate,"Do pass and be ordered to the Consent Calendar",7,0,0,0,7
959935,676033,2017-09-13,Senate,"Assembly 3rd Reading AB500 Bloom et al. By Allen",40,0,0,0,40
959935,676260,2017-09-14,Assembly,"AB 500 Bloom Concurrence in Senate Amendments",78,0,1,0,79
959936,618565,2017-04-04,Assembly,"Do pass as amended and be re-referred to the Committee on [Human Services]",15,0,0,0,15
959936,633079,2017-04-25,Assembly,"Do pass and be re-referred to the Committee on [Appropriations] with recommendation: To Consent Calendar",7,0,0,0,7
959936,651621,2017-05-26,Assembly,"Do pass",17,0,0,0,17
959936,655807,2017-05-31,Assembly,"AB 501 RIDLEY-THOMAS Assembly Third Reading",75,0,5,0,80
959936,668948,2017-06-27,Senate,"Do pass as amended, but first amend, and re-refer to the Committee on [Health] with the recommendation: To Consent Calendar",5,0,0,0,5
959936,672593,2017-07-12,Senate,"Do pass as amended, but first amend, and re-refer to the Committee on [Appropriations] with the recommendation: To Consent Calendar",8,0,1,0,9
959936,673772,2017-08-21,Senate,"Placed on suspense file",7,0,0,0,7
959936,674510,2017-09-01,Senate,"Do pass as amended",7,0,0,0,7
959936,675346,2017-09-11,Senate,"Assembly 3rd Reading AB501 Ridley-Thomas By Roth",39,0,1,0,40
959936,675935,2017-09-13,Assembly,"AB 501 RIDLEY-THOMAS Concurrence in Senate Amendments",77,0,2,0,79
959937,632077,2017-04-24,Senate,"Do pass as amended",9,0,0,0,9
959937,635820,2017-05-01,Senate,"Senate 3rd Reading SB314 Nguyen",37,0,3,0,40
959937,669161,2017-06-27,Assembly,"Do pass",14,0,2,0,16
959937,674299,2017-08-31,Assembly,"SB 314 Nguyen Senate Third Reading By LOW",73,0,6,0,79
959937,674928,2017-09-05,Senate,"Special Consent SB314",40,0,0,0,40
959939,620152,2017-04-04,Senate,"Do pass and be ordered to the Consent Calendar",6,0,1,0,7
959939,629263,2017-04-20,Senate,"Consent Calendar 2nd SB333",36,0,4,0,40
959939,662387,2017-06-13,Assembly,"Do pass. To Consent Calendar",11,0,0,0,11
959939,665124,2017-06-19,Assembly,"SB 333 Anderson Consent Calendar Second Day Regular Session",74,0,6,0,80
959939,667958,2017-06-22,Senate,"Unfinished Business SB333 Anderson et al. Concurrence",37,0,3,0,40
959940,631940,2017-04-24,Assembly,"Do pass as amended and be re-referred to the Committee on [Appropriations]",10,0,0,0,10
959940,651678,2017-05-26,Assembly,"Do pass",17,0,0,0,17
959940,654121,2017-05-30,Assembly,"AB 525 AGUIAR-CURRY Assembly Third Reading",77,0,3,0,80
959940,671497,2017-07-05,Senate,"Do pass, but first be re-referred to the Committee on [Appropriations]",7,0,0,0,7
959940,674446,2017-08-31,Senate,"Assembly 3rd Reading AB525 Aguiar-Curry By Bates",39,0,1,0,40
961400,610681,2017-03-21,Assembly,"Do pass and be re-referred to the Committee on [Appropriations]",7,0,0,0,7
961400,652141,2017-05-26,Assembly,"Do pass as amended",16,0,1,0,17
961400,655765,2017-05-31,Assembly,"AB 557 RUBIO Assembly Third Reading",74,0,6,0,80
961400,672392,2017-07-11,Senate,"Do pass as amended, but first amend, and re-refer to the Committee on [Appropriations] with the recommendation: To Consent Calendar",7,0,0,0,7
961400,673848,2017-08-21,Senate,"Placed on suspense file",7,0,0,0,7
961400,674475,2017-09-01,Senate,"Do pass",7,0,0,0,7
961400,676108,2017-09-14,Senate,"Special Consent Calendar # AB557",40,0,0,0,40
961400,676442,2017-09-15,Assembly,"AB 557 RUBIO Concurrence in Senate Amendments",79,0,0,0,79
961401,631761,2017-04-25,Assembly,"Do pass as amended, and be re-referred to the Committee on [Appropriations] with recommendation: To Consent Calendar",7,0,0,0,7
961401,642557,2017-05-10,Assembly,"Do pass. To Consent Calendar",17,0,0,0,17
961401,646440,2017-05-18,Assembly,"AB 660 RUBIO Consent Calendar Second Day Regular Session",69,0,11,0,80
961401,666126,2017-06-20,Senate,"Do pass, but first be re-referred to the Committee on [Appropriations] with the recommendation: To Consent Calendar",7,0,0,0,7
961401,671905,2017-07-10,Senate,"Placed on suspense file",7,0,0,0,7
961401,674518,2017-09-01,Senate,"Do pass as amended",7,0,0,0,7
961401,676110,2017-09-14,Senate,"Special Consent Calendar # AB660",40,0,0,0,40
961401,676326,2017-09-14,Assembly,"AB 660 Rubio Special Consent Calendar 1st Day Regular Session",79,0,0,0,79
961402,636770,2017-05-02,Assembly,"Do pass as amended",11,0,0,0,11
961402,644257,2017-05-15,Assembly,"AB 634 EGGMAN Assembly Third Reading",78,0,2,0,80
961402,669103,2017-06-27,Senate,"Do pass as amended, but first amend, and re-refer to the Committee on [Judiciary]",13,0,0,0,13
961402,672846,2017-07-18,Senate,"Do pass as amended",6,0,1,0,7
961402,674978,2017-09-05,Senate,"Assembly 3rd Reading AB634 Eggman By Hertzberg",34,6,0,0,40
961402,675192,2017-09-07,Assembly,"AB 634 EGGMAN Concurrence in Senate Amendments",73,4,2,0,79
961403,618630,2017-04-04,Assembly,"Do pass and be re-referred to the Committee on [Appropriations]",14,0,1,0,15
961403,651856,2017-05-26,Assembly,"Do pass",17,0,0,0,17
961403,654433,2017-05-30,Assembly,"AB 612 RUBIO Assembly Third Reading",77,0,3,0,80
961404,613943,2017-03-28,Senate,"Do pass as amended, but first amend, and re-refer to the Committee on [Appropriations] with the recommendation: To Consent Calendar",9,0,0,0,9
961404,629050,2017-04-20,Senate,"Consent Calendar 2nd SB372",36,0,4,0,40
961404,670417,2017-06-28,Assembly,"Do pass as amended and be re-referred to the Committee on [Water, Parks, and Wildlife]",9,0,0,0,9
961404,672183,2017-07-11,Assembly,"Do pass and be re-referred to the Committee on [Appropriations]",15,0,0,0,15
961404,674246,2017-08-30,Assembly,"Do pass",15,0,2,0,17
961404,675538,2017-09-11,Assembly,"SB 372 Cannella Third Reading Urgency By GRAY",76,0,3,0,79
961404,676068,2017-09-14,Senate,"Special Consent Calendar SB372 Cannella et al. Urgency Clause",40,0,0,0,40
961405,613845,2017-03-28,Assembly,"Do pass and be re-referred to the Committee on [Appropriations] with recommendation: To Consent Calendar",7,0,0,0,7
961405,633557,2017-04-26,Assembly,"Do pass. To Consent Calendar",16,0,1,0,17
961405,638555,2017-05-04,Assembly,"AB 585 GIPSON Consent Calendar Second Day Regular Session",76,0,4,0,80
961405,662310,2017-06-13,Senate,"Do pass, but first be re-referred to the Committee on [Appropriations] with the recommendation: To Consent Calendar",7,0,0,0,7
961405,670966,2017-07-03,Senate,"Consent Calendar 2nd AB585",33,0,7,0,40
961406,630320,2017-04-24,Senate,"Do pass as amended, but first amend, and re-refer to the Committee on [Appropriations]",10,0,1,0,11
961406,644841,2017-05-15,Senate,"Placed on suspense file",7,0,0,0,7
961408,614677,2017-03-28,Senate,"Do pass and be ordered to the Consent Calendar",9,0,0,0,9
961408,617323,2017-04-03,Senate,"Consent Calendar 2nd SB367 Bates",39,0,1,0,40
961408,665678,2017-06-19,Assembly,"Do pass. To Consent Calendar",8,0,0,0,8
961408,672797,2017-07-17,Assembly,"SB 367 Bates Senate Third Reading By BROUGH",77,0,2,0,79
961408,674983,2017-09-05,Assembly,"SB 367 Bates Senate Third Reading By BROUGH",76,0,3,0,79
961408,675146,2017-09-07,Senate,"Special Consent Calendar # SB367",40,0,0,0,40
961409,632187,2017-04-24,Assembly,"Do pass and be re-referred to the Committee on [Appropriations]",4,6,0,0,10
961409,632188,2017-04-24,Assembly,Reconsideration,10,0,0,0,10
961410,618440,2017-04-03,Assembly,"Do pass as amended and be re-referred to the Committee on [Public Employees, Retirement, and Social Security]",10,0,0,0,10
961410,627989,2017-04-19,Assembly,"Do pass and be re-referred to the Committee on [Appropriations]",7,0,0,0,7
961412,620196,2017-04-04,Assembly,"Do pass and be re-referred to the Committee on [Appropriations]",7,0,0,0,7
961412,651858,2017-05-26,Assembly,"Do pass as amended",12,5,0,0,17
961412,655739,2017-05-31,Assembly,"AB 603 QUIRK-SILVA Assembly Third Reading",60,16,4,0,80
961412,671333,2017-07-05,Senate,"Do pass, but first be re-referred to the Committee on [Human Services]",6,0,1,0,7
961412,672418,2017-07-11,Senate,"Do pass, but first be re-referred to the Committee on [Appropriations]",7,0,0,0,7
961412,673910,2017-08-21,Senate,"Placed on suspense file",7,0,0,0,7
961412,674821,2017-09-01,Senate,"Do pass as amended",5,2,0,0,7
961412,675937,2017-09-13,Senate,"Assembly 3rd Reading AB603 Quirk-Silva By McGuire",40,0,0,0,40
961412,676192,2017-09-14,Assembly,"AB 603 Quirk-Silva Concurrence in Senate Amendments",62,17,0,0,79
961413,631785,2017-04-25,Assembly,"Do pass as amended and be re-referred to the Committee on [Appropriations]",15,0,0,0,15
961413,651752,2017-05-26,Assembly,"Do pass as amended",17,0,0,0,17
961413,655904,2017-05-31,Assembly,"AB 589 BIGELOW Assembly Third Reading",76,0,4,0,80
961413,672022,2017-07-11,Senate,"Do pass as amended, but first amend, and re-refer to the Committee on [Appropriations] with the recommendation: To Consent Calendar",9,0,0,0,9
961413,673875,2017-08-21,Senate,"Placed on suspense file",7,0,0,0,7
961413,674505,2017-09-01,Senate,"Do pass as amended",7,0,0,0,7
961413,675583,2017-09-12,Senate,"Assembly 3rd Reading AB589 Bigelow By Hertzberg",40,0,0,0,40
961413,675584,2017-09-12,Senate,"Assembly 3rd Reading AB589 Bigelow By Hertzberg Reconsider",39,0,1,0,40
961413,675873,2017-09-13,Senate,"Assembly 3rd Reading AB589 Bigelow By Hertzberg",40,0,0,0,40
961413,676188,2017-09-14,Assembly,"AB 589 Bigelow Concurrence in Senate Amendments",79,0,0,0,79
961413,774523,2017-09-13,Senate,,39,0,0,0,39
961414,629000,2017-04-18,Assembly,"Do pass and be re-referred to the Committee on [Appropriations]",13,0,0,0,13
961414,633187,2017-04-26,Assembly,"Do pass. To Consent Calendar",16,0,1,0,17
961414,638577,2017-05-04,Assembly,"AB 637 MEDINA Consent Calendar Second Day Regular Session",76,0,4,0,80
961414,667242,2017-06-21,Senate,"Do pass, but first be re-referred to the Committee on [Appropriations] with the recommendation: To Consent Calendar",6,0,1,0,7
961414,672951,2017-07-20,Senate,"Consent Calendar 2nd AB637",38,0,2,0,40
961414,674237,2017-08-29,Assembly,"With recommendation: That Senate amendments be concurred in",12,0,1,0,13
961414,675406,2017-09-11,Assembly,"AB 637 MEDINA Concurrence in Senate Amendments",79,0,0,0,79
961415,614791,2017-03-29,Senate,"Do pass, but first be re-referred to the Committee on [Rules]",6,0,1,0,7
961415,644534,2017-05-15,Senate,"Senate 3rd Reading SB365 Dodd et al",29,10,1,0,40
961415,670245,2017-06-28,Assembly,"Do pass as amended",8,0,1,0,9
961415,672724,2017-07-17,Assembly,"SB 365 Dodd Senate Third Reading By GRAYSON",59,14,6,0,79
961415,673905,2017-08-21,Senate,"Unfinished Business SB365 Dodd et al. Concurrence",29,10,1,0,40
961416,627233,2017-04-18,Assembly,"Do pass as amended and be re-referred to the Committee on [Appropriations]",8,3,0,0,11
961416,652126,2017-05-26,Assembly,"Do pass as amended",12,5,0,0,17
961416,656015,2017-05-31,Assembly,"AB 638 CABALLERO Assembly Third Reading",52,21,7,0,80
961416,672472,2017-07-11,Senate,"Do pass as amended, but first amend, and re-refer to the Committee on [Appropriations]",4,2,1,0,7
961416,767855,2018-06-25,Senate,"Placed on suspense file",7,0,0,0,7
961416,771802,2018-08-16,Senate,"Do pass",5,2,0,0,7
961416,773731,2018-08-30,Senate,"Assembly 3rd Reading AB638 Caballero et al. By Monning",13,17,10,0,40
961419,620284,2017-04-05,Assembly,"Do pass and be re-referred to the Committee on [Revenue and Taxation]",7,0,0,0,7
961419,641498,2017-05-08,Assembly,"Do pass as amended and be re-referred to the Committee on [Appropriations]",9,0,1,0,10
961419,651626,2017-05-26,Assembly,"Do pass",17,0,0,0,17
961419,654122,2017-05-30,Assembly,"AB 571 GARCIA, E. Assembly Third Reading",77,0,3,0,80
961419,669275,2017-06-27,Senate,"Do pass, but first be re-referred to the Committee on [Governance and Finance] with the recommendation: To Consent Calendar",12,0,1,0,13
961419,671403,2017-07-05,Senate,"Do pass, but first be re-referred to the Committee on [Appropriations]",6,1,0,0,7
961419,672779,2017-07-17,Senate,"Do pass",6,1,0,0,7
961419,672780,2017-07-17,Senate,"[07-17-2017] set for [First] hearing: Reconsideration of favorable vote granted",7,0,0,0,7
961419,672781,2017-07-17,Senate,"Do pass",7,0,0,0,7
961419,676616,2017-09-15,Senate,"Assembly 3rd Reading AB571 Eduardo Garcia et al. By Beall Urgency Clause",35,3,2,0,40
961419,676617,2017-09-15,Assembly,"AB 571 GARCIA, E. Concurrence - Urgency Added",78,0,1,0,79
961420,608361,2017-03-21,Senate,"Do pass, but first be re-referred to the Committee on [Appropriations] with the recommendation: To Consent Calendar",7,0,0,0,7
961420,661184,2017-04-06,Senate,"Consent Calendar 2nd SB381 De León",39,0,1,0,40
961420,662411,2017-06-13,Assembly,"Do pass and be re-referred to the Committee on [Appropriations] with recommendation: To Consent Calendar",7,0,0,0,7
961420,669682,2017-06-28,Assembly,"Do pass. To Consent Calendar",14,0,3,0,17
961421,615152,2017-03-28,Senate,"Do pass, but first be re-referred to the Committee on [Appropriations] with the recommendation: To Consent Calendar",7,0,0,0,7
961421,629164,2017-04-20,Senate,"Consent Calendar 2nd SB340",36,0,4,0,40
961421,671944,2017-07-10,Assembly,"Do pass and be re-referred to the Committee on [Appropriations] with recommendation: To Consent Calendar",7,0,4,0,11
961421,674056,2017-08-23,Assembly,"Do pass. To Consent Calendar",15,0,2,0,17
961421,674303,2017-08-31,Assembly,"SB 340 Hertzberg Consent Calendar Second Day Regular Session",73,0,6,0,79
961421,674924,2017-09-05,Senate,"Special Consent SB340",40,0,0,0,40
961422,626823,2017-04-18,Senate,"Do pass as amended, but first amend, and re-refer to the Committee on [Environmental Quality]",8,3,0,0,11
961422,644774,2017-05-15,Senate,"Placed on suspense file",7,0,0,0,7
961422,650644,2017-05-25,Senate,"Do pass",5,2,0,0,7
961422,654395,2017-05-30,Senate,"Senate 3rd Reading SB338 Skinner et al",25,13,2,0,40
961422,671363,2017-07-05,Assembly,"Do pass as amended and be re-referred to the Committee on [Appropriations]",11,2,2,0,15
961422,672874,2017-07-19,Assembly,"Do pass",12,4,1,0,17
961422,674859,2017-09-05,Assembly,"SB 338 Skinner Senate Third Reading By MULLIN",46,26,7,0,79
961422,675077,2017-09-06,Senate,"Unfinished Business SB338 Skinner et al. Concurrence",27,13,0,0,40
961423,627063,2017-04-17,Assembly,"Do pass as amended and be re-referred to the Committee on [Education]",9,1,0,0,10
961425,613829,2017-03-28,Senate,"Do pass, but first be re-referred to the Committee on [Agriculture] with the recommendation: To Consent Calendar",11,0,2,0,13
961425,627752,2017-04-18,Senate,"Do pass, but first be re-referred to the Committee on [Appropriations]",5,0,0,0,5
961425,644578,2017-05-15,Senate,"Placed on suspense file",7,0,0,0,7
961425,650760,2017-05-25,Senate,"Do pass",7,0,0,0,7
961425,655954,2017-05-31,Senate,"Special Consent Calendar # SB368",40,0,0,0,40
961425,667237,2017-06-21,Assembly,"Do pass and be re-referred to the Committee on [Agriculture] with recommendation: To Consent Calendar",17,0,4,0,21
961425,669802,2017-06-28,Assembly,"Do pass and be re-referred to the Committee on [Appropriations] with recommendation: To Consent Calendar",9,0,1,0,10
961425,672947,2017-07-19,Assembly,"Do pass. To Consent Calendar",16,0,1,0,17
961425,674134,2017-08-24,Assembly,"SB 368 McGuire Consent Calendar Second Day Regular Session",76,0,3,0,79
961425,675673,2017-09-12,Senate,"Unfinished Business SB368 McGuire et al. Concurrence",40,0,0,0,40
961426,632244,2017-04-25,Assembly,"Do pass as amended, and be re-referred to the Committee on [Appropriations] with recommendation: To Consent Calendar",7,0,0,0,7
961426,649269,2017-05-24,Assembly,"Do pass. To Consent Calendar",17,0,0,0,17
961426,654336,2017-05-30,Assembly,"AB 560 SALAS Consent Calendar Second Day Regular Session",77,0,3,0,80
961426,671371,2017-07-05,Senate,"Do pass as amended, but first amend, and re-refer to the Committee on [Appropriations]",7,0,0,0,7
961426,673768,2017-08-21,Senate,"Placed on suspense file",7,0,0,0,7
961426,674616,2017-09-01,Senate,"Do pass",7,0,0,0,7
961426,676112,2017-09-14,Senate,"Special Consent Calendar # AB560",40,0,0,0,40
961426,676343,2017-09-14,Assembly,"AB 560 Salas Special Consent Calendar 1st Day Regular Session",79,0,0,0,79
961427,611186,2017-03-23,Assembly,"Be adopted. To third reading",9,0,2,0,11
961428,610289,2017-03-22,Assembly,"Do pass as amended",6,1,0,0,7
961428,640578,2017-05-08,Assembly,"AB 591 O'DONNELL Assembly Third Reading",59,18,3,0,80
961428,660341,2017-06-07,Senate,"Do pass",6,1,0,0,7
961428,671912,2017-07-10,Senate,"Assembly 3rd Reading AB591 O'Donnell By Hueso",29,11,0,0,40
961429,614788,2017-03-28,Senate,"Do pass, but first be re-referred to the Committee on [Appropriations] with the recommendation: To Consent Calendar",7,0,0,0,7
961429,629157,2017-04-20,Senate,"Consent Calendar 2nd SB387",36,0,4,0,40
961429,662666,2017-06-13,Assembly,"Do pass and be re-referred to the Committee on [Appropriations] with recommendation: To Consent Calendar",11,0,0,0,11
961429,669671,2017-06-28,Assembly,"Do pass. To Consent Calendar",14,0,3,0,17
961429,671562,2017-07-06,Assembly,"SB 387 Jackson Consent Calendar Second Day Regular Session",74,0,6,0,80
961430,608288,2017-03-21,Assembly,"Do pass and be re-referred to the Committee on [Appropriations] with recommendation: To Consent Calendar",7,0,0,0,7
961430,651541,2017-05-26,Assembly,"Do pass",17,0,0,0,17
961430,654313,2017-05-30,Assembly,"AB 578 REYES Assembly Third Reading",76,0,4,0,80
961430,666091,2017-06-20,Senate,"Do pass, but first be re-referred to the Committee on [Appropriations]",6,1,0,0,7
961430,671860,2017-07-10,Senate,"Placed on suspense file",7,0,0,0,7
961431,627122,2017-04-17,Assembly,"Do pass and be re-referred to the Committee on [Appropriations] with recommendation: To Consent Calendar",10,0,0,0,10
961431,633550,2017-04-26,Assembly,"Do pass. To Consent Calendar",16,0,1,0,17
961431,638369,2017-05-04,Assembly,"AB 652 FLORA Consent Calendar Second Day Regular Session",76,0,4,0,80
961431,659786,2017-06-07,Senate,"Do pass, but first be re-referred to the Committee on [Appropriations] with the recommendation: To Consent Calendar",7,0,0,0,7
961431,670970,2017-07-03,Senate,"Consent Calendar 2nd AB652",33,0,7,0,40
961432,669808,2017-06-28,Senate,"Do pass as amended, but first amend, and re-refer to the Committee on [Appropriations]",7,0,0,0,7
961432,672769,2017-07-17,Senate,"Placed on suspense file",7,0,0,0,7
961432,674676,2017-09-01,Senate,"Do pass as amended",7,0,0,0,7
961432,675017,2017-09-06,Senate,"Senate 3rd Reading SB343 Bradford Urgency Clause",39,0,1,0,40
961432,769728,2018-07-02,Assembly,"Do pass as amended and be re-referred to the Committee on [Appropriations]",9,0,1,0,10
961432,771853,2018-08-16,Assembly,"Do pass as amended",12,0,5,0,17
961432,773565,2018-08-29,Assembly,"SB 343 Bradford Third Reading Urgency By GIPSON",80,0,0,0,80
961432,773694,2018-08-30,Senate,"Unfinished Business SB343 Bradford Urgency Clause Concurrence",39,0,1,0,40
961433,626038,2017-04-17,Assembly,"Do pass and be re-referred to the Committee on [Communications and Conveyance]",13,0,1,0,14
961433,634569,2017-04-26,Assembly,"Do pass and be re-referred to the Committee on [Appropriations]",12,0,1,0,13
961433,651561,2017-05-26,Assembly,"Do pass",17,0,0,0,17
961433,654186,2017-05-30,Assembly,"AB 623 RODRIGUEZ Assembly Third Reading",77,0,3,0,80
961433,668974,2017-06-27,Senate,"Do pass as amended, but first amend, and re-refer to the Committee on [Appropriations] with the recommendation: To Consent Calendar",12,0,1,0,13
961435,615039,2017-03-29,Assembly,"Do pass and be re-referred to the Committee on [Appropriations]",19,0,2,0,21
961435,633558,2017-04-26,Assembly,"Do pass. To Consent Calendar",16,0,1,0,17
961435,638719,2017-05-04,Assembly,"AB 609 SANTIAGO Consent Calendar Second Day Regular Session",76,0,4,0,80
961435,662304,2017-06-13,Senate,"Do pass, but first be re-referred to the Committee on [Appropriations]",12,0,1,0,13
961435,674340,2017-08-31,Senate,"Assembly 3rd Reading AB609 Santiago By Dodd",40,0,0,0,40
961436,633298,2017-04-26,Assembly,"Do pass as amended and be re-referred to the Committee on [Appropriations]",5,1,1,0,7
961436,651740,2017-05-26,Assembly,"Do pass",13,4,0,0,17
961436,655939,2017-05-31,Assembly,"AB 668 GONZALEZ FLETCHER Assembly Third Reading",56,19,5,0,80
961436,669919,2017-06-28,Senate,"Do pass as amended, but first amend, and re-refer to the Committee on [Elections and Constitutional Amendments]",5,2,0,0,7
961436,672633,2017-07-12,Senate,"Do pass, but first be re-referred to the Committee on [Appropriations]",4,1,0,0,5
961436,673747,2017-08-21,Senate,"Placed on suspense file",7,0,0,0,7
961436,674826,2017-09-01,Senate,"Do pass as amended",5,2,0,0,7
961437,621636,2017-04-05,Assembly,"Do pass as amended, and be re-referred to the Committee on [Appropriations] with recommendation: To Consent Calendar",7,0,0,0,7
961437,652131,2017-05-26,Assembly,"Do pass",17,0,0,0,17
961437,655736,2017-05-31,Assembly,"AB 643 FRAZIER Assembly Third Reading",77,0,3,0,80
961437,670001,2017-06-28,Senate,"Do pass, but first be re-referred to the Committee on [Appropriations]",7,0,0,0,7
961437,672008,2017-07-10,Senate,"Placed on suspense file",7,0,0,0,7
961437,674817,2017-09-01,Senate,"Do pass",6,0,1,0,7
961437,676004,2017-09-13,Senate,"Assembly 3rd Reading AB643 Frazier By Leyva",40,0,0,0,40
961437,676302,2017-09-14,Assembly,"AB 643 Frazier Concurrence in Senate Amendments",78,0,1,0,79
961438,631709,2017-04-25,Assembly,"Do pass and be re-referred to the Committee on [Appropriations]",14,0,1,0,15
961438,651791,2017-05-26,Assembly,"Do pass as amended",12,0,5,0,17
961438,655984,2017-05-31,Assembly,"AB 587 CHIU Assembly Third Reading",73,0,7,0,80
961438,671525,2017-07-05,Senate,"Do pass as amended, but first amend, and re-refer to the Committee on [Appropriations]",9,0,0,0,9
961439,620131,2017-04-04,Assembly,"Do pass and be re-referred to the Committee on [Appropriations]",7,0,0,0,7
961439,686177,2018-01-18,Assembly,"Do pass as amended",17,0,0,0,17
961439,689940,2018-01-29,Assembly,"AB 550 REYES Assembly Third Reading",77,0,0,0,77
961440,613789,2017-03-28,Senate,"Do pass, but first be re-referred to the Committee on [Appropriations]",4,0,1,0,5
961440,635669,2017-05-01,Senate,"Senate 3rd Reading SB360 Skinner",37,0,3,0,40
961440,672410,2017-07-11,Assembly,"Do pass and be re-referred to the Committee on [Appropriations]",7,0,0,0,7
961440,674030,2017-08-23,Assembly,"Do pass. To Consent Calendar",15,0,2,0,17
961440,674293,2017-08-31,Assembly,"SB 360 Skinner Consent Calendar Second Day Regular Session",73,0,6,0,79
961440,674939,2017-09-05,Senate,"Special Consent SB360",40,0,0,0,40
961441,641756,2017-05-09,Assembly,"Do pass as amended",7,0,0,0,7
961441,647992,2017-05-22,Assembly,"AB 597 STONE Assembly Third Reading",65,5,10,0,80
961441,662112,2017-06-13,Senate,"Do pass as amended, but first amend, and re-refer to the Committee on [Judiciary]",4,0,1,0,5
961441,669686,2017-06-27,Senate,"Do pass",6,0,1,0,7
961441,675366,2017-09-11,Senate,"Assembly 3rd Reading AB597 Mark Stone By Hill",38,0,2,0,40
961441,675939,2017-09-13,Assembly,"AB 597 STONE Concurrence in Senate Amendments",69,8,2,0,79
961442,618557,2017-04-04,Assembly,"Do pass and be re-referred to the Committee on [Appropriations]",15,0,0,0,15
961443,610742,2017-03-22,Senate,"Do pass and be ordered to the Consent Calendar",7,0,0,0,7
961443,616118,2017-03-30,Senate,"Consent Calendar 2nd SB344",37,0,3,0,40
961443,667350,2017-06-21,Assembly,"Do pass as amended",7,0,0,0,7
961443,674436,2017-08-31,Assembly,"SB 344 Bradford Senate Third Reading By MCCARTY",75,0,4,0,79
961443,674919,2017-09-05,Senate,"Special Consent SB344",40,0,0,0,40
961444,614423,2017-03-28,Senate,"Do pass, but first be re-referred to the Committee on [Appropriations]",7,2,0,0,9
961444,626283,2017-04-17,Senate,"Placed on suspense file",7,0,0,0,7
961444,650566,2017-05-25,Senate,"Do pass",5,2,0,0,7
961444,654306,2017-05-30,Senate,"Senate 3rd Reading SB386 Glazer et al",29,11,0,0,40
961444,668977,2017-06-27,Assembly,"Do pass as amended and be re-referred to the Committee on [Appropriations]",10,4,1,0,15
961444,674523,2017-09-01,Assembly,"Do pass",11,5,1,0,17
961444,675663,2017-09-12,Assembly,"SB 386 Glazer Senate Third Reading By GONZALEZ FLETCHER",56,22,1,0,79
961444,675798,2017-09-13,Senate,"Unfinished Business SB386 Glazer et al. Concurrence",28,12,0,0,40
961445,615928,2017-03-29,Senate,"Do pass as amended, but first amend, and re-refer to the Committee on [Appropriations]",7,0,2,0,9
961445,630495,2017-04-24,Senate,"Senate 3rd Reading SB374 Newman",39,0,1,0,40
961445,666240,2017-06-20,Assembly,"Do pass and be re-referred to the Committee on [Appropriations] with recommendation: To Consent Calendar",15,0,0,0,15
961445,669740,2017-06-28,Assembly,"Do pass. To Consent Calendar",14,0,3,0,17
961445,671595,2017-07-06,Assembly,"SB 374 Newman Consent Calendar Second Day Regular Session",74,0,6,0,80
961445,672627,2017-07-13,Senate,"Unfinished Business SB374 Newman Concurrence",36,0,4,0,40
961446,621144,2017-04-05,Assembly,"Do pass and be re-referred to the Committee on [Appropriations] with recommendation: To Consent Calendar",7,0,0,0,7
961446,633584,2017-04-26,Assembly,"Do pass. To Consent Calendar",16,0,1,0,17
961446,638527,2017-05-04,Assembly,"AB 616 AGUIAR-CURRY Consent Calendar Second Day Regular Session",76,0,4,0,80
961446,660211,2017-06-07,Senate,"Do pass, but first be re-referred to the Committee on [Appropriations] with the recommendation: To Consent Calendar",7,0,0,0,7
961446,668704,2017-06-26,Senate,"Placed on suspense file",7,0,0,0,7
961446,674557,2017-09-01,Senate,"Do pass",7,0,0,0,7
961446,675308,2017-09-11,Senate,"Assembly 3rd Reading AB616 Aguiar-Curry et al. By Atkins",40,0,0,0,40
961447,637573,2017-05-03,Assembly,"Do pass and be re-referred to the Committee on [Appropriations]",12,1,0,0,13
961447,651890,2017-05-26,Assembly,"Do pass",13,3,1,0,17
961447,656179,2017-05-31,Assembly,"AB 570 GONZALEZ FLETCHER Assembly Third Reading",61,15,4,0,80
961447,672485,2017-07-12,Senate,"Do pass, but first be re-referred to the Committee on [Appropriations]",4,1,0,0,5
961447,673745,2017-08-21,Senate,"Placed on suspense file",7,0,0,0,7
961447,674741,2017-09-01,Senate,"Do pass",5,2,0,0,7
961447,675229,2017-09-07,Senate,"Assembly 3rd Reading AB570 Gonzalez Fletcher By Hueso",25,11,4,0,40
961450,618286,2017-04-04,Assembly,"Do pass and be re-referred to the Committee on [Appropriations]",15,0,1,0,16
961450,637267,2017-05-03,Assembly,"Do pass. To Consent Calendar",16,0,1,0,17
961450,654330,2017-05-30,Assembly,"AB 602 BONTA Third Reading Urgency",75,0,5,0,80
961450,664998,2017-06-19,Senate,"Do pass, but first be re-referred to the Committee on [Appropriations] with the recommendation: To Consent Calendar",9,0,0,0,9
961450,671902,2017-07-10,Senate,"Consent Calendar 2nd AB602 Bonta Urgency Clause",40,0,0,0,40
961450,672701,2017-07-17,Assembly,"AB 602 BONTA Concurrence in Senate Amendments",77,0,2,0,79
961451,617950,2017-04-03,Senate,"Do pass as amended, but first amend, and re-refer to the Committee on [Appropriations]",9,0,0,0,9
961451,626253,2017-04-17,Senate,"Placed on suspense file",7,0,0,0,7
961451,650776,2017-05-25,Senate,"Do pass",7,0,0,0,7
961451,655965,2017-05-31,Senate,"Special Consent Calendar # SB351",40,0,0,0,40
961451,672149,2017-07-11,Assembly,"Do pass and be re-referred to the Committee on [Appropriations]",16,0,0,0,16
961451,674654,2017-09-01,Assembly,"Do pass as amended",16,0,1,0,17
961451,675967,2017-09-13,Assembly,"SB 351 Roth Senate Third Reading By RIDLEY-THOMAS",78,0,1,0,79
961451,676267,2017-09-14,Senate,"Unfinished Business SB351 Roth et al. Concurrence",39,1,0,0,40
961452,614921,2017-03-28,Senate,"Do pass as amended, but first amend, and re-refer to the Committee on [Public Safety] with the recommendation: To Consent Calendar",7,0,0,0,7
961452,627119,2017-04-18,Senate,"Do pass as amended, but first amend, and re-refer to the Committee on [Appropriations] with the recommendation: To Consent Calendar",7,0,0,0,7
961452,644273,2017-05-15,Senate,"Placed on suspense file",7,0,0,0,7
961455,635778,2017-05-01,Assembly,"Be re-referred to the Committee on [Judiciary]",10,0,1,0,11
961455,641900,2017-05-09,Assembly,"Do pass",10,1,0,0,11
961455,656877,2017-06-01,Assembly,"AB 646 KALRA Assembly Third Reading",65,7,8,0,80
961455,672902,2017-07-18,Senate,"Do pass, but first be re-referred to the Committee on [Appropriations]",7,0,0,0,7
961455,673748,2017-08-21,Senate,"Placed on suspense file",7,0,0,0,7
961455,674625,2017-09-01,Senate,"Do pass as amended",7,0,0,0,7
961455,675191,2017-09-07,Senate,"Assembly 3rd Reading AB646 Kalra et al. By Beall",40,0,0,0,40
961455,675341,2017-09-11,Assembly,"AB 646 KALRA Concurrence in Senate Amendments",76,0,3,0,79
961456,631947,2017-04-24,Assembly,"Do pass as amended and be re-referred to the Committee on [Appropriations]",7,2,1,0,10
961457,628064,2017-04-19,Assembly,"Do pass and be re-referred to the Committee on [Appropriations] with recommendation: To Consent Calendar",7,0,0,0,7
961457,642762,2017-05-10,Assembly,"Do pass. To Consent Calendar",17,0,0,0,17
961457,646589,2017-05-18,Assembly,"AB 590 MEDINA Consent Calendar Second Day Regular Session",69,0,11,0,80
961457,661980,2017-06-12,Senate,"Do pass, but first be re-referred to the Committee on [Appropriations] with the recommendation: To Consent Calendar",5,0,0,0,5
961457,670953,2017-07-03,Senate,"Consent Calendar 2nd AB590",33,0,7,0,40
961458,627994,2017-04-19,Assembly,"Do pass and be re-referred to the Committee on [Revenue and Taxation]",11,1,1,0,13
961458,631889,2017-04-24,Assembly,"Do pass as amended and be re-referred to the Committee on [Appropriations]",6,1,3,0,10
961459,618271,2017-04-04,Assembly,"Do pass and be re-referred to the Committee on [Judiciary] with recommendation: To Consent Calendar",14,0,1,0,15
961459,626801,2017-04-18,Assembly,"Do pass and be re-referred to the Committee on [Appropriations] with recommendation: To Consent Calendar",11,0,0,0,11
961459,637612,2017-05-03,Assembly,"Do pass. To Consent Calendar",16,0,1,0,17
961459,643395,2017-05-11,Assembly,"AB 575 JONES-SAWYER Consent Calendar Second Day Regular Session",77,0,3,0,80
961459,666342,2017-06-20,Senate,"Do pass, but first be re-referred to the Committee on [Appropriations] with the recommendation: To Consent Calendar",7,0,0,0,7
961459,672562,2017-07-13,Senate,"Consent Calendar 2nd AB575",39,0,1,0,40
961459,674925,2017-09-05,Senate,"Assembly 3rd Reading AB575 Jones-Sawyer By Beall",40,0,0,0,40
961459,675187,2017-09-07,Assembly,"AB 575 JONES-SAWYER Concurrence in Senate Amendments",79,0,0,0,79
961460,627887,2017-04-18,Assembly,"Do pass and be re-referred to the Committee on [Appropriations]",7,0,0,0,7
961460,651822,2017-05-26,Assembly,"Do pass as amended",14,0,3,0,17
961460,656241,2017-05-31,Assembly,"AB 614 LIMÓN Assembly Third Reading",74,0,6,0,80
961460,672529,2017-07-12,Senate,"Do pass as amended, but first amend, and re-refer to the Committee on [Appropriations]",8,0,1,0,9
961460,673742,2017-08-21,Senate,"Placed on suspense file",7,0,0,0,7
961461,634616,2017-04-26,Assembly,"Do pass and be re-referred to the Committee on [Appropriations]",7,0,2,0,9
961461,643238,2017-05-10,Assembly,"Do pass",13,3,1,0,17
961461,644548,2017-05-15,Assembly,"AB 552 IRWIN Assembly Third Reading",59,15,6,0,80
961461,672327,2017-07-11,Senate,"Do pass as amended, but first amend, and re-refer to the Committee on [Appropriations]",6,1,0,0,7
961461,674311,2017-08-31,Senate,"Assembly 3rd Reading AB552 Irwin By Jackson",28,10,2,0,40
961461,674917,2017-09-05,Assembly,"AB 552 IRWIN Concurrence in Senate Amendments",60,16,3,0,79
961463,610082,2017-03-21,Assembly,"Do pass and be re-referred to the Committee on [Appropriations] with recommendation: To Consent Calendar",7,0,0,0,7
961464,619362,2017-04-04,Senate,"Do pass, but first be re-referred to the Committee on [Governance and Finance]",3,0,2,0,5
961464,634513,2017-04-26,Senate,"Do pass, but first be re-referred to the Committee on [Appropriations]",7,0,0,0,7
961464,647924,2017-05-22,Senate,"Senate 3rd Reading SB348 Leyva",34,3,3,0,40
961464,663106,2017-06-14,Assembly,"Do pass and be re-referred to the Committee on [Local Government]",6,0,1,0,7
961465,641503,2017-05-08,Senate,"Do pass",2,3,0,0,5
961465,641504,2017-05-08,Senate,"[First] hearing set for [05-09-2017]: Failed passage in Committee. Reconsideration granted",5,0,0,0,5
961466,626173,2017-04-17,Senate,"Do pass, but first be re-referred to the Committee on [Appropriations]",9,0,0,0,9
961466,630422,2017-04-24,Senate,"Placed on suspense file",7,0,0,0,7
961466,650345,2017-05-25,Senate,"Do pass",7,0,0,0,7
961466,656270,2017-05-31,Senate,"Special Consent Calendar # SB357",40,0,0,0,40
961466,672119,2017-07-11,Assembly,"Do pass as amended and be re-referred to the Committee on [Appropriations]",6,0,1,0,7
961466,674592,2017-09-01,Assembly,"Do pass",16,0,1,0,17
961466,675600,2017-09-12,Assembly,"SB 357 Hueso Senate Third Reading By GARCIA, E",78,0,1,0,79
961466,675876,2017-09-13,Senate,"Unfinished Business SB357 Hueso et al. Concurrence",40,0,0,0,40
961470,606887,2017-03-20,Assembly,"Do pass and be re-referred to the Committee on [Appropriations] with recommendation: To Consent Calendar",14,0,0,0,14
961470,619870,2017-04-05,Assembly,"Do pass. To Consent Calendar",17,0,0,0,17
961470,629192,2017-04-20,Assembly,"AB 636 IRWIN Consent Calendar Second Day Regular Session",74,0,6,0,80
961470,763092,2018-06-13,Senate,"Do pass, but first be re-referred to the Committee on [Appropriations] with the recommendation: To Consent Calendar",7,0,0,0,7
961470,769640,2018-07-02,Senate,"Consent Calendar AB636",37,0,2,0,39
961470,770953,2018-08-06,Assembly,"AB 636 IRWIN Concurrence in Senate Amendments",77,0,3,0,80
961471,608280,2017-03-21,Assembly,"Do pass and be re-referred to the Committee on [Appropriations] with recommendation: To Consent Calendar",7,0,0,0,7
961472,621290,2017-04-05,Assembly,"Do pass and be re-referred to the Committee on [Utilities and Energy]",8,0,1,0,9
961472,628062,2017-04-19,Assembly,"Do pass and be re-referred to the Committee on [Appropriations]",14,0,1,0,15
961472,652152,2017-05-26,Assembly,"Do pass as amended",12,0,5,0,17
961472,656168,2017-05-31,Assembly,"AB 546 CHIU Assembly Third Reading",75,0,5,0,80
961472,671477,2017-07-05,Senate,"Do pass as amended, but first amend, and re-refer to the Committee on [Appropriations]",7,0,0,0,7
961472,675002,2017-09-05,Senate,"Assembly 3rd Reading AB546 Chiu By Allen",40,0,0,0,40
961472,675208,2017-09-07,Assembly,"AB 546 CHIU Concurrence in Senate Amendments",78,0,1,0,79
961473,633698,2017-04-26,Assembly,"Do pass and be re-referred to the Committee on [Appropriations]",3,4,0,0,7
961473,633699,2017-04-26,Assembly,Reconsideration,7,0,0,0,7
961473,684874,2018-01-10,Assembly,"Do pass as amended and be re-referred to the Committee on [Appropriations]",7,0,0,0,7
961473,686204,2018-01-18,Assembly,"Do pass. To Consent Calendar",17,0,0,0,17
961473,689998,2018-01-29,Assembly,"AB 664 STEINORTH Consent Calendar Second Day Regular Session",75,0,2,0,77
961473,765309,2018-06-19,Senate,"Do pass, but first be re-referred to the Committee on [Appropriations]",5,0,0,0,5
961473,770959,2018-08-06,Senate,"Assembly 3rd Reading AB664 Steinorth By Stern",37,0,2,0,39
961473,771150,2018-08-09,Assembly,"AB 664 STEINORTH Concurrence in Senate Amendments",77,0,3,0,80
961474,610329,2017-03-22,Assembly,"Do pass and be re-referred to the Committee on [Appropriations]",7,0,0,0,7
961474,637514,2017-05-03,Assembly,"Do pass. To Consent Calendar",16,0,1,0,17
961474,643660,2017-05-11,Assembly,"AB 667 REYES Consent Calendar Second Day Regular Session",77,0,3,0,80
961474,663273,2017-06-14,Senate,"Do pass, but first be re-referred to the Committee on [Appropriations] with the recommendation: To Consent Calendar",7,0,0,0,7
961474,668763,2017-06-26,Senate,"Placed on suspense file",7,0,0,0,7
961474,674825,2017-09-01,Senate,"Do pass",7,0,0,0,7
961474,676065,2017-09-14,Senate,"Special Consent Calendar # AB667",40,0,0,0,40
961475,608466,2017-03-21,Assembly,"Do pass as amended and be re-referred to the Committee on [Appropriations]",9,2,4,0,15
961476,627904,2017-04-19,Assembly,"Do pass and be re-referred to the Committee on [Judiciary]",10,1,2,0,13
961476,652138,2017-05-26,Assembly,"Do pass",12,3,2,0,17
961476,656146,2017-05-31,Assembly,"AB 553 DALY Assembly Third Reading",56,18,6,0,80
961476,672303,2017-07-12,Senate,"Do pass, but first be re-referred to the Committee on [Appropriations]",4,1,0,0,5
961476,771244,2018-08-13,Senate,"Placed on suspense file",7,0,0,0,7
961476,771903,2018-08-16,Senate,"Do pass as amended",5,2,0,0,7
961476,773037,2018-08-27,Senate,"Assembly 3rd Reading AB553 Daly By Lara",26,12,2,0,40
961476,773484,2018-08-29,Assembly,"AB 553 DALY Concurrence in Senate Amendments",56,22,2,0,80
961477,627912,2017-04-18,Assembly,"Do pass and be re-referred to the Committee on [Judiciary]",7,0,0,0,7
961477,641400,2017-05-09,Assembly,"Do pass",11,0,0,0,11
961477,644241,2017-05-15,Assembly,"AB 611 DABABNEH Assembly Third Reading",78,0,2,0,80
961477,659782,2017-06-07,Senate,"Do pass, but first be re-referred to the Committee on [Judiciary]",11,0,2,0,13
961477,672886,2017-07-18,Senate,"Do pass and be ordered to the Consent Calendar",7,0,0,0,7
961477,675013,2017-09-06,Senate,"Assembly 3rd Reading AB611 Dababneh By Mendoza",40,0,0,0,40
961477,675403,2017-09-11,Assembly,"AB 611 DABABNEH Concurrence in Senate Amendments",78,0,1,0,79
961478,620473,2017-04-04,Assembly,"Do pass as amended and be re-referred to the Committee on [Judiciary]",7,0,0,0,7
961478,637231,2017-05-02,Assembly,"Do pass. To Consent Calendar",11,0,0,0,11
961478,640593,2017-05-08,Assembly,"AB 619 DAHLE Consent Calendar Second Day Regular Session",77,0,3,0,80
961478,659917,2017-06-07,Senate,"Do pass, but first be re-referred to the Committee on [Judiciary]",7,0,0,0,7
961478,666310,2017-06-20,Senate,"Do pass as amended, and be ordered to the Consent Calendar",7,0,0,0,7
961478,671014,2017-07-03,Senate,"Consent Calendar 2nd AB619",33,0,7,0,40
961478,671613,2017-07-06,Assembly,"AB 619 DAHLE Concurrence in Senate Amendments",76,0,4,0,80
961480,609750,2017-03-21,Assembly,"Do pass and be re-referred to the Committee on [Judiciary]",7,0,0,0,7
961480,627069,2017-04-18,Assembly,"Do pass and be re-referred to the Committee on [Appropriations] with recommendation: To Consent Calendar",11,0,0,0,11
961480,651647,2017-05-26,Assembly,"Do pass",17,0,0,0,17
961480,654410,2017-05-30,Assembly,"AB 604 GIPSON Assembly Third Reading",77,0,3,0,80
961480,669013,2017-06-27,Senate,"Do pass, but first be re-referred to the Committee on [Judiciary] with the recommendation: To Consent Calendar",5,0,0,0,5
961480,672336,2017-07-11,Senate,"Do pass, but first be re-referred to the Committee on [Appropriations]",7,0,0,0,7
961480,673799,2017-08-21,Senate,"Placed on suspense file",7,0,0,0,7
961480,674562,2017-09-01,Senate,"Do pass as amended",7,0,0,0,7
961480,676199,2017-09-14,Senate,"Special Consent Calendar # AB604",40,0,0,0,40
961480,676200,2017-09-14,Assembly,"AB 604 Gipson Special Consent Calendar 1st Day Regular Session",79,0,0,0,79
961481,627460,2017-04-17,Assembly,"Do pass as amended and be re-referred to the Committee on [Appropriations]",7,2,1,0,10
961482,620149,2017-04-05,Senate,"Do pass, but first be re-referred to the Committee on [Appropriations]",5,1,1,0,7
961482,626765,2017-04-17,Senate,"Placed on suspense file",7,0,0,0,7
961482,650692,2017-05-25,Senate,"Do pass as amended",5,2,0,0,7
961482,655933,2017-05-31,Senate,"Senate 3rd Reading SB377 Monning",27,12,1,0,40
961482,672036,2017-07-11,Assembly,"Do pass and be re-referred to the Committee on [Appropriations]",7,0,0,0,7
961482,674740,2017-09-01,Assembly,"Do pass",11,5,1,0,17
961483,627179,2017-04-18,Assembly,"Do pass as amended and be re-referred to the Committee on [Appropriations]",15,0,1,0,16
961483,642840,2017-05-10,Assembly,"Do pass",16,1,0,0,17
961483,644459,2017-05-15,Assembly,"AB 613 NAZARIAN Assembly Third Reading",78,0,2,0,80
961483,662044,2017-06-12,Senate,"Do pass, but first be re-referred to the Committee on [Appropriations]",9,0,0,0,9
961483,674187,2017-08-28,Senate,"Do pass as amended",7,0,0,0,7
961483,773003,2018-08-27,Senate,"Assembly 3rd Reading AB613 Nazarian et al. By Hill",37,0,3,0,40
961483,773312,2018-08-29,Assembly,"AB 613 NAZARIAN Concurrence in Senate Amendments",80,0,0,0,80
961484,608504,2017-03-21,Assembly,"Do pass and be re-referred to the Committee on [Appropriations]",14,0,1,0,15
961484,620540,2017-04-05,Assembly,"Do pass. To Consent Calendar",17,0,0,0,17
961484,629430,2017-04-20,Assembly,"AB 661 MAYES Consent Calendar Second Day Regular Session",74,0,6,0,80
961484,669471,2017-06-27,Senate,"Do pass as amended, but first amend, and re-refer to the Committee on [Appropriations] with the recommendation: To Consent Calendar",8,0,1,0,9
961484,673861,2017-08-21,Senate,"Placed on suspense file",7,0,0,0,7
961484,674750,2017-09-01,Senate,"Do pass",7,0,0,0,7
961484,675091,2017-09-06,Senate,"Assembly 3rd Reading AB661 Mayes et al. By Roth",40,0,0,0,40
961484,675398,2017-09-11,Assembly,"AB 661 MAYES Concurrence in Senate Amendments",78,0,1,0,79
961485,627060,2017-04-17,Assembly,"Do pass as amended and be re-referred to the Committee on [Housing and Community Development]",7,3,0,0,10
961485,633599,2017-04-26,Assembly,"Do pass as amended and be re-referred to the Committee on [Appropriations]",4,2,1,0,7
961485,651736,2017-05-26,Assembly,"Do pass as amended",10,6,1,0,17
961485,656843,2017-06-01,Assembly,"AB 663 BLOOM Assembly Third Reading",33,37,10,0,80
961486,636483,2017-05-02,Assembly,"Do pass and be re-referred to the Committee on [Public Safety]",10,0,0,0,10
961486,684761,2018-01-08,Assembly,"Do pass",11,0,0,0,11
961486,685393,2018-01-16,Assembly,"AB 608 IRWIN Assembly Third Reading",71,0,6,0,77
961487,614233,2017-03-28,Assembly,"Do pass as amended, and be re-referred to the Committee on [Judiciary] with recommendation: To Consent Calendar",14,0,1,0,15
961487,615370,2017-03-28,Assembly,"Do pass as amended and be re-referred to the Committee on [Judiciary]",11,1,3,0,15
961487,627679,2017-04-18,Assembly,"Do pass and be re-referred to the Committee on [Appropriations]",10,1,0,0,11
961487,642545,2017-05-10,Assembly,"Do pass",12,5,0,0,17
961487,644454,2017-05-15,Assembly,"AB 651 MURATSUCHI Assembly Third Reading",58,18,4,0,80
961487,671568,2017-07-05,Senate,"Do pass, but first be re-referred to the Committee on [Judiciary]",7,2,0,0,9
961487,672447,2017-07-11,Senate,"Do pass as amended, but first amend, and re-refer to the Committee on [Appropriations]",5,2,0,0,7
961487,673752,2017-08-21,Senate,"Placed on suspense file",7,0,0,0,7
961487,674804,2017-09-01,Senate,"Do pass",5,2,0,0,7
961487,675293,2017-09-11,Senate,"Assembly 3rd Reading AB651 Muratsuchi By Lara",27,13,0,0,40
961487,675580,2017-09-12,Assembly,"AB 651 MURATSUCHI Concurrence in Senate Amendments",52,25,2,0,79
961488,631652,2017-04-25,Senate,"Do pass as amended, but first amend, and re-refer to the Committee on [Appropriations]",5,2,0,0,7
961488,644342,2017-05-15,Senate,"Placed on suspense file",7,0,0,0,7
961488,650592,2017-05-25,Senate,"Do pass as amended",5,2,0,0,7
961488,656000,2017-05-31,Senate,"Senate 3rd Reading SB345 Bradford",23,15,2,0,40
961488,672201,2017-07-11,Assembly,"Do pass and be re-referred to the Committee on [Appropriations]",5,1,1,0,7
961488,674602,2017-09-01,Assembly,"Do pass as amended",11,5,1,0,17
961488,675920,2017-09-13,Assembly,"SB 345 Bradford Senate Third Reading By JONES-SAWYER",47,29,3,0,79
961488,676090,2017-09-14,Senate,"Unfinished Business SB345 Bradford Concurrence",26,14,0,0,40
961488,774562,2017-05-31,Senate,,5,2,2,0,9
961490,631773,2017-04-25,Assembly,"Do pass as amended and be re-referred to the Committee on [Appropriations]",12,0,3,0,15
961490,686222,2018-01-18,Assembly,"Do pass as amended",16,0,1,0,17
961490,689989,2018-01-29,Assembly,"AB 626 GARCIA, E. Assembly Third Reading",66,1,10,0,77
961490,766272,2018-06-20,Senate,"Do pass, but first be re-referred to the Committee on [Judiciary]",7,0,2,0,9
961490,771255,2018-08-13,Senate,"Placed on suspense file",7,0,0,0,7
961490,771874,2018-08-16,Senate,"Do pass",6,0,1,0,7
961490,773171,2018-08-28,Senate,"Assembly 3rd Reading AB626 Eduardo Garcia et al. By Lara",36,0,4,0,40
961490,773617,2018-08-29,Assembly,"AB 626 GARCIA, E. Concurrence in Senate Amendments",77,0,3,0,80
961491,631928,2017-04-25,Senate,"Do pass, but first be re-referred to the Committee on [Appropriations]",4,5,4,0,13
961491,631929,2017-04-25,Senate,"[Second] hearing set for [04-25-2017]: Failed passage in Committee. Reconsideration granted",13,0,0,0,13
961492,618469,2017-04-04,Assembly,"Do pass and be re-referred to the Committee on [Insurance]",12,2,1,0,15
961492,686176,2018-01-18,Assembly,"Do pass as amended",13,4,0,0,17
961492,689894,2018-01-29,Assembly,"AB 595 WOOD Assembly Third Reading",54,22,1,0,77
961492,766271,2018-06-20,Senate,"Do pass, but first be re-referred to the Committee on [Judiciary]",7,1,1,0,9
961492,770294,2018-08-06,Senate,"Placed on suspense file",7,0,0,0,7
961492,771738,2018-08-16,Senate,"Do pass as amended",6,1,0,0,7
961492,772521,2018-08-23,Senate,"Assembly 3rd Reading AB595 Wood By Monning",24,13,3,0,40
961492,772912,2018-08-27,Assembly,"AB 595 WOOD Concurrence in Senate Amendments",53,23,4,0,80
961493,615328,2017-03-29,Assembly,"Do pass and be re-referred to the Committee on [Labor and Employment]",20,0,1,0,21
961493,628854,2017-04-19,Assembly,"Do pass and be re-referred to the Committee on [Appropriations] with recommendation: To Consent Calendar",7,0,0,0,7
961493,651931,2017-05-26,Assembly,"Do pass",17,0,0,0,17
961493,654088,2017-05-30,Assembly,"AB 579 FLORA Assembly Third Reading",76,0,4,0,80
961493,663260,2017-06-14,Senate,"Do pass, but first be re-referred to the Committee on [Governmental Organization]",4,0,1,0,5
961493,669294,2017-06-27,Senate,"Do pass, but first be re-referred to the Committee on [Appropriations]",13,0,0,0,13
961493,672696,2017-07-17,Senate,"Do pass",7,0,0,0,7
961493,674413,2017-08-31,Senate,"Assembly 3rd Reading AB579 Flora et al. By Bradford Urgency Clause",37,1,2,0,40
961493,674997,2017-09-05,Assembly,"AB 579 FLORA Concurrence - Urgency Added",76,0,3,0,79
961494,614009,2017-03-28,Senate,"Do pass, but first be re-referred to the Committee on [Judiciary]",11,0,2,0,13
961494,633134,2017-04-25,Senate,"Do pass as amended, but first amend, and re-refer to the Committee on [Appropriations]",7,0,0,0,7
961494,647988,2017-05-22,Senate,"Senate 3rd Reading SB378 Portantino",37,0,3,0,40
961494,667171,2017-06-21,Assembly,"Do pass and be re-referred to the Committee on [Judiciary]",13,0,8,0,21
961494,669098,2017-06-27,Assembly,"Do pass as amended and be re-referred to the Committee on [Appropriations]",10,0,1,0,11
961495,627855,2017-04-18,Assembly,"Do pass and be re-referred to the Committee on [Appropriations]",8,3,2,0,13
961495,637635,2017-05-03,Assembly,"Do pass",11,5,1,0,17
961495,640697,2017-05-08,Assembly,"AB 618 LOW Assembly Third Reading",54,21,5,0,80
961495,660345,2017-06-07,Senate,"Do pass, but first be re-referred to the Committee on [Judiciary]",5,2,0,0,7
961495,666294,2017-06-20,Senate,"Do pass, but first be re-referred to the Committee on [Appropriations]",5,1,1,0,7
961495,674427,2017-08-31,Senate,"Assembly 3rd Reading AB618 Low et al. By Lara",28,12,0,0,40
961495,674965,2017-09-05,Assembly,"AB 618 LOW Concurrence in Senate Amendments",52,23,4,0,79
961496,620162,2017-04-05,Assembly,"Do pass as amended and be re-referred to the Committee on [Appropriations]",6,1,0,0,7
961496,633566,2017-04-26,Assembly,"Do pass",15,1,1,0,17
961496,641317,2017-05-08,Assembly,"AB 551 LEVINE Assembly Third Reading",72,1,7,0,80
961496,666521,2017-06-20,Senate,"Do pass, but first be re-referred to the Committee on [Appropriations]",5,0,0,0,5
961496,673940,2017-08-21,Senate,"Assembly 3rd Reading AB551 Levine By Anderson",39,0,1,0,40
961498,627191,2017-04-18,Assembly,"Do pass as amended",11,0,0,0,11
961498,635717,2017-05-01,Assembly,"AB 644 BERMAN Assembly Third Reading",70,1,9,0,80
961498,672361,2017-07-11,Senate,"Do pass",7,0,0,0,7
961498,674281,2017-08-31,Senate,"Special Consent Calendar # AB644",37,0,3,0,40
961499,608608,2017-03-21,Assembly,"Do pass and be re-referred to the Committee on [Appropriations]",15,0,0,0,15
961499,620209,2017-04-05,Assembly,"Do pass as amended. To Consent Calendar",17,0,0,0,17
961499,629147,2017-04-20,Assembly,"AB 658 WALDRON Consent Calendar Second Day Regular Session",74,0,6,0,80
961499,658530,2017-06-05,Senate,"Do pass, but first be re-referred to the Committee on [Appropriations] with the recommendation: To Consent Calendar",9,0,0,0,9
961499,668755,2017-06-26,Senate,"Placed on suspense file",7,0,0,0,7
961499,674704,2017-09-01,Senate,"Do pass",7,0,0,0,7
961499,675445,2017-09-11,Senate,"Assembly 3rd Reading AB658 Waldron By Hernandez",40,0,0,0,40
961500,621012,2017-04-05,Assembly,"Do pass as amended and be re-referred to the Committee on [Appropriations]",8,0,1,0,9
961500,633705,2017-04-26,Assembly,"Do pass. To Consent Calendar",16,0,1,0,17
961500,638474,2017-05-04,Assembly,"AB 549 QUIRK Consent Calendar Second Day Regular Session",76,0,4,0,80
961500,660218,2017-06-07,Senate,"Do pass as amended, but first amend, and re-refer to the Committee on [Appropriations]",7,0,0,0,7
961500,671867,2017-07-10,Senate,"Assembly 3rd Reading AB549 Quirk et al. By Skinner",40,0,0,0,40
961500,672774,2017-07-17,Assembly,"AB 549 QUIRK Concurrence in Senate Amendments",78,0,1,0,79
961501,684708,2018-01-09,Assembly,"Do pass and be re-referred to the Committee on [Appropriations] with recommendation: To Consent Calendar",7,0,0,0,7
961501,686246,2018-01-18,Assembly,"Do pass",17,0,0,0,17
961501,689883,2018-01-29,Assembly,"AB 605 MULLIN Assembly Third Reading",77,0,0,0,77
961501,762942,2018-06-12,Senate,"Do pass as amended, but first amend, and re-refer to the Committee on [Appropriations]",6,0,1,0,7
961501,769615,2018-07-02,Senate,"Placed on suspense file",7,0,0,0,7
961501,771767,2018-08-16,Senate,"Do pass",7,0,0,0,7
961501,772657,2018-08-24,Senate,"Special Consent AB605",39,0,1,0,40
961501,773631,2018-08-29,Assembly,"AB 605 MULLIN Concurrence in Senate Amendments",79,0,1,0,80
961502,627081,2017-04-18,Senate,"Do pass, but first be re-referred to the Committee on [Appropriations]",11,0,0,0,11
961502,654096,2017-05-30,Senate,"Senate 3rd Reading SB385 Hueso",40,0,0,0,40
961502,672289,2017-07-12,Assembly,"Do pass as amended and be re-referred to the Committee on [Appropriations]",15,0,0,0,15
961502,674248,2017-08-30,Assembly,"Do pass. To Consent Calendar",15,0,2,0,17
961502,675374,2017-09-11,Assembly,"SB 385 Hueso Senate Third Reading By HOLDEN",78,0,1,0,79
961502,676036,2017-09-14,Senate,"Special Consent Calendar SB385",40,0,0,0,40
961503,615400,2017-03-29,Senate,"Do pass and be ordered to the Consent Calendar",7,0,0,0,7
961503,621207,2017-04-06,Senate,"Consent Calendar 2nd SB361 Hernandez et al. Urgency Clause",39,0,1,0,40
961503,663606,2017-06-14,Assembly,"Do pass. To Consent Calendar",9,0,0,0,9
961503,667848,2017-06-22,Assembly,"SB 361 Hernandez Consent Calendar Second Day Regular Session",74,0,6,0,80
961504,618599,2017-04-04,Senate,"Do pass, but first be re-referred to the Committee on [Veterans Affairs] with the recommendation: To Consent Calendar",6,0,1,0,7
961504,632433,2017-04-25,Senate,"Do pass, but first be re-referred to the Committee on [Appropriations] with the recommendation: To Consent Calendar",7,0,0,0,7
961504,644589,2017-05-15,Senate,"Placed on suspense file",7,0,0,0,7
961504,650763,2017-05-25,Senate,"Do pass as amended",7,0,0,0,7
961504,655899,2017-05-31,Senate,"Senate 3rd Reading SB339 Roth et al",39,0,1,0,40
961504,669590,2017-06-27,Assembly,"Do pass and be re-referred to the Committee on [Public Safety]",8,0,2,0,10
961504,672208,2017-07-11,Assembly,"Do pass and be re-referred to the Committee on [Appropriations] with recommendation: To Consent Calendar",7,0,0,0,7
961504,674688,2017-09-01,Assembly,"Do pass",16,0,1,0,17
961504,675172,2017-09-07,Assembly,"SB 339 Roth Senate Third Reading By IRWIN",78,0,1,0,79
961504,676301,2017-09-14,Senate,"Special Consent Calendar SB339",40,0,0,0,40
961506,628013,2017-04-19,Assembly,"Do pass as amended and be re-referred to the Committee on [Appropriations]",6,1,0,0,7
961506,638632,2017-05-04,Assembly,"AB 565 BLOOM Assembly Third Reading",74,0,6,0,80
961506,768210,2018-06-26,Senate,"Do pass as amended, but first amend, and re-refer to the Committee on [Appropriations]",12,0,1,0,13
961506,770310,2018-08-06,Senate,"Placed on suspense file",7,0,0,0,7
961506,771726,2018-08-16,Senate,"Do pass",7,0,0,0,7
961506,773610,2018-08-29,Senate,"Assembly 3rd Reading AB565 Bloom By Allen",39,0,1,0,40
961506,773882,2018-08-30,Assembly,"With recommendation: That Senate amendments be concurred in",7,0,0,0,7
961506,773985,2018-08-31,Assembly,"AB 565 BLOOM Concurrence in Senate Amendments",78,1,1,0,80
961507,634502,2017-04-27,Senate,"Senate 3rd Reading SCR21 De León",36,0,4,0,40
961507,644389,2017-05-15,Assembly,"Be adopted. To third reading",7,4,0,0,11
961507,651733,2017-05-26,Assembly,"SCR 21 De León Senate Third Reading By COOLEY",53,23,4,0,80
961507,672755,2017-07-17,Senate,"Unfinished Business SCR21 De León Concurrence",27,12,1,0,40
961508,618605,2017-04-04,Assembly,"Do pass as amended, and be re-referred to the Committee on [Appropriations] with recommendation: To Consent Calendar",7,0,0,0,7
961508,642448,2017-05-10,Assembly,"Do pass. To Consent Calendar",17,0,0,0,17
961508,646424,2017-05-18,Assembly,"AB 662 CHOI Consent Calendar Second Day Regular Session",69,0,11,0,80
961508,666220,2017-06-20,Senate,"Do pass, but first be re-referred to the Committee on [Appropriations] with the recommendation: To Consent Calendar",7,0,0,0,7
961508,674060,2017-08-24,Senate,"Consent Calendar 2nd AB662",38,0,2,0,40
961508,674192,2017-08-28,Assembly,"AB 662 CHOI Concurrence in Senate Amendments",73,0,6,0,79
961509,641811,2017-05-08,Assembly,"Do pass and be re-referred to the Committee on [Appropriations]",9,0,1,0,10
961509,645860,2017-05-17,Assembly,"Do pass",17,0,0,0,17
961509,656917,2017-06-01,Assembly,"AB 653 RIDLEY-THOMAS Assembly Third Reading",75,1,4,0,80
961509,768931,2018-06-27,Senate,"Do pass and be ordered to the Consent Calendar",9,0,0,0,9
961509,769257,2018-06-27,Senate,"Do pass, but first be re-referred to the Committee on [Health]",5,0,2,0,7
961509,769785,2018-07-05,Senate,"Consent Calendar AB653",35,0,4,0,39
961509,772151,2018-08-20,Assembly,"With recommendation: That Senate amendments be concurred in, but first be re-referred to Com. on [Health]",9,0,0,0,9
961509,772450,2018-08-21,Assembly,"With recommendation: That Senate amendments be concurred in",15,0,0,0,15
961509,772876,2018-08-27,Assembly,"AB 653 CUNNINGHAM Concurrence in Senate Amendments",80,0,0,0,80
961510,620092,2017-04-05,Senate,"Do pass, but first be re-referred to the Committee on [Appropriations]",7,0,0,0,7
961510,626240,2017-04-17,Senate,"Placed on suspense file",7,0,0,0,7
961511,628288,2017-04-19,Senate,"Do pass as amended, but first amend, and re-refer to the Committee on [Appropriations]",7,0,0,0,7
961511,644367,2017-05-15,Senate,"Placed on suspense file",7,0,0,0,7
961511,650658,2017-05-25,Senate,"Do pass",5,2,0,0,7
961511,653957,2017-05-30,Senate,"Senate 3rd Reading SB354 Portantino",33,6,1,0,40
961511,762885,2018-06-13,Assembly,"Do pass and be re-referred to the Committee on [Appropriations]",5,0,2,0,7
961511,771591,2018-08-16,Assembly,"Do pass as amended",13,0,4,0,17
961511,773607,2018-08-29,Assembly,"SB 354 Portantino Senate Third Reading By THURMOND",65,10,5,0,80
961511,773843,2018-08-30,Senate,"Unfinished Business SB354 Portantino et al. Concurrence",33,6,1,0,40
961512,627933,2017-04-18,Assembly,"Do pass and be re-referred to the Committee on [Appropriations]",13,0,0,0,13
961512,637687,2017-05-03,Assembly,"Do pass. To Consent Calendar",16,0,1,0,17
961512,643556,2017-05-11,Assembly,"AB 669 BERMAN Consent Calendar Second Day Regular Session",77,0,3,0,80
961512,672071,2017-07-11,Senate,"Do pass, but first be re-referred to the Committee on [Appropriations] with the recommendation: To Consent Calendar",11,0,2,0,13
961512,673965,2017-08-21,Senate,"Placed on suspense file",7,0,0,0,7
961512,674469,2017-09-01,Senate,"Do pass",7,0,0,0,7
961512,675014,2017-09-06,Senate,"Assembly 3rd Reading AB669 Berman By Hernandez",40,0,0,0,40
961512,675782,2017-09-13,Assembly,"With recommendation: That Senate amendments be concurred in",13,0,1,0,14
961512,676547,2017-09-15,Assembly,"AB 669 BERMAN Concurrence in Senate Amendments",79,0,0,0,79
961514,643223,2017-05-10,Assembly,"Do pass as amended",6,1,2,0,9
961514,654933,2017-05-30,Assembly,"AB 556 LIMÓN Assembly Third Reading",57,17,6,0,80
961514,669829,2017-06-28,Senate,"Do pass as amended",6,1,0,0,7
961514,674950,2017-09-05,Senate,"Assembly 3rd Reading AB556 Limón By Jackson",30,10,0,0,40
961514,675188,2017-09-07,Assembly,"AB 556 LIMÓN Concurrence in Senate Amendments",58,21,0,0,79
961516,627055,2017-04-18,Assembly,"Do pass as amended and be re-referred to the Committee on [Appropriations]",6,1,0,0,7
961516,651566,2017-05-26,Assembly,"Do pass",16,1,0,0,17
961516,655742,2017-05-31,Assembly,"AB 558 QUIRK-SILVA Assembly Third Reading",75,1,4,0,80
961516,753822,2018-05-16,Senate,"Do pass, but first be re-referred to the Committee on [Transportation and Housing]",7,0,0,0,7
961516,762133,2018-06-12,Senate,"Do pass, but first be re-referred to the Committee on [Appropriations] with the recommendation: To Consent Calendar",12,0,1,0,13
961516,771331,2018-08-13,Senate,"Assembly 3rd Reading AB558 Quirk-Silva By Wieckowski",35,0,5,0,40
961516,772557,2018-08-23,Assembly,"With recommendation: That Senate amendments be concurred in",12,0,2,0,14
961516,772812,2018-08-27,Assembly,"AB 558 QUIRK-SILVA Concurrence in Senate Amendments",69,0,11,0,80
961517,627192,2017-04-18,Senate,"Do pass, but first be re-referred to the Committee on [Appropriations]",10,0,3,0,13
961517,644442,2017-05-15,Senate,"Do pass as amended",7,0,0,0,7
961517,655033,2017-05-30,Senate,"Senate 3rd Reading SB389 Roth",40,0,0,0,40
961517,671857,2017-07-10,Assembly,"Do pass as amended and be re-referred to the Committee on [Appropriations]",13,0,1,0,14
961518,619881,2017-04-05,Senate,"Do pass as amended, but first amend, and re-refer to the Committee on [Appropriations]",7,0,0,0,7
961518,635958,2017-05-01,Senate,"Placed on suspense file",7,0,0,0,7
961520,613934,2017-03-28,Assembly,"Do pass and be re-referred to the Committee on [Accountability and Administrative Review]",7,0,0,0,7
961520,633777,2017-04-26,Assembly,"Do pass and be re-referred to the Committee on [Appropriations]",4,1,2,0,7
961521,620157,2017-04-04,Senate,"Do pass, but first be re-referred to the Committee on [Public Safety]",9,1,3,0,13
961521,632419,2017-04-25,Senate,"Do pass, but first be re-referred to the Committee on [Appropriations]",5,2,0,0,7
961521,647954,2017-05-22,Senate,"Placed on suspense file",7,0,0,0,7
961521,650639,2017-05-25,Senate,"Do pass",5,1,1,0,7
961521,656144,2017-05-31,Senate,"Senate 3rd Reading SB347 Jackson",26,12,2,0,40
961522,610585,2017-03-22,Senate,"Do pass as amended, and be ordered to the Consent Calendar",7,0,0,0,7
961522,616156,2017-03-30,Senate,"Consent Calendar 2nd SB341",37,0,3,0,40
961522,667251,2017-06-21,Assembly,"Do pass. To Consent Calendar",6,0,1,0,7
961522,670280,2017-06-29,Assembly,"SB 341 Wilk Consent Calendar Second Day Regular Session",74,0,6,0,80
961524,627126,2017-04-18,Assembly,"Do pass and be re-referred to the Committee on [Appropriations]",14,0,1,0,15
961526,610016,2017-03-22,Senate,"Do pass, but first be re-referred to the Committee on [Appropriations]",7,0,0,0,7
961526,629227,2017-04-20,Senate,"Senate 3rd Reading SB346 Glazer et al. Urgency Clause",40,0,0,0,40
961526,672202,2017-07-11,Assembly,"Do pass and be re-referred to the Committee on [Appropriations]",5,3,5,0,13
961526,672203,2017-07-11,Assembly,Reconsideration,13,0,0,0,13
961526,768738,2018-06-26,Assembly,"Do pass and be re-referred to the Committee on [Appropriations]",11,0,2,0,13
961527,631776,2017-04-25,Senate,"Do pass as amended, but first amend, and re-refer to the Committee on [Appropriations]",4,0,1,0,5
961527,644831,2017-05-15,Senate,"Placed on suspense file",7,0,0,0,7
961527,650398,2017-05-25,Senate,"Do pass",7,0,0,0,7
961527,656171,2017-05-31,Senate,"Special Consent Calendar # SB380",40,0,0,0,40
961527,672416,2017-07-11,Assembly,"Do pass as amended, and be re-referred to the Committee on [Appropriations] with recommendation: To Consent Calendar",7,0,0,0,7
961527,674684,2017-09-01,Assembly,"Do pass as amended",11,0,6,0,17
961527,675754,2017-09-13,Assembly,"SB 380 Bradford Senate Third Reading By THURMOND",78,0,1,0,79
961527,676044,2017-09-14,Senate,"Unfinished Business SB380 Bradford Concurrence",40,0,0,0,40
961529,628159,2017-04-19,Senate,"Do pass, but first be re-referred to the Committee on [Appropriations]",7,0,0,0,7
961529,635885,2017-05-01,Senate,"Placed on suspense file",7,0,0,0,7
961529,650753,2017-05-25,Senate,"Do pass",7,0,0,0,7
961529,654527,2017-05-30,Senate,"Senate 3rd Reading SB390 Mendoza",35,4,1,0,40
961529,667603,2017-06-21,Assembly,"Do pass and be re-referred to the Committee on [Appropriations]",5,2,0,0,7
961529,674695,2017-09-01,Assembly,"Do pass",11,5,1,0,17
961529,675714,2017-09-12,Assembly,"SB 390 Mendoza Senate Third Reading By O'DONNELL",56,23,0,0,79
961529,675945,2017-09-13,Senate,"Unfinished Business SB390 Mendoza Concurrence",34,6,0,0,40
961530,614916,2017-03-29,Assembly,"Do pass and be re-referred to the Committee on [Appropriations]",5,2,0,0,7
961530,651798,2017-05-26,Assembly,"Do pass as amended",12,5,0,0,17
961530,656202,2017-05-31,Assembly,"AB 621 BOCANEGRA Assembly Third Reading",53,21,6,0,80
961530,672400,2017-07-12,Senate,"Do pass, but first be re-referred to the Committee on [Appropriations]",4,1,0,0,5
961530,673920,2017-08-21,Senate,"Placed on suspense file",7,0,0,0,7
961530,674512,2017-09-01,Senate,"Do pass as amended",5,2,0,0,7
961530,675626,2017-09-12,Senate,"Assembly 3rd Reading AB621 Bocanegra et al. By Lara",27,13,0,0,40
961530,676373,2017-09-14,Assembly,"AB 621 BOCANEGRA Concurrence in Senate Amendments",55,24,0,0,79
961531,610202,2017-03-22,Assembly,"Do pass and be re-referred to the Committee on [Appropriations] with recommendation: To Consent Calendar",10,0,0,0,10
961531,620625,2017-04-05,Assembly,"Do pass. To Consent Calendar",17,0,0,0,17
961531,629462,2017-04-20,Assembly,"AB 564 AGRI. Consent Calendar Second Day Regular Session",74,0,6,0,80
961531,659737,2017-06-06,Senate,"Do pass, but first be re-referred to the Committee on [Appropriations] with the recommendation: To Consent Calendar",4,0,1,0,5
961531,670964,2017-07-03,Senate,"Consent Calendar 2nd AB564 AGRI",33,0,7,0,40
961532,591712,2017-02-23,Senate,"Senate 3rd Reading SCR23 Monning et al",40,0,0,0,40
961532,596786,2017-03-02,Assembly,"Be adopted. To Consent Calendar",11,0,0,0,11
961532,600741,2017-03-09,Assembly,"SCR 23 Monning Consent Calendar Second Day",76,0,4,0,80
961533,609193,2017-03-21,Assembly,"Do pass and be re-referred to the Committee on [Appropriations]",7,0,0,0,7
961533,619880,2017-04-05,Assembly,"Do pass",17,0,0,0,17
961533,628891,2017-04-20,Assembly,"AB 593 GLORIA Assembly Third Reading",75,0,5,0,80
961533,661512,2017-06-12,Senate,"Do pass as amended, but first amend, and re-refer to the Committee on [Appropriations]",9,0,0,0,9
961533,673835,2017-08-21,Senate,"Assembly 3rd Reading AB593 Gloria By Hill",33,6,1,0,40
961533,674107,2017-08-24,Assembly,"AB 593 GLORIA Concurrence in Senate Amendments",74,0,5,0,79
961535,627039,2017-04-18,Senate,"Do pass, but first be re-referred to the Committee on [Public Safety]",11,0,2,0,13
961535,631543,2017-04-25,Senate,"Do pass, but first be re-referred to the Committee on [Appropriations] with the recommendation: To Consent Calendar",7,0,0,0,7
961535,644258,2017-05-15,Senate,"Placed on suspense file",7,0,0,0,7
961536,607294,2017-03-20,Assembly,"Be adopted. To Consent Calendar",14,0,0,0,14
961536,629424,2017-04-20,Assembly,"ACR 22 BAKER Assembly Third Reading",72,0,8,0,80
961536,672155,2017-07-11,Senate,"Be adopted, but first be re-referred to the Committee on [Appropriations] with recommendation: To Consent Calendar",11,0,2,0,13
961536,674132,2017-08-24,Senate,"Consent Calendar 2nd ACR22",38,0,2,0,40
961537,619738,2017-04-04,Assembly,"Do pass and be re-referred to the Committee on [Water, Parks, and Wildlife]",7,0,0,0,7
961537,631798,2017-04-25,Assembly,"Do pass and be re-referred to the Committee on [Appropriations]",15,0,0,0,15
961537,651573,2017-05-26,Assembly,"Do pass",17,0,0,0,17
961537,654304,2017-05-30,Assembly,"AB 574 QUIRK Assembly Third Reading",77,0,3,0,80
961537,671382,2017-07-05,Senate,"Do pass as amended, but first amend, and re-refer to the Committee on [Natural Resources and Water]",7,0,0,0,7
961537,673909,2017-08-21,Senate,"Placed on suspense file",7,0,0,0,7
961537,674722,2017-09-01,Senate,"Do pass as amended",7,0,0,0,7
961537,675032,2017-09-06,Senate,"Assembly 3rd Reading AB574 Quirk By Hertzberg",40,0,0,0,40
961537,675392,2017-09-11,Assembly,"AB 574 QUIRK Concurrence in Senate Amendments",78,0,1,0,79
961539,619371,2017-04-04,Assembly,"Do pass and be re-referred to the Committee on [Appropriations]",14,0,1,0,15
961539,651790,2017-05-26,Assembly,"Do pass as amended",16,0,1,0,17
961539,655992,2017-05-31,Assembly,"AB 572 QUIRK-SILVA Assembly Third Reading",76,0,4,0,80
961539,768288,2018-06-26,Senate,"Do pass, but first be re-referred to the Committee on [Appropriations] with the recommendation: To Consent Calendar",7,0,0,0,7
961539,770565,2018-08-06,Senate,"Placed on suspense file",7,0,0,0,7
961539,771680,2018-08-16,Senate,"Do pass",7,0,0,0,7
961539,772705,2018-08-24,Senate,"Special Consent AB572",39,0,1,0,40
961540,610266,2017-03-21,Assembly,"Do pass as amended and be re-referred to the Committee on [Appropriations]",7,0,0,0,7
961540,651901,2017-05-26,Assembly,"Do pass",17,0,0,0,17
961540,656093,2017-05-31,Assembly,"AB 563 ARAMBULA Assembly Third Reading",76,1,3,0,80
961540,669056,2017-06-27,Senate,"Do pass, but first be re-referred to the Committee on [Appropriations]",5,0,0,0,5
961540,671851,2017-07-10,Senate,"Placed on suspense file",7,0,0,0,7
961540,674786,2017-09-01,Senate,"Do pass as amended",7,0,0,0,7
961540,675679,2017-09-12,Senate,"Assembly 3rd Reading AB563 Arambula et al. By Wiener",40,0,0,0,40
961540,676346,2017-09-14,Assembly,"AB 563 ARAMBULA Concurrence in Senate Amendments",78,1,0,0,79
961541,610204,2017-03-22,Senate,"Do pass, but first be re-referred to the Committee on [Health]",7,0,0,0,7
961541,629426,2017-04-19,Senate,"Do pass, but first be re-referred to the Committee on [Appropriations]",9,0,0,0,9
961541,635673,2017-05-01,Senate,"Placed on suspense file",7,0,0,0,7
961541,650749,2017-05-25,Senate,"Do pass",7,0,0,0,7
961541,655993,2017-05-31,Senate,"Special Consent Calendar # SB379",40,0,0,0,40
961541,667155,2017-06-21,Assembly,"Do pass and be re-referred to the Committee on [Health]",6,0,1,0,7
961541,672074,2017-07-11,Assembly,"Do pass and be re-referred to the Committee on [Appropriations]",15,0,0,0,15
961541,674796,2017-09-01,Assembly,"Do pass",16,0,1,0,17
961541,675660,2017-09-12,Assembly,"SB 379 Atkins Senate Third Reading By WOOD",79,0,0,0,79
961542,608387,2017-03-21,Assembly,"Do pass and be re-referred to the Committee on [Appropriations]",7,0,0,0,7
961542,651873,2017-05-26,Assembly,"Do pass",17,0,0,0,17
961542,654434,2017-05-30,Assembly,"AB 665 LEVINE Assembly Third Reading",75,1,4,0,80
961542,668966,2017-06-27,Senate,"Do pass, but first be re-referred to the Committee on [Veterans Affairs]",7,0,0,0,7
961542,672130,2017-07-11,Senate,"Do pass, but first be re-referred to the Committee on [Appropriations]",6,0,1,0,7
961542,673896,2017-08-21,Senate,"Placed on suspense file",7,0,0,0,7
961546,616093,2017-03-29,Senate,"Do pass as amended, but first amend, and re-refer to the Committee on [Judiciary]",7,2,0,0,9
961546,633535,2017-04-25,Senate,"Do pass as amended, but first amend, and re-refer to the Committee on [Appropriations]",5,2,0,0,7
961546,644316,2017-05-15,Senate,"Placed on suspense file",7,0,0,0,7
961546,650774,2017-05-25,Senate,"Do pass as amended",5,2,0,0,7
961546,655797,2017-05-31,Senate,"Senate 3rd Reading SB349 Lara et al",24,15,1,0,40
961546,669153,2017-06-27,Assembly,"Do pass as amended and be re-referred to the Committee on [Appropriations]",10,4,1,0,15
961546,674699,2017-09-01,Assembly,"Do pass",10,5,2,0,17
961546,772703,2018-08-24,Assembly,"SB 349 Lara Senate Third Reading By GONZALEZ FLETCHER Amendment Set #1",44,22,14,0,80
961546,773365,2018-08-29,Assembly,"SB 349 Lara Senate Third Reading By GONZALEZ FLETCHER",54,23,3,0,80
961546,773852,2018-08-30,Senate,"That the Assembly amendments be concurred in",5,1,1,0,7
961546,774046,2018-08-31,Senate,"Unfinished Business SB349 Lara et al. Concurrence",28,10,2,0,40
961547,629249,2017-04-19,Assembly,"Do pass and be re-referred to the Committee on [Appropriations]",5,1,1,0,7
961547,652175,2017-05-26,Assembly,"Do pass",12,5,0,0,17
961547,656006,2017-05-31,Assembly,"AB 581 MCCARTY Assembly Third Reading",59,15,6,0,80
961547,669645,2017-06-28,Senate,"Do pass, but first be re-referred to the Committee on [Appropriations]",3,1,1,0,5
961547,671907,2017-07-10,Senate,"Placed on suspense file",7,0,0,0,7
961547,674813,2017-09-01,Senate,"Do pass",5,2,0,0,7
961547,675109,2017-09-07,Senate,"Assembly 3rd Reading AB581 McCarty By Leyva",28,11,1,0,40
961548,618824,2017-04-04,Assembly,"Do pass and be re-referred to the Committee on [Appropriations] with recommendation: To Consent Calendar",14,0,1,0,15
961548,652124,2017-05-26,Assembly,"Do pass",17,0,0,0,17
961548,656211,2017-05-31,Assembly,"AB 659 RIDLEY-THOMAS Assembly Third Reading",76,0,4,0,80
961548,667332,2017-06-21,Senate,"Do pass as amended, but first amend, and re-refer to the Committee on [Appropriations] with the recommendation: To Consent Calendar",9,0,0,0,9
961548,673974,2017-08-21,Senate,"Placed on suspense file",7,0,0,0,7
961548,674831,2017-09-01,Senate,"Do pass",7,0,0,0,7
961548,675345,2017-09-11,Senate,"Assembly 3rd Reading AB659 Ridley-Thomas By Hernandez",40,0,0,0,40
961548,676006,2017-09-13,Assembly,"AB 659 RIDLEY-THOMAS Concurrence in Senate Amendments",77,0,2,0,79
961549,620136,2017-04-05,Assembly,"Do pass and be re-referred to the Committee on [Appropriations] with recommendation: To Consent Calendar",7,0,0,0,7
961549,633525,2017-04-26,Assembly,"Do pass. To Consent Calendar",16,0,1,0,17
961549,638665,2017-05-04,Assembly,"AB 639 OBERNOLTE Consent Calendar Second Day Regular Session",76,0,4,0,80
961549,662162,2017-06-13,Senate,"Do pass, but first be re-referred to the Committee on [Appropriations] with the recommendation: To Consent Calendar",12,0,1,0,13
961549,670963,2017-07-03,Senate,"Consent Calendar 2nd AB639",33,0,7,0,40
961551,613842,2017-03-28,Senate,"Do pass and be ordered to the Consent Calendar",7,0,0,0,7
961551,617546,2017-04-03,Senate,"Consent Calendar 2nd SB355",39,0,1,0,40
961551,662135,2017-06-13,Assembly,"Do pass. To Consent Calendar",7,0,0,0,7
961551,665043,2017-06-19,Assembly,"SB 355 Mitchell Consent Calendar Second Day Regular Session",74,0,6,0,80
961553,608596,2017-03-21,Senate,"Do pass, but first be re-referred to the Committee on [Appropriations]",11,0,0,0,11
961553,621051,2017-04-06,Senate,"Senate 3rd Reading SB376 Bradford",39,0,1,0,40
961553,667664,2017-06-21,Assembly,"Do pass and be re-referred to the Committee on [Appropriations]",14,0,1,0,15
961554,610499,2017-03-22,Assembly,"Do pass as amended and be re-referred to the Committee on [Jobs, Economic Development, and the Economy]",7,0,0,0,7
961554,631819,2017-04-25,Assembly,"Do pass as amended, and be re-referred to the Committee on [Appropriations] with recommendation: To Consent Calendar",7,0,0,0,7
961554,651964,2017-05-26,Assembly,"Do pass as amended",16,0,1,0,17
961554,656099,2017-05-31,Assembly,"AB 547 CHÁVEZ Assembly Third Reading",77,0,3,0,80
961554,669270,2017-06-27,Senate,"Do pass, but first be re-referred to the Committee on [Veterans Affairs] with the recommendation: To Consent Calendar",13,0,0,0,13
961554,672174,2017-07-11,Senate,"Do pass, but first be re-referred to the Committee on [Appropriations] with the recommendation: To Consent Calendar",6,0,1,0,7
961554,673765,2017-08-21,Senate,"Placed on suspense file",7,0,0,0,7
961554,674822,2017-09-01,Senate,"Do pass",7,0,0,0,7
961554,676165,2017-09-14,Senate,"Special Consent Calendar # AB547",40,0,0,0,40
961555,634623,2017-04-26,Assembly,"Do pass as amended and be re-referred to the Committee on [Appropriations]",5,1,1,0,7
961556,614087,2017-03-28,Assembly,"Do pass as amended, and be re-referred to the Committee on [Appropriations] with recommendation: To Consent Calendar",7,0,0,0,7
961556,633827,2017-04-26,Assembly,"Do pass. To Consent Calendar",16,0,1,0,17
961556,638621,2017-05-04,Assembly,"AB 657 CUNNINGHAM Consent Calendar Second Day Regular Session",76,0,4,0,80
961556,658132,2017-06-05,Senate,"Do pass, but first be re-referred to the Committee on [Appropriations] with the recommendation: To Consent Calendar",9,0,0,0,9
961556,671004,2017-07-03,Senate,"Consent Calendar 2nd AB657",33,0,7,0,40
961557,632223,2017-04-24,Assembly,"Do pass as amended and be re-referred to the Committee on [Appropriations]",10,0,0,0,10
961558,634540,2017-04-27,Senate,"Senate 3rd Reading SCR22 Hueso",37,0,3,0,40
961558,640655,2017-05-08,Assembly,"Be adopted. To Consent Calendar",9,0,2,0,11
961558,643639,2017-05-11,Assembly,"SCR 22 Hueso Consent Calendar Second Day Regular Session",77,0,3,0,80
961559,627024,2017-04-18,Assembly,"Do pass as amended, and be re-referred to the Committee on [Appropriations] with recommendation: To Consent Calendar",7,0,0,0,7
961559,637533,2017-05-03,Assembly,"Do pass. To Consent Calendar",16,0,1,0,17
961559,643497,2017-05-11,Assembly,"AB 562 MURATSUCHI Consent Calendar Second Day Regular Session",77,0,3,0,80
961559,672151,2017-07-11,Senate,"Do pass as amended, but first amend, and re-refer to the Committee on [Appropriations]",5,1,1,0,7
961559,674278,2017-08-31,Senate,"Assembly 3rd Reading AB562 Muratsuchi et al. By Hernandez",36,0,4,0,40
961559,675060,2017-09-06,Assembly,"With recommendation: That Senate amendments be concurred in",6,0,1,0,7
961559,675376,2017-09-11,Assembly,"AB 562 MURATSUCHI Concurrence in Senate Amendments",77,0,2,0,79
961560,626932,2017-04-18,Senate,"Do pass as amended, but first amend, and re-refer to the Committee on [Appropriations]",11,0,0,0,11
961560,644588,2017-05-15,Senate,"Placed on suspense file",7,0,0,0,7
961560,650299,2017-05-25,Senate,"Do pass as amended",6,1,0,0,7
961560,656140,2017-05-31,Senate,"Senate 3rd Reading SB366 Leyva",35,4,1,0,40
961561,610032,2017-03-20,Assembly,"Do pass as amended and be re-referred to the Committee on [Transportation]",8,1,1,0,10
961561,612722,2017-03-27,Assembly,"Do pass and be re-referred to the Committee on [Appropriations]",12,1,1,0,14
961561,651585,2017-05-26,Assembly,"Do pass",13,2,2,0,17
961561,655901,2017-05-31,Assembly,"AB 582 GARCIA, C. Assembly Third Reading",62,13,5,0,80
961561,669101,2017-06-27,Senate,"Do pass as amended, but first amend, and re-refer to the Committee on [Environmental Quality]",9,3,1,0,13
961561,671300,2017-07-05,Senate,"Do pass, but first be re-referred to the Committee on [Appropriations]",5,2,0,0,7
961561,672753,2017-07-17,Senate,"Placed on suspense file",7,0,0,0,7
961561,774552,2017-05-26,Assembly,?,12,1,2,0,15
961562,606888,2017-03-20,Assembly,"Do pass and be re-referred to the Committee on [Appropriations]",13,0,1,0,14
961562,633136,2017-04-26,Assembly,"Do pass. To Consent Calendar",16,0,1,0,17
961562,638642,2017-05-04,Assembly,"AB 615 COOPER Consent Calendar Second Day Regular Session",76,0,4,0,80
961562,671362,2017-07-05,Senate,"Do pass as amended, but first amend, and re-refer to the Committee on [Transportation and Housing]",7,0,0,0,7
961562,672170,2017-07-11,Senate,"Do pass, but first be re-referred to the Committee on [Appropriations]",12,0,1,0,13
961562,675300,2017-09-11,Senate,"Assembly 3rd Reading AB615 Cooper By Galgiani Urgency Clause",37,0,3,0,40
961562,675915,2017-09-13,Assembly,"AB 615 COOPER Concurrence in Senate Amendments",78,0,1,0,79
961563,637473,2017-05-03,Senate,"Do pass, but first be re-referred to the Committee on [Appropriations]",6,0,1,0,7
961563,648013,2017-05-22,Senate,"Senate 3rd Reading SB373 Cannella et al",37,0,3,0,40
961563,672617,2017-07-12,Assembly,"Do pass",9,0,0,0,9
961563,674142,2017-08-24,Assembly,"SB 373 Cannella Senate Third Reading By GRAY",74,0,5,0,79
961563,674414,2017-08-31,Senate,"Special Consent Calendar # SB373",37,0,3,0,40
961564,608461,2017-03-21,Assembly,"Do pass and be re-referred to the Committee on [Appropriations]",6,1,0,0,7
961565,607282,2017-03-20,Assembly,"Do pass and be re-referred to the Committee on [Appropriations]",10,4,0,0,14
961565,651706,2017-05-26,Assembly,"Do pass",12,5,0,0,17
961565,655920,2017-05-31,Assembly,"AB 630 COOPER Assembly Third Reading",54,20,6,0,80
961565,671327,2017-07-05,Senate,"Do pass, but first be re-referred to the Committee on [Transportation and Housing]",5,1,1,0,7
961565,672056,2017-07-11,Senate,"Do pass, but first be re-referred to the Committee on [Appropriations]",8,3,2,0,13
961565,673961,2017-08-21,Senate,"Placed on suspense file",7,0,0,0,7
961565,674835,2017-09-01,Senate,"Do pass as amended",5,2,0,0,7
961565,675895,2017-09-13,Senate,"Assembly 3rd Reading AB630 Cooper By Stern",29,11,0,0,40
961565,676358,2017-09-14,Assembly,"AB 630 Cooper Concurrence in Senate Amendments",55,23,1,0,79
961566,627788,2017-04-18,Assembly,"Do pass and be re-referred to the Committee on [Education]",11,1,1,0,13
961566,643219,2017-05-10,Assembly,"Do pass as amended",5,1,1,0,7
961566,647855,2017-05-22,Assembly,"AB 568 GONZALEZ FLETCHER Assembly Third Reading",65,9,6,0,80
961566,667476,2017-06-21,Senate,"Do pass, but first be re-referred to the Committee on [Appropriations]",4,1,2,0,7
961566,672004,2017-07-10,Senate,"Placed on suspense file",7,0,0,0,7
961566,674764,2017-09-01,Senate,"Do pass as amended",5,1,1,0,7
961566,675061,2017-09-06,Senate,"Assembly 3rd Reading AB568 Gonzalez Fletcher By Mendoza",31,8,1,0,40
961566,675349,2017-09-11,Assembly,"AB 568 GONZALEZ FLETCHER Concurrence in Senate Amendments",63,13,3,0,79
961567,684913,2018-01-10,Assembly,"Do pass as amended",7,0,0,0,7
961567,685403,2018-01-16,Assembly,"AB 666 AGUIAR-CURRY Assembly Third Reading",71,0,6,0,77
961567,760823,2018-06-06,Senate,"Do pass",5,0,0,0,5
961567,769618,2018-07-02,Senate,"Assembly 3rd Reading AB666 Aguiar-Curry et al. By Dodd",37,0,2,0,39
961567,770906,2018-08-06,Assembly,"AB 666 AGUIAR-CURRY Concurrence in Senate Amendments",75,0,5,0,80
961568,628276,2017-04-18,Assembly,"Do pass and be re-referred to the Committee on [Appropriations]",13,0,0,0,13
961570,633919,2017-04-26,Assembly,"Do pass as amended and be re-referred to the Committee on [Appropriations]",5,2,0,0,7
961570,642760,2017-05-10,Assembly,"Do pass",11,6,0,0,17
961570,644243,2017-05-15,Assembly,"AB 606 BERMAN Assembly Third Reading",42,31,7,0,80
961570,666369,2017-06-20,Senate,"Do pass, but first be re-referred to the Committee on [Appropriations]",4,1,0,0,5
961570,675112,2017-09-07,Senate,"Assembly 3rd Reading AB606 Berman et al. By Hertzberg",26,14,0,0,40
961571,610496,2017-03-21,Assembly,"Do pass as amended and be re-referred to the Committee on [Appropriations]",7,0,0,0,7
961571,651506,2017-05-26,Assembly,"Do pass",14,3,0,0,17
961571,656274,2017-05-31,Assembly,"AB 607 GLORIA Assembly Third Reading",67,9,4,0,80
961571,672334,2017-07-11,Senate,"Do pass, but first be re-referred to the Committee on [Appropriations]",7,0,0,0,7
961571,673839,2017-08-21,Senate,"Placed on suspense file",7,0,0,0,7
961571,674784,2017-09-01,Senate,"Do pass as amended",6,0,1,0,7
961571,675726,2017-09-12,Senate,"Assembly 3rd Reading AB607 Gloria By Wiener",38,2,0,0,40
961571,676222,2017-09-14,Assembly,"AB 607 GLORIA Concurrence in Senate Amendments",71,7,1,0,79
961573,628000,2017-04-18,Assembly,"Do pass and be re-referred to the Committee on [Appropriations]",10,1,2,0,13
961573,652045,2017-05-26,Assembly,"Do pass",12,4,1,0,17
961573,655995,2017-05-31,Assembly,"AB 584 QUIRK-SILVA Assembly Third Reading",65,8,7,0,80
961573,669932,2017-06-28,Senate,"Do pass, but first be re-referred to the Committee on [Appropriations]",5,0,2,0,7
961573,671863,2017-07-10,Senate,"Placed on suspense file",7,0,0,0,7
961573,674841,2017-09-01,Senate,"Do pass",7,0,0,0,7
961573,675371,2017-09-11,Senate,"Assembly 3rd Reading AB584 Quirk-Silva By Newman",38,0,2,0,40
961574,660437,2017-06-07,Senate,"Be adopted, but first be re-referred to the Committee on [Elections and Constitutional Amendments]",2,6,1,0,9
961574,660438,2017-06-07,Senate,"[First] hearing set for [06-07-2017]: Failed passage in Committee. Reconsideration granted",9,0,0,0,9
961575,616229,2017-03-29,Assembly,"Do pass and be re-referred to the Committee on [Judiciary]",5,2,0,0,7
961575,631989,2017-04-25,Assembly,"Do pass and be re-referred to the Committee on [Appropriations]",9,1,1,0,11
961575,651590,2017-05-26,Assembly,"Do pass",12,5,0,0,17
961575,656138,2017-05-31,Assembly,"AB 569 GONZALEZ FLETCHER Assembly Third Reading",54,17,9,0,80
961575,669663,2017-06-28,Senate,"Do pass, but first be re-referred to the Committee on [Judiciary]",3,1,1,0,5
961575,672419,2017-07-11,Senate,"Do pass as amended, but first amend, and re-refer to the Committee on [Appropriations]",5,2,0,0,7
961575,673744,2017-08-21,Senate,"Placed on suspense file",7,0,0,0,7
961575,674556,2017-09-01,Senate,"Do pass as amended",5,2,0,0,7
961575,675705,2017-09-12,Senate,"Assembly 3rd Reading AB569 Gonzalez Fletcher By Atkins",27,13,0,0,40
961575,676333,2017-09-14,Assembly,"AB 569 GONZALEZ FLETCHER Concurrence in Senate Amendments",55,20,4,0,79
961576,620094,2017-04-05,Senate,"Do pass, but first be re-referred to the Committee on [Appropriations] with the recommendation: To Consent Calendar",7,0,0,0,7
961576,629131,2017-04-20,Senate,"Consent Calendar 2nd SB363 B. & F.I",36,0,4,0,40
961576,672009,2017-07-10,Assembly,"Do pass and be re-referred to the Committee on [Appropriations] with recommendation: To Consent Calendar",7,0,4,0,11
961576,674011,2017-08-23,Assembly,"Do pass as amended. To Consent Calendar",15,0,2,0,17
961576,674328,2017-08-31,Assembly,"SB 363 I., B. & F.I. Consent Calendar Second Day Regular Session",73,0,6,0,79
961576,674946,2017-09-05,Senate,"Special Consent SB363 I., B. & F.I",40,0,0,0,40
961577,627901,2017-04-19,Assembly,"Do pass as amended and be re-referred to the Committee on [Appropriations]",11,0,2,0,13
961578,630494,2017-04-24,Senate,"Do pass as amended, but first amend, and re-refer to the Committee on [Appropriations]",7,2,2,0,11
961578,647962,2017-05-22,Senate,"Placed on suspense file",7,0,0,0,7
961578,650659,2017-05-25,Senate,"Do pass as amended",5,2,0,0,7
961578,656213,2017-05-31,Senate,"Senate 3rd Reading SB356 Skinner",25,13,2,0,40
961578,671289,2017-07-05,Assembly,"Do pass as amended and be re-referred to the Committee on [Appropriations]",9,4,2,0,15
961579,609276,2017-03-21,Senate,"Do pass, but first be re-referred to the Committee on [Appropriations] with the recommendation: To Consent Calendar",5,0,0,0,5
961579,661225,2017-04-06,Senate,"Consent Calendar 2nd SB358 Stern",39,0,1,0,40
961579,672477,2017-07-12,Assembly,"Do pass and be re-referred to the Committee on [Appropriations] with recommendation: To Consent Calendar",6,0,1,0,7
961579,674006,2017-08-23,Assembly,"Do pass. To Consent Calendar",15,0,2,0,17
961579,674313,2017-08-31,Assembly,"SB 358 Stern Consent Calendar Second Day Regular Session",73,0,6,0,79
961580,642982,2017-05-10,Assembly,"Do pass. To Consent Calendar",6,0,1,0,7
961580,646588,2017-05-18,Assembly,"AB 617 GOMEZ Consent Calendar Second Day Regular Session",69,0,11,0,80
961580,672555,2017-07-13,Senate,"Do pass, but first be re-referred to the Committee on [Appropriations]",5,2,0,0,7
961580,672771,2017-07-17,Senate,"Do pass",5,2,0,0,7
961580,672772,2017-07-17,Senate,"Assembly 3rd Reading AB617 Cristina Garcia By Lara",27,13,0,0,40
961580,672773,2017-07-17,Assembly,"AB 617 GARCIA, C. Concurrence in Senate Amendments",50,24,5,0,79
961581,613490,2017-03-28,Senate,"Do pass, but first be re-referred to the Committee on [Appropriations]",8,2,3,0,13
961581,626094,2017-04-17,Senate,"Placed on suspense file",7,0,0,0,7
961581,650553,2017-05-25,Senate,"Do pass as amended",5,2,0,0,7
961581,655894,2017-05-31,Senate,"Senate 3rd Reading SB384 Wiener et al",27,9,4,0,40
961581,671331,2017-07-05,Assembly,"Do pass as amended and be re-referred to the Committee on [Appropriations]",15,4,2,0,21
961581,674549,2017-09-01,Assembly,"Do pass as amended",12,0,5,0,17
961581,675306,2017-09-11,Assembly,"Do pass",5,2,0,0,7
961581,676489,2017-09-15,Assembly,"SB 384 Wiener Senate Third Reading By LOW",45,29,5,0,79
961581,676490,2017-09-16,Senate,"Unfinished Business SB384 Wiener et al. Concurrence",28,5,7,0,40
961582,635011,2017-04-26,Senate,"Do pass, but first be re-referred to the Committee on [Appropriations]",9,0,0,0,9
961582,644984,2017-05-15,Senate,"Placed on suspense file",7,0,0,0,7
962923,609940,2017-03-21,Assembly,"Do pass as amended and be re-referred to the Committee on [Appropriations]",5,1,1,0,7
962923,651654,2017-05-26,Assembly,"Do pass as amended",12,5,0,0,17
962923,655876,2017-05-31,Assembly,"AB 676 LIMÓN Assembly Third Reading",55,21,4,0,80
962923,672340,2017-07-11,Senate,"Do pass, but first be re-referred to the Committee on [Labor and Industrial Relations]",4,3,0,0,7
962923,672341,2017-07-12,Senate,"Do pass, but first be re-referred to the Committee on [Appropriations]",4,1,0,0,5
962923,674205,2017-08-28,Senate,"Placed on suspense file",7,0,0,0,7
962925,620142,2017-04-04,Assembly,"Do pass",10,0,0,0,10
962925,629006,2017-04-20,Assembly,"AB 671 CHÁVEZ Assembly Third Reading",75,0,5,0,80
962925,669191,2017-06-27,Senate,"Do pass",7,0,0,0,7
962925,672707,2017-07-17,Senate,"Special Consent Calendar # AB671",38,0,2,0,40
962925,673982,2017-08-21,Assembly,"AB 671 CHÁVEZ Concurrence in Senate Amendments",78,0,1,0,79
962932,627532,2017-04-18,Assembly,"Do pass and be re-referred to the Committee on [Appropriations]",14,0,2,0,16
962932,637430,2017-05-03,Assembly,"Do pass. To Consent Calendar",16,0,1,0,17
962932,643620,2017-05-11,Assembly,"AB 710 WOOD Consent Calendar Second Day Regular Session",77,0,3,0,80
962932,735498,2018-04-09,Senate,"Do pass, but first be re-referred to the Committee on [Rules]",9,0,0,0,9
962932,753380,2018-05-15,Senate,"Do pass, but first be re-referred to the Committee on [Appropriations] with the recommendation: To Consent Calendar",7,0,0,0,7
962932,763688,2018-06-14,Senate,"Assembly 3rd Reading AB710 Wood By Hill Urgency Clause",37,0,2,0,39
962932,764358,2018-06-18,Assembly,"AB 710 WOOD Concurrence - Urgency Added",78,0,2,0,80
962938,609990,2017-03-22,Assembly,"Do pass and be re-referred to the Committee on [Appropriations]",6,0,1,0,7
962938,651516,2017-05-26,Assembly,"Do pass",13,4,0,0,17
962938,655914,2017-05-31,Assembly,"AB 716 O'DONNELL Assembly Third Reading",57,19,4,0,80
962938,766191,2018-06-20,Senate,"Do pass as amended, but first amend, and re-refer to the Committee on [Appropriations]",5,0,2,0,7
962938,772920,2018-08-27,Senate,"Assembly 3rd Reading AB716 O'Donnell By Allen",38,0,2,0,40
962938,773280,2018-08-29,Assembly,"With recommendation: That Senate amendments be concurred in",16,0,1,0,17
962938,773281,2018-08-29,Assembly,"With recommendation: That Senate amendments be concurred in, but first be re-referred to Com. on [Appropriations]",7,0,0,0,7
962938,773754,2018-08-30,Assembly,"AB 716 O'DONNELL Concurrence in Senate Amendments",80,0,0,0,80
962945,636606,2017-05-02,Assembly,"Do pass as amended",11,0,0,0,11
962945,644456,2017-05-15,Assembly,"AB 688 CALDERON Assembly Third Reading",78,0,2,0,80
962945,669877,2017-06-27,Senate,"Do pass and be ordered to the Consent Calendar",6,0,1,0,7
962945,676613,2017-09-15,Senate,"Assembly 3rd Reading AB688 Calderon By Stern",37,0,3,0,40
962945,676614,2017-09-16,Assembly,"AB 688 CALDERON Concurrence in Senate Amendments",77,0,2,0,79
962952,633416,2017-04-26,Assembly,"Do pass as amended and be re-referred to the Committee on [Local Government]",5,2,0,0,7
962952,642795,2017-05-10,Assembly,"Do pass as amended",7,1,1,0,9
962952,654296,2017-05-30,Assembly,"AB 678 BOCANEGRA Assembly Third Reading",68,6,6,0,80
962952,666178,2017-06-20,Senate,"Do pass as amended, but first amend, and re-refer to the Committee on [Judiciary]",8,2,3,0,13
962952,672346,2017-07-11,Senate,"Do pass",6,1,0,0,7
962952,672725,2017-07-17,Senate,"Do pass",5,2,0,0,7
962952,676530,2017-09-15,Senate,"Assembly 3rd Reading AB678 Bocanegra et al. By Skinner",27,10,3,0,40
962952,676531,2017-09-15,Assembly,"AB 678 BOCANEGRA Concurrence in Senate Amendments",70,7,2,0,79
962962,618529,2017-04-04,Assembly,"Do pass and be re-referred to the Committee on [Human Services]",15,0,0,0,15
962962,633157,2017-04-25,Assembly,"Do pass and be re-referred to the Committee on [Appropriations]",7,0,0,0,7
962967,613479,2017-03-28,Assembly,"Do pass as amended and be re-referred to the Committee on [Appropriations]",11,0,0,0,11
962974,643103,2017-05-10,Assembly,"Do pass. To Consent Calendar",6,0,1,0,7
962974,646433,2017-05-18,Assembly,"AB 691 LEVINE Consent Calendar Second Day Regular Session",69,0,11,0,80
962974,663130,2017-06-14,Senate,"Do pass as amended, and be ordered to the Consent Calendar",7,0,0,0,7
962974,674426,2017-08-31,Senate,"Assembly 3rd Reading AB691 Levine By Pan",40,0,0,0,40
962974,674881,2017-09-05,Assembly,"AB 691 LEVINE Concurrence in Senate Amendments",77,0,2,0,79
962980,637530,2017-05-03,Assembly,"Do pass",8,0,1,0,9
962980,643588,2017-05-11,Assembly,"AB 734 BONTA Assembly Third Reading",63,9,8,0,80
962980,767121,2018-06-20,Senate,"Do pass, but first be re-referred to the Committee on [Judiciary]",7,0,0,0,7
962980,768893,2018-06-26,Senate,"Do pass as amended, but first amend, and re-refer to the Committee on [Appropriations]",5,1,1,0,7
962980,771373,2018-08-13,Senate,"Placed on suspense file",7,0,0,0,7
962980,771867,2018-08-16,Senate,"Do pass as amended",7,0,0,0,7
962980,774161,2018-08-31,Assembly,"With recommendation: That Senate amendments be concurred in",6,2,2,0,10
962980,774162,2018-08-31,Senate,"Assembly 3rd Reading AB734 Bonta et al. By Skinner",33,0,7,0,40
962980,774163,2018-08-31,Assembly,"AB 734 Bonta Concurrence in Senate Amendments",66,4,10,0,80
962988,631756,2017-04-25,Assembly,"Do pass and be re-referred to the Committee on [Appropriations]",11,4,0,0,15
962988,651897,2017-05-26,Assembly,"Do pass as amended",13,4,0,0,17
962988,656137,2017-05-31,Assembly,"AB 732 FRAZIER Assembly Third Reading",71,1,8,0,80
962988,669132,2017-06-27,Senate,"Do pass, but first be re-referred to the Committee on [Appropriations]",8,0,1,0,9
962988,671895,2017-07-10,Senate,"Placed on suspense file",7,0,0,0,7
962998,637598,2017-05-03,Assembly,"Do pass",8,1,0,0,9
962998,648109,2017-05-22,Assembly,"AB 722 LIMÓN Assembly Third Reading",60,13,7,0,80
962998,672891,2017-07-19,Senate,"Do pass",5,2,0,0,7
962998,674428,2017-08-31,Senate,"Assembly 3rd Reading AB722 Limón By Jackson",27,12,1,0,40
962998,675173,2017-09-07,Assembly,"AB 722 LIMÓN Concurrence in Senate Amendments",59,17,3,0,79
963007,618595,2017-04-04,Assembly,"Do pass and be re-referred to the Committee on [Appropriations]",5,2,0,0,7
963007,651804,2017-05-26,Assembly,"Do pass",12,5,0,0,17
963007,656838,2017-06-01,Assembly,"AB 736 GIPSON Assembly Third Reading",49,29,2,0,80
963007,672084,2017-07-11,Senate,"Do pass, but first be re-referred to the Committee on [Appropriations]",5,2,0,0,7
963007,673830,2017-08-21,Senate,"Placed on suspense file",7,0,0,0,7
963022,607444,2017-03-20,Assembly,"Do pass and be re-referred to the Committee on [Appropriations] with recommendation: To Consent Calendar",14,0,0,0,14
963022,619929,2017-04-05,Assembly,"Do pass. To Consent Calendar",17,0,0,0,17
963022,629208,2017-04-20,Assembly,"AB 695 BOCANEGRA Consent Calendar Second Day Regular Session",74,0,6,0,80
963022,658854,2017-06-06,Senate,"Do pass, but first be re-referred to the Committee on [Appropriations] with the recommendation: To Consent Calendar",13,0,0,0,13
963022,670985,2017-07-03,Senate,"Consent Calendar 2nd AB695",33,0,7,0,40
963034,621156,2017-04-05,Assembly,"Do pass",5,3,1,0,9
963034,638291,2017-05-04,Assembly,"AB 733 BERMAN Assembly Third Reading",56,17,7,0,80
963034,659779,2017-06-07,Senate,"Do pass, but first be re-referred to the Committee on [Environmental Quality]",5,2,0,0,7
963034,667315,2017-06-21,Senate,"Do pass as amended",5,1,1,0,7
963034,674943,2017-09-05,Senate,"Assembly 3rd Reading AB733 Berman et al. By Stern",27,11,2,0,40
963034,675202,2017-09-07,Assembly,"AB 733 BERMAN Concurrence in Senate Amendments",58,20,1,0,79
963049,627012,2017-04-17,Assembly,"Do pass as amended and be re-referred to the Committee on [Appropriations]",10,0,0,0,10
963049,651527,2017-05-26,Assembly,"Do pass as amended",17,0,0,0,17
963049,656120,2017-05-31,Assembly,"AB 707 AGUIAR-CURRY Assembly Third Reading",76,0,4,0,80
963049,672088,2017-07-11,Senate,"Do pass, but first be re-referred to the Committee on [Appropriations]",9,0,0,0,9
963049,673949,2017-08-21,Senate,"Placed on suspense file",7,0,0,0,7
963049,674797,2017-09-01,Senate,"Do pass",7,0,0,0,7
963049,676202,2017-09-14,Senate,"Special Consent Calendar # AB707",40,0,0,0,40
963049,676203,2017-09-14,Assembly,"AB 707 Aguiar-Curry Special Consent Calendar 1st Day Regular Session",79,0,0,0,79
963058,631721,2017-04-24,Assembly,"Do pass and be re-referred to the Committee on [Appropriations]",10,4,0,0,14
963058,642986,2017-05-10,Assembly,"Do pass",12,5,0,0,17
963058,647861,2017-05-22,Assembly,"AB 673 CHU Assembly Third Reading",55,21,4,0,80
963058,662386,2017-06-13,Senate,"Do pass, but first be re-referred to the Committee on [Appropriations]",10,3,0,0,13
963058,671989,2017-07-10,Senate,"Assembly 3rd Reading AB673 Chu By Hill",28,12,0,0,40
963064,630508,2017-04-24,Assembly,"Be re-referred to the Committee on [Health]",11,0,0,0,11
963083,613140,2017-03-27,Assembly,"Do pass and be re-referred to the Committee on [Appropriations]",12,0,2,0,14
963083,634440,2017-04-26,Assembly,"Do pass. To Consent Calendar",16,0,1,0,17
963083,638508,2017-05-04,Assembly,"AB 697 FONG Consent Calendar Second Day Regular Session",76,0,4,0,80
963083,669266,2017-06-27,Senate,"Do pass, but first be re-referred to the Committee on [Appropriations]",11,0,2,0,13
963083,772457,2018-08-22,Senate,"Assembly 3rd Reading AB697 Fong By Beall",39,0,1,0,40
963083,773002,2018-08-27,Assembly,"AB 697 FONG Concurrence in Senate Amendments",79,0,1,0,80
963093,642776,2017-05-10,Assembly,"Do pass as amended",5,3,1,0,9
963093,654328,2017-05-30,Assembly,"AB 709 MCCARTY Assembly Third Reading",49,26,5,0,80
963093,671917,2017-07-10,Senate,"Do pass as amended, but first amend, and re-refer to the Committee on [Appropriations]",2,6,1,0,9
963093,671918,2017-07-10,Senate,"[First] hearing set for [07-10-2017]: Failed passage in Committee. Reconsideration granted",9,0,0,0,9
963093,764971,2018-06-19,Senate,"Do pass, but first be re-referred to the Committee on [Governance and Finance]",10,3,0,0,13
963093,769216,2018-06-27,Senate,"Do pass",5,2,0,0,7
963093,774011,2018-08-31,Assembly,"With recommendation: That Senate amendments be concurred in",6,3,0,0,9
963093,774012,2018-08-31,Senate,"Assembly 3rd Reading AB709 McCarty By Pan",27,10,3,0,40
963093,774013,2018-08-31,Assembly,"AB 709 McCarty Concurrence in Senate Amendments",49,30,1,0,80
963099,607085,2017-03-20,Assembly,"Do pass and be re-referred to the Committee on [Appropriations]",14,0,0,0,14
963112,632854,2017-04-24,Assembly,"Do pass as amended and be re-referred to the Committee on [Appropriations]",9,1,0,0,10
963124,620130,2017-04-05,Assembly,"Do pass and be re-referred to the Committee on [Judiciary]",7,0,0,0,7
963124,641502,2017-05-09,Assembly,"Do pass. To Consent Calendar",11,0,0,0,11
963124,644433,2017-05-15,Assembly,"AB 690 QUIRK-SILVA Consent Calendar Second Day Regular Session",79,0,1,0,80
963124,658663,2017-06-06,Senate,"Do pass, but first be re-referred to the Committee on [Judiciary] with the recommendation: To Consent Calendar",13,0,0,0,13
963124,669629,2017-06-27,Senate,"Do pass and be ordered to the Consent Calendar",6,0,1,0,7
963124,671879,2017-07-10,Senate,"Consent Calendar 2nd AB690 Quirk-Silva",40,0,0,0,40
963129,619978,2017-04-05,Assembly,"Do pass and be re-referred to the Committee on [Governmental Organization]",5,2,0,0,7
963129,634352,2017-04-27,Assembly,"Do pass and be re-referred to the Committee on [Appropriations]",14,6,1,0,21
963145,608431,2017-03-21,Assembly,"Do pass as amended, and be re-referred to the Committee on [Appropriations] with recommendation: To Consent Calendar",7,0,0,0,7
963145,633133,2017-04-26,Assembly,"Do pass. To Consent Calendar",16,0,1,0,17
963145,638576,2017-05-04,Assembly,"AB 693 IRWIN Consent Calendar Second Day Regular Session",76,0,4,0,80
963145,666318,2017-06-20,Senate,"Do pass and be ordered to the Consent Calendar",7,0,0,0,7
963145,674316,2017-08-31,Senate,"Assembly 3rd Reading AB693 Irwin By Stern Urgency Clause",39,0,1,0,40
963145,674968,2017-09-05,Assembly,"AB 693 IRWIN Concurrence - Urgency Added",77,0,2,0,79
963149,628929,2017-04-19,Assembly,"Do pass and be re-referred to the Committee on [Appropriations]",7,0,0,0,7
963149,651855,2017-05-26,Assembly,"Do pass",17,0,0,0,17
963149,654140,2017-05-30,Assembly,"AB 708 QUIRK-SILVA Assembly Third Reading",73,0,7,0,80
963149,669594,2017-06-28,Senate,"Do pass, but first be re-referred to the Committee on [Appropriations]",4,0,1,0,5
963165,621054,2017-04-05,Assembly,"Do pass and be re-referred to the Committee on [Judiciary]",5,1,1,0,7
963165,627115,2017-04-18,Assembly,"Do pass as amended and be re-referred to the Committee on [Appropriations]",10,1,0,0,11
963165,651922,2017-05-26,Assembly,"Do pass as amended",12,4,1,0,17
963165,656840,2017-06-01,Assembly,"AB 699 O'DONNELL Assembly Third Reading",60,13,7,0,80
963165,669758,2017-06-27,Senate,"Do pass, but first be re-referred to the Committee on [Education]",4,1,2,0,7
963165,672308,2017-07-12,Senate,"Do pass, but first be re-referred to the Committee on [Appropriations]",7,0,0,0,7
963165,673792,2017-08-21,Senate,"Placed on suspense file",7,0,0,0,7
963165,674481,2017-09-01,Senate,"Do pass as amended",5,2,0,0,7
963165,675847,2017-09-13,Senate,"Assembly 3rd Reading AB699 O'Donnell et al. By Mendoza",31,6,3,0,40
963165,676537,2017-09-15,Assembly,"AB 699 O'DONNELL Concurrence in Senate Amendments",60,13,6,0,79
963178,627801,2017-04-18,Assembly,"Do pass as amended and be re-referred to the Committee on [Appropriations]",13,0,0,0,13
963178,651908,2017-05-26,Assembly,"Do pass as amended",13,0,4,0,17
963178,656174,2017-05-31,Assembly,"AB 705 IRWIN Assembly Third Reading",76,0,4,0,80
963178,672345,2017-07-12,Senate,"Do pass as amended, but first amend, and re-refer to the Committee on [Appropriations]",7,0,0,0,7
963178,673914,2017-08-21,Senate,"Placed on suspense file",7,0,0,0,7
963178,674503,2017-09-01,Senate,"Do pass",7,0,0,0,7
963178,676184,2017-09-14,Senate,"Special Consent Calendar # AB705",40,0,0,0,40
963178,676185,2017-09-14,Assembly,"AB 705 Irwin Special Consent Calendar 1st Day Regular Session",79,0,0,0,79
963178,777223,2017-05-26,Assembly,,13,0,4,0,17
963186,632107,2017-04-25,Assembly,"Do pass as amended and be re-referred to the Committee on [Appropriations]",11,0,0,0,11
963186,642857,2017-05-10,Assembly,"Do pass. To Consent Calendar",17,0,0,0,17
963186,646437,2017-05-18,Assembly,"AB 724 CHOI Consent Calendar Second Day Regular Session",69,0,11,0,80
963186,672409,2017-07-11,Senate,"Do pass, but first be re-referred to the Committee on [Appropriations]",7,0,0,0,7
963186,774021,2018-08-31,Senate,"Assembly 3rd Reading AB724 Choi et al. By Moorlach",38,0,2,0,40
963186,774022,2018-08-31,Assembly,"AB 724 CHOI Concurrence in Senate Amendments",79,0,1,0,80
963192,618618,2017-04-04,Assembly,"Do pass as amended and be re-referred to the Committee on [Judiciary]",7,0,0,0,7
963192,641792,2017-05-09,Assembly,"Do pass as amended",10,0,1,0,11
963192,647873,2017-05-22,Assembly,"AB 720 EGGMAN Assembly Third Reading",75,0,5,0,80
963192,672161,2017-07-11,Senate,"Do pass as amended, but first amend, and re-refer to the Committee on [Appropriations]",7,0,0,0,7
963192,673803,2017-08-21,Senate,"Placed on suspense file",7,0,0,0,7
963192,674700,2017-09-01,Senate,"Do pass",7,0,0,0,7
963192,676166,2017-09-14,Senate,"Special Consent Calendar # AB720",40,0,0,0,40
963192,676325,2017-09-14,Assembly,"AB 720 Eggman Special Consent Calendar 1st Day Regular Session",79,0,0,0,79
963207,630528,2017-04-24,Assembly,"Be re-referred to the Committee on [Environmental Safety and Toxic Materials]",11,0,0,0,11
963214,608522,2017-03-21,Assembly,"Do pass and be re-referred to the Committee on [Appropriations]",8,4,3,0,15
963214,652174,2017-05-26,Assembly,"Do pass",12,5,0,0,17
963214,655828,2017-05-31,Assembly,"AB 725 LEVINE Assembly Third Reading",54,20,6,0,80
963214,669009,2017-06-27,Senate,"Do pass, but first be re-referred to the Committee on [Appropriations]",6,2,1,0,9
963214,671831,2017-07-10,Senate,"Placed on suspense file",7,0,0,0,7
963214,674527,2017-09-01,Senate,"Do pass as amended",5,2,0,0,7
963214,675431,2017-09-11,Senate,"Assembly 3rd Reading AB725 Levine et al. By Jackson",26,11,3,0,40
963214,675808,2017-09-13,Assembly,"AB 725 LEVINE Concurrence in Senate Amendments",57,20,2,0,79
963220,608447,2017-03-21,Assembly,"Do pass and be re-referred to the Committee on [Appropriations]",7,0,0,0,7
963229,607091,2017-03-20,Assembly,"Do pass and be re-referred to the Committee on [Appropriations]",10,2,2,0,14
963229,651576,2017-05-26,Assembly,"Do pass",12,5,0,0,17
963229,655922,2017-05-31,Assembly,"AB 696 CABALLERO Assembly Third Reading",64,12,4,0,80
963229,666296,2017-06-20,Senate,"Do pass, but first be re-referred to the Committee on [Appropriations]",11,1,1,0,13
963229,671947,2017-07-10,Senate,"Placed on suspense file",7,0,0,0,7
963229,674791,2017-09-01,Senate,"Do pass",7,0,0,0,7
963229,675347,2017-09-11,Senate,"Assembly 3rd Reading AB696 Caballero et al. By Cannella",40,0,0,0,40
963229,675611,2017-09-12,Assembly,"AB 696 CABALLERO Concurrence in Senate Amendments",64,14,1,0,79
963244,619926,2017-04-05,Assembly,"Do pass as amended and be re-referred to the Committee on [Judiciary]",5,2,0,0,7
963244,631738,2017-04-25,Assembly,"Do pass as amended and be re-referred to the Committee on [Appropriations]",8,2,1,0,11
963244,651917,2017-05-26,Assembly,"Do pass as amended",12,5,0,0,17
963244,656181,2017-05-31,Assembly,"AB 686 SANTIAGO Assembly Third Reading",55,21,4,0,80
963244,762154,2018-06-12,Senate,"Do pass as amended, but first amend, and re-refer to the Committee on [Judiciary]",11,1,1,0,13
963244,768836,2018-06-26,Senate,"Do pass, but first be re-referred to the Committee on [Appropriations]",5,1,1,0,7
963244,770363,2018-08-06,Senate,"Placed on suspense file",7,0,0,0,7
963244,771522,2018-08-16,Senate,"Do pass as amended",5,2,0,0,7
963244,772378,2018-08-21,Senate,"Assembly 3rd Reading AB686 Santiago et al. By Wiener",31,7,2,0,40
963244,772893,2018-08-27,Assembly,"AB 686 SANTIAGO Concurrence in Senate Amendments",56,23,1,0,80
963249,609884,2017-03-21,Assembly,"Do pass as amended and be re-referred to the Committee on [Aging and Long-Term Care]",7,0,0,0,7
963249,619803,2017-04-04,Assembly,"Do pass and be re-referred to the Committee on [Appropriations]",7,0,0,0,7
963249,651871,2017-05-26,Assembly,"Do pass",13,3,1,0,17
963249,655796,2017-05-31,Assembly,"AB 713 CHU Assembly Third Reading",62,14,4,0,80
963249,669119,2017-06-27,Senate,"Do pass, but first be re-referred to the Committee on [Appropriations]",5,0,0,0,5
963249,671873,2017-07-10,Senate,"Placed on suspense file",7,0,0,0,7
963249,674622,2017-09-01,Senate,"Do pass",6,0,1,0,7
963249,675606,2017-09-12,Senate,"Assembly 3rd Reading AB713 Chu By Newman",39,0,1,0,40
963249,676277,2017-09-14,Assembly,"AB 713 CHU Concurrence in Senate Amendments",71,5,3,0,79
963257,618634,2017-04-04,Assembly,"Do pass and be re-referred to the Committee on [Appropriations]",7,0,0,0,7
963257,651821,2017-05-26,Assembly,"Do pass",17,0,0,0,17
963257,654387,2017-05-30,Assembly,"AB 702 LACKEY Assembly Third Reading",77,0,3,0,80
963257,669182,2017-06-27,Senate,"Do pass as amended, but first amend, and re-refer to the Committee on [Appropriations]",6,0,1,0,7
963257,672746,2017-07-17,Senate,"Placed on suspense file",7,0,0,0,7
963257,774539,2017-05-26,Assembly,,7,0,0,0,7
963267,628636,2017-04-19,Assembly,"Do pass and be re-referred to the Committee on [Communications and Conveyance]",20,0,1,0,21
963267,634578,2017-04-26,Assembly,"Do pass as amended and be re-referred to the Committee on [Appropriations]",12,0,1,0,13
963267,645934,2017-05-17,Assembly,"Do pass. To Consent Calendar",17,0,0,0,17
963267,651512,2017-05-26,Assembly,"AB 711 LOW Consent Calendar Second Day Regular Session",76,0,4,0,80
963267,669129,2017-06-27,Senate,"Do pass, but first be re-referred to the Committee on [Appropriations]",13,0,0,0,13
963267,673996,2017-08-21,Senate,"Assembly 3rd Reading AB711 Low et al. By Dodd",39,0,1,0,40
963267,674214,2017-08-28,Assembly,"AB 711 LOW Concurrence in Senate Amendments",73,0,6,0,79
963270,626753,2017-04-17,Assembly,"Do pass and be re-referred to the Committee on [Appropriations]",13,0,1,0,14
963270,652169,2017-05-26,Assembly,"Do pass",17,0,0,0,17
963270,654462,2017-05-30,Assembly,"AB 692 CHU Assembly Third Reading",76,0,4,0,80
963270,669170,2017-06-27,Senate,"Do pass as amended, but first amend, and re-refer to the Committee on [Education]",13,0,0,0,13
963270,672483,2017-07-12,Senate,"Do pass, but first be re-referred to the Committee on [Appropriations] with the recommendation: To Consent Calendar",7,0,0,0,7
963270,673937,2017-08-21,Senate,"Placed on suspense file",7,0,0,0,7
963281,619394,2017-04-04,Assembly,"Do pass. To Consent Calendar",7,0,0,0,7
963281,626196,2017-04-17,Assembly,"AB 730 QUIRK Consent Calendar Second Day Regular Session",76,0,4,0,80
963281,662609,2017-06-13,Senate,"Do pass and be ordered to the Consent Calendar",13,0,0,0,13
963281,665353,2017-06-19,Senate,"Consent Calendar 2nd AB730",33,0,7,0,40
963285,619418,2017-04-04,Assembly,"Do pass as amended and be re-referred to the Committee on [Appropriations]",14,1,0,0,15
963285,652132,2017-05-26,Assembly,"Do pass as amended",12,0,5,0,17
963285,655746,2017-05-31,Assembly,"AB 700 JONES-SAWYER Assembly Third Reading",70,4,6,0,80
963285,768199,2018-06-26,Senate,"Do pass, but first be re-referred to the Committee on [Appropriations]",12,0,1,0,13
963285,772176,2018-08-20,Senate,"Assembly 3rd Reading AB700 Jones-Sawyer By Mitchell",36,0,4,0,40
963285,773052,2018-08-28,Assembly,"With recommendation: That Senate amendments be concurred in",17,0,3,0,20
963285,773363,2018-08-29,Assembly,"AB 700 JONES-SAWYER Concurrence in Senate Amendments",78,0,2,0,80
963292,619337,2017-04-03,Assembly,"Do pass as amended and be re-referred to the Committee on [Appropriations]",9,0,1,0,10
963292,652139,2017-05-26,Assembly,"Do pass",17,0,0,0,17
963292,655767,2017-05-31,Assembly,"AB 684 STONE Assembly Third Reading",74,0,6,0,80
963292,672117,2017-07-11,Senate,"Do pass as amended, but first amend, and re-refer to the Committee on [Appropriations]",8,0,1,0,9
963292,673913,2017-08-21,Senate,"Placed on suspense file",7,0,0,0,7
963301,618386,2017-04-04,Assembly,"Do pass",14,0,1,0,15
963301,629001,2017-04-20,Assembly,"AB 727 NAZARIAN Assembly Third Reading",73,0,7,0,80
963301,660047,2017-06-07,Senate,"Do pass as amended, and be ordered to the Consent Calendar",9,0,0,0,9
963301,675582,2017-09-12,Senate,"Assembly 3rd Reading AB727 Nazarian By Hernandez",40,0,0,0,40
963301,676225,2017-09-14,Assembly,"AB 727 NAZARIAN Concurrence in Senate Amendments",78,0,1,0,79
963307,628862,2017-04-19,Assembly,"Do pass and be re-referred to the Committee on [Appropriations]",5,2,0,0,7
963307,651535,2017-05-26,Assembly,"Do pass",12,5,0,0,17
963307,655910,2017-05-31,Assembly,"AB 670 THURMOND Assembly Third Reading",54,22,4,0,80
963307,672370,2017-07-12,Senate,"Do pass, but first be re-referred to the Committee on [Appropriations]",4,1,0,0,5
963307,673865,2017-08-21,Senate,"Placed on suspense file",7,0,0,0,7
963307,674763,2017-09-01,Senate,"Do pass",5,2,0,0,7
963307,675667,2017-09-12,Senate,"Assembly 3rd Reading AB670 Thurmond By Mitchell",24,14,2,0,40
963325,608505,2017-03-21,Assembly,"Do pass and be re-referred to the Committee on [Appropriations] with recommendation: To Consent Calendar",11,0,0,0,11
963325,620010,2017-04-05,Assembly,"Do pass. To Consent Calendar",17,0,0,0,17
963325,629130,2017-04-20,Assembly,"AB 712 BLOOM Assembly Third Reading",76,0,4,0,80
963325,666198,2017-06-20,Senate,"Do pass, but first be re-referred to the Committee on [Appropriations]",6,0,1,0,7
963325,674380,2017-08-31,Senate,"Assembly 3rd Reading AB712 Bloom By Jackson",39,0,1,0,40
963325,674882,2017-09-05,Assembly,"AB 712 BLOOM FINAL FORM Motion to Appeal the Decision of the Chair By KILEY",24,51,4,0,79
963325,674883,2017-09-05,Assembly,"AB 712 BLOOM FINAL FORM Motion to Appeal the Decision of the Chair By ALLEN",18,47,14,0,79
963325,674884,2017-09-05,Assembly,"AB 712 BLOOM FINAL FORM",72,1,6,0,79
963340,608410,2017-03-21,Assembly,"Do pass and be re-referred to the Committee on [Appropriations] with recommendation: To Consent Calendar",15,0,0,0,15
963340,651754,2017-05-26,Assembly,"Do pass as amended",16,0,1,0,17
963340,656082,2017-05-31,Assembly,"AB 735 MAIENSCHEIN Assembly Third Reading",76,0,4,0,80
963340,669810,2017-06-28,Senate,"Do pass, but first be re-referred to the Committee on [Appropriations] with the recommendation: To Consent Calendar",7,0,2,0,9
963340,672727,2017-07-17,Senate,"Placed on suspense file",7,0,0,0,7
963354,610521,2017-03-22,Assembly,"Do pass as amended, and be re-referred to the Committee on [Appropriations] with recommendation: To Consent Calendar",7,0,0,0,7
963354,633551,2017-04-26,Assembly,"Do pass. To Consent Calendar",16,0,1,0,17
963354,638695,2017-05-04,Assembly,"AB 681 CHAU Consent Calendar Second Day Regular Session",76,0,4,0,80
963354,667306,2017-06-21,Senate,"Do pass, but first be re-referred to the Committee on [Appropriations] with the recommendation: To Consent Calendar",6,0,1,0,7
963354,672619,2017-07-13,Senate,"Consent Calendar 2nd AB681",39,0,1,0,40
963354,673818,2017-08-21,Assembly,"AB 681 CHAU Concurrence in Senate Amendments",77,1,1,0,79
963362,618244,2017-04-04,Assembly,"Do pass and be re-referred to the Committee on [Appropriations] with recommendation: To Consent Calendar",14,0,1,0,15
963362,651619,2017-05-26,Assembly,"Do pass",17,0,0,0,17
963362,654277,2017-05-30,Assembly,"AB 715 WOOD Assembly Third Reading",77,0,3,0,80
963362,667090,2017-06-21,Senate,"Do pass, but first be re-referred to the Committee on [Appropriations]",9,0,0,0,9
963362,671833,2017-07-10,Senate,"Placed on suspense file",7,0,0,0,7
963362,674487,2017-09-01,Senate,"Do pass",7,0,0,0,7
963362,675075,2017-09-06,Senate,"Assembly 3rd Reading AB715 Wood By Pan",40,0,0,0,40
963362,675365,2017-09-11,Assembly,"AB 715 WOOD Concurrence in Senate Amendments",77,0,2,0,79
963371,628029,2017-04-19,Assembly,"Do pass and be re-referred to the Committee on [Appropriations]",6,0,1,0,7
963371,637615,2017-05-03,Assembly,"Do pass. To Consent Calendar",16,0,1,0,17
963371,643445,2017-05-11,Assembly,"AB 679 COOLEY Consent Calendar Second Day Regular Session",77,0,3,0,80
963371,668622,2017-06-26,Senate,"Do pass, but first be re-referred to the Committee on [Appropriations] with the recommendation: To Consent Calendar",5,0,0,0,5
963371,672611,2017-07-13,Senate,"Consent Calendar 2nd AB679",39,0,1,0,40
963371,673806,2017-08-21,Assembly,"AB 679 COOLEY Concurrence in Senate Amendments",76,0,3,0,79
963371,775126,2017-07-13,Senate,Cons,5,0,1,0,6
963377,633635,2017-04-26,Assembly,"Do pass as amended and be re-referred to the Committee on [Appropriations]",12,0,3,0,15
963377,651864,2017-05-26,Assembly,"Do pass",17,0,0,0,17
963377,654425,2017-05-30,Assembly,"AB 726 HOLDEN Assembly Third Reading",76,0,4,0,80
963377,671892,2017-07-10,Senate,"Do pass as amended, but first amend, and re-refer to the Committee on [Appropriations]",10,0,1,0,11
963377,673993,2017-08-21,Senate,"Placed on suspense file",7,0,0,0,7
963377,674708,2017-09-01,Senate,"Do pass as amended",7,0,0,0,7
963390,608484,2017-03-21,Assembly,"Do pass and be re-referred to the Committee on [Appropriations] with recommendation: To Consent Calendar",7,0,0,0,7
963390,634379,2017-04-27,Assembly,"AB 683 GARCIA, E. Assembly Third Reading",72,0,8,0,80
963390,662252,2017-06-13,Senate,"Do pass and be ordered to the Consent Calendar",7,0,0,0,7
963390,665098,2017-06-19,Senate,"Consent Calendar 2nd AB683",33,0,7,0,40
963408,610367,2017-03-22,Assembly,"Do pass and be re-referred to the Committee on [Agriculture]",7,0,0,0,7
963408,620218,2017-04-05,Assembly,"Do pass and be re-referred to the Committee on [Appropriations] with recommendation: To Consent Calendar",9,0,1,0,10
963408,651613,2017-05-26,Assembly,"Do pass",17,0,0,0,17
963408,655757,2017-05-31,Assembly,"AB 822 CABALLERO Assembly Third Reading",76,0,4,0,80
963408,669363,2017-06-27,Senate,"Do pass, but first be re-referred to the Committee on [Agriculture]",13,0,0,0,13
963408,671612,2017-07-06,Senate,"Do pass, but first be re-referred to the Committee on [Appropriations]",4,0,1,0,5
963408,672737,2017-07-17,Senate,"Placed on suspense file",7,0,0,0,7
963408,674577,2017-09-01,Senate,"Do pass",7,0,0,0,7
963408,675226,2017-09-07,Senate,"Assembly 3rd Reading AB822 Caballero et al. By Galgiani",39,0,1,0,40
963408,675312,2017-09-11,Assembly,"AB 822 CABALLERO Concurrence in Senate Amendments",77,0,2,0,79
963412,613711,2017-03-28,Senate,"Do pass as amended, but first amend, and re-refer to the Committee on [Governance and Finance]",4,0,1,0,5
963412,635769,2017-05-01,Senate,"Senate 3rd Reading SB433 Mendoza",37,0,3,0,40
963412,669214,2017-06-27,Assembly,"Do pass as amended and be re-referred to the Committee on [Privacy and Consumer Protection]",7,0,0,0,7
963412,672216,2017-07-11,Assembly,"Do pass and be re-referred to the Committee on [Appropriations] with recommendation: To Consent Calendar",10,0,0,0,10
963412,674041,2017-08-23,Assembly,"Do pass. To Consent Calendar",15,0,2,0,17
963413,614849,2017-03-29,Assembly,"Do pass and be re-referred to the Committee on [Appropriations]",13,0,2,0,15
963413,633527,2017-04-26,Assembly,"Do pass. To Consent Calendar",16,0,1,0,17
963413,638672,2017-05-04,Assembly,"AB 759 DAHLE Consent Calendar Second Day Regular Session",76,0,4,0,80
963413,659555,2017-06-06,Senate,"Do pass, but first be re-referred to the Committee on [Appropriations]",10,0,1,0,11
963413,672013,2017-07-10,Senate,"Assembly 3rd Reading AB759 Dahle et al. By Hueso",39,0,1,0,40
963413,672709,2017-07-17,Assembly,"AB 759 DAHLE Concurrence in Senate Amendments",77,0,2,0,79
963420,620393,2017-04-04,Senate,"Do pass, but first be re-referred to the Committee on [Appropriations]",4,7,2,0,13
963420,620394,2017-04-04,Senate,"[First] hearing set for [04-05-2017]: Failed passage in Committee. Reconsideration granted",13,0,0,0,13
963422,632767,2017-04-25,Assembly,"Do pass and be re-referred to the Committee on [Appropriations]",15,0,0,0,15
963422,637471,2017-05-03,Assembly,"Do pass. To Consent Calendar",16,0,1,0,17
963422,643585,2017-05-11,Assembly,"AB 798 GARCIA, E. Consent Calendar Second Day Regular Session",77,0,3,0,80
963422,672899,2017-07-19,Senate,"Do pass",7,0,0,0,7
963422,674406,2017-08-31,Senate,"Special Consent Calendar # AB798 Eduardo Garcia By Hueso Urgency Clause",37,0,3,0,40
963422,675672,2017-09-12,Assembly,"With recommendation: That Senate amendments be concurred in",9,0,0,0,9
963422,676305,2017-09-14,Assembly,"AB 798 GARCIA, E. Concurrence - Urgency Added",79,0,0,0,79
963437,628048,2017-04-19,Assembly,"Do pass as amended and be re-referred to the Committee on [Appropriations]",9,5,1,0,15
963437,642677,2017-05-10,Assembly,"Do pass",12,5,0,0,17
963437,644550,2017-05-15,Assembly,"AB 797 IRWIN Assembly Third Reading",54,24,2,0,80
963437,659302,2017-06-06,Senate,"Do pass as amended, but first amend, and re-refer to the Committee on [Appropriations]",9,1,1,0,11
963437,668880,2017-06-26,Senate,"Placed on suspense file",7,0,0,0,7
963437,674705,2017-09-01,Senate,"Do pass",5,2,0,0,7
963437,675586,2017-09-12,Senate,"Assembly 3rd Reading AB797 Irwin By Stern",30,10,0,0,40
963437,676177,2017-09-14,Assembly,"AB 797 IRWIN Concurrence in Senate Amendments",54,24,1,0,79
963446,634492,2017-04-27,Assembly,"Do pass as amended and be re-referred to the Committee on [Appropriations]",11,0,0,0,11
963449,631630,2017-04-25,Senate,"Do pass, but first be re-referred to the Committee on [Appropriations]",3,1,1,0,5
963449,644427,2017-05-15,Senate,"Placed on suspense file",7,0,0,0,7
963449,650599,2017-05-25,Senate,"Do pass as amended",5,2,0,0,7
963449,656131,2017-05-31,Senate,"Senate 3rd Reading SB426 Pan",28,11,1,0,40
963449,669174,2017-06-27,Assembly,"Do pass as amended and be re-referred to the Committee on [Appropriations]",7,0,0,0,7
963450,613804,2017-03-28,Senate,"Do pass, but first be re-referred to the Committee on [Judiciary] with the recommendation: To Consent Calendar",4,0,1,0,5
963450,627845,2017-04-18,Senate,"Do pass and be ordered to the Consent Calendar",7,0,0,0,7
963450,634709,2017-04-27,Senate,"Consent Calendar 2nd SB413",36,0,4,0,40
963450,666243,2017-06-20,Assembly,"Do pass and be re-referred to the Committee on [Judiciary]",7,0,0,0,7
963450,668968,2017-06-27,Assembly,"Do pass. To Consent Calendar",11,0,0,0,11
963450,671559,2017-07-06,Assembly,"SB 413 Morrell Consent Calendar Second Day",74,0,6,0,80
963453,632116,2017-04-25,Senate,"Do pass as amended, but first amend, and re-refer to the Committee on [Appropriations]",12,1,0,0,13
963453,644599,2017-05-15,Senate,"Placed on suspense file",7,0,0,0,7
963453,650471,2017-05-25,Senate,"Do pass as amended",6,1,0,0,7
963453,655911,2017-05-31,Senate,"Senate 3rd Reading SB406 Leyva",38,2,0,0,40
963453,668723,2017-06-26,Assembly,"Do pass",14,0,0,0,14
963453,674302,2017-08-31,Assembly,"SB 406 Leyva Senate Third Reading By RODRIGUEZ",75,1,3,0,79
963453,674930,2017-09-05,Senate,"Unfinished Business SB406 Leyva Concurrence",40,0,0,0,40
963459,608480,2017-03-21,Assembly,"Do pass",5,1,1,0,7
963459,621399,2017-04-06,Assembly,"AB 721 BIGELOW Assembly Third Reading",66,4,10,0,80
963460,631817,2017-04-24,Assembly,"Do pass and be re-referred to the Committee on [Appropriations]",14,0,0,0,14
963460,651708,2017-05-26,Assembly,"Do pass",17,0,0,0,17
963460,656918,2017-06-01,Assembly,"AB 758 EGGMAN Assembly Third Reading",72,0,8,0,80
963460,675800,2017-09-13,Senate,"Do pass, but first be re-referred to the Committee on [Appropriations]",11,1,1,0,13
963460,676420,2017-09-15,Senate,"Do pass",7,0,0,0,7
963460,676566,2017-09-15,Senate,"Assembly 3rd Reading AB758 Eggman et al. By Beall",36,1,3,0,40
963460,676567,2017-09-16,Assembly,"AB 758 EGGMAN Concurrence in Senate Amendments",70,1,8,0,79
963462,608344,2017-03-21,Senate,"Do pass, but first be re-referred to the Committee on [Appropriations] with the recommendation: To Consent Calendar",7,0,0,0,7
963462,661205,2017-04-06,Senate,"Consent Calendar 2nd SB420 Monning",39,0,1,0,40
963462,662292,2017-06-13,Assembly,"Do pass and be re-referred to the Committee on [Appropriations] with recommendation: To Consent Calendar",7,0,0,0,7
963462,669646,2017-06-28,Assembly,"Do pass. To Consent Calendar",14,0,3,0,17
963462,674067,2017-08-24,Assembly,"SB 420 Monning Senate Third Reading By QUIRK",75,1,3,0,79
963462,674309,2017-08-31,Senate,"Special Consent Calendar # SB420",37,0,3,0,40
963466,618413,2017-04-04,Senate,"Do pass as amended, but first amend, and re-refer to the Committee on [Health]",4,0,1,0,5
963466,635905,2017-05-01,Senate,"Placed on suspense file",7,0,0,0,7
963466,650844,2017-05-25,Senate,"Do pass",7,0,0,0,7
963466,654606,2017-05-30,Senate,"Senate 3rd Reading SB398 Monning",40,0,0,0,40
963466,666214,2017-06-20,Assembly,"Do pass and be re-referred to the Committee on [Human Services] with recommendation: To Consent Calendar",15,0,0,0,15
963466,762184,2018-06-12,Assembly,"Do pass and be re-referred to the Committee on [Appropriations]",7,0,0,0,7
963466,771534,2018-08-16,Assembly,"Do pass",17,0,0,0,17
963466,772579,2018-08-23,Assembly,"SB 398 Monning Senate Third Reading By THURMOND",79,0,1,0,80
963466,772659,2018-08-24,Senate,"Unfinished Business SB398 Monning Concurrence",39,0,1,0,40
963471,632102,2017-04-24,Senate,"Do pass, but first be re-referred to the Committee on [Appropriations]",8,1,0,0,9
963471,647835,2017-05-22,Senate,"Placed on suspense file",7,0,0,0,7
963471,650712,2017-05-25,Senate,"Do pass as amended",7,0,0,0,7
963471,655873,2017-05-31,Senate,"Senate 3rd Reading SB392 Bates",40,0,0,0,40
963477,633993,2017-04-26,Assembly,"Do pass as amended and be re-referred to the Committee on [Appropriations]",7,0,0,0,7
963477,642668,2017-05-10,Assembly,"Do pass",9,4,4,0,17
963477,656278,2017-05-31,Assembly,"AB 776 HARPER Assembly Third Reading",53,17,10,0,80
963477,672655,2017-07-12,Senate,"Do pass, but first be re-referred to the Committee on [Appropriations]",1,1,3,0,5
963477,672656,2017-07-12,Senate,"[First] hearing set for [07-13-2017]: Failed passage in Committee. Reconsideration granted",5,0,0,0,5
963480,615024,2017-03-29,Assembly,"Do pass as amended and be re-referred to the Committee on [Utilities and Energy]",17,2,2,0,21
963480,627907,2017-04-19,Assembly,"Do pass and be re-referred to the Committee on [Appropriations]",11,2,2,0,15
963480,651572,2017-05-26,Assembly,"Do pass",13,3,1,0,17
963480,656844,2017-06-01,Assembly,"AB 807 CHU Assembly Third Reading",62,9,9,0,80
963480,671880,2017-07-10,Senate,"Do pass as amended, but first amend, and re-refer to the Committee on [Appropriations]",8,1,2,0,11
963480,673817,2017-08-21,Senate,"Placed on suspense file",7,0,0,0,7
963480,674480,2017-09-01,Senate,"Do pass",5,2,0,0,7
963480,763481,2018-06-14,Senate,"Assembly 3rd Reading AB807 Chu et al. By Wiener",26,9,4,0,39
963480,766904,2018-06-21,Assembly,"AB 807 CHU Concurrence in Senate Amendments",68,6,6,0,80
963480,777236,2018-06-14,Senate,"Assembly 3rd Reading AB807 C",5,9,4,0,18
963487,634612,2017-04-26,Senate,"Do pass, but first be re-referred to the Committee on [Appropriations] with the recommendation: To Consent Calendar",9,0,0,0,9
963487,647915,2017-05-22,Senate,"Consent Calendar 2nd SB437",37,0,3,0,40
963487,672264,2017-07-11,Assembly,"Do pass and be re-referred to the Committee on [Appropriations] with recommendation: To Consent Calendar",15,0,0,0,15
963487,674054,2017-08-23,Assembly,"Do pass. To Consent Calendar",15,0,2,0,17
963487,674288,2017-08-31,Assembly,"SB 437 Atkins Consent Calendar Second Day Regular Session",73,0,6,0,79
963487,775122,2017-08-23,Assembly,,15,0,2,0,17
963488,633627,2017-04-26,Senate,"Do pass, but first be re-referred to the Committee on [Appropriations] with the recommendation: To Consent Calendar",9,0,0,0,9
963488,644612,2017-05-15,Senate,"Placed on suspense file",7,0,0,0,7
963492,628156,2017-04-19,Senate,"Do pass, but first be re-referred to the Committee on [Appropriations]",5,2,0,0,7
963492,655254,2017-05-30,Senate,"Senate 3rd Reading SB427 Leyva",29,10,1,0,40
963492,669380,2017-06-27,Assembly,"Do pass and be re-referred to the Committee on [Appropriations]",6,0,1,0,7
963492,672896,2017-07-19,Assembly,"Do pass. To Consent Calendar",16,0,1,0,17
963492,674105,2017-08-24,Assembly,"SB 427 Leyva Consent Calendar Second Day Regular Session",76,0,3,0,79
963496,633585,2017-04-25,Assembly,"Do pass and be re-referred to the Committee on [Appropriations]",11,1,1,0,13
963496,652044,2017-05-26,Assembly,"Do pass as amended",12,4,1,0,17
963496,656908,2017-06-01,Assembly,"AB 813 EGGMAN Assembly Third Reading",78,0,2,0,80
963496,764994,2018-06-19,Senate,"Do pass, but first be re-referred to the Committee on [Judiciary]",6,1,4,0,11
963496,768841,2018-06-26,Senate,"Do pass, but first be re-referred to the Committee on [Appropriations]",4,2,1,0,7
963496,771258,2018-08-13,Senate,"Placed on suspense file",7,0,0,0,7
963504,610145,2017-03-21,Assembly,"Do pass as amended and be re-referred to the Committee on [Appropriations]",7,0,0,0,7
963504,633449,2017-04-26,Assembly,"Do pass. To Consent Calendar",16,0,1,0,17
963504,638415,2017-05-04,Assembly,"AB 766 FRIEDMAN Consent Calendar Second Day Regular Session",76,0,4,0,80
963504,662301,2017-06-13,Senate,"Do pass as amended, but first amend, and re-refer to the Committee on [Appropriations] with the recommendation: To Consent Calendar",4,0,1,0,5
963504,672335,2017-07-12,Senate,"Do pass as amended, but first amend, and re-refer to the Committee on [Appropriations] with the recommendation: To Consent Calendar",7,0,0,0,7
963504,675385,2017-09-11,Senate,"Assembly 3rd Reading AB766 Friedman By Mitchell",39,0,1,0,40
963504,675859,2017-09-13,Assembly,"AB 766 FRIEDMAN Concurrence in Senate Amendments",78,0,1,0,79
963506,684757,2018-01-09,Assembly,"Do pass and be re-referred to the Committee on [Appropriations]",13,0,0,0,13
963506,686205,2018-01-18,Assembly,"Do pass. To Consent Calendar",17,0,0,0,17
963506,690084,2018-01-29,Assembly,"AB 809 QUIRK-SILVA Consent Calendar Second Day Regular Session",75,0,2,0,77
963508,637543,2017-05-03,Assembly,"Do pass and be re-referred to the Committee on [Revenue and Taxation]",7,1,1,0,9
963508,641855,2017-05-08,Assembly,"Do pass as amended",6,2,2,0,10
963508,651547,2017-05-26,Assembly,"AB 747 GLORIA Assembly Third Reading",61,11,8,0,80
963508,671379,2017-07-05,Senate,"Do pass and be ordered to the Consent Calendar",7,0,0,0,7
963508,773442,2018-08-29,Senate,"Do pass",6,0,1,0,7
963508,773443,2018-08-29,Senate,"Do pass, but first be re-referred to the Committee on [Appropriations]",8,0,1,0,9
963508,774073,2018-08-31,Assembly,"With recommendation: That Senate amendments be concurred in",12,0,3,0,15
963508,774074,2018-08-31,Senate,"Assembly 3rd Reading AB747 Caballero By Hertzberg",39,0,1,0,40
963508,774075,2018-08-31,Assembly,"AB 747 Caballero Concurrence in Senate Amendments",69,5,6,0,80
963515,610085,2017-03-22,Senate,"Do pass, but first be re-referred to the Committee on [Appropriations]",4,1,0,0,5
963515,634342,2017-04-27,Senate,"Senate 3rd Reading SB418 Hernandez et al",27,10,3,0,40
963515,671338,2017-07-05,Assembly,"Do pass and be re-referred to the Committee on [Appropriations]",6,1,0,0,7
963515,672934,2017-07-19,Assembly,"Do pass",16,0,1,0,17
963515,674144,2017-08-24,Assembly,"SB 418 Hernandez Senate Third Reading By GONZALEZ FLETCHER",75,0,4,0,79
963515,674258,2017-08-30,Senate,"That the Assembly amendments be concurred in",5,0,0,0,5
963515,674892,2017-09-05,Senate,"Unfinished Business SB418 Hernandez et al. Concurrence",37,3,0,0,40
963517,626909,2017-04-18,Senate,"Do pass, but first be re-referred to the Committee on [Business, Professions and Economic Development] with the recommendation: To Consent Calendar",12,0,1,0,13
963517,632114,2017-04-24,Senate,"Do pass, but first be re-referred to the Committee on [Appropriations]",8,0,1,0,9
963517,647877,2017-05-22,Senate,"Senate 3rd Reading SB442 Newman",37,0,3,0,40
963517,669672,2017-06-28,Assembly,"Do pass and be re-referred to the Committee on [Health]",7,0,0,0,7
963517,672102,2017-07-11,Assembly,"Do pass and be re-referred to the Committee on [Appropriations]",14,0,1,0,15
963517,674032,2017-08-23,Assembly,"Do pass",10,3,4,0,17
963517,675292,2017-09-11,Assembly,"SB 442 Newman Senate Third Reading By GLORIA",59,12,8,0,79
963517,675790,2017-09-13,Senate,"Unfinished Business SB442 Newman et al. Concurrence",39,1,0,0,40
963519,619761,2017-04-05,Assembly,"Do pass and be re-referred to the Committee on [Local Government]",5,2,0,0,7
963519,634611,2017-04-26,Assembly,"Do pass and be re-referred to the Committee on [Appropriations]",6,3,0,0,9
963519,652143,2017-05-26,Assembly,"Do pass as amended",12,5,0,0,17
963519,656074,2017-05-31,Assembly,"AB 801 WEBER Assembly Third Reading",53,23,4,0,80
963519,669572,2017-06-28,Senate,"Do pass, but first be re-referred to the Committee on [Elections and Constitutional Amendments]",5,2,0,0,7
963519,672666,2017-07-12,Senate,"Do pass, but first be re-referred to the Committee on [Appropriations]",3,1,1,0,5
963519,673954,2017-08-21,Senate,"Placed on suspense file",7,0,0,0,7
963519,674770,2017-09-01,Senate,"Do pass",5,2,0,0,7
963519,675722,2017-09-12,Senate,"Assembly 3rd Reading AB801 Weber et al. By Atkins",23,14,3,0,40
963519,676233,2017-09-14,Assembly,"AB 801 WEBER Concurrence in Senate Amendments",53,25,1,0,79
963520,610181,2017-03-22,Assembly,"Do pass and be re-referred to the Committee on [Appropriations]",7,0,0,0,7
963520,652054,2017-05-26,Assembly,"Do pass as amended",13,4,0,0,17
963520,655794,2017-05-31,Assembly,"AB 677 CHIU Assembly Third Reading",63,10,7,0,80
963520,672039,2017-07-11,Senate,"Do pass, but first be re-referred to the Committee on [Rules]",10,2,1,0,13
963520,672536,2017-07-13,Senate,"Do pass as amended, but first amend, and re-refer to the Committee on [Appropriations]",5,0,2,0,7
963520,673900,2017-08-21,Senate,"Placed on suspense file",7,0,0,0,7
963520,674747,2017-09-01,Senate,"Do pass as amended",5,2,0,0,7
963520,675210,2017-09-07,Senate,"Assembly 3rd Reading AB677 Chiu et al. By Wiener",29,11,0,0,40
963520,675507,2017-09-11,Assembly,"AB 677 CHIU Concurrence in Senate Amendments",63,10,6,0,79
963525,641827,2017-05-08,Assembly,"Do pass as amended and be re-referred to the Committee on [Appropriations]",9,0,1,0,10
963527,613703,2017-03-28,Assembly,"Do pass",5,2,0,0,7
963527,621398,2017-04-06,Assembly,"AB 789 RUBIO Assembly Third Reading",46,30,4,0,80
963527,666341,2017-06-20,Senate,"Do pass",6,0,1,0,7
963527,674282,2017-08-31,Senate,"Assembly 3rd Reading AB789 Rubio By Mitchell",36,0,4,0,40
963527,675496,2017-09-11,Assembly,"AB 789 RUBIO Concurrence in Senate Amendments",75,3,1,0,79
963531,634343,2017-04-26,Senate,"Do pass as amended, but first amend, and re-refer to the Committee on [Appropriations]",7,0,0,0,7
963531,647804,2017-05-22,Senate,"Placed on suspense file",7,0,0,0,7
963534,771466,2018-08-13,Senate,"Be adopted, but first be re-referred to the Committee on [Elections and Constitutional Amendments]",2,3,0,0,5
963534,771467,2018-08-13,Senate,"[Second] hearing set for [08-14-2018]: Failed passage in Committee. Reconsideration granted",5,0,0,0,5
963541,634414,2017-04-26,Senate,"Do pass as amended, but first amend, and re-refer to the Committee on [Appropriations]",6,0,1,0,7
963541,644272,2017-05-15,Senate,"Placed on suspense file",7,0,0,0,7
963541,650476,2017-05-25,Senate,"Do pass as amended",6,0,1,0,7
963541,655839,2017-05-31,Senate,"Senate 3rd Reading SB448 Wieckowski",39,0,1,0,40
963541,672614,2017-07-12,Assembly,"Do pass as amended and be re-referred to the Committee on [Appropriations]",9,0,0,0,9
963541,674009,2017-08-23,Assembly,"Do pass",14,0,3,0,17
963541,674346,2017-08-31,Assembly,"SB 448 Wieckowski Senate Third Reading By AGUIAR-CURRY",76,0,3,0,79
963541,674874,2017-09-05,Senate,"Special Consent SB448",40,0,0,0,40
963542,631729,2017-04-24,Senate,"Do pass as amended, but first amend, and re-refer to the Committee on [Judiciary]",3,1,5,0,9
963542,631730,2017-04-24,Senate,"[First] hearing set for [04-25-2017]: Failed passage in Committee. Reconsideration granted",9,0,0,0,9
963542,684859,2018-01-09,Senate,"Do pass as amended",6,0,1,0,7
963542,690892,2018-01-30,Senate,"Senate 3rd Reading SB419 Portantino et al. Urgency Clause",39,0,1,0,40
963542,769682,2018-07-03,Assembly,"Do pass as amended, and be re-referred to the Committee on [Rules] with recommendation: To Consent Calendar",10,0,0,0,10
963542,772702,2018-08-24,Assembly,"Do pass as amended. To Consent Calendar",10,0,1,0,11
963542,774035,2018-08-31,Senate,"Unfinished Business SB419 Portantino et al. Urgency Clause Concurrence",39,0,1,0,40
963542,774036,2018-08-31,Assembly,"SB 419 Portantino Consent Calendar Second Day",79,0,1,0,80
963546,608471,2017-03-21,Assembly,"Do pass and be re-referred to the Committee on [Appropriations]",10,0,1,0,11
963546,620121,2017-04-05,Assembly,"Do pass. To Consent Calendar",17,0,0,0,17
963546,629015,2017-04-20,Assembly,"AB 772 DALY Assembly Third Reading",76,0,4,0,80
963546,666301,2017-06-20,Senate,"Do pass, but first be re-referred to the Committee on [Appropriations] with the recommendation: To Consent Calendar",7,0,0,0,7
963546,672637,2017-07-13,Senate,"Consent Calendar 2nd AB772",39,0,1,0,40
963546,673868,2017-08-21,Assembly,"AB 772 DALY Concurrence in Senate Amendments",78,0,1,0,79
963551,641464,2017-05-08,Assembly,"Do pass as amended and be re-referred to the Committee on [Appropriations]",3,5,2,0,10
963552,629043,2017-04-19,Assembly,"Do pass and be re-referred to the Committee on [Transportation]",5,4,0,0,9
963552,631829,2017-04-24,Assembly,"Do pass and be re-referred to the Committee on [Appropriations]",10,4,0,0,14
963552,651843,2017-05-26,Assembly,"Do pass as amended",12,5,0,0,17
963552,655857,2017-05-31,Assembly,"AB 805 GONZALEZ FLETCHER Assembly Third Reading",50,25,5,0,80
963552,671312,2017-07-05,Senate,"Do pass, but first be re-referred to the Committee on [Transportation and Housing]",5,2,0,0,7
963552,672160,2017-07-11,Senate,"Do pass as amended, but first amend, and re-refer to the Committee on [Appropriations]",9,3,1,0,13
963552,674193,2017-08-28,Senate,"Placed on suspense file",7,0,0,0,7
963552,674719,2017-09-01,Senate,"Do pass",5,2,0,0,7
963552,675209,2017-09-07,Senate,"Assembly 3rd Reading AB805 Gonzalez Fletcher By Atkins",25,13,2,0,40
963552,675298,2017-09-11,Assembly,"AB 805 GONZALEZ FLETCHER Concurrence in Senate Amendments",46,28,5,0,79
963555,618637,2017-04-04,Senate,"Do pass, but first be re-referred to the Committee on [Health]",3,1,1,0,5
963555,684898,2018-01-10,Senate,"Do pass, but first be re-referred to the Committee on [Appropriations]",6,2,1,0,9
963555,685424,2018-01-16,Senate,"Placed on suspense file",7,0,0,0,7
963555,686225,2018-01-18,Senate,"Do pass as amended",5,2,0,0,7
963555,690035,2018-01-29,Senate,"Senate 3rd Reading SB399 Portantino",28,8,4,0,40
963555,762189,2018-06-12,Assembly,"Do pass as amended and be re-referred to the Committee on [Appropriations]",11,2,2,0,15
963555,771880,2018-08-16,Assembly,"Do pass",12,4,1,0,17
963555,772816,2018-08-27,Assembly,"SB 399 Portantino Senate Third Reading By NAZARIAN",59,15,6,0,80
963555,773139,2018-08-28,Senate,"Unfinished Business SB399 Portantino et al. Concurrence",27,10,3,0,40
963556,618891,2017-04-04,Senate,"Do pass, but first be re-referred to the Committee on [Appropriations] with the recommendation: To Consent Calendar",4,0,1,0,5
963556,629061,2017-04-20,Senate,"Consent Calendar 2nd SB401",36,0,4,0,40
963556,663020,2017-06-13,Assembly,"Do pass and be re-referred to the Committee on [Accountability and Administrative Review] with recommendation: To Consent Calendar",6,0,1,0,7
963556,669814,2017-06-28,Assembly,"Do pass and be re-referred to the Committee on [Appropriations] with recommendation: To Consent Calendar",7,0,0,0,7
963556,672866,2017-07-19,Assembly,"Do pass. To Consent Calendar",16,0,1,0,17
963556,674112,2017-08-24,Assembly,"SB 401 Pan Consent Calendar Second Day Regular Session",76,0,3,0,79
963565,630476,2017-04-24,Assembly,"Do pass as amended and be re-referred to the Committee on [Appropriations]",7,3,1,0,11
963567,628467,2017-04-19,Assembly,"Do pass as amended and be re-referred to the Committee on [Appropriations]",14,0,1,0,15
963567,649404,2017-05-24,Assembly,"Do pass. To Consent Calendar",17,0,0,0,17
963567,654138,2017-05-30,Assembly,"AB 803 QUIRK Consent Calendar Second Day Regular Session",77,0,3,0,80
963567,666429,2017-06-20,Senate,"Do pass as amended, but first amend, and re-refer to the Committee on [Appropriations]",9,1,1,0,11
963567,671928,2017-07-10,Senate,"Placed on suspense file",7,0,0,0,7
963568,610709,2017-03-21,Assembly,"Do pass and be re-referred to the Committee on [Appropriations] with recommendation: To Consent Calendar",7,0,0,0,7
963568,620570,2017-04-05,Assembly,"Do pass. To Consent Calendar",17,0,0,0,17
963568,628879,2017-04-20,Assembly,"AB 818 BURKE Consent Calendar Second Day Regular Session",74,0,6,0,80
963568,662820,2017-06-13,Senate,"Do pass, but first be re-referred to the Committee on [Appropriations]",4,0,1,0,5
963568,672697,2017-07-17,Senate,"Assembly 3rd Reading AB818 Burke By Wiener",40,0,0,0,40
963572,621174,2017-04-05,Senate,"Do pass, but first be re-referred to the Committee on [Appropriations] with the recommendation: To Consent Calendar",9,0,0,0,9
963572,634541,2017-04-27,Senate,"Consent Calendar 2nd SB449",36,0,4,0,40
963572,666205,2017-06-20,Assembly,"Do pass as amended and be re-referred to the Committee on [Appropriations]",15,0,0,0,15
963572,669821,2017-06-28,Assembly,"Do pass. To Consent Calendar",14,0,3,0,17
963572,671570,2017-07-06,Assembly,"SB 449 Monning Consent Calendar Second Day Regular Session",74,0,6,0,80
963572,674268,2017-08-31,Assembly,"SB 449 Monning Senate Third Reading By LIMÓN",75,0,4,0,79
963572,674979,2017-09-05,Senate,"Special Consent SB449",40,0,0,0,40
963579,631720,2017-04-25,Senate,"Do pass as amended, but first amend, and re-refer to the Committee on [Appropriations]",7,0,0,0,7
963579,644482,2017-05-15,Senate,"Placed on suspense file",7,0,0,0,7
963582,615062,2017-03-28,Senate,"Do pass, but first be re-referred to the Committee on [Appropriations] with the recommendation: To Consent Calendar",7,0,0,0,7
963582,626252,2017-04-17,Senate,"Placed on suspense file",7,0,0,0,7
963582,650806,2017-05-25,Senate,"Do pass",7,0,0,0,7
963582,655836,2017-05-31,Senate,"Special Consent Calendar # SB403 Cannella Urgency Clause",40,0,0,0,40
963582,666386,2017-06-20,Assembly,"Do pass and be re-referred to the Committee on [Appropriations] with recommendation: To Consent Calendar",11,0,0,0,11
963582,674782,2017-09-01,Assembly,"Do pass",16,0,1,0,17
963582,676361,2017-09-14,Assembly,"SB 403 Cannella Third Reading Urgency By SALAS",78,0,1,0,79
963583,609975,2017-03-22,Assembly,"Do pass and be re-referred to the Committee on [Natural Resources]",7,0,0,0,7
963583,626937,2017-04-17,Assembly,"Do pass and be re-referred to the Committee on [Appropriations] with recommendation: To Consent Calendar",10,0,0,0,10
963583,651700,2017-05-26,Assembly,"Do pass",17,0,0,0,17
963583,654503,2017-05-30,Assembly,"AB 816 KILEY Assembly Third Reading",76,0,4,0,80
963583,672165,2017-07-11,Senate,"Do pass, but first be re-referred to the Committee on [Appropriations] with the recommendation: To Consent Calendar",9,0,0,0,9
963583,673871,2017-08-21,Senate,"Placed on suspense file",7,0,0,0,7
963587,642966,2017-05-10,Assembly,"Do pass",2,5,0,0,7
963587,642967,2017-05-10,Assembly,Reconsideration,7,0,0,0,7
963594,613744,2017-03-28,Assembly,"Do pass as amended. To Consent Calendar",11,0,0,0,11
963594,626376,2017-04-17,Assembly,"AB 740 REYES Consent Calendar Second Day",76,0,4,0,80
963594,658635,2017-06-06,Senate,"Do pass, but first be re-referred to the Committee on [Appropriations] with the recommendation: To Consent Calendar",6,0,1,0,7
963594,670984,2017-07-03,Senate,"Consent Calendar 2nd AB740",33,0,7,0,40
963598,631841,2017-04-25,Senate,"Do pass, but first be re-referred to the Committee on [Appropriations] with the recommendation: To Consent Calendar",7,0,0,0,7
963598,644819,2017-05-15,Senate,"Do pass",7,0,0,0,7
963598,647840,2017-05-22,Senate,"Senate 3rd Reading SB410 Nguyen et al",37,0,3,0,40
963598,669553,2017-06-27,Assembly,"Do pass and be re-referred to the Committee on [Public Employees, Retirement, and Social Security]",9,0,1,0,10
963598,671611,2017-07-06,Assembly,"Do pass and be re-referred to the Committee on [Appropriations]",7,0,0,0,7
963598,672935,2017-07-19,Assembly,"Do pass. To Consent Calendar",16,0,1,0,17
963598,674103,2017-08-24,Assembly,"SB 410 Nguyen Consent Calendar Second Day Regular Session",76,0,3,0,79
963599,615292,2017-03-28,Senate,"Do pass as amended, but first amend, and re-refer to the Committee on [Appropriations]",7,0,0,0,7
963599,626216,2017-04-17,Senate,"Placed on suspense file",7,0,0,0,7
963609,633176,2017-04-26,Senate,"Do pass, but first be re-referred to the Committee on [Appropriations] with the recommendation: To Consent Calendar",9,0,0,0,9
963609,644871,2017-05-15,Senate,"Do pass",7,0,0,0,7
963609,647920,2017-05-22,Senate,"Senate 3rd Reading SB430 Insurance (Mendoza)",37,0,3,0,40
963609,672517,2017-07-12,Assembly,"Do pass and be re-referred to the Committee on [Appropriations] with recommendation: To Consent Calendar",12,0,1,0,13
963609,674039,2017-08-23,Assembly,"Do pass. To Consent Calendar",15,0,2,0,17
963609,674366,2017-08-31,Assembly,"SB 430 INS. Consent Calendar Second Day Regular Session",73,0,6,0,79
963611,618600,2017-04-04,Assembly,"Do pass and be re-referred to the Committee on [Judiciary] with recommendation: To Consent Calendar",7,0,0,0,7
963611,626893,2017-04-18,Assembly,"Do pass and be re-referred to the Committee on [Appropriations] with recommendation: To Consent Calendar",11,0,0,0,11
963611,637574,2017-05-03,Assembly,"Do pass. To Consent Calendar",16,0,1,0,17
963611,643483,2017-05-11,Assembly,"AB 748 TING Consent Calendar Second Day Regular Session",77,0,3,0,80
963611,672180,2017-07-11,Senate,"Do pass as amended, but first amend, and re-refer to the Committee on [Rules]",5,2,0,0,7
963611,768771,2018-06-26,Senate,"Do pass as amended, but first amend, and re-refer to the Committee on [Appropriations]",6,1,0,0,7
963611,770515,2018-08-06,Senate,"Placed on suspense file",7,0,0,0,7
963611,771744,2018-08-16,Senate,"Do pass as amended",5,2,0,0,7
963611,773170,2018-08-28,Senate,"Assembly 3rd Reading AB748 Ting et al. By Mitchell",24,13,3,0,40
963611,773962,2018-08-31,Assembly,"With recommendation: That Senate amendments be concurred in",5,2,0,0,7
963611,773980,2018-08-31,Assembly,"AB 748 TING Concurrence in Senate Amendments",41,32,7,0,80
963613,633061,2017-04-25,Assembly,"Do pass and be re-referred to the Committee on [Appropriations]",7,0,0,0,7
963613,645765,2017-05-17,Assembly,"Do pass. To Consent Calendar",17,0,0,0,17
963613,651548,2017-05-26,Assembly,"AB 752 RUBIO Consent Calendar Second Day Regular Session",76,0,4,0,80
963613,667279,2017-06-21,Senate,"Do pass as amended, but first amend, and re-refer to the Committee on [Human Services]",6,0,1,0,7
963613,672368,2017-07-11,Senate,"Do pass as amended, but first amend, and re-refer to the Committee on [Appropriations]",7,0,0,0,7
963613,673751,2017-08-21,Senate,"Placed on suspense file",7,0,0,0,7
963613,674611,2017-09-01,Senate,"Do pass as amended",6,0,1,0,7
963613,675181,2017-09-07,Senate,"Assembly 3rd Reading AB752 Rubio et al. By Lara",40,0,0,0,40
963613,675328,2017-09-11,Assembly,"AB 752 RUBIO Concurrence in Senate Amendments",77,0,2,0,79
963620,632631,2017-04-25,Senate,"Do pass as amended, but first amend, and re-refer to the Committee on [Appropriations] with the recommendation: To Consent Calendar",13,0,0,0,13
963620,647876,2017-05-22,Senate,"Consent Calendar 2nd SB400",37,0,3,0,40
963620,668746,2017-06-26,Assembly,"Do pass and be re-referred to the Committee on [Appropriations]",12,1,1,0,14
963620,674666,2017-09-01,Assembly,"Do pass",15,1,1,0,17
963620,675587,2017-09-12,Assembly,"SB 400 Portantino Senate Third Reading By LOW",75,1,3,0,79
963620,676083,2017-09-14,Senate,"That the Assembly amendments be concurred in",10,0,3,0,13
963620,676517,2017-09-15,Senate,"Unfinished Business SB400 Portantino Concurrence",37,1,2,0,40
963625,608460,2017-03-21,Senate,"Do pass",5,2,0,0,7
963625,626192,2017-04-17,Senate,"Placed on suspense file",7,0,0,0,7
963625,650751,2017-05-25,Senate,"Do pass",5,2,0,0,7
963625,654245,2017-05-30,Senate,"Senate 3rd Reading SB395 Lara et al",27,12,1,0,40
963625,669082,2017-06-27,Assembly,"Do pass",4,2,1,0,7
963625,676248,2017-09-14,Assembly,"SB 395 Lara Senate Third Reading By CHIU",46,28,5,0,79
963625,676549,2017-09-15,Senate,"Unfinished Business SB395 Lara et al. Concurrence",29,9,2,0,40
963626,684733,2018-01-09,Assembly,"Do pass and be re-referred to the Committee on [Appropriations]",15,0,1,0,16
963631,642530,2017-05-09,Senate,"Do pass as amended",7,0,0,0,7
963631,655949,2017-05-31,Senate,"Senate 3rd Reading SB407 Wieckowski",40,0,0,0,40
963631,666361,2017-06-20,Assembly,"Do pass as amended",11,0,0,0,11
963631,672804,2017-07-17,Assembly,"SB 407 Wieckowski Senate Third Reading By GONZALEZ FLETCHER",75,0,4,0,79
963631,674071,2017-08-24,Senate,"Special Consent SB407",38,0,2,0,40
963636,632818,2017-04-25,Senate,"Do pass, but first be re-referred to the Committee on [Appropriations] with the recommendation: To Consent Calendar",13,0,0,0,13
963636,647991,2017-05-22,Senate,"Consent Calendar 2nd SB452",37,0,3,0,40
963636,752263,2018-05-10,Assembly,"Be re-referred to the Committee on [Natural Resources]",9,0,2,0,11
963636,768325,2018-06-25,Assembly,"Do pass as amended and be re-referred to the Committee on [Appropriations]",8,0,2,0,10
963636,771669,2018-08-16,Assembly,"Do pass as amended",12,0,5,0,17
963636,772649,2018-08-24,Assembly,"SB 452 Glazer Third Reading Urgency By GLORIA Amendment Set #1",49,22,9,0,80
963636,773288,2018-08-29,Assembly,"SB 452 Glazer Third Reading Urgency By GLORIA",74,1,5,0,80
963636,773847,2018-08-30,Senate,"That the Assembly amendments be concurred in",6,0,1,0,7
963636,774042,2018-08-31,Senate,"Unfinished Business SB452 Glazer et al. Urgency Clause Concurrence",37,1,2,0,40
963638,628962,2017-04-19,Senate,"Do pass as amended, but first amend, and re-refer to the Committee on [Appropriations]",9,0,0,0,9
963638,644419,2017-05-15,Senate,"Senate 3rd Reading SB432 Pan",37,1,2,0,40
963638,666163,2017-06-20,Assembly,"Do pass as amended and be re-referred to the Committee on [Appropriations]",13,0,2,0,15
963638,672849,2017-07-19,Assembly,"Do pass. To Consent Calendar",16,0,1,0,17
963638,674093,2017-08-24,Assembly,"SB 432 Pan Consent Calendar Second Day Regular Session",76,0,3,0,79
963638,676176,2017-09-14,Assembly,"SB 432 Pan Senate Third Reading By RODRIGUEZ",79,0,0,0,79
963638,676546,2017-09-15,Senate,"Unfinished Business SB432 Pan et al. Concurrence",37,0,3,0,40
963640,610084,2017-03-21,Assembly,"Do pass as amended and be re-referred to the Committee on [Appropriations]",7,0,0,0,7
963649,633700,2017-04-26,Assembly,"Do pass as amended and be re-referred to the Committee on [Appropriations]",6,1,0,0,7
963649,651504,2017-05-26,Assembly,"Do pass",11,5,1,0,17
963649,655747,2017-05-31,Assembly,"AB 739 CHAU Assembly Third Reading",51,20,9,0,80
963649,672188,2017-07-11,Senate,"Do pass as amended, but first amend, and re-refer to the Committee on [Appropriations]",9,4,0,0,13
963649,673788,2017-08-21,Senate,"Placed on suspense file",7,0,0,0,7
963649,674774,2017-09-01,Senate,"Do pass as amended",5,2,0,0,7
963649,675795,2017-09-13,Senate,"Assembly 3rd Reading AB739 Chau By Skinner",27,13,0,0,40
963649,676574,2017-09-15,Assembly,"AB 739 CHAU Concurrence in Senate Amendments",55,23,1,0,79
963650,633964,2017-04-26,Assembly,"Do pass and be re-referred to the Committee on [Appropriations]",2,5,0,0,7
963650,633965,2017-04-26,Assembly,Reconsideration,7,0,0,0,7
963653,632777,2017-04-25,Assembly,"Do pass and be re-referred to the Committee on [Appropriations]",8,7,0,0,15
963654,633659,2017-04-26,Assembly,"Do pass and be re-referred to the Committee on [Appropriations]",3,1,3,0,7
963654,633660,2017-04-26,Assembly,Reconsideration,7,0,0,0,7
963659,619766,2017-04-05,Senate,"Do pass as amended, but first amend, and re-refer to the Committee on [Veterans Affairs]",7,0,0,0,7
963659,631933,2017-04-25,Senate,"Do pass, but first be re-referred to the Committee on [Appropriations]",6,0,1,0,7
963659,644323,2017-05-15,Senate,"Placed on suspense file",7,0,0,0,7
963660,619900,2017-04-04,Assembly,"Do pass as amended and be re-referred to the Committee on [Appropriations]",7,0,0,0,7
963663,633351,2017-04-25,Assembly,"Do pass and be re-referred to the Committee on [Appropriations]",12,0,1,0,13
963663,642516,2017-05-10,Assembly,"Do pass",17,0,0,0,17
963663,644467,2017-05-15,Assembly,"AB 819 MEDINA Assembly Third Reading",79,0,1,0,80
963663,662988,2017-06-14,Senate,"Do pass, but first be re-referred to the Committee on [Appropriations]",4,2,1,0,7
963663,674291,2017-08-31,Senate,"Assembly 3rd Reading AB819 Medina By Allen",39,0,1,0,40
963664,628024,2017-04-19,Senate,"Do pass, but first be re-referred to the Committee on [Appropriations]",7,0,0,0,7
963664,635777,2017-05-01,Senate,"Placed on suspense file",7,0,0,0,7
963664,650664,2017-05-25,Senate,"Do pass",7,0,0,0,7
963664,656279,2017-05-31,Senate,"Special Consent Calendar # SB434 Galgiani Urgency Clause",40,0,0,0,40
963664,672194,2017-07-10,Assembly,"Do pass as amended, and be re-referred to the Committee on [Appropriations] with recommendation: To Consent Calendar",10,0,0,0,10
963664,774542,2017-05-01,Senate,,7,0,0,0,7
963667,634708,2017-04-27,Assembly,"Do pass and be re-referred to the Committee on [Appropriations]",17,0,4,0,21
963667,645998,2017-05-17,Assembly,"Do pass",15,0,2,0,17
963667,655989,2017-05-31,Assembly,"AB 779 BURKE Assembly Third Reading",73,0,7,0,80
963667,672079,2017-07-11,Senate,"Do pass, but first be re-referred to the Committee on [Appropriations]",13,0,0,0,13
963672,626431,2017-04-17,Assembly,"Do pass and be re-referred to the Committee on [Appropriations] with recommendation: To Consent Calendar",13,0,1,0,14
963672,651544,2017-05-26,Assembly,"Do pass",17,0,0,0,17
963672,654522,2017-05-30,Assembly,"AB 810 GALLAGHER Assembly Third Reading",77,0,3,0,80
963672,662405,2017-06-13,Senate,"Do pass, but first be re-referred to the Committee on [Appropriations] with the recommendation: To Consent Calendar",13,0,0,0,13
963672,668606,2017-06-26,Senate,"Placed on suspense file",7,0,0,0,7
963672,674792,2017-09-01,Senate,"Do pass",7,0,0,0,7
963672,675441,2017-09-11,Senate,"Assembly 3rd Reading AB810 Gallagher et al. By Nielsen",40,0,0,0,40
963674,613633,2017-03-28,Senate,"Do pass as amended, but first amend, and re-refer to the Committee on [Judiciary]",6,1,0,0,7
963674,617480,2017-03-28,Senate,"Do pass, but first be re-referred to the Committee on [Judiciary]",6,1,0,0,7
963674,633570,2017-04-25,Senate,"Do pass as amended, but first amend, and re-refer to the Committee on [Appropriations]",7,0,0,0,7
963674,644483,2017-05-15,Senate,"Placed on suspense file",7,0,0,0,7
963674,650615,2017-05-25,Senate,"Do pass",5,2,0,0,7
963674,653985,2017-05-30,Senate,"Senate 3rd Reading SB393 Lara et al",33,6,1,0,40
963674,669031,2017-06-27,Assembly,"Do pass as amended and be re-referred to the Committee on [Judiciary]",6,0,1,0,7
963674,672048,2017-07-11,Assembly,"Do pass as amended and be re-referred to the Committee on [Appropriations]",11,0,0,0,11
963674,674599,2017-09-01,Assembly,"Do pass as amended",13,3,1,0,17
963674,675822,2017-09-13,Assembly,"SB 393 Lara Senate Third Reading By WEBER",69,8,2,0,79
963674,676075,2017-09-14,Senate,"Unfinished Business SB393 Lara et al. Concurrence",35,4,1,0,40
963678,631904,2017-04-25,Assembly,"Do pass as amended and be re-referred to the Committee on [Appropriations]",7,0,0,0,7
963678,686446,2018-01-18,Assembly,"Do pass",17,0,0,0,17
963678,690065,2018-01-29,Assembly,"AB 767 QUIRK-SILVA Assembly Third Reading",75,0,2,0,77
963678,767930,2018-06-25,Senate,"Do pass as amended, but first amend, and re-refer to the Committee on [Appropriations]",9,0,0,0,9
963678,770935,2018-08-06,Senate,"Placed on suspense file",7,0,0,0,7
963678,771986,2018-08-16,Senate,"Do pass as amended",7,0,0,0,7
963678,772597,2018-08-23,Senate,"Assembly 3rd Reading AB767 Quirk-Silva By Nguyen",39,0,1,0,40
963678,773435,2018-08-29,Senate,"Assembly 3rd Reading AB767 Quirk-Silva By Nguyen",39,0,1,0,40
963678,773910,2018-08-30,Assembly,"With recommendation: That Senate amendments be concurred in",5,0,2,0,7
963678,774114,2018-08-31,Assembly,"AB 767 QUIRK-SILVA Concurrence in Senate Amendments",79,0,1,0,80
963687,608137,2017-03-21,Assembly,"Do pass as amended",8,2,1,0,11
963687,617628,2017-04-03,Assembly,"AB 814 BLOOM Assembly Third Reading",43,28,9,0,80
963687,662412,2017-06-13,Senate,"Do pass, but first be re-referred to the Committee on [Appropriations]",5,2,0,0,7
963687,668750,2017-06-26,Senate,"Placed on suspense file",7,0,0,0,7
963687,674823,2017-09-01,Senate,"Do pass",5,2,0,0,7
963687,675043,2017-09-06,Senate,"Assembly 3rd Reading AB814 Bloom et al. By Jackson",18,18,4,0,40
963687,675044,2017-09-06,Senate,"Assembly 3rd Reading AB814 Bloom et al. By Jackson Reconsider",39,0,1,0,40
963691,606983,2017-03-20,Assembly,"Do pass and be re-referred to the Committee on [Appropriations]",13,1,0,0,14
963691,633235,2017-04-26,Assembly,"Do pass",16,0,1,0,17
963691,635648,2017-05-01,Assembly,"AB 790 STONE Assembly Third Reading",66,6,8,0,80
963691,658888,2017-06-06,Senate,"Do pass, but first be re-referred to the Committee on [Appropriations]",13,0,0,0,13
963691,672687,2017-07-17,Senate,"Do pass",7,0,0,0,7
963691,674953,2017-09-05,Senate,"Assembly 3rd Reading AB790 Mark Stone By Skinner",38,2,0,0,40
963692,607040,2017-03-20,Assembly,"Be adopted. To Consent Calendar",14,0,0,0,14
963692,611115,2017-03-23,Assembly,"ACR 23 BOCANEGRA Consent Calendar Second Day Regular Session",76,0,4,0,80
963692,672090,2017-07-11,Senate,"Be adopted, but first be re-referred to the Committee on [Appropriations] with recommendation: To Consent Calendar",11,0,2,0,13
963692,674081,2017-08-24,Senate,"Consent Calendar 2nd ACR23",38,0,2,0,40
963698,610119,2017-03-22,Assembly,"Do pass and be re-referred to the Committee on [Appropriations] with recommendation: To Consent Calendar",10,0,0,0,10
963698,619860,2017-04-05,Assembly,"Do pass. To Consent Calendar",17,0,0,0,17
963698,629149,2017-04-20,Assembly,"AB 768 AGUIAR-CURRY Consent Calendar Second Day Regular Session",74,0,6,0,80
963698,659247,2017-06-06,Senate,"Do pass, but first be re-referred to the Committee on [Appropriations] with the recommendation: To Consent Calendar",4,0,1,0,5
963698,671012,2017-07-03,Senate,"Consent Calendar 2nd AB768",33,0,7,0,40
963699,642525,2017-05-10,Assembly,"Do pass as amended",5,2,0,0,7
963699,647982,2017-05-22,Assembly,"AB 765 LOW Assembly Third Reading",49,28,3,0,80
963699,666820,2017-06-20,Senate,"Do pass",4,1,0,0,5
963699,674875,2017-09-05,Senate,"Assembly 3rd Reading AB765 Low By Stern",24,14,2,0,40
963702,628049,2017-04-19,Senate,"Do pass as amended, but first amend, and re-refer to the Committee on [Appropriations]",5,2,0,0,7
963702,644880,2017-05-15,Senate,"Placed on suspense file",7,0,0,0,7
963702,650754,2017-05-25,Senate,"Do pass as amended",5,2,0,0,7
963702,655851,2017-05-31,Senate,"Senate 3rd Reading SB424 Allen",28,11,1,0,40
963703,627130,2017-04-18,Assembly,"Do pass and be re-referred to the Committee on [Appropriations]",7,0,0,0,7
963706,631917,2017-04-25,Senate,"Do pass, but first be re-referred to the Committee on [Appropriations]",6,1,0,0,7
963706,644391,2017-05-15,Senate,"Placed on suspense file",7,0,0,0,7
963706,650631,2017-05-25,Senate,"Do pass as amended",5,2,0,0,7
963706,655759,2017-05-31,Senate,"Senate 3rd Reading SB421 Wiener et al",27,11,2,0,40
963706,672166,2017-07-11,Assembly,"Do pass as amended and be re-referred to the Committee on [Appropriations]",5,1,1,0,7
963709,614872,2017-03-29,Senate,"Do pass, but first be re-referred to the Committee on [Human Services] with the recommendation: To Consent Calendar",7,0,0,0,7
963709,632020,2017-04-25,Senate,"Do pass, but first be re-referred to the Committee on [Appropriations]",4,0,1,0,5
963709,644976,2017-05-15,Senate,"Placed on suspense file",7,0,0,0,7
963711,684915,2018-01-10,Assembly,"Do pass and be re-referred to the Committee on [Appropriations]",6,0,1,0,7
963713,626182,2017-04-17,Senate,"Do pass, but first be re-referred to the Committee on [Appropriations]",9,0,0,0,9
963713,635742,2017-05-01,Senate,"Do pass",7,0,0,0,7
963713,644441,2017-05-15,Senate,"Senate 3rd Reading SB443 Hernandez et al",39,0,1,0,40
963713,672085,2017-07-11,Assembly,"Do pass and be re-referred to the Committee on [Appropriations]",16,0,0,0,16
963713,674575,2017-09-01,Assembly,"Do pass as amended",15,0,2,0,17
963713,675942,2017-09-13,Assembly,"SB 443 Hernandez Senate Third Reading By CHIU",77,0,2,0,79
963713,676064,2017-09-14,Senate,"Unfinished Business SB443 Hernandez et al. Concurrence",39,1,0,0,40
963715,618376,2017-04-04,Senate,"Do pass, but first be re-referred to the Committee on [Appropriations]",5,1,1,0,7
963715,644404,2017-05-15,Senate,"Senate 3rd Reading SB439 Mitchell et al",24,13,3,0,40
963715,762104,2018-06-12,Assembly,"Do pass and be re-referred to the Committee on [Appropriations]",5,2,0,0,7
963715,771545,2018-08-16,Assembly,"Do pass as amended",11,0,6,0,17
963715,773884,2018-08-30,Assembly,"SB 439 Mitchell Senate Third Reading By KAMLAGER-DOVE",43,32,5,0,80
963715,773989,2018-08-31,Senate,"Unfinished Business SB439 Mitchell et al. Concurrence",24,14,2,0,40
963724,642515,2017-05-10,Assembly,"Do pass. To Consent Calendar",6,0,1,0,7
963724,646491,2017-05-18,Assembly,"AB 760 ARAMBULA Consent Calendar Second Day Regular Session",69,0,11,0,80
963724,663440,2017-06-14,Senate,"Do pass and be ordered to the Consent Calendar",7,0,0,0,7
963724,667881,2017-06-22,Senate,"Consent Calendar 2nd AB760 Arambula et al. Urgency Clause",37,0,3,0,40
963728,632367,2017-04-25,Assembly,"Do pass as amended",13,1,1,0,15
963728,654563,2017-05-30,Assembly,"AB 718 FRAZIER Assembly Third Reading",76,0,4,0,80
963728,672207,2017-07-11,Senate,"Do pass as amended, but first amend, and re-refer to the Committee on [Appropriations] with the recommendation: To Consent Calendar",9,0,0,0,9
963728,674217,2017-08-28,Senate,"Do pass as amended",7,0,0,0,7
963728,676150,2017-09-14,Senate,"Special Consent Calendar # AB718",40,0,0,0,40
963728,676382,2017-09-14,Assembly,"AB 718 Frazier Special Consent Calendar 1st Day Regular Session",79,0,0,0,79
963729,627900,2017-04-19,Senate,"Do pass, but first be re-referred to the Committee on [Health]",6,1,0,0,7
963729,634597,2017-04-26,Senate,"Do pass, but first be re-referred to the Committee on [Appropriations]",7,1,1,0,9
963729,644581,2017-05-15,Senate,"Placed on suspense file",7,0,0,0,7
963729,650455,2017-05-25,Senate,"Do pass",5,2,0,0,7
963729,654276,2017-05-30,Senate,"Senate 3rd Reading SB396 Lara",29,10,1,0,40
963729,670969,2017-07-03,Assembly,"Be re-referred to the Committee on [Labor and Employment]",11,0,0,0,11
963729,671372,2017-07-05,Assembly,"Do pass and be re-referred to the Committee on [Appropriations]",6,1,0,0,7
963729,674013,2017-08-23,Assembly,"Do pass",10,5,2,0,17
963729,674368,2017-08-31,Assembly,"SB 396 Lara Senate Third Reading By THURMOND Amend By THURMOND Set #1",53,20,6,0,79
963729,676366,2017-09-14,Assembly,"SB 396 Lara Senate Third Reading By THURMOND",58,16,5,0,79
963729,676421,2017-09-15,Senate,"That the Assembly amendments be concurred in",4,1,0,0,5
963729,676551,2017-09-15,Senate,"Unfinished Business SB396 Lara et al. Concurrence",28,8,4,0,40
963733,620137,2017-04-04,Senate,"Do pass, but first be re-referred to the Committee on [Governance and Finance]",3,6,4,0,13
963733,620138,2017-04-04,Senate,"[First] hearing set for [04-05-2017]: Failed passage in Committee. Reconsideration granted",13,0,0,0,13
963733,684713,2018-01-09,Senate,"Do pass, but first be re-referred to the Committee on [Governance and Finance]",4,6,3,0,13
963738,618336,2017-04-04,Senate,"Do pass, but first be re-referred to the Committee on [Judiciary] with the recommendation: To Consent Calendar",4,0,1,0,5
963738,628511,2017-04-18,Senate,"Do pass as amended, but first amend, and re-refer to the Committee on [Appropriations] with the recommendation: To Consent Calendar",7,0,0,0,7
963738,644495,2017-05-15,Senate,"Consent Calendar 2nd SB438",39,0,1,0,40
963738,663175,2017-06-13,Assembly,"Do pass and be re-referred to the Committee on [Judiciary] with recommendation: To Consent Calendar",6,0,1,0,7
963738,666335,2017-06-20,Assembly,"Do pass and be re-referred to the Committee on [Appropriations] with recommendation: To Consent Calendar",11,0,0,0,11
963738,669846,2017-06-28,Assembly,"Do pass. To Consent Calendar",14,0,3,0,17
963738,671604,2017-07-06,Assembly,"SB 438 Roth Consent Calendar Second Day Regular Session",74,0,6,0,80
963738,674987,2017-09-05,Assembly,"SB 438 Roth Senate Third Reading By CERVANTES",76,0,3,0,79
963738,675219,2017-09-07,Senate,"Special Consent Calendar # SB438",40,0,0,0,40
963739,633261,2017-04-26,Assembly,"Do pass and be re-referred to the Committee on [Appropriations]",7,0,0,0,7
963739,652123,2017-05-26,Assembly,"Do pass as amended",13,4,0,0,17
963739,655811,2017-05-31,Assembly,"AB 755 GARCIA, E. Assembly Third Reading",70,5,5,0,80
963739,676242,2017-09-14,Senate,"Do pass, but first be re-referred to the Committee on [Appropriations]",7,0,0,0,7
963739,676486,2017-09-15,Senate,"Assembly 3rd Reading AB755 Eduardo Garcia et al. By Hueso",38,0,2,0,40
963739,676487,2017-09-16,Assembly,"With recommendation: That Senate amendments be concurred in",9,0,0,0,9
963739,676488,2017-09-16,Assembly,"AB 755 GARCIA, E. Concurrence in Senate Amendments",77,0,2,0,79
963743,627629,2017-04-18,Assembly,"Do pass as amended, and be re-referred to the Committee on [Appropriations] with recommendation: To Consent Calendar",11,0,0,0,11
963743,637562,2017-05-03,Assembly,"Do pass. To Consent Calendar",16,0,1,0,17
963743,643691,2017-05-11,Assembly,"AB 794 GALLAGHER Consent Calendar Second Day Regular Session",77,0,3,0,80
963743,663213,2017-06-14,Senate,"Do pass, but first be re-referred to the Committee on [Judiciary] with the recommendation: To Consent Calendar",6,0,1,0,7
963743,672301,2017-07-11,Senate,"Do pass, but first be re-referred to the Committee on [Appropriations]",7,0,0,0,7
963743,674317,2017-08-31,Senate,"Assembly 3rd Reading AB794 Gallagher By Hertzberg",38,0,2,0,40
963743,674894,2017-09-05,Assembly,"AB 794 GALLAGHER Concurrence in Senate Amendments",77,0,2,0,79
963744,610178,2017-03-21,Assembly,"Do pass and be re-referred to the Committee on [Public Safety]",5,2,0,0,7
963744,631855,2017-04-25,Assembly,"Do pass as amended and be re-referred to the Committee on [Appropriations]",5,2,0,0,7
963744,651906,2017-05-26,Assembly,"Do pass",12,5,0,0,17
963744,655744,2017-05-31,Assembly,"AB 811 GIPSON Assembly Third Reading",49,25,6,0,80
963744,668949,2017-06-27,Senate,"Do pass, but first be re-referred to the Committee on [Public Safety]",4,0,1,0,5
963744,672132,2017-07-11,Senate,"Do pass, but first be re-referred to the Committee on [Appropriations]",5,2,0,0,7
963744,674206,2017-08-28,Senate,"Placed on suspense file",7,0,0,0,7
963744,674631,2017-09-01,Senate,"Do pass as amended",5,1,1,0,7
963744,675621,2017-09-12,Senate,"Assembly 3rd Reading AB811 Gipson By Mitchell",35,4,1,0,40
963744,676369,2017-09-14,Assembly,"AB 811 GIPSON Concurrence in Senate Amendments",51,24,4,0,79
963746,618494,2017-04-04,Assembly,"Do pass and be re-referred to the Committee on [Appropriations]",2,5,0,0,7
963746,618495,2017-04-04,Assembly,Reconsideration,6,0,1,0,7
963750,621125,2017-04-05,Assembly,"Do pass and be re-referred to the Committee on [Appropriations]",7,0,0,0,7
963750,651536,2017-05-26,Assembly,"Do pass",17,0,0,0,17
963750,656805,2017-06-01,Assembly,"AB 738 LIMÓN Assembly Third Reading",78,0,2,0,80
963750,671451,2017-07-05,Senate,"Do pass, but first be re-referred to the Committee on [Appropriations] with the recommendation: To Consent Calendar",6,0,1,0,7
963750,672795,2017-07-17,Senate,"Placed on suspense file",7,0,0,0,7
963750,674543,2017-09-01,Senate,"Do pass as amended",7,0,0,0,7
963750,676098,2017-09-14,Senate,"Special Consent Calendar # AB738",40,0,0,0,40
963750,676374,2017-09-14,Assembly,"AB 738 Limón Special Consent Calendar 1st Day Regular Session",79,0,0,0,79
963752,632015,2017-04-25,Senate,"Do pass as amended, but first amend, and re-refer to the Committee on [Appropriations]",9,1,3,0,13
963752,647899,2017-05-22,Senate,"Senate 3rd Reading SB405 Mendoza",22,9,9,0,40
963756,608457,2017-03-21,Senate,"Do pass, but first be re-referred to the Committee on [Appropriations]",5,2,0,0,7
963756,626114,2017-04-17,Senate,"Placed on suspense file",7,0,0,0,7
963756,650790,2017-05-25,Senate,"Do pass as amended",5,2,0,0,7
963756,655967,2017-05-31,Senate,"Senate 3rd Reading SB394 Lara et al",28,12,0,0,40
963756,669030,2017-06-27,Assembly,"Do pass and be re-referred to the Committee on [Appropriations]",4,1,2,0,7
963756,672904,2017-07-19,Assembly,"Do pass",11,4,2,0,17
963756,676455,2017-09-15,Assembly,"SB 394 Lara Senate Third Reading By GONZALEZ FLETCHER",44,30,5,0,79
963756,676456,2017-09-15,Senate,"Unfinished Business SB394 Lara et al. Concurrence",28,9,3,0,40
963757,610812,2017-03-22,Senate,"Do pass, but first be re-referred to the Committee on [Appropriations]",7,0,0,0,7
963757,617795,2017-04-03,Senate,"Do pass",7,0,0,0,7
963757,621026,2017-04-06,Senate,"Senate 3rd Reading SB440 Hertzberg et al",39,0,1,0,40
963757,667151,2017-06-19,Assembly,"Do pass as amended and be re-referred to the Committee on [Appropriations]",9,0,1,0,10
963757,672858,2017-07-19,Assembly,"Do pass. To Consent Calendar",16,0,1,0,17
963757,674139,2017-08-24,Assembly,"SB 440 Hertzberg Consent Calendar Second Day Regular Session",76,0,3,0,79
963757,674410,2017-08-31,Senate,"Special Consent Calendar # SB440",37,0,3,0,40
963759,616273,2017-03-29,Assembly,"Do pass and be re-referred to the Committee on [Appropriations]",7,0,0,0,7
963763,642835,2017-05-10,Assembly,"Do pass",6,0,1,0,7
963763,644429,2017-05-15,Assembly,"AB 802 LOW Assembly Third Reading",76,0,4,0,80
963763,658864,2017-06-06,Senate,"Do pass",4,0,1,0,5
963763,668681,2017-06-26,Senate,"Special Consent Calendar # AB802",39,0,1,0,40
963766,615109,2017-03-28,Senate,"Do pass, but first be re-referred to the Committee on [Appropriations]",7,0,0,0,7
963766,626784,2017-04-17,Senate,"Placed on suspense file",7,0,0,0,7
963766,650850,2017-05-25,Senate,"Do pass",7,0,0,0,7
963766,655988,2017-05-31,Senate,"Special Consent Calendar # SB409",40,0,0,0,40
963766,672468,2017-07-11,Assembly,"Do pass as amended and be re-referred to the Committee on [Appropriations]",9,0,1,0,10
963768,613586,2017-03-28,Assembly,"Do pass and be re-referred to the Committee on [Appropriations]",7,0,0,0,7
963768,633129,2017-04-26,Assembly,"Do pass",14,0,3,0,17
963768,638464,2017-05-04,Assembly,"AB 785 JONES-SAWYER Assembly Third Reading",67,0,13,0,80
963768,658825,2017-06-06,Senate,"Do pass, but first be re-referred to the Committee on [Appropriations]",7,0,0,0,7
963768,668596,2017-06-26,Senate,"Placed on suspense file",7,0,0,0,7
963768,674490,2017-09-01,Senate,"Do pass as amended",7,0,0,0,7
963768,675058,2017-09-06,Senate,"Assembly 3rd Reading AB785 Jones-Sawyer By Jackson",40,0,0,0,40
963768,675361,2017-09-11,Assembly,"AB 785 JONES-SAWYER Concurrence in Senate Amendments",76,0,3,0,79
963771,609951,2017-03-21,Assembly,"Do pass and be re-referred to the Committee on [Appropriations] with recommendation: To Consent Calendar",7,0,0,0,7
963771,652004,2017-05-26,Assembly,"Do pass",17,0,0,0,17
963771,654317,2017-05-30,Assembly,"AB 763 SALAS Assembly Third Reading",77,0,3,0,80
963771,669077,2017-06-27,Senate,"Do pass, but first be re-referred to the Committee on [Appropriations] with the recommendation: To Consent Calendar",5,0,0,0,5
963771,671931,2017-07-10,Senate,"Placed on suspense file",7,0,0,0,7
963772,628125,2017-04-19,Assembly,"Do pass and be re-referred to the Committee on [Revenue and Taxation]",13,0,0,0,13
963772,631508,2017-04-24,Assembly,"Do pass as amended and be re-referred to the Committee on [Appropriations]",9,1,0,0,10
963772,651857,2017-05-26,Assembly,"Do pass",17,0,0,0,17
963772,656080,2017-05-31,Assembly,"AB 778 CABALLERO Assembly Third Reading",76,0,4,0,80
963772,671296,2017-07-05,Senate,"Do pass, but first be re-referred to the Committee on [Appropriations]",7,0,0,0,7
963772,672800,2017-07-17,Senate,"Placed on suspense file",7,0,0,0,7
963772,674800,2017-09-01,Senate,"Do pass",7,0,0,0,7
963772,675098,2017-09-06,Senate,"Assembly 3rd Reading AB778 Caballero et al. By Mendoza",40,0,0,0,40
963772,675318,2017-09-11,Assembly,"AB 778 CABALLERO Concurrence in Senate Amendments",77,0,2,0,79
963778,620145,2017-04-05,Senate,"Do pass as amended, but first amend, and re-refer to the Committee on [Appropriations]",7,0,0,0,7
963778,630304,2017-04-24,Senate,"Senate 3rd Reading SB447 Nielsen et al",37,0,3,0,40
963778,667462,2017-06-19,Assembly,"Do pass as amended",9,0,1,0,10
963778,671608,2017-07-06,Assembly,"SB 447 Nielsen Senate Third Reading By BIGELOW",76,0,4,0,80
963778,671956,2017-07-10,Senate,"Unfinished Business SB447 Nielsen et al. Concurrence",38,0,2,0,40
963782,632153,2017-04-25,Senate,"Do pass as amended, but first amend, and re-refer to the Committee on [Appropriations]",7,2,0,0,9
963782,644866,2017-05-15,Senate,"Placed on suspense file",7,0,0,0,7
963784,614956,2017-03-29,Senate,"Do pass as amended, but first amend, and re-refer to the Committee on [Appropriations]",7,0,0,0,7
963784,630490,2017-04-24,Senate,"Placed on suspense file",7,0,0,0,7
963784,650431,2017-05-25,Senate,"Do pass as amended",5,1,1,0,7
963784,656095,2017-05-31,Senate,"Senate 3rd Reading SB436 Allen",40,0,0,0,40
963786,619126,2017-04-03,Assembly,"Do pass and be re-referred to the Committee on [Appropriations] with recommendation: To Consent Calendar",10,0,0,0,10
963792,621123,2017-04-05,Assembly,"Do pass as amended and be re-referred to the Committee on [Appropriations]",9,0,0,0,9
963792,633583,2017-04-26,Assembly,"Do pass. To Consent Calendar",16,0,1,0,17
963792,638729,2017-05-04,Assembly,"AB 804 GARCIA, C. Consent Calendar Second Day Regular Session",76,0,4,0,80
963792,662844,2017-06-13,Senate,"Do pass as amended, but first amend, and re-refer to the Committee on [Appropriations]",11,0,2,0,13
963792,675011,2017-09-05,Senate,"Assembly 3rd Reading AB804 Cristina Garcia et al. By Galgiani",40,0,0,0,40
963792,675217,2017-09-07,Assembly,"AB 804 GARCIA, C. Concurrence in Senate Amendments",79,0,0,0,79
963797,619928,2017-04-04,Assembly,"Do pass and be re-referred to the Committee on [Education]",7,0,0,0,7
963797,634543,2017-04-26,Assembly,"Do pass as amended and be re-referred to the Committee on [Appropriations]",7,0,0,0,7
963797,651610,2017-05-26,Assembly,"Do pass as amended",16,0,1,0,17
963797,656054,2017-05-31,Assembly,"AB 746 GONZALEZ FLETCHER Assembly Third Reading",76,0,4,0,80
963797,669651,2017-06-28,Senate,"Do pass, but first be re-referred to the Committee on [Environmental Quality]",7,0,0,0,7
963797,671369,2017-07-05,Senate,"Do pass, but first be re-referred to the Committee on [Appropriations]",7,0,0,0,7
963797,672714,2017-07-17,Senate,"Placed on suspense file",7,0,0,0,7
963797,674624,2017-09-01,Senate,"Do pass",7,0,0,0,7
963797,675687,2017-09-12,Senate,"Assembly 3rd Reading AB746 Gonzalez Fletcher By Allen",40,0,0,0,40
963797,676342,2017-09-14,Assembly,"AB 746 GONZALEZ FLETCHER Concurrence in Senate Amendments",78,0,1,0,79
963799,628088,2017-04-19,Senate,"Do pass, but first be re-referred to the Committee on [Appropriations]",7,0,0,0,7
963799,654832,2017-05-30,Senate,"Senate 3rd Reading SB450 Hertzberg et al",40,0,0,0,40
963799,672540,2017-07-12,Assembly,"Do pass and be re-referred to the Committee on [Appropriations]",9,0,0,0,9
963799,674046,2017-08-23,Assembly,"Do pass. To Consent Calendar",15,0,2,0,17
963799,675315,2017-09-11,Assembly,"SB 450 Hertzberg Senate Third Reading By COOLEY",77,0,2,0,79
963799,676237,2017-09-14,Senate,"Special Consent Calendar SB450",40,0,0,0,40
964740,621493,2017-04-05,Assembly,"Do pass and be re-referred to the Committee on [Appropriations]",8,0,1,0,9
964740,652090,2017-05-26,Assembly,"Do pass",17,0,0,0,17
964740,654318,2017-05-30,Assembly,"AB 873 LACKEY Assembly Third Reading",77,0,3,0,80
964740,762250,2018-06-12,Senate,"Do pass, but first be re-referred to the Committee on [Appropriations]",7,0,0,0,7
964740,769555,2018-07-02,Senate,"Assembly 3rd Reading AB873 Lackey et al. By Wilk",37,0,2,0,39
964740,769802,2018-07-05,Assembly,"AB 873 LACKEY Concurrence in Senate Amendments",71,0,9,0,80
964747,608477,2017-03-21,Assembly,"Do pass as amended. To Consent Calendar",11,0,0,0,11
964747,615993,2017-03-30,Assembly,"AB 828 OBERNOLTE Consent Calendar Second Day Regular Session",74,0,6,0,80
964747,662275,2017-06-13,Senate,"Do pass and be ordered to the Consent Calendar",7,0,0,0,7
964747,665265,2017-06-19,Senate,"Consent Calendar 2nd AB828",33,0,7,0,40
964747,675163,2017-09-07,Assembly,"AB 828 OBERNOLTE Final Form",77,0,2,0,79
964750,620044,2017-04-05,Assembly,"Do pass and be re-referred to the Committee on [Appropriations]",5,1,1,0,7
964750,633573,2017-04-26,Assembly,"Do pass",12,4,1,0,17
964750,635713,2017-05-01,Assembly,"AB 855 LOW Assembly Third Reading",53,21,6,0,80
964750,659298,2017-06-06,Senate,"Do pass, but first be re-referred to the Committee on [Appropriations]",3,1,1,0,5
964750,668726,2017-06-26,Senate,"Placed on suspense file",7,0,0,0,7
964750,674558,2017-09-01,Senate,"Do pass",5,2,0,0,7
964755,627135,2017-04-18,Assembly,"Do pass and be re-referred to the Committee on [Appropriations] with recommendation: To Consent Calendar",15,0,0,0,15
964755,652140,2017-05-26,Assembly,"Do pass",17,0,0,0,17
964755,654231,2017-05-30,Assembly,"AB 839 GARCIA, E. Assembly Third Reading",77,0,3,0,80
964755,667524,2017-06-21,Senate,"Do pass, but first be re-referred to the Committee on [Appropriations] with the recommendation: To Consent Calendar",9,0,0,0,9
964755,673931,2017-08-21,Senate,"Placed on suspense file",7,0,0,0,7
964765,627953,2017-04-19,Assembly,"Do pass and be re-referred to the Committee on [Appropriations]",15,2,4,0,21
964766,634408,2017-04-26,Assembly,"Do pass and be re-referred to the Committee on [Appropriations]",9,0,0,0,9
964766,642628,2017-05-10,Assembly,"Do pass. To Consent Calendar",17,0,0,0,17
964766,646519,2017-05-18,Assembly,"AB 829 CHIU Consent Calendar Second Day Regular Session",69,0,11,0,80
964766,769185,2018-06-27,Senate,"Do pass",6,0,1,0,7
964766,772505,2018-08-23,Senate,"Assembly 3rd Reading AB829 Chiu By Wiener",35,0,5,0,40
964766,773098,2018-08-28,Assembly,"With recommendation: That Senate amendments be concurred in",9,0,0,0,9
964766,773615,2018-08-29,Assembly,"AB 829 CHIU Concurrence in Senate Amendments",78,0,2,0,80
964768,618243,2017-04-04,Assembly,"Do pass and be re-referred to the Committee on [Governmental Organization]",14,0,1,0,15
964768,627954,2017-04-19,Assembly,"Do pass and be re-referred to the Committee on [Appropriations]",20,0,1,0,21
964768,637518,2017-05-03,Assembly,"Do pass. To Consent Calendar",16,0,1,0,17
964768,643443,2017-05-11,Assembly,"AB 860 COOLEY Consent Calendar Second Day Regular Session",77,0,3,0,80
964768,667105,2017-06-21,Senate,"Do pass, but first be re-referred to the Committee on [Appropriations] with the recommendation: To Consent Calendar",9,0,0,0,9
964768,672545,2017-07-13,Senate,"Consent Calendar 2nd AB860",39,0,1,0,40
964776,684756,2018-01-09,Assembly,"Do pass and be re-referred to the Committee on [Appropriations] with recommendation: To Consent Calendar",7,0,0,0,7
964776,686201,2018-01-18,Assembly,"Do pass",17,0,0,0,17
964776,690066,2018-01-29,Assembly,"AB 862 MAIENSCHEIN Assembly Third Reading",77,0,0,0,77
964776,753240,2018-05-15,Senate,"Do pass, but first be re-referred to the Committee on [Appropriations] with the recommendation: To Consent Calendar",7,0,0,0,7
964776,767883,2018-06-25,Senate,"Placed on suspense file",7,0,0,0,7
964778,628045,2017-04-18,Assembly,"Do pass and be re-referred to the Committee on [Appropriations]",11,2,0,0,13
964790,621527,2017-04-05,Assembly,"Do pass as amended and be re-referred to the Committee on [Appropriations]",5,1,1,0,7
964790,652167,2017-05-26,Assembly,"Do pass",13,4,0,0,17
964790,655785,2017-05-31,Assembly,"AB 858 DABABNEH Assembly Third Reading",67,10,3,0,80
964790,669996,2017-06-28,Senate,"Do pass, but first be re-referred to the Committee on [Appropriations]",7,0,0,0,7
964790,671974,2017-07-10,Senate,"Placed on suspense file",7,0,0,0,7
964790,674780,2017-09-01,Senate,"Do pass as amended",6,0,1,0,7
964790,675290,2017-09-11,Senate,"Assembly 3rd Reading AB858 Dababneh By Pan",40,0,0,0,40
964790,675774,2017-09-13,Assembly,"AB 858 DABABNEH Concurrence in Senate Amendments",70,7,2,0,79
964793,634618,2017-04-26,Assembly,"Do pass and be re-referred to the Committee on [Appropriations]",9,0,0,0,9
964793,649511,2017-05-24,Assembly,"Do pass. To Consent Calendar",17,0,0,0,17
964793,654135,2017-05-30,Assembly,"AB 851 CABALLERO Consent Calendar Second Day Regular Session",77,0,3,0,80
964793,671409,2017-07-05,Senate,"Do pass, but first be re-referred to the Committee on [Appropriations]",7,0,0,0,7
964793,675715,2017-09-12,Senate,"That the measure be returned to Senate Floor for consideration. Ordered to third reading",5,0,2,0,7
964793,675997,2017-09-13,Senate,"Assembly 3rd Reading AB851 Caballero et al. By Hill",39,0,1,0,40
964793,676274,2017-09-14,Assembly,"With recommendation: That Senate amendments be concurred in",6,0,3,0,9
964793,676425,2017-09-15,Assembly,"AB 851 CABALLERO Concurrence in Senate Amendments",79,0,0,0,79
964800,633780,2017-04-26,Assembly,"Do pass and be re-referred to the Committee on [Appropriations] with recommendation: To Consent Calendar",10,0,0,0,10
964800,642735,2017-05-10,Assembly,"Do pass. To Consent Calendar",17,0,0,0,17
964800,646533,2017-05-18,Assembly,"AB 861 DAHLE Consent Calendar Second Day Regular Session",69,0,11,0,80
964800,666741,2017-06-20,Senate,"Do pass, but first be re-referred to the Committee on [Appropriations] with the recommendation: To Consent Calendar",5,0,0,0,5
964800,672634,2017-07-13,Senate,"Consent Calendar 2nd AB861",39,0,1,0,40
964800,672732,2017-07-17,Assembly,"AB 861 DAHLE Concurrence in Senate Amendments",78,0,1,0,79
964802,610188,2017-03-22,Assembly,"Do pass and be re-referred to the Committee on [Appropriations]",7,0,0,0,7
964802,619967,2017-04-05,Assembly,"Do pass. To Consent Calendar",17,0,0,0,17
964802,628963,2017-04-20,Assembly,"AB 872 CHAU Consent Calendar Second Day Regular Session",74,0,6,0,80
964802,660002,2017-06-07,Senate,"Do pass, but first be re-referred to the Committee on [Public Safety] with the recommendation: To Consent Calendar",7,0,0,0,7
964802,669075,2017-06-27,Senate,"Do pass, but first be re-referred to the Committee on [Appropriations] with the recommendation: To Consent Calendar",7,0,0,0,7
964802,672977,2017-07-20,Senate,"Consent Calendar 2nd AB872",38,0,2,0,40
964810,620362,2017-04-05,Assembly,"Do pass as amended and be re-referred to the Committee on [Appropriations]",6,0,1,0,7
964810,633231,2017-04-26,Assembly,"Do pass. To Consent Calendar",16,0,1,0,17
964810,638462,2017-05-04,Assembly,"AB 867 COOLEY Consent Calendar Second Day Regular Session",76,0,4,0,80
964810,659182,2017-06-06,Senate,"Do pass, but first be re-referred to the Committee on [Appropriations]",4,0,1,0,5
964810,674851,2017-09-05,Senate,"Assembly 3rd Reading AB867 Cooley By Stern",40,0,0,0,40
964811,627188,2017-04-18,Assembly,"Do pass as amended, and be re-referred to the Committee on [Appropriations] with recommendation: To Consent Calendar",15,0,0,0,15
964811,637434,2017-05-03,Assembly,"Do pass. To Consent Calendar",16,0,1,0,17
964811,643607,2017-05-11,Assembly,"AB 836 CHIU Consent Calendar Second Day Regular Session",77,0,3,0,80
964811,672661,2017-07-12,Senate,"Do pass, but first be re-referred to the Committee on [Appropriations] with the recommendation: To Consent Calendar",8,0,1,0,9
964811,674080,2017-08-24,Senate,"Consent Calendar 2nd AB836",38,0,2,0,40
964811,674899,2017-09-05,Assembly,"AB 836 CHIU Concurrence in Senate Amendments",76,0,3,0,79
964826,619899,2017-04-04,Assembly,"Do pass as amended and be re-referred to the Committee on [Appropriations]",7,0,0,0,7
964830,627034,2017-04-18,Assembly,"Do pass and be re-referred to the Committee on [Appropriations]",14,0,1,0,15
964830,633290,2017-04-26,Assembly,"Do pass. To Consent Calendar",16,0,1,0,17
964830,638530,2017-05-04,Assembly,"AB 845 WOOD Consent Calendar Second Day Regular Session",76,0,4,0,80
964830,658060,2017-06-05,Senate,"Do pass as amended, but first amend, and re-refer to the Committee on [Public Safety]",9,0,0,0,9
964830,666249,2017-06-20,Senate,"Do pass, but first be re-referred to the Committee on [Appropriations] with the recommendation: To Consent Calendar",7,0,0,0,7
964830,673809,2017-08-21,Senate,"Placed on suspense file",7,0,0,0,7
964838,618628,2017-04-03,Assembly,"Do pass and be re-referred to the Committee on [Appropriations]",9,0,1,0,10
964838,651567,2017-05-26,Assembly,"Do pass",14,0,3,0,17
964838,656037,2017-05-31,Assembly,"AB 864 MCCARTY Assembly Third Reading",74,0,6,0,80
964838,672144,2017-07-11,Senate,"Do pass, but first be re-referred to the Committee on [Appropriations]",9,0,0,0,9
964838,673947,2017-08-21,Senate,"Placed on suspense file",7,0,0,0,7
964838,674830,2017-09-01,Senate,"Do pass",6,1,0,0,7
964838,675027,2017-09-06,Senate,"Assembly 3rd Reading AB864 McCarty By Hertzberg",38,0,2,0,40
964838,675397,2017-09-11,Assembly,"AB 864 MCCARTY Concurrence in Senate Amendments",77,0,2,0,79
964841,633077,2017-04-24,Assembly,"Do pass as amended and be re-referred to the Committee on [Appropriations]",10,0,0,0,10
964841,642852,2017-05-10,Assembly,"Do pass as amended",17,0,0,0,17
964841,647898,2017-05-22,Assembly,"AB 846 COOLEY Assembly Third Reading",75,0,5,0,80
964841,663243,2017-06-14,Senate,"Do pass, but first be re-referred to the Committee on [Appropriations]",6,0,1,0,7
964841,668740,2017-06-26,Senate,"Do pass",7,0,0,0,7
964841,672738,2017-07-17,Senate,"Special Consent Calendar # AB846",38,0,2,0,40
964847,607281,2017-03-20,Assembly,"Do pass and be re-referred to the Committee on [Appropriations]",9,4,1,0,14
964847,652156,2017-05-26,Assembly,"Do pass as amended",12,5,0,0,17
964847,657034,2017-06-01,Assembly,"AB 857 TING Assembly Third Reading",53,24,3,0,80
964847,672060,2017-07-11,Senate,"Do pass, but first be re-referred to the Committee on [Appropriations]",9,3,1,0,13
964847,673758,2017-08-21,Senate,"Placed on suspense file",7,0,0,0,7
964847,674546,2017-09-01,Senate,"Do pass as amended",5,2,0,0,7
964847,675021,2017-09-06,Senate,"Assembly 3rd Reading AB857 Ting et al. By Wiener",27,13,0,0,40
964847,675523,2017-09-11,Assembly,"AB 857 TING Concurrence in Senate Amendments",52,25,2,0,79
964850,633213,2017-04-26,Assembly,"Do pass and be re-referred to the Committee on [Appropriations]",7,0,0,0,7
964850,642537,2017-05-10,Assembly,"Do pass. To Consent Calendar",17,0,0,0,17
964850,646489,2017-05-18,Assembly,"AB 863 CERVANTES Consent Calendar Second Day Regular Session",69,0,11,0,80
964850,666213,2017-06-20,Senate,"Do pass as amended, but first amend, and re-refer to the Committee on [Environmental Quality] with the recommendation: To Consent Calendar",12,0,1,0,13
964850,671356,2017-07-05,Senate,"Do pass, but first be re-referred to the Committee on [Appropriations] with the recommendation: To Consent Calendar",7,0,0,0,7
964850,674096,2017-08-24,Senate,"Consent Calendar 2nd AB863",38,0,2,0,40
964850,676552,2017-09-15,Assembly,"AB 863 CERVANTES Concurrence in Senate Amendments",77,0,2,0,79
964864,612818,2017-03-27,Assembly,"Be re-referred to the Committee on [Health]",11,0,0,0,11
964864,632017,2017-04-25,Assembly,"Do pass and be re-referred to the Committee on [Appropriations]",14,0,1,0,15
964864,637272,2017-05-03,Assembly,"Do pass. To Consent Calendar",16,0,1,0,17
964864,643347,2017-05-11,Assembly,"AB 823 CHAU Consent Calendar Second Day Regular Session",77,0,3,0,80
964864,665120,2017-06-19,Senate,"Do pass, but first be re-referred to the Committee on [Appropriations]",9,0,0,0,9
964864,673746,2017-08-21,Senate,"Placed on suspense file",7,0,0,0,7
964870,684217,2018-01-08,Assembly,"Be re-referred to the Committee on [Public Safety]",9,0,2,0,11
964870,685123,2018-01-12,Assembly,"Do pass and be re-referred to the Committee on [Appropriations]",7,0,0,0,7
964870,686275,2018-01-18,Assembly,"Do pass",17,0,0,0,17
964870,689930,2018-01-29,Assembly,"AB 865 LEVINE Assembly Third Reading",76,0,1,0,77
964870,753177,2018-05-15,Senate,"Do pass, but first be re-referred to the Committee on [Veterans Affairs] with the recommendation: To Consent Calendar",7,0,0,0,7
964870,768248,2018-06-26,Senate,"Do pass, but first be re-referred to the Committee on [Appropriations]",6,0,0,0,6
964870,770525,2018-08-06,Senate,"Placed on suspense file",7,0,0,0,7
964870,771759,2018-08-16,Senate,"Do pass as amended",6,1,0,0,7
964870,772373,2018-08-21,Senate,"Assembly 3rd Reading AB865 Levine By Roth",38,0,2,0,40
964870,772795,2018-08-27,Assembly,"AB 865 LEVINE Concurrence in Senate Amendments",79,0,1,0,80
964877,610294,2017-03-22,Assembly,"Do pass as amended and be re-referred to the Committee on [Appropriations]",7,0,0,0,7
964877,619918,2017-04-05,Assembly,"Do pass. To Consent Calendar",17,0,0,0,17
964877,629310,2017-04-20,Assembly,"AB 840 QUIRK Consent Calendar Second Day Regular Session",74,0,6,0,80
964877,659190,2017-06-06,Senate,"Do pass, but first be re-referred to the Committee on [Appropriations]",4,0,1,0,5
964877,675710,2017-09-12,Senate,"Assembly 3rd Reading AB840 Quirk et al. By Leyva",40,0,0,0,40
964877,676227,2017-09-14,Assembly,"With recommendation: That Senate amendments be concurred in",6,0,1,0,7
964877,676501,2017-09-15,Assembly,"AB 840 QUIRK Concurrence in Senate Amendments",77,0,2,0,79
964886,642860,2017-05-10,Assembly,"Do pass as amended",5,1,1,0,7
964886,656322,2017-05-31,Assembly,"AB 841 WEBER Assembly Third Reading",42,29,9,0,80
964886,669809,2017-06-28,Senate,"Do pass as amended",5,0,2,0,7
964886,674873,2017-09-05,Senate,"Assembly 3rd Reading AB841 Weber et al. By Monning",27,13,0,0,40
964886,675482,2017-09-11,Assembly,"AB 841 WEBER Concurrence in Senate Amendments",53,25,1,0,79
964888,634417,2017-04-26,Assembly,"Do pass and be re-referred to the Committee on [Appropriations]",5,1,1,0,7
964891,621664,2017-04-05,Assembly,"Do pass and be re-referred to the Committee on [Appropriations]",5,0,2,0,7
964891,633718,2017-04-26,Assembly,"Do pass",12,4,1,0,17
964891,638610,2017-05-04,Assembly,"AB 830 KALRA Assembly Third Reading",56,17,7,0,80
964891,660775,2017-06-07,Senate,"Do pass, but first be re-referred to the Committee on [Appropriations]",5,2,0,0,7
964891,675814,2017-09-13,Senate,"Assembly 3rd Reading AB830 Kalra et al. By Allen",26,14,0,0,40
964891,676496,2017-09-15,Assembly,"AB 830 KALRA Concurrence in Senate Amendments",57,22,0,0,79
964892,627898,2017-04-18,Assembly,"Do pass and be re-referred to the Committee on [Accountability and Administrative Review]",8,4,1,0,13
964892,633562,2017-04-26,Assembly,"Do pass and be re-referred to the Committee on [Appropriations]",4,2,1,0,7
964892,642520,2017-05-10,Assembly,"Do pass",14,3,0,0,17
964892,654150,2017-05-30,Assembly,"AB 848 MCCARTY Assembly Third Reading",59,18,3,0,80
964892,671304,2017-07-05,Senate,"Do pass as amended, but first amend, and re-refer to the Committee on [Appropriations]",6,0,1,0,7
964892,673787,2017-08-21,Senate,"Placed on suspense file",7,0,0,0,7
964892,674467,2017-09-01,Senate,"Do pass as amended",6,1,0,0,7
964892,675619,2017-09-12,Senate,"Assembly 3rd Reading AB848 McCarty et al. By Lara",33,6,1,0,40
964892,675799,2017-09-13,Assembly,"AB 848 McCarty Concurrence in Senate Amendments",59,19,1,0,79
964905,609920,2017-03-22,Assembly,"Do pass and be re-referred to the Committee on [Health]",7,0,0,0,7
964905,627598,2017-04-18,Assembly,"Do pass as amended and be re-referred to the Committee on [Appropriations]",10,0,5,0,15
964905,651550,2017-05-26,Assembly,"Do pass as amended",12,1,4,0,17
964905,655862,2017-05-31,Assembly,"AB 834 O'DONNELL Assembly Third Reading",61,8,11,0,80
964905,669750,2017-06-28,Senate,"Do pass, but first be re-referred to the Committee on [Health]",7,0,0,0,7
964905,671580,2017-07-05,Senate,"Do pass, but first be re-referred to the Committee on [Appropriations]",9,0,0,0,9
964905,672723,2017-07-17,Senate,"Placed on suspense file",7,0,0,0,7
964913,620051,2017-04-04,Assembly,"Do pass and be re-referred to the Committee on [Water, Parks, and Wildlife]",6,0,1,0,7
964913,632496,2017-04-25,Assembly,"Do pass and be re-referred to the Committee on [Appropriations]",14,0,1,0,15
964913,649418,2017-05-24,Assembly,"Do pass",16,0,1,0,17
964913,653977,2017-05-30,Assembly,"AB 869 RUBIO Assembly Third Reading",69,1,10,0,80
964913,777404,2017-05-24,Assembly,,14,0,1,0,15
964915,630378,2017-04-24,Assembly,"Be re-referred to the Committee on [Transportation]",11,0,0,0,11
964915,683967,2018-01-04,Assembly,"Be re-referred to the Committee on [Public Safety]",9,0,2,0,11
964915,684721,2018-01-09,Assembly,"Do pass",7,0,0,0,7
964915,685471,2018-01-16,Assembly,"AB 870 LEVINE Assembly Third Reading",72,0,5,0,77
964915,753331,2018-05-15,Senate,"Do pass",7,0,0,0,7
964916,634556,2017-04-26,Assembly,"Do pass as amended and be re-referred to the Committee on [Appropriations]",5,2,0,0,7
964925,636571,2017-05-02,Assembly,"Do pass and be re-referred to the Committee on [Appropriations]",8,1,2,0,11
964925,651845,2017-05-26,Assembly,"Do pass",12,4,1,0,17
964925,656829,2017-06-01,Assembly,"AB 859 EGGMAN Assembly Third Reading",43,17,20,0,80
964925,672854,2017-07-18,Senate,"Do pass, but first be re-referred to the Committee on [Rules]",5,2,0,0,7
964925,674181,2017-08-28,Senate,"Placed on suspense file",7,0,0,0,7
964925,674661,2017-09-01,Senate,"Do pass",5,2,0,0,7
964925,675081,2017-09-06,Senate,"Assembly 3rd Reading AB859 Eggman By Mitchell",23,12,5,0,40
964925,675082,2017-09-06,Senate,"Assembly 3rd Reading AB859 Eggman By Mitchell Reconsider",40,0,0,0,40
964925,675083,2017-09-06,Senate,"Assembly 3rd Reading AB859 Eggman By Mitchell",26,12,2,0,40
964925,675926,2017-09-13,Assembly,"AB 859 EGGMAN Concurrence in Senate Amendments",41,21,17,0,79
964927,631451,2017-04-25,Assembly,"Do pass as amended and be re-referred to the Committee on [Appropriations]",15,0,0,0,15
964927,649397,2017-05-24,Assembly,"Do pass",17,0,0,0,17
964927,656880,2017-06-01,Assembly,"AB 844 BURKE Assembly Third Reading",75,0,5,0,80
964927,671923,2017-07-10,Senate,"Do pass, but first be re-referred to the Committee on [Appropriations]",9,0,0,0,9
964927,674207,2017-08-28,Senate,"Placed on suspense file",7,0,0,0,7
964935,632016,2017-04-25,Assembly,"Do pass and be re-referred to the Committee on [Appropriations] with recommendation: To Consent Calendar",11,0,0,0,11
964935,637415,2017-05-03,Assembly,"Do pass. To Consent Calendar",16,0,1,0,17
964935,643563,2017-05-11,Assembly,"AB 866 CUNNINGHAM Consent Calendar Second Day Regular Session",77,0,3,0,80
964935,669422,2017-06-27,Senate,"Do pass, but first be re-referred to the Committee on [Appropriations] with the recommendation: To Consent Calendar",12,0,1,0,13
964935,672643,2017-07-13,Senate,"Consent Calendar 2nd AB866",39,0,1,0,40
964935,673813,2017-08-21,Assembly,"AB 866 CUNNINGHAM Concurrence in Senate Amendments",77,0,2,0,79
964939,645469,2017-05-15,Assembly,"Do pass and be re-referred to the Committee on [Appropriations]",9,1,0,0,10
964944,626888,2017-04-17,Assembly,"Do pass as amended and be re-referred to the Committee on [Appropriations]",8,2,0,0,10
964950,613839,2017-03-28,Assembly,"Do pass as amended and be re-referred to the Committee on [Appropriations]",14,0,2,0,16
964950,651753,2017-05-26,Assembly,"Do pass",13,4,0,0,17
964950,656035,2017-05-31,Assembly,"AB 827 RUBIO Assembly Third Reading",66,8,6,0,80
964950,669123,2017-06-26,Senate,"Do pass, but first be re-referred to the Committee on [Appropriations]",8,1,0,0,9
964950,672739,2017-07-17,Senate,"Placed on suspense file",7,0,0,0,7
964960,621129,2017-04-05,Assembly,"Do pass and be re-referred to the Committee on [Appropriations]",8,0,1,0,9
964960,633220,2017-04-26,Assembly,"Do pass. To Consent Calendar",16,0,1,0,17
964960,638297,2017-05-04,Assembly,"AB 852 GRAYSON Consent Calendar Second Day Regular Session",76,0,4,0,80
964964,629254,2017-04-19,Assembly,"Do pass and be re-referred to the Committee on [Appropriations]",7,0,0,0,7
964967,618227,2017-04-04,Assembly,"Do pass and be re-referred to the Committee on [Appropriations]",13,0,2,0,15
964967,633545,2017-04-26,Assembly,"Do pass. To Consent Calendar",16,0,1,0,17
964967,638392,2017-05-04,Assembly,"AB 850 CHAU Consent Calendar Second Day Regular Session",76,0,4,0,80
964967,660168,2017-06-07,Senate,"Do pass as amended, but first amend, and re-refer to the Committee on [Appropriations]",9,0,0,0,9
964967,675632,2017-09-12,Senate,"Assembly 3rd Reading AB850 Chau et al. By Pan",40,0,0,0,40
964967,676339,2017-09-14,Assembly,"AB 850 CHAU Concurrence in Senate Amendments",78,0,1,0,79
964969,633478,2017-04-26,Assembly,"Do pass and be re-referred to the Committee on [Appropriations]",6,1,0,0,7
964969,643184,2017-05-10,Assembly,"Do pass",12,5,0,0,17
964969,644526,2017-05-15,Assembly,"AB 837 LOW Assembly Third Reading",58,20,2,0,80
964969,666312,2017-06-20,Senate,"Do pass, but first be re-referred to the Committee on [Appropriations]",4,1,0,0,5
964969,675116,2017-09-07,Senate,"Assembly 3rd Reading AB837 Low By Allen",27,13,0,0,40
964969,675467,2017-09-11,Assembly,"AB 837 LOW Concurrence in Senate Amendments",54,20,5,0,79
964975,634083,2017-04-25,Assembly,"Do pass and be re-referred to the Committee on [Appropriations]",12,0,1,0,13
964975,642392,2017-05-10,Assembly,"Do pass",17,0,0,0,17
964975,644295,2017-05-15,Assembly,"AB 868 BERMAN Assembly Third Reading",79,0,1,0,80
964975,661698,2017-06-12,Senate,"Do pass as amended, but first amend, and re-refer to the Committee on [Education]",9,0,0,0,9
964975,671367,2017-07-05,Senate,"Do pass, but first be re-referred to the Committee on [Appropriations] with the recommendation: To Consent Calendar",6,0,1,0,7
964975,674420,2017-08-31,Senate,"Assembly 3rd Reading AB868 Berman By Bates",39,0,1,0,40
964975,674865,2017-09-05,Assembly,"AB 868 BERMAN Concurrence in Senate Amendments",77,0,2,0,79
964976,627922,2017-04-18,Assembly,"Do pass and be re-referred to the Committee on [Appropriations]",11,1,1,0,13
964976,638089,2017-05-03,Assembly,"Do pass",16,0,1,0,17
964976,640724,2017-05-08,Assembly,"AB 847 BOCANEGRA Assembly Third Reading",72,5,3,0,80
964976,774563,2017-05-03,Assembly,"ders=""noes 05/03/17"" class=""columnField"" style=""text-align:left"">",11,0,1,0,12
965397,642744,2017-05-10,Assembly,"Do pass as amended",8,0,1,0,9
965397,647963,2017-05-22,Assembly,"AB 979 LACKEY Assembly Third Reading",76,0,4,0,80
965397,667491,2017-06-21,Senate,"Do pass, but first be re-referred to the Committee on [Appropriations]",7,0,0,0,7
965397,673932,2017-08-21,Senate,"Assembly 3rd Reading AB979 Lackey By Moorlach",38,1,1,0,40
965399,634777,2017-04-26,Senate,"Do pass as amended, but first amend, and re-refer to the Committee on [Appropriations]",9,0,0,0,9
965399,644266,2017-05-15,Senate,"Placed on suspense file",7,0,0,0,7
965399,650783,2017-05-25,Senate,"Do pass as amended",6,0,1,0,7
965399,655931,2017-05-31,Senate,"Senate 3rd Reading SB538 Monning",22,9,9,0,40
965400,614489,2017-03-28,Assembly,"Do pass as amended and be re-referred to the Committee on [Accountability and Administrative Review]",6,0,1,0,7
965400,633259,2017-04-26,Assembly,"Do pass and be re-referred to the Committee on [Appropriations]",7,0,0,0,7
965401,620154,2017-04-05,Senate,"Do pass, but first be re-referred to the Committee on [Appropriations]",5,0,0,0,5
965401,630438,2017-04-24,Senate,"Senate 3rd Reading SB489 Bradford",38,0,2,0,40
965401,672424,2017-07-12,Assembly,"Do pass. To Consent Calendar",12,0,1,0,13
965401,672975,2017-07-20,Assembly,"SB 489 Bradford Consent Calendar Second Day Regular Session",67,0,12,0,79
965401,674059,2017-08-24,Senate,"Special Consent Calendar # SB489",38,0,2,0,40
965403,628065,2017-04-18,Assembly,"Do pass and be re-referred to the Committee on [Appropriations]",13,0,0,0,13
965403,652162,2017-05-26,Assembly,"Do pass",17,0,0,0,17
965403,654451,2017-05-30,Assembly,"AB 990 RODRIGUEZ Assembly Third Reading",75,0,5,0,80
965403,671410,2017-07-05,Senate,"Do pass, but first be re-referred to the Committee on [Appropriations] with the recommendation: To Consent Calendar",6,0,1,0,7
965403,672990,2017-07-20,Senate,"Consent Calendar 2nd AB990",38,0,2,0,40
965405,613482,2017-03-27,Assembly,"Do pass as amended and be re-referred to the Committee on [Appropriations]",6,2,2,0,10
965406,684912,2018-01-10,Senate,"Do pass, but first be re-referred to the Committee on [Environmental Quality] with the recommendation: To Consent Calendar",7,0,0,0,7
965406,686855,2018-01-22,Senate,"Senate 3rd Reading SB519 Beall",38,0,2,0,40
965406,766706,2018-06-20,Assembly,"Do pass",7,0,2,0,9
965406,772551,2018-08-23,Assembly,"SB 519 Beall Senate Third Reading Amend By GIPSON Set #1",58,18,4,0,80
965406,773450,2018-08-29,Assembly,"Do pass",10,3,1,0,14
965406,773965,2018-08-31,Senate,"That the Assembly amendments be concurred in",11,1,1,0,13
965406,774082,2018-08-31,Senate,"Unfinished Business SB519 Beall et al. Concurrence",32,5,3,0,40
965406,774083,2018-08-31,Assembly,"SB 519 Beall Senate Third Reading By GIPSON",58,17,5,0,80
965407,634351,2017-04-26,Senate,"Do pass, but first be re-referred to the Committee on [Appropriations]",7,2,0,0,9
965407,644326,2017-05-15,Senate,"Placed on suspense file",7,0,0,0,7
965409,614953,2017-03-29,Assembly,"Do pass as amended and be re-referred to the Committee on [Appropriations]",20,0,1,0,21
965409,633405,2017-04-26,Assembly,"Do pass. To Consent Calendar",16,0,1,0,17
965409,638428,2017-05-04,Assembly,"AB 997 AGUIAR-CURRY Consent Calendar Second Day Regular Session",76,0,4,0,80
965409,662344,2017-06-13,Senate,"Do pass as amended, but first amend, and re-refer to the Committee on [Appropriations]",12,0,1,0,13
965409,674323,2017-08-31,Senate,"Assembly 3rd Reading AB997 Aguiar-Curry By Berryhill",40,0,0,0,40
965409,674963,2017-09-05,Assembly,"AB 997 AGUIAR-CURRY Concurrence in Senate Amendments",77,0,2,0,79
965411,618615,2017-04-04,Senate,"Do pass as amended, but first amend, and re-refer to the Committee on [Appropriations]",4,0,3,0,7
965411,635817,2017-05-01,Senate,"Placed on suspense file",7,0,0,0,7
965411,650797,2017-05-25,Senate,"Do pass as amended",5,0,2,0,7
965411,655924,2017-05-31,Senate,"Senate 3rd Reading SB500 Leyva et al",40,0,0,0,40
965411,669136,2017-06-27,Assembly,"Do pass as amended and be re-referred to the Committee on [Appropriations]",6,0,1,0,7
965411,674600,2017-09-01,Assembly,"Do pass",16,0,1,0,17
965411,676341,2017-09-14,Assembly,"SB 500 Leyva Senate Third Reading By GARCIA, C",75,0,4,0,79
965411,676440,2017-09-15,Senate,"Unfinished Business SB500 Leyva et al. Concurrence",38,0,2,0,40
965412,627117,2017-04-18,Assembly,"Do pass as amended and be re-referred to the Committee on [Appropriations]",11,0,0,0,11
965414,633430,2017-04-25,Assembly,"Do pass and be re-referred to the Committee on [Appropriations]",9,3,1,0,13
965415,618613,2017-04-03,Assembly,"Do pass as amended and be re-referred to the Committee on [Appropriations]",8,1,1,0,10
965416,628581,2017-04-19,Senate,"Do pass, but first be re-referred to the Committee on [Judiciary]",7,0,0,0,7
965416,633120,2017-04-25,Senate,"Do pass as amended, but first amend, and re-refer to the Committee on [Appropriations]",7,0,0,0,7
965416,644773,2017-05-15,Senate,"Placed on suspense file",7,0,0,0,7
965417,608350,2017-03-21,Senate,"Do pass, but first be re-referred to the Committee on [Appropriations]",5,2,0,0,7
965417,626159,2017-04-17,Senate,"Placed on suspense file",7,0,0,0,7
965417,650629,2017-05-25,Senate,"Do pass as amended",5,2,0,0,7
965417,656076,2017-05-31,Senate,"Senate 3rd Reading SB464 Hill",25,14,1,0,40
965417,668963,2017-06-27,Assembly,"Do pass and be re-referred to the Committee on [Appropriations]",4,2,1,0,7
965417,672842,2017-07-19,Assembly,"Do pass",12,4,1,0,17
965417,674066,2017-08-24,Assembly,"SB 464 Hill Senate Third Reading By MCCARTY",46,27,6,0,79
965417,674948,2017-09-05,Senate,"Unfinished Business SB464 Hill et al. Concurrence",24,14,2,0,40
965419,628020,2017-04-19,Assembly,"Do pass and be re-referred to the Committee on [Natural Resources]",11,0,4,0,15
965419,631951,2017-04-24,Assembly,"Do pass as amended and be re-referred to the Committee on [Appropriations]",9,1,0,0,10
965419,651563,2017-05-26,Assembly,"Do pass",17,0,0,0,17
965419,656858,2017-06-01,Assembly,"AB 920 AGUIAR-CURRY Assembly Third Reading",75,0,5,0,80
965419,671840,2017-07-10,Senate,"Do pass as amended, but first amend, and re-refer to the Committee on [Appropriations]",11,0,0,0,11
965419,673886,2017-08-21,Senate,"Placed on suspense file",7,0,0,0,7
965420,608464,2017-03-21,Assembly,"Do pass as amended, and be re-referred to the Committee on [Appropriations] with recommendation: To Consent Calendar",7,0,0,0,7
965421,620097,2017-04-05,Senate,"Do pass, but first be re-referred to the Committee on [Appropriations]",5,0,0,0,5
965421,634668,2017-04-27,Senate,"Senate 3rd Reading SB490 Bradford",37,0,3,0,40
965421,660656,2017-06-07,Assembly,"Do pass and be re-referred to the Committee on [Appropriations]",6,0,1,0,7
965421,669907,2017-06-28,Assembly,"Do pass. To Consent Calendar",14,0,3,0,17
965421,674400,2017-08-31,Assembly,"SB 490 Bradford Senate Third Reading By JONES-SAWYER",74,0,5,0,79
965421,674893,2017-09-05,Senate,"Special Consent SB490",40,0,0,0,40
965422,610312,2017-03-22,Assembly,"Do pass and be re-referred to the Committee on [Appropriations] with recommendation: To Consent Calendar",7,0,0,0,7
965422,620245,2017-04-05,Assembly,"Do pass. To Consent Calendar",17,0,0,0,17
965422,629533,2017-04-20,Assembly,"AB 949 GIPSON Consent Calendar Second Day Regular Session",74,0,6,0,80
965422,660174,2017-06-07,Senate,"Do pass, but first be re-referred to the Committee on [Appropriations] with the recommendation: To Consent Calendar",7,0,0,0,7
965422,670978,2017-07-03,Senate,"Consent Calendar 2nd AB949",33,0,7,0,40
965423,684769,2018-01-09,Assembly,"Do pass and be re-referred to the Committee on [Appropriations]",15,0,1,0,16
965423,686289,2018-01-18,Assembly,"Do pass. To Consent Calendar",17,0,0,0,17
965423,690064,2018-01-29,Assembly,"AB 1013 LOW Consent Calendar Second Day Regular Session",75,0,2,0,77
965423,753359,2018-05-15,Senate,"Do pass, but first be re-referred to the Committee on [Appropriations]",5,0,0,0,5
965423,767840,2018-06-25,Senate,"Placed on suspense file",7,0,0,0,7
965423,771975,2018-08-16,Senate,"Do pass",7,0,0,0,7
965423,773009,2018-08-27,Senate,"Assembly 3rd Reading AB1013 Low By Chang",39,0,1,0,40
965423,773368,2018-08-29,Assembly,"AB 1013 LOW Concurrence in Senate Amendments",78,0,2,0,80
965424,634537,2017-04-26,Assembly,"Do pass and be re-referred to the Committee on [Appropriations]",5,1,3,0,9
965424,649519,2017-05-24,Assembly,"Do pass",17,0,0,0,17
965424,651409,2017-05-26,Assembly,"AB 994 MURATSUCHI Assembly Third Reading",73,2,5,0,80
965424,667739,2017-06-21,Senate,"Do pass, but first be re-referred to the Committee on [Appropriations]",7,0,0,0,7
965424,674401,2017-08-31,Senate,"Assembly 3rd Reading AB994 Muratsuchi et al. By Allen",38,0,2,0,40
965425,628972,2017-04-19,Senate,"Be adopted as amended, but first amend, and re-refer to the Committee on [Elections and Constitutional Amendments]",7,0,0,0,7
965425,659067,2017-06-06,Senate,"Be adopted, but first be re-referred to the Committee on [Appropriations]",4,0,1,0,5
965425,668616,2017-06-26,Senate,"Placed on suspense file",7,0,0,0,7
965425,674470,2017-09-01,Senate,"Be adopted",7,0,0,0,7
965425,675088,2017-09-06,Senate,"Senate 3rd Reading SCA9 Glazer",39,0,1,0,40
965425,685427,2018-01-16,Assembly,"Be adopted and re-referred to the Committee on [Appropriations]",7,0,3,0,10
965425,686186,2018-01-18,Assembly,"Be adopted",17,0,0,0,17
965425,689974,2018-01-29,Assembly,"SCA 9 Glazer Senate Third Reading By GONZALEZ FLETCHER",76,0,1,0,77
965426,642655,2017-05-09,Senate,"Do pass, but first be re-referred to the Committee on [Appropriations] with the recommendation: To Consent Calendar",7,0,0,0,7
965426,651372,2017-05-26,Senate,"Consent Calendar 2nd SB491",37,0,3,0,40
965426,672116,2017-07-11,Assembly,"Do pass as amended and be re-referred to the Committee on [Appropriations]",11,0,0,0,11
965426,674591,2017-09-01,Assembly,"Do pass",13,0,4,0,17
965426,675166,2017-09-07,Assembly,"SB 491 Bradford Senate Third Reading By THURMOND",72,0,7,0,79
965426,675860,2017-09-13,Senate,"Unfinished Business SB491 Bradford et al. Concurrence",40,0,0,0,40
965427,633254,2017-04-25,Senate,"Do pass as amended, but first amend, and re-refer to the Committee on [Appropriations] with the recommendation: To Consent Calendar",7,0,0,0,7
965427,647902,2017-05-22,Senate,"Consent Calendar 2nd SB467",37,0,3,0,40
965428,617712,2017-04-03,Assembly,"Do pass and be re-referred to the Committee on [Natural Resources]",13,0,1,0,14
965428,631825,2017-04-24,Assembly,"Do pass and be re-referred to the Committee on [Appropriations] with recommendation: To Consent Calendar",10,0,0,0,10
965428,637613,2017-05-03,Assembly,"Do pass. To Consent Calendar",16,0,1,0,17
965428,643417,2017-05-11,Assembly,"AB 1073 GARCIA, E. Consent Calendar Second Day Regular Session",77,0,3,0,80
965428,662430,2017-06-13,Senate,"Do pass, but first be re-referred to the Committee on [Environmental Quality]",12,0,1,0,13
965428,667192,2017-06-21,Senate,"Do pass as amended, but first amend, and re-refer to the Committee on [Appropriations] with the recommendation: To Consent Calendar",6,0,1,0,7
965428,672717,2017-07-17,Senate,"Placed on suspense file",7,0,0,0,7
965428,674441,2017-09-01,Senate,"Do pass",7,0,0,0,7
965428,675161,2017-09-07,Senate,"Assembly 3rd Reading AB1073 Eduardo Garcia By Lara",40,0,0,0,40
965428,675363,2017-09-11,Assembly,"AB 1073 GARCIA, E. Concurrence in Senate Amendments",78,0,1,0,79
965429,620807,2017-04-04,Assembly,"Do pass as amended and be re-referred to the Committee on [Appropriations]",7,0,0,0,7
965429,637405,2017-05-03,Assembly,"Do pass. To Consent Calendar",16,0,1,0,17
965429,643576,2017-05-11,Assembly,"AB 959 HOLDEN Consent Calendar Second Day Regular Session",77,0,3,0,80
965429,672479,2017-07-11,Senate,"Do pass as amended, but first amend, and re-refer to the Committee on [Appropriations]",7,0,0,0,7
965429,673969,2017-08-21,Senate,"Placed on suspense file",7,0,0,0,7
965429,674762,2017-09-01,Senate,"Do pass as amended",7,0,0,0,7
965429,676048,2017-09-14,Senate,"Special Consent Calendar # AB959",40,0,0,0,40
965429,676331,2017-09-14,Assembly,"AB 959 Holden Special Consent Calendar 1st Day Regular Session",79,0,0,0,79
965430,626780,2017-04-17,Assembly,"Do pass as amended and be re-referred to the Committee on [Appropriations]",9,1,0,0,10
965431,637232,2017-05-02,Senate,"Do pass",2,1,4,0,7
965431,637233,2017-05-02,Senate,"[First] hearing set for [05-03-2017]: Failed passage in Committee. Reconsideration granted",7,0,0,0,7
965433,631873,2017-04-25,Senate,"Do pass, but first be re-referred to the Committee on [Appropriations]",13,0,0,0,13
965433,644639,2017-05-15,Senate,"Placed on suspense file",7,0,0,0,7
965433,650827,2017-05-25,Senate,"Do pass",7,0,0,0,7
965433,656081,2017-05-31,Senate,"Special Consent Calendar # SB480",40,0,0,0,40
965434,631957,2017-04-25,Assembly,"Do pass and be re-referred to the Committee on [Appropriations] with recommendation: To Consent Calendar",7,0,0,0,7
965434,651675,2017-05-26,Assembly,"Do pass",17,0,0,0,17
965434,656161,2017-05-31,Assembly,"AB 923 RIDLEY-THOMAS Assembly Third Reading",75,0,5,0,80
965434,671022,2017-07-03,Senate,"Do pass, but first be re-referred to the Committee on [Appropriations] with the recommendation: To Consent Calendar",6,0,3,0,9
965434,672802,2017-07-17,Senate,"Placed on suspense file",7,0,0,0,7
965436,608572,2017-03-21,Assembly,"Do pass and be re-referred to the Committee on [Appropriations]",7,0,0,0,7
965436,652158,2017-05-26,Assembly,"Do pass",17,0,0,0,17
965436,654440,2017-05-30,Assembly,"AB 891 GARCIA, E. Assembly Third Reading",77,0,3,0,80
965436,676129,2017-09-14,Senate,"Assembly 3rd Reading AB891 Mayes et al. By Glazer Urgency Clause",40,0,0,0,40
965436,676458,2017-09-15,Assembly,"AB 891 Mayes Concurrence - Urgency Added",77,0,2,0,79
965437,641553,2017-05-09,Assembly,"Do pass as amended",14,0,1,0,15
965437,646457,2017-05-18,Assembly,"AB 893 GARCIA, E. Assembly Third Reading",67,0,13,0,80
965437,768757,2018-06-27,Senate,"Do pass as amended, but first amend, and re-refer to the Committee on [Appropriations]",7,2,2,0,11
965437,770902,2018-08-06,Senate,"Placed on suspense file",7,0,0,0,7
965437,771751,2018-08-16,Senate,"Do pass",5,2,0,0,7
965438,633601,2017-04-26,Senate,"Do pass, but first be re-referred to the Committee on [Judiciary]",1,2,2,0,5
965438,633602,2017-04-26,Senate,"[Second] hearing set for [04-26-2017]: Failed passage in Committee. Reconsideration granted",5,0,0,0,5
965439,619657,2017-04-04,Senate,"Do pass, but first be re-referred to the Committee on [Environmental Quality]",8,3,2,0,13
965439,627762,2017-04-19,Senate,"Do pass, but first be re-referred to the Committee on [Appropriations]",5,2,0,0,7
965439,635810,2017-05-01,Senate,"Placed on suspense file",7,0,0,0,7
965439,650691,2017-05-25,Senate,"Do pass as amended",5,2,0,0,7
965439,655734,2017-05-31,Senate,"Senate 3rd Reading SB498 Skinner",27,13,0,0,40
965439,668580,2017-06-26,Assembly,"Do pass and be re-referred to the Committee on [Accountability and Administrative Review]",11,3,0,0,14
965439,672298,2017-07-12,Assembly,"Do pass and be re-referred to the Committee on [Appropriations]",5,2,0,0,7
965439,674439,2017-09-01,Assembly,"Do pass as amended",11,5,1,0,17
965439,675890,2017-09-13,Assembly,"SB 498 Skinner Senate Third Reading By CALDERON",54,24,1,0,79
965439,676059,2017-09-14,Senate,"Unfinished Business SB498 Skinner Concurrence",27,13,0,0,40
965440,619806,2017-04-05,Assembly,"Do pass as amended and be re-referred to the Committee on [Appropriations]",7,0,0,0,7
965440,652172,2017-05-26,Assembly,"Do pass as amended",16,0,1,0,17
965440,655818,2017-05-31,Assembly,"AB 1004 CALDERON Assembly Third Reading",76,0,4,0,80
965440,672625,2017-07-12,Senate,"Do pass, but first be re-referred to the Committee on [Appropriations]",5,0,0,0,5
965440,673863,2017-08-21,Senate,"Placed on suspense file",7,0,0,0,7
965440,674761,2017-09-01,Senate,"Do pass as amended",7,0,0,0,7
965440,676592,2017-09-15,Senate,"Assembly 3rd Reading AB1004 Calderon By Stern",36,0,4,0,40
965440,676593,2017-09-16,Assembly,"AB 1004 CALDERON Concurrence in Senate Amendments",77,0,2,0,79
965441,684743,2018-01-09,Assembly,"Do pass as amended",5,1,4,0,10
965441,684744,2018-01-09,Assembly,Reconsideration,10,0,0,0,10
965442,630274,2017-04-24,Senate,"Do pass, but first be re-referred to the Committee on [Appropriations]",2,3,0,0,5
965442,630275,2017-04-24,Senate,"[First] hearing set for [04-24-2017]: Failed passage in Committee. Reconsideration granted",5,0,0,0,5
965443,620598,2017-04-05,Assembly,"Do pass and be re-referred to the Committee on [Judiciary] with recommendation: To Consent Calendar",13,0,0,0,13
965443,627424,2017-04-18,Assembly,"Do pass and be re-referred to the Committee on [Appropriations] with recommendation: To Consent Calendar",11,0,0,0,11
965443,649386,2017-05-24,Assembly,"Do pass. To Consent Calendar",17,0,0,0,17
965443,654079,2017-05-30,Assembly,"AB 1034 CHAU Consent Calendar Second Day Regular Session",77,0,3,0,80
965443,666740,2017-06-20,Senate,"Do pass, but first be re-referred to the Committee on [Energy, Utilities and Communications] with the recommendation: To Consent Calendar",7,0,0,0,7
965443,671021,2017-07-03,Senate,"Do pass as amended, but first amend, and re-refer to the Committee on [Judiciary]",9,0,2,0,11
965443,672300,2017-07-11,Senate,"Do pass, but first be re-referred to the Committee on [Appropriations] with the recommendation: To Consent Calendar",7,0,0,0,7
965443,674405,2017-08-31,Senate,"Assembly 3rd Reading AB1034 Chau By Roth",38,0,2,0,40
965443,674921,2017-09-05,Assembly,"AB 1034 CHAU Concurrence in Senate Amendments",76,0,3,0,79
965444,629112,2017-04-19,Assembly,"Do pass as amended and be re-referred to the Committee on [Transportation]",8,1,0,0,9
965445,684740,2018-01-09,Senate,"Do pass, but first be re-referred to the Committee on [Appropriations] with the recommendation: To Consent Calendar",9,0,4,0,13
965445,690560,2018-01-29,Senate,"Consent Calendar SB532",39,0,1,0,40
965445,766477,2018-06-20,Assembly,"Do pass and be re-referred to the Committee on [Appropriations] with recommendation: To Consent Calendar",19,0,2,0,21
965445,771099,2018-08-08,Assembly,"Do pass. To Consent Calendar",17,0,0,0,17
965445,773808,2018-08-30,Assembly,"SB 532 Dodd Senate Third Reading By AGUIAR-CURRY",79,1,0,0,80
965445,774047,2018-08-31,Senate,"Unfinished Business SB532 Dodd Concurrence",39,0,1,0,40
965446,631932,2017-04-24,Senate,"Do pass, but first be re-referred to the Committee on [Appropriations]",7,0,2,0,9
965446,644911,2017-05-15,Senate,"Placed on suspense file",7,0,0,0,7
965447,627037,2017-04-18,Assembly,"Do pass and be re-referred to the Committee on [Appropriations]",14,0,2,0,16
965447,651519,2017-05-26,Assembly,"Do pass as amended",16,0,1,0,17
965447,655866,2017-05-31,Assembly,"AB 996 CUNNINGHAM Assembly Third Reading",75,1,4,0,80
965447,671926,2017-07-10,Senate,"Do pass as amended, but first amend, and re-refer to the Committee on [Appropriations]",9,0,0,0,9
965447,673991,2017-08-21,Senate,"Placed on suspense file",7,0,0,0,7
965447,774579,2017-04-18,Assembly,,0,0,2,0,2
965448,627016,2017-04-18,Senate,"Do pass, but first be re-referred to the Committee on [Appropriations]",7,0,0,0,7
965448,635668,2017-05-01,Senate,"Placed on suspense file",7,0,0,0,7
965450,633476,2017-04-25,Assembly,"Do pass and be re-referred to the Committee on [Appropriations]",9,3,1,0,13
965450,686161,2018-01-18,Assembly,"Do pass",12,5,0,0,17
965450,690061,2018-01-29,Assembly,"AB 1037 LIMÓN Assembly Third Reading",52,23,2,0,77
965450,760353,2018-06-06,Senate,"Do pass as amended, but first amend, and re-refer to the Committee on [Appropriations]",5,0,1,0,6
965450,767894,2018-06-25,Senate,"Placed on suspense file",7,0,0,0,7
965451,605348,2017-03-16,Assembly,"Be re-referred to the Committee on [Water, Parks, and Wildlife]",9,0,2,0,11
965451,618467,2017-04-04,Assembly,"Do pass as amended and be re-referred to the Committee on [Appropriations]",11,0,4,0,15
965452,612953,2017-03-27,Senate,"Do pass and be ordered to the Consent Calendar",9,0,0,0,9
965452,616198,2017-03-30,Senate,"Consent Calendar 2nd SB510",37,0,3,0,40
965452,666268,2017-06-20,Assembly,"Do pass and be re-referred to the Committee on [Appropriations]",15,0,1,0,16
965452,675239,2017-09-07,Assembly,"SB 510 Stone Senate Third Reading By WALDRON",79,0,0,0,79
965455,613016,2017-03-27,Senate,"Do pass, but first be re-referred to the Committee on [Judiciary]",3,2,0,0,5
965455,637556,2017-05-02,Senate,"Do pass as amended",5,2,0,0,7
965455,654297,2017-05-30,Senate,"Senate 3rd Reading SB550 Pan",25,14,1,0,40
965455,667202,2017-06-21,Assembly,"Do pass",5,0,2,0,7
965455,672806,2017-07-18,Assembly,"Do pass",9,2,0,0,11
965455,675490,2017-09-11,Assembly,"SB 550 Pan Senate Third Reading By RODRIGUEZ",55,20,4,0,79
965455,675635,2017-09-12,Senate,"Unfinished Business SB550 Pan Concurrence",25,14,1,0,40
965455,675636,2017-09-12,Senate,"Unfinished Business SB550 Pan Concurrence Reconsider",40,0,0,0,40
965455,675637,2017-09-12,Senate,"Unfinished Business SB550 Pan Concurrence",27,13,0,0,40
965457,630339,2017-04-24,Senate,"Do pass, but first be re-referred to the Committee on [Appropriations] with the recommendation: To Consent Calendar",5,0,0,0,5
965457,644493,2017-05-15,Senate,"Consent Calendar 2nd SB525",39,0,1,0,40
965457,671584,2017-07-06,Assembly,"Do pass and be re-referred to the Committee on [Appropriations] with recommendation: To Consent Calendar",7,0,0,0,7
965457,672859,2017-07-19,Assembly,"Do pass. To Consent Calendar",16,0,1,0,17
965457,674069,2017-08-24,Assembly,"SB 525 Pan Consent Calendar Second Day Regular Session",76,0,3,0,79
965459,614929,2017-03-29,Senate,"Do pass, but first be re-referred to the Committee on [Environmental Quality]",6,1,0,0,7
965459,627745,2017-04-19,Senate,"Do pass, but first be re-referred to the Committee on [Appropriations]",7,0,0,0,7
965459,635740,2017-05-01,Senate,"Placed on suspense file",7,0,0,0,7
965459,650528,2017-05-25,Senate,"Do pass as amended",5,1,1,0,7
965459,655913,2017-05-31,Senate,"Senate 3rd Reading SB541 Allen",37,2,1,0,40
965459,669104,2017-06-27,Assembly,"Do pass and be re-referred to the Committee on [Education]",6,0,1,0,7
965459,672589,2017-07-12,Assembly,"Do pass and be re-referred to the Committee on [Appropriations]",7,0,0,0,7
965459,674596,2017-09-01,Assembly,"Do pass",16,0,1,0,17
965459,675124,2017-09-07,Assembly,"SB 541 Allen Senate Third Reading By FRIEDMAN",77,0,2,0,79
965459,675383,2017-09-11,Senate,"Unfinished Business SB541 Allen et al. Concurrence",40,0,0,0,40
965460,626915,2017-04-18,Assembly,"Do pass and be re-referred to the Committee on [Appropriations] with recommendation: To Consent Calendar",15,0,0,0,15
965460,651639,2017-05-26,Assembly,"Do pass",17,0,0,0,17
965460,654429,2017-05-30,Assembly,"AB 974 QUIRK-SILVA Assembly Third Reading",77,0,3,0,80
965460,672569,2017-07-12,Senate,"Do pass, but first be re-referred to the Committee on [Appropriations]",8,0,1,0,9
965460,673873,2017-08-21,Senate,"Placed on suspense file",7,0,0,0,7
965460,674640,2017-09-01,Senate,"Do pass as amended",7,0,0,0,7
965460,675200,2017-09-07,Senate,"Assembly 3rd Reading AB974 Quirk-Silva By Hueso",40,0,0,0,40
965460,675291,2017-09-11,Assembly,"AB 974 QUIRK-SILVA Concurrence in Senate Amendments",78,0,1,0,79
965461,631786,2017-04-25,Assembly,"Do pass and be re-referred to the Committee on [Appropriations]",14,0,1,0,15
965463,608279,2017-03-21,Assembly,"Do pass and be re-referred to the Committee on [Appropriations]",7,0,0,0,7
965463,633409,2017-04-26,Assembly,"Do pass. To Consent Calendar",16,0,1,0,17
965463,638468,2017-05-04,Assembly,"AB 993 BAKER Consent Calendar Second Day Regular Session",76,0,4,0,80
965463,666244,2017-06-20,Senate,"Do pass, but first be re-referred to the Committee on [Appropriations]",7,0,0,0,7
965463,674295,2017-08-31,Senate,"Assembly 3rd Reading AB993 Baker et al. By Jackson",39,0,1,0,40
965463,675186,2017-09-07,Assembly,"AB 993 BAKER Concurrence in Senate Amendments",79,0,0,0,79
965465,614167,2017-03-28,Senate,"Do pass, but first be re-referred to the Committee on [Appropriations]",10,0,3,0,13
965465,634716,2017-04-27,Senate,"Senate 3rd Reading SB461 Allen et al",37,0,3,0,40
965465,667339,2017-06-21,Assembly,"Do pass and be re-referred to the Committee on [Appropriations]",17,0,4,0,21
965465,669612,2017-06-28,Assembly,"Do pass. To Consent Calendar",14,0,3,0,17
965465,675429,2017-09-11,Assembly,"SB 461 Allen Senate Third Reading By BLOOM",79,0,0,0,79
965465,676070,2017-09-14,Senate,"Special Consent Calendar SB461",40,0,0,0,40
965466,633508,2017-04-26,Senate,"Do pass as amended, but first amend, and re-refer to the Committee on [Appropriations]",4,1,2,0,7
965466,644684,2017-05-15,Senate,"Placed on suspense file",7,0,0,0,7
965467,637505,2017-05-03,Assembly,"Do pass and be re-referred to the Committee on [Elections and Redistricting]",8,0,1,0,9
965467,642690,2017-05-10,Assembly,"Do pass as amended and be re-referred to the Committee on [Appropriations]",6,0,1,0,7
965467,649277,2017-05-24,Assembly,"Do pass as amended",16,0,1,0,17
965467,654363,2017-05-30,Assembly,"AB 943 SANTIAGO Assembly Third Reading",72,2,6,0,80
965467,671305,2017-07-05,Senate,"Do pass, but first be re-referred to the Committee on [Elections and Constitutional Amendments]",6,1,0,0,7
965467,672544,2017-07-12,Senate,"Do pass as amended, but first amend, and re-refer to the Committee on [Appropriations]",4,0,1,0,5
965467,673895,2017-08-21,Senate,"Placed on suspense file",7,0,0,0,7
965469,632134,2017-04-25,Assembly,"Do pass and be re-referred to the Committee on [Appropriations]",5,2,0,0,7
965469,651829,2017-05-26,Assembly,"Do pass",11,6,0,0,17
965469,656850,2017-06-01,Assembly,"AB 958 TING Assembly Third Reading",44,28,8,0,80
965469,671316,2017-07-05,Senate,"Do pass as amended, but first amend, and re-refer to the Committee on [Appropriations]",5,2,0,0,7
965469,767131,2018-06-20,Senate,"Do pass, but first be re-referred to the Committee on [Appropriations]",5,2,0,0,7
965470,637608,2017-05-03,Assembly,"Do pass. To Consent Calendar",20,0,1,0,21
965470,643628,2017-05-11,Assembly,"AB 924 GRAY Consent Calendar Second Day Regular Session",77,0,3,0,80
965470,767946,2018-06-25,Senate,"Do pass, but first be re-referred to the Committee on [Governance and Finance]",8,0,1,0,9
965470,769276,2018-06-27,Senate,"Do pass as amended, but first amend, and re-refer to the Committee on [Appropriations]",6,1,0,0,7
965470,771316,2018-08-13,Senate,"Placed on suspense file",7,0,0,0,7
965471,626962,2017-04-18,Assembly,"Do pass as amended, and be re-referred to the Committee on [Appropriations] with recommendation: To Consent Calendar",11,0,0,0,11
965471,637584,2017-05-03,Assembly,"Do pass. To Consent Calendar",16,0,1,0,17
965471,643438,2017-05-11,Assembly,"AB 976 BERMAN Consent Calendar Second Day Regular Session",77,0,3,0,80
965471,669675,2017-06-27,Senate,"Do pass, but first be re-referred to the Committee on [Appropriations] with the recommendation: To Consent Calendar",6,0,1,0,7
965471,675678,2017-09-12,Senate,"Assembly 3rd Reading AB976 Berman By Jackson",40,0,0,0,40
965471,675773,2017-09-13,Assembly,"AB 976 Berman Concurrence in Senate Amendments",79,0,0,0,79
965473,619767,2017-04-05,Senate,"Do pass as amended, but first amend, and re-refer to the Committee on [Environmental Quality]",7,0,0,0,7
965473,636179,2017-05-01,Senate,"Do pass",7,0,0,0,7
965473,638664,2017-05-04,Senate,"Senate 3rd Reading SB551 Hueso",39,0,1,0,40
965473,667323,2017-06-20,Assembly,"Do pass as amended and be re-referred to the Committee on [Banking and Finance]",6,0,1,0,7
965473,765183,2018-06-19,Assembly,"Do pass as amended and be re-referred to the Committee on [Banking and Finance]",6,0,1,0,7
965474,629106,2017-04-19,Senate,"Do pass, but first be re-referred to the Committee on [Judiciary]",9,0,0,0,9
965474,633656,2017-04-25,Senate,"Do pass, but first be re-referred to the Committee on [Appropriations]",7,0,0,0,7
965474,644936,2017-05-15,Senate,"Do pass",7,0,0,0,7
965474,655204,2017-05-30,Senate,"Senate 3rd Reading SB481 Pan",27,12,1,0,40
965474,669295,2017-06-27,Assembly,"Do pass as amended and be re-referred to the Committee on [Judiciary]",15,0,0,0,15
965474,763501,2018-06-14,Assembly,"Be re-referred to the Committees on [Local Government] and [Housing and Community Development]",7,0,4,0,11
965474,765946,2018-06-20,Assembly,"Do pass and be re-referred to the Committee on [Housing and Community Development]",6,1,2,0,9
965474,768744,2018-06-27,Assembly,"Do pass",5,1,1,0,7
965474,770355,2018-08-06,Assembly,"SB 481 Pan Senate Third Reading By MCCARTY",53,22,5,0,80
965474,771479,2018-08-15,Senate,"That the Assembly amendments be concurred in",6,0,1,0,7
965474,772401,2018-08-21,Senate,"Unfinished Business SB481 Pan Concurrence",31,6,3,0,40
965476,684725,2018-01-09,Assembly,"Do pass and be re-referred to the Committee on [Local Government]",6,0,0,0,6
965476,684885,2018-01-10,Assembly,"Do pass as amended and be re-referred to the Committee on [Appropriations]",8,0,1,0,9
965477,627765,2017-04-18,Senate,"Do pass as amended, but first amend, and re-refer to the Committee on [Appropriations] with the recommendation: To Consent Calendar",7,0,0,0,7
965477,648002,2017-05-22,Senate,"Consent Calendar 2nd SB469",37,0,3,0,40
965477,662390,2017-06-13,Assembly,"Do pass and be re-referred to the Committee on [Appropriations] with recommendation: To Consent Calendar",11,0,0,0,11
965477,672941,2017-07-19,Assembly,"Do pass. To Consent Calendar",16,0,1,0,17
965477,675000,2017-09-05,Assembly,"SB 469 Skinner Senate Third Reading By STONE",76,0,3,0,79
965477,675108,2017-09-07,Senate,"Special Consent Calendar # SB469",40,0,0,0,40
965479,633131,2017-04-26,Senate,"Do pass as amended, but first amend, and re-refer to the Committee on [Appropriations]",7,0,0,0,7
965479,644582,2017-05-15,Senate,"Placed on suspense file",7,0,0,0,7
965479,650793,2017-05-25,Senate,"Do pass as amended",5,2,0,0,7
965479,655986,2017-05-31,Senate,"Senate 3rd Reading SB494 Hueso et al",31,8,1,0,40
965479,672559,2017-07-12,Assembly,"Do pass and be re-referred to the Committee on [Appropriations]",5,1,1,0,7
965479,674668,2017-09-01,Assembly,"Do pass",11,4,2,0,17
965479,675728,2017-09-12,Assembly,"SB 494 Hueso Senate Third Reading By GONZALEZ FLETCHER",59,17,3,0,79
965479,675763,2017-09-13,Senate,"Unfinished Business SB494 Hueso et al. Concurrence",30,8,2,0,40
965481,626965,2017-04-18,Assembly,"Do pass and be re-referred to the Committee on [Health]",15,0,1,0,16
965481,632051,2017-04-25,Assembly,"Do pass as amended and be re-referred to the Committee on [Appropriations]",15,0,0,0,15
965481,649368,2017-05-24,Assembly,"Do pass. To Consent Calendar",17,0,0,0,17
965481,654572,2017-05-30,Assembly,"AB 1048 ARAMBULA Consent Calendar Second Day Regular Session",77,0,3,0,80
965481,669105,2017-06-26,Senate,"Do pass, but first be re-referred to the Committee on [Health]",9,0,0,0,9
965481,672528,2017-07-12,Senate,"Do pass, but first be re-referred to the Committee on [Appropriations]",8,0,1,0,9
965481,673773,2017-08-21,Senate,"Do pass",7,0,0,0,7
965481,675174,2017-09-07,Senate,"Assembly 3rd Reading AB1048 Arambula By Pan Reconsider",40,0,0,0,40
965481,675175,2017-09-07,Senate,"Assembly 3rd Reading AB1048 Arambula By Pan Reconsider",39,0,1,0,40
965481,675608,2017-09-12,Senate,"Assembly 3rd Reading AB1048 Arambula By Pan",40,0,0,0,40
965481,676241,2017-09-14,Assembly,"AB 1048 ARAMBULA Concurrence in Senate Amendments",79,0,0,0,79
965482,628047,2017-04-19,Senate,"Do pass, but first be re-referred to the Committee on [Appropriations]",7,0,0,0,7
965482,635716,2017-05-01,Senate,"Do pass",7,0,0,0,7
965482,645708,2017-05-17,Senate,"That the measure be returned to Senate Floor for consideration. Ordered to third reading",7,0,0,0,7
965482,654374,2017-05-30,Senate,"Senate 3rd Reading SB503 Newman et al. Urgency Clause",40,0,0,0,40
965482,671359,2017-07-05,Assembly,"Do pass and be re-referred to the Committee on [Revenue and Taxation]",7,0,0,0,7
965482,672106,2017-07-10,Assembly,"Do pass as amended, and be re-referred to the Committee on [Appropriations] with recommendation: To Consent Calendar",10,0,0,0,10
965482,674016,2017-08-23,Assembly,"Do pass as amended",15,0,2,0,17
965482,676376,2017-09-14,Assembly,"SB 503 Newman Senate Third Reading By MURATSUCHI",78,0,1,0,79
965482,676497,2017-09-15,Senate,"Unfinished Business SB503 Newman et al. Concurrence",38,0,2,0,40
965483,627865,2017-04-19,Assembly,"Do pass and be re-referred to the Committee on [Local Government]",7,0,0,0,7
965483,634407,2017-04-26,Assembly,"Do pass and be re-referred to the Committee on [Appropriations]",9,0,0,0,9
965483,642514,2017-05-10,Assembly,"Do pass. To Consent Calendar",17,0,0,0,17
965483,646382,2017-05-18,Assembly,"AB 879 GRAYSON Consent Calendar Second Day Regular Session",69,0,11,0,80
965483,662145,2017-06-13,Senate,"Do pass, but first be re-referred to the Committee on [Appropriations] with the recommendation: To Consent Calendar",13,0,0,0,13
965483,676535,2017-09-15,Senate,"Assembly 3rd Reading AB879 Grayson By Beall",38,0,2,0,40
965483,676536,2017-09-15,Assembly,"AB 879 GRAYSON Concurrence in Senate Amendments",78,0,1,0,79
965484,612879,2017-03-27,Senate,"Do pass as amended, but first amend, and re-refer to the Committee on [Judiciary]",9,0,0,0,9
965484,628129,2017-04-18,Senate,"Do pass as amended, but first amend, and re-refer to the Committee on [Appropriations]",7,0,0,0,7
965484,644658,2017-05-15,Senate,"Placed on suspense file",7,0,0,0,7
965484,650346,2017-05-25,Senate,"Do pass",7,0,0,0,7
965484,655926,2017-05-31,Senate,"Special Consent Calendar # SB559",40,0,0,0,40
965484,671915,2017-07-10,Assembly,"Do pass and be re-referred to the Committee on [Judiciary]",12,0,4,0,16
965484,672162,2017-07-11,Assembly,"Do pass as amended and be re-referred to the Committee on [Appropriations]",11,0,0,0,11
965484,674528,2017-09-01,Assembly,"Do pass as amended",16,0,1,0,17
965484,675778,2017-09-13,Assembly,"SB 559 Morrell Senate Third Reading By KILEY",76,2,1,0,79
965484,676121,2017-09-14,Senate,"Unfinished Business SB559 Morrell Concurrence",40,0,0,0,40
965485,615048,2017-03-29,Assembly,"Do pass and be re-referred to the Committee on [Appropriations]",20,0,1,0,21
965485,633655,2017-04-26,Assembly,"Do pass. To Consent Calendar",16,0,1,0,17
965485,638479,2017-05-04,Assembly,"AB 987 GARCIA, C. Consent Calendar Second Day Regular Session",76,0,4,0,80
965485,662597,2017-06-13,Senate,"Do pass, but first be re-referred to the Committee on [Appropriations]",10,0,3,0,13
965485,767118,2018-06-20,Senate,"Do pass, but first be re-referred to the Committee on [Judiciary]",7,0,0,0,7
965485,768853,2018-06-26,Senate,"Do pass as amended, but first amend, and re-refer to the Committee on [Appropriations]",5,1,1,0,7
965485,771392,2018-08-13,Senate,"Placed on suspense file",7,0,0,0,7
965485,771796,2018-08-16,Senate,"Do pass as amended",6,1,0,0,7
965485,771797,2018-08-16,Senate,"[08-16-2018] set for [First] hearing: Reconsideration of favorable vote granted",7,0,0,0,7
965485,771798,2018-08-16,Senate,"Do pass as amended",7,0,0,0,7
965485,773958,2018-08-31,Assembly,"With recommendation: That Senate amendments be concurred in",6,3,1,0,10
965485,774004,2018-08-31,Senate,"Assembly 3rd Reading AB987 Kamlager-Dove et al. By Bradford",34,0,6,0,40
965485,774005,2018-08-31,Assembly,"AB 987 Kamlager-Dove Concurrence in Senate Amendments",68,4,8,0,80
965486,619822,2017-04-05,Assembly,"Do pass as amended and be re-referred to the Committee on [Education]",10,3,0,0,13
965486,634371,2017-04-26,Assembly,"Do pass as amended and be re-referred to the Committee on [Appropriations]",6,0,1,0,7
965486,651651,2017-05-26,Assembly,"Do pass",12,4,1,0,17
965486,656275,2017-05-31,Assembly,"AB 1082 BURKE Assembly Third Reading",54,17,9,0,80
965486,671882,2017-07-10,Senate,"Do pass, but first be re-referred to the Committee on [Education]",9,2,0,0,11
965486,672380,2017-07-12,Senate,"Do pass as amended, but first amend, and re-refer to the Committee on [Appropriations]",7,0,0,0,7
965486,673898,2017-08-21,Senate,"Placed on suspense file",7,0,0,0,7
965486,674642,2017-09-01,Senate,"Do pass as amended",5,1,1,0,7
965486,675697,2017-09-12,Senate,"Assembly 3rd Reading AB1082 Burke et al. By Bradford",30,9,1,0,40
965486,675854,2017-09-13,Assembly,"AB 1082 Burke Concurrence in Senate Amendments",57,21,1,0,79
965487,613510,2017-03-28,Senate,"Do pass as amended, but first amend, and re-refer to the Committee on [Appropriations]",7,0,0,0,7
965487,626088,2017-04-17,Senate,"Placed on suspense file",7,0,0,0,7
965487,650745,2017-05-25,Senate,"Do pass as amended",7,0,0,0,7
965487,655846,2017-05-31,Senate,"Senate 3rd Reading SB513 Bradford",40,0,0,0,40
965487,669037,2017-06-27,Assembly,"Do pass as amended, and be re-referred to the Committee on [Appropriations] with recommendation: To Consent Calendar",6,0,1,0,7
965487,672848,2017-07-19,Assembly,"Do pass. To Consent Calendar",16,0,1,0,17
965487,674092,2017-08-24,Assembly,"SB 513 Bradford Consent Calendar Second Day Regular Session",76,0,3,0,79
965487,674361,2017-08-31,Senate,"Special Consent Calendar # SB513",37,0,3,0,40
965488,609755,2017-03-21,Assembly,"Do pass and be re-referred to the Committee on [Judiciary] with recommendation: To Consent Calendar",7,0,0,0,7
965488,627466,2017-04-18,Assembly,"Do pass and be re-referred to the Committee on [Appropriations] with recommendation: To Consent Calendar",11,0,0,0,11
965488,651879,2017-05-26,Assembly,"Do pass",17,0,0,0,17
965488,654565,2017-05-30,Assembly,"AB 1006 MAIENSCHEIN Assembly Third Reading",77,0,3,0,80
965488,669131,2017-06-27,Senate,"Do pass, but first be re-referred to the Committee on [Judiciary]",5,0,0,0,5
965488,675151,2017-09-07,Senate,"Assembly 3rd Reading AB1006 Maienschein et al. By Beall Reconsider",40,0,0,0,40
965488,675152,2017-09-07,Senate,"Assembly 3rd Reading AB1006 Maienschein et al. By Beall Reconsider",39,0,1,0,40
965488,675615,2017-09-12,Senate,"Assembly 3rd Reading AB1006 Maienschein et al. By Beall",40,0,0,0,40
965488,675923,2017-09-13,Assembly,"AB 1006 Maienschein Concurrence in Senate Amendments",79,0,0,0,79
965489,620112,2017-04-04,Assembly,"Do pass and be re-referred to the Committee on [Appropriations]",10,0,0,0,10
965489,651509,2017-05-26,Assembly,"Do pass",17,0,0,0,17
965489,655887,2017-05-31,Assembly,"AB 998 GRAYSON Assembly Third Reading",77,0,3,0,80
965489,765651,2018-06-19,Senate,"Do pass, but first be re-referred to the Committee on [Judiciary]",6,0,1,0,7
965489,769734,2018-07-03,Senate,"Do pass as amended",7,0,0,0,7
965489,772940,2018-08-27,Senate,"Assembly 3rd Reading AB998 Grayson et al. By Stone",39,0,1,0,40
965489,773106,2018-08-28,Assembly,"With recommendation: That Senate amendments be concurred in",6,0,1,0,7
965489,773359,2018-08-29,Assembly,"AB 998 GRAYSON Concurrence in Senate Amendments",80,0,0,0,80
965490,634657,2017-04-26,Assembly,"Do pass and be re-referred to the Committee on [Appropriations] with recommendation: To Consent Calendar",7,0,0,0,7
965490,652133,2017-05-26,Assembly,"Do pass as amended",12,0,5,0,17
965490,656110,2017-05-31,Assembly,"AB 1035 O'DONNELL Assembly Third Reading",76,0,4,0,80
965490,669904,2017-06-28,Senate,"Do pass, but first be re-referred to the Committee on [Appropriations] with the recommendation: To Consent Calendar",7,0,0,0,7
965490,672556,2017-07-13,Senate,"Consent Calendar 2nd AB1035",39,0,1,0,40
965490,675296,2017-09-11,Senate,"Assembly 3rd Reading AB1035 O'Donnell By Allen",40,0,0,0,40
965490,675581,2017-09-12,Assembly,"AB 1035 O'DONNELL Concurrence in Senate Amendments",79,0,0,0,79
965496,636508,2017-05-02,Assembly,"Do pass as amended and be re-referred to the Committee on [Health]",11,0,0,0,11
965496,641862,2017-05-09,Assembly,"Do pass",14,0,1,0,15
965496,647925,2017-05-22,Assembly,"AB 937 EGGMAN Assembly Third Reading",75,0,5,0,80
965497,632025,2017-04-25,Assembly,"Do pass as amended and be re-referred to the Committee on [Appropriations]",15,0,0,0,15
965497,649304,2017-05-24,Assembly,"Do pass. To Consent Calendar",17,0,0,0,17
965497,654379,2017-05-30,Assembly,"AB 1074 MAIENSCHEIN Consent Calendar Second Day Regular Session",77,0,3,0,80
965497,663091,2017-06-14,Senate,"Do pass as amended, but first amend, and re-refer to the Committee on [Human Services] with the recommendation: To Consent Calendar",9,0,0,0,9
965497,672396,2017-07-11,Senate,"Do pass, but first be re-referred to the Committee on [Appropriations] with the recommendation: To Consent Calendar",7,0,0,0,7
965497,673794,2017-08-21,Senate,"Do pass as amended",7,0,0,0,7
965497,674936,2017-09-05,Senate,"Assembly 3rd Reading AB1074 Maienschein By Mitchell",40,0,0,0,40
965497,675190,2017-09-07,Assembly,"AB 1074 MAIENSCHEIN Concurrence in Senate Amendments",78,1,0,0,79
965498,641593,2017-05-08,Assembly,"Do pass as amended and be re-referred to the Committee on [Appropriations]",8,1,1,0,10
965499,631915,2017-04-24,Senate,"Do pass, but first be re-referred to the Committee on [Appropriations]",8,0,1,0,9
965499,654274,2017-05-30,Senate,"Senate 3rd Reading SB547 Hill",40,0,0,0,40
965499,669055,2017-06-27,Assembly,"Do pass and be re-referred to the Committee on [Privacy and Consumer Protection]",16,0,0,0,16
965499,672025,2017-07-11,Assembly,"Do pass and be re-referred to the Committee on [Appropriations]",9,1,0,0,10
965499,674738,2017-09-01,Assembly,"Do pass",13,0,4,0,17
965499,676459,2017-09-15,Senate,"That the Assembly amendments be concurred in",8,0,1,0,9
965499,676460,2017-09-15,Assembly,"SB 547 Hill Senate Third Reading By LOW",74,4,1,0,79
965499,676461,2017-09-15,Senate,"Unfinished Business SB547 Hill Concurrence",34,2,4,0,40
965500,633072,2017-04-26,Assembly,"Do pass and be re-referred to the Committee on [Local Government]",10,0,0,0,10
965501,631900,2017-04-25,Assembly,"Bill measure be retained in committee, and subject matter be referred to Rules Committee for assignment to the proper committee",5,0,10,0,15
965502,671837,2017-07-10,Senate,"Do pass",7,0,0,0,7
965502,672586,2017-07-13,Senate,"Senate 3rd Reading SB534 Lara Urgency Clause",39,0,1,0,40
965502,674249,2017-08-30,Assembly,"Do pass",15,0,2,0,17
965502,674901,2017-09-05,Assembly,"SB 534 Lara Third Reading Urgency By GONZALEZ FLETCHER",74,1,4,0,79
965502,675223,2017-09-07,Senate,"Unfinished Business SB534 Lara Urgency Clause Concurrence",30,9,1,0,40
965503,667292,2017-06-21,Senate,"Do pass as amended, but first amend, and re-refer to the Committee on [Appropriations] with the recommendation: To Consent Calendar",6,0,1,0,7
965503,671864,2017-07-10,Senate,"Do pass",7,0,0,0,7
965503,672534,2017-07-13,Senate,"Senate 3rd Reading SB458 Wiener Urgency Clause",39,0,1,0,40
965503,674195,2017-08-28,Assembly,"Do pass and be re-referred to the Committee on [Appropriations]",8,0,2,0,10
965503,674733,2017-09-01,Assembly,"Do pass as amended",15,0,2,0,17
965503,675844,2017-09-13,Assembly,"SB 458 Wiener Third Reading Urgency By FRIEDMAN",77,0,2,0,79
965503,676171,2017-09-14,Senate,"Unfinished Business SB458 Wiener Urgency Clause Concurrence",39,0,1,0,40
965504,612564,2017-03-27,Senate,"Do pass, but first be re-referred to the Committee on [Judiciary]",3,1,1,0,5
965504,628174,2017-04-18,Senate,"Do pass as amended, but first amend, and re-refer to the Committee on [Appropriations]",5,1,1,0,7
965504,638726,2017-05-04,Senate,"Senate 3rd Reading SB548 Atkins et al",31,4,5,0,40
965504,667175,2017-06-21,Assembly,"Do pass and be re-referred to the Committee on [Judiciary]",5,1,1,0,7
965504,674679,2017-09-01,Assembly,"Do pass as amended",11,5,1,0,17
965506,632003,2017-04-25,Senate,"Do pass as amended, but first amend, and re-refer to the Committee on [Appropriations] with the recommendation: To Consent Calendar",13,0,0,0,13
965506,633579,2017-04-25,Senate,"Do pass, but first be re-referred to the Committee on [Appropriations] with the recommendation: To Consent Calendar",13,0,0,0,13
965506,644432,2017-05-15,Senate,"Placed on suspense file",7,0,0,0,7
965506,650446,2017-05-25,Senate,"Do pass as amended",7,0,0,0,7
965506,655959,2017-05-31,Senate,"Senate 3rd Reading SB477 Cannella et al",40,0,0,0,40
965506,671994,2017-07-10,Assembly,"Do pass and be re-referred to the Committee on [Local Government] with recommendation: To Consent Calendar",14,0,0,0,14
965506,672641,2017-07-12,Assembly,"Do pass and be re-referred to the Committee on [Appropriations] with recommendation: To Consent Calendar",9,0,0,0,9
965507,627273,2017-04-18,Assembly,"Do pass and be re-referred to the Committee on [Appropriations]",7,0,0,0,7
965507,652178,2017-05-26,Assembly,"Do pass as amended",16,0,1,0,17
965507,656083,2017-05-31,Assembly,"AB 1068 GONZALEZ FLETCHER Assembly Third Reading",74,1,5,0,80
965507,668987,2017-06-27,Senate,"Do pass, but first be re-referred to the Committee on [Appropriations]",7,0,0,0,7
965507,671849,2017-07-10,Senate,"Placed on suspense file",7,0,0,0,7
965507,674613,2017-09-01,Senate,"Do pass as amended",7,0,0,0,7
965507,675442,2017-09-11,Senate,"Assembly 3rd Reading AB1068 Gonzalez Fletcher By Bradford",39,0,1,0,40
965507,675851,2017-09-13,Assembly,"AB 1068 GONZALEZ FLETCHER Concurrence in Senate Amendments",77,1,1,0,79
965509,598238,2017-03-06,Assembly,"Be adopted. To third reading",11,0,0,0,11
965511,625901,2017-04-17,Assembly,"Do pass and be re-referred to the Committee on [Natural Resources]",10,3,1,0,14
965511,631653,2017-04-24,Assembly,"Do pass as amended and be re-referred to the Committee on [Appropriations]",7,3,0,0,10
965511,651894,2017-05-26,Assembly,"Do pass as amended",12,5,0,0,17
965511,656313,2017-05-31,Assembly,"AB 964 GOMEZ Assembly Third Reading",52,23,5,0,80
965511,671408,2017-07-05,Senate,"Do pass, but first be re-referred to the Committee on [Transportation and Housing]",5,1,1,0,7
965511,672068,2017-07-11,Senate,"Do pass, but first be re-referred to the Committee on [Appropriations]",9,3,1,0,13
965512,642617,2017-05-09,Senate,"Do pass as amended, and be ordered to the Consent Calendar",7,0,0,0,7
965512,654373,2017-05-30,Senate,"Senate 3rd Reading SB479 Morrell",38,1,1,0,40
965512,666159,2017-06-20,Assembly,"Do pass",11,0,0,0,11
965512,672692,2017-07-17,Assembly,"SB 479 Morrell Senate Third Reading By CHEN",73,1,5,0,79
965512,673869,2017-08-21,Senate,"Unfinished Business SB479 Morrell Concurrence",38,1,1,0,40
965513,614940,2017-03-29,Assembly,"Do pass and be re-referred to the Committee on [Appropriations]",20,0,1,0,21
965513,633299,2017-04-26,Assembly,"Do pass. To Consent Calendar",16,0,1,0,17
965513,638734,2017-05-04,Assembly,"AB 1033 GARCIA, C. Consent Calendar Second Day Regular Session",76,0,4,0,80
965513,672164,2017-07-11,Senate,"Do pass as amended, but first amend, and re-refer to the Committee on [Appropriations]",4,3,0,0,7
965513,673874,2017-08-21,Senate,"Placed on suspense file",7,0,0,0,7
965517,618258,2017-04-04,Assembly,"Do pass and be re-referred to the Committee on [Appropriations]",11,0,4,0,15
965519,608451,2017-03-21,Assembly,"Do pass and be re-referred to the Committee on [Appropriations] with recommendation: To Consent Calendar",11,0,0,0,11
965519,620118,2017-04-05,Assembly,"Do pass. To Consent Calendar",17,0,0,0,17
965519,629286,2017-04-20,Assembly,"AB 905 MAIENSCHEIN Consent Calendar Second Day Regular Session",74,0,6,0,80
965519,662224,2017-06-13,Senate,"Do pass, but first be re-referred to the Committee on [Appropriations]",7,0,0,0,7
965519,672962,2017-07-20,Senate,"Assembly 3rd Reading AB905 Maienschein By Stern",38,0,2,0,40
965520,627104,2017-04-18,Assembly,"Do pass and be re-referred to the Committee on [Governmental Organization]",10,0,0,0,10
965520,634633,2017-04-27,Assembly,"Do pass and be re-referred to the Committee on [Appropriations]",20,0,1,0,21
965520,651862,2017-05-26,Assembly,"Do pass",16,1,0,0,17
965520,655802,2017-05-31,Assembly,"AB 1022 IRWIN Assembly Third Reading",76,0,4,0,80
965520,669240,2017-06-27,Senate,"Do pass, but first be re-referred to the Committee on [Judiciary]",13,0,0,0,13
965520,672291,2017-07-11,Senate,"Do pass, but first be re-referred to the Committee on [Appropriations]",7,0,0,0,7
965520,673958,2017-08-21,Senate,"Placed on suspense file",7,0,0,0,7
965520,674758,2017-09-01,Senate,"Do pass",7,0,0,0,7
965520,675521,2017-09-11,Senate,"Assembly 3rd Reading AB1022 Irwin By Lara",40,0,0,0,40
965520,676001,2017-09-13,Assembly,"AB 1022 IRWIN Concurrence in Senate Amendments",78,0,1,0,79
965521,614775,2017-03-29,Senate,"Do pass as amended, but first amend, and re-refer to the Committee on [Appropriations]",6,1,0,0,7
965521,626069,2017-04-17,Senate,"Placed on suspense file",7,0,0,0,7
965521,650693,2017-05-25,Senate,"Do pass as amended",5,2,0,0,7
965521,655847,2017-05-31,Senate,"Senate 3rd Reading SB478 Portantino",29,10,1,0,40
965521,672182,2017-07-11,Assembly,"Do pass as amended and be re-referred to the Committee on [Appropriations]",13,0,0,0,13
965521,674538,2017-09-01,Assembly,"Do pass",12,4,1,0,17
965521,675139,2017-09-07,Assembly,"SB 478 Portantino Senate Third Reading By MEDINA",70,6,3,0,79
965521,675412,2017-09-11,Senate,"Unfinished Business SB478 Portantino Concurrence",30,10,0,0,40
965522,620067,2017-04-05,Assembly,"Do pass and be re-referred to the Committee on [Appropriations] with recommendation: To Consent Calendar",7,0,0,0,7
965522,633438,2017-04-26,Assembly,"Do pass. To Consent Calendar",16,0,1,0,17
965522,638595,2017-05-04,Assembly,"AB 1044 QUIRK Consent Calendar Second Day Regular Session",76,0,4,0,80
965522,658941,2017-06-06,Senate,"Do pass, but first be re-referred to the Committee on [Appropriations] with the recommendation: To Consent Calendar",4,0,1,0,5
965522,670955,2017-07-03,Senate,"Consent Calendar 2nd AB1044",33,0,7,0,40
965524,609798,2017-03-22,Assembly,"Do pass and be re-referred to the Committee on [Appropriations]",6,0,1,0,7
965524,651642,2017-05-26,Assembly,"Do pass as amended",13,0,4,0,17
965524,656129,2017-05-31,Assembly,"AB 973 LOW Assembly Third Reading",70,0,10,0,80
965524,672546,2017-07-12,Senate,"Do pass, but first be re-referred to the Committee on [Appropriations]",5,0,0,0,5
965524,673831,2017-08-21,Senate,"Placed on suspense file",7,0,0,0,7
965524,674477,2017-09-01,Senate,"Do pass",7,0,0,0,7
965524,676050,2017-09-14,Senate,"Special Consent Calendar # AB973",40,0,0,0,40
965524,676571,2017-09-15,Assembly,"AB 973 LOW Concurrence in Senate Amendments",74,0,5,0,79
965525,637969,2017-05-02,Senate,"Do pass as amended",7,0,0,0,7
965525,648094,2017-05-22,Senate,"Senate 3rd Reading SB466 Bates et al",37,0,3,0,40
965525,662251,2017-06-13,Assembly,"Do pass and be re-referred to the Committee on [Privacy and Consumer Protection] with recommendation: To Consent Calendar",11,0,0,0,11
965525,672159,2017-07-11,Assembly,"Do pass. To Consent Calendar",10,0,0,0,10
965525,672790,2017-07-17,Assembly,"SB 466 Bates Consent Calendar Second Day",78,0,1,0,79
965526,627744,2017-04-18,Senate,"Do pass, but first be re-referred to the Committee on [Appropriations]",5,0,0,0,5
965526,638338,2017-05-04,Senate,"Senate 3rd Reading SB511 Stern",37,0,3,0,40
965526,672484,2017-07-12,Assembly,"Do pass and be re-referred to the Committee on [Appropriations]",5,1,1,0,7
965526,674043,2017-08-23,Assembly,"Do pass",10,5,2,0,17
965526,675575,2017-09-11,Assembly,"SB 511 Stern Senate Third Reading By MULLIN",55,20,4,0,79
965526,774566,2017-08-23,Assembly,"eaders=""noes 08/23/17"" class=""columnField"" style=""text-align:left"">",5,5,2,0,12
965527,633108,2017-04-26,Assembly,"Do pass as amended and be re-referred to the Committee on [Appropriations]",7,0,0,0,7
965527,649374,2017-05-24,Assembly,"Do pass. To Consent Calendar",17,0,0,0,17
965527,654431,2017-05-30,Assembly,"AB 1086 DALY Consent Calendar Second Day Regular Session",77,0,3,0,80
965527,666145,2017-06-20,Senate,"Do pass, but first be re-referred to the Committee on [Appropriations]",12,0,1,0,13
965527,672718,2017-07-17,Senate,"Assembly 3rd Reading AB1086 Daly et al. By Wiener",40,0,0,0,40
965527,673763,2017-08-21,Assembly,"AB 1086 DALY Concurrence in Senate Amendments",76,0,3,0,79
965528,637536,2017-05-03,Senate,"Do pass",8,0,1,0,9
965528,640710,2017-05-08,Senate,"Senate 3rd Reading SB512 Hernandez et al",38,0,2,0,40
965528,666300,2017-06-20,Assembly,"Do pass as amended and be re-referred to the Committee on [Business and Professions]",15,0,0,0,15
965528,672141,2017-07-11,Assembly,"Do pass as amended and be re-referred to the Committee on [Appropriations]",16,0,0,0,16
965528,674022,2017-08-23,Assembly,"Do pass. To Consent Calendar",15,0,2,0,17
965528,674271,2017-08-31,Assembly,"SB 512 Hernandez Consent Calendar Second Day Regular Session",73,0,6,0,79
965528,675031,2017-09-06,Senate,"That the Assembly amendments be concurred in",9,0,0,0,9
965528,676091,2017-09-14,Senate,"Special Consent SB512 Hernandez et al",40,0,0,0,40
965529,615023,2017-03-29,Senate,"Do pass, but first be re-referred to the Committee on [Appropriations] with the recommendation: To Consent Calendar",7,0,0,0,7
965529,626745,2017-04-17,Senate,"Placed on suspense file",7,0,0,0,7
965529,650743,2017-05-25,Senate,"Do pass as amended",7,0,0,0,7
965529,655945,2017-05-31,Senate,"Senate 3rd Reading SB544 McGuire",40,0,0,0,40
965529,672618,2017-07-12,Assembly,"Do pass. To Consent Calendar",7,0,0,0,7
965529,673003,2017-07-20,Assembly,"SB 544 McGuire Consent Calendar Second Day Regular Session",67,0,12,0,79
965529,674023,2017-08-23,Senate,"That the Assembly amendments be concurred in",5,0,2,0,7
965529,674399,2017-08-31,Senate,"Special Consent Calendar # SB544",37,0,3,0,40
965530,615726,2017-03-28,Senate,"Do pass, but first be re-referred to the Committee on [Judiciary]",7,0,0,0,7
965530,628286,2017-04-18,Senate,"Do pass as amended, but first amend, and re-refer to the Committee on [Appropriations]",7,0,0,0,7
965530,644621,2017-05-15,Senate,"Placed on suspense file",7,0,0,0,7
965530,650883,2017-05-25,Senate,"Do pass",7,0,0,0,7
965530,656085,2017-05-31,Senate,"Special Consent Calendar # SB485",40,0,0,0,40
965530,769093,2018-06-26,Assembly,"Do pass and be re-referred to the Committee on [Appropriations]",9,0,1,0,10
965531,610067,2017-03-21,Assembly,"Do pass as amended, and be re-referred to the Committee on [Appropriations] with recommendation: To Consent Calendar",7,0,0,0,7
965531,643104,2017-05-10,Assembly,"Do pass. To Consent Calendar",17,0,0,0,17
965531,646459,2017-05-18,Assembly,"AB 1021 BAKER Consent Calendar Second Day Regular Session",69,0,11,0,80
965531,662855,2017-06-13,Senate,"Do pass, but first be re-referred to the Committee on [Appropriations]",4,0,1,0,5
965531,672793,2017-07-17,Senate,"Assembly 3rd Reading AB1021 Baker et al. By Wiener",40,0,0,0,40
965533,633479,2017-04-26,Assembly,"Do pass and be re-referred to the Committee on [Appropriations]",1,5,1,0,7
965535,619703,2017-04-05,Assembly,"Do pass and be re-referred to the Committee on [Water, Parks, and Wildlife]",10,3,0,0,13
965535,631881,2017-04-25,Assembly,"Do pass and be re-referred to the Committee on [Appropriations]",9,4,2,0,15
965535,651690,2017-05-26,Assembly,"Do pass as amended",12,5,0,0,17
965535,655799,2017-05-31,Assembly,"AB 1083 BURKE Assembly Third Reading",52,19,9,0,80
965535,671869,2017-07-10,Senate,"Do pass, but first be re-referred to the Committee on [Natural Resources and Water]",9,2,0,0,11
965535,672016,2017-07-11,Senate,"Do pass as amended, but first amend, and re-refer to the Committee on [Appropriations]",6,1,2,0,9
965535,673911,2017-08-21,Senate,"Placed on suspense file",7,0,0,0,7
965535,674511,2017-09-01,Senate,"Do pass as amended",5,2,0,0,7
965535,675664,2017-09-12,Senate,"Assembly 3rd Reading AB1083 Burke et al. By Bradford",28,10,2,0,40
965535,676319,2017-09-14,Assembly,"AB 1083 BURKE Concurrence in Senate Amendments",55,22,2,0,79
965537,627078,2017-04-18,Assembly,"Do pass and be re-referred to the Committee on [Education]",14,0,1,0,15
965537,634641,2017-04-26,Assembly,"Do pass as amended and be re-referred to the Committee on [Appropriations]",7,0,0,0,7
965540,626945,2017-04-18,Senate,"Do pass as amended, but first amend, and re-refer to the Committee on [Appropriations]",10,1,0,0,11
965540,647807,2017-05-22,Senate,"Placed on suspense file",7,0,0,0,7
965540,650699,2017-05-25,Senate,"Do pass as amended",5,1,1,0,7
965540,656193,2017-05-31,Senate,"Senate 3rd Reading SB518 De León et al",31,8,1,0,40
965540,752086,2018-05-10,Assembly,"Be re-referred to the Committee on [Water, Parks, and Wildlife]",9,0,2,0,11
965540,762213,2018-06-12,Assembly,"Do pass and be re-referred to the Committee on [Appropriations]",15,0,0,0,15
965540,771570,2018-08-16,Assembly,"Do pass",17,0,0,0,17
965540,775018,2017-05-25,Senate,"Do passtle=""No Votes Recorded"">No Votes Recorded:",7,0,1,0,8
965541,621233,2017-04-05,Assembly,"Do pass as amended and be re-referred to the Committee on [Appropriations]",5,1,1,0,7
965541,651531,2017-05-26,Assembly,"Do pass",13,4,0,0,17
965541,655917,2017-05-31,Assembly,"AB 952 REYES Assembly Third Reading",63,11,6,0,80
965541,671401,2017-07-05,Senate,"Do pass, but first be re-referred to the Committee on [Appropriations]",6,0,1,0,7
965541,672803,2017-07-17,Senate,"Placed on suspense file",7,0,0,0,7
965541,674496,2017-09-01,Senate,"Do pass as amended",7,0,0,0,7
965541,675319,2017-09-11,Senate,"Assembly 3rd Reading AB952 Reyes By Lara",38,2,0,0,40
965541,676003,2017-09-13,Assembly,"AB 952 REYES Concurrence in Senate Amendments",79,0,0,0,79
965542,619740,2017-04-05,Senate,"Do pass, but first be re-referred to the Committee on [Appropriations]",7,0,0,0,7
965542,630704,2017-04-24,Senate,"Placed on suspense file",7,0,0,0,7
965542,650501,2017-05-25,Senate,"Do pass as amended",7,0,0,0,7
965542,655938,2017-05-31,Senate,"Senate 3rd Reading SB463 Lara et al",40,0,0,0,40
965543,613615,2017-03-28,Senate,"Do pass, but first be re-referred to the Committee on [Appropriations]",7,1,1,0,9
965543,626566,2017-04-17,Senate,"Placed on suspense file",7,0,0,0,7
965543,650504,2017-05-25,Senate,"Do pass as amended",5,2,0,0,7
965543,656254,2017-05-31,Senate,"Senate 3rd Reading SB473 Hertzberg",28,11,1,0,40
965543,672137,2017-07-11,Assembly,"Do pass and be re-referred to the Committee on [Appropriations]",8,6,1,0,15
965543,674691,2017-09-01,Assembly,"Do pass as amended",11,5,1,0,17
965543,772506,2018-08-23,Assembly,"SB 473 Hertzberg Senate Third Reading By AGUIAR-CURRY",50,25,5,0,80
965543,772680,2018-08-24,Senate,"Unfinished Business SB473 Hertzberg Concurrence",26,10,4,0,40
965544,632826,2017-04-25,Senate,"Do pass as amended, but first amend, and re-refer to the Committee on [Rules]",7,2,0,0,9
965544,656786,2017-06-01,Senate,"Senate 3rd Reading SB465 Jackson et al",21,14,5,0,40
965544,672110,2017-07-10,Assembly,"Do pass as amended and be re-referred to the Committee on [Appropriations]",8,2,0,0,10
965544,674675,2017-09-01,Assembly,"Do pass",10,6,1,0,17
965544,772538,2018-08-23,Assembly,"SB 465 Jackson Senate Third Reading Amend By LIMÓN Set #1",49,25,6,0,80
965544,773105,2018-08-28,Assembly,"Do pass and be re-referred to the Committee on [Appropriations]",6,3,0,0,9
965544,773462,2018-08-29,Assembly,"Do pass",11,5,1,0,17
965544,773964,2018-08-31,Senate,"That the Assembly amendments be concurred in",6,1,0,0,7
965544,774214,2018-08-31,Senate,"Unfinished Business SB465 Jackson et al. Concurrence",25,12,3,0,40
965544,774215,2018-08-31,Assembly,"SB 465 Jackson Senate Third Reading By AGUIAR-CURRY",44,31,5,0,80
965545,619974,2017-04-05,Senate,"Do pass as amended, but first amend, and re-refer to the Committee on [Education] with the recommendation: To Consent Calendar",9,0,0,0,9
965545,633239,2017-04-26,Senate,"Do pass, but first be re-referred to the Committee on [Appropriations] with the recommendation: To Consent Calendar",7,0,0,0,7
965545,644372,2017-05-15,Senate,"Consent Calendar 2nd SB557",39,0,1,0,40
965545,666332,2017-06-20,Assembly,"Do pass as amended and be re-referred to the Committee on [Education]",15,0,0,0,15
965545,672590,2017-07-12,Assembly,"Do pass and be re-referred to the Committee on [Appropriations] with recommendation: To Consent Calendar",7,0,0,0,7
965545,674018,2017-08-23,Assembly,"Do pass. To Consent Calendar",15,0,2,0,17
965545,674294,2017-08-31,Assembly,"SB 557 Hernandez Consent Calendar Second Day Regular Session",73,0,6,0,79
965545,674942,2017-09-05,Senate,"Special Consent SB557",40,0,0,0,40
965546,608567,2017-03-21,Senate,"Do pass as amended, but first amend, and re-refer to the Committee on [Appropriations]",11,0,0,0,11
965546,629041,2017-04-20,Senate,"Senate 3rd Reading SB549 Bradford",40,0,0,0,40
965546,667138,2017-06-21,Assembly,"Do pass as amended and be re-referred to the Committee on [Appropriations]",14,0,1,0,15
965546,672847,2017-07-19,Assembly,"Do pass as amended",16,0,1,0,17
965546,674324,2017-08-31,Assembly,"SB 549 Bradford Senate Third Reading By IRWIN",76,0,3,0,79
965546,674916,2017-09-05,Senate,"Special Consent SB549",40,0,0,0,40
965547,619950,2017-04-04,Assembly,"Do pass and be re-referred to the Committee on [Appropriations]",7,0,0,0,7
965547,633366,2017-04-26,Assembly,"Do pass",16,0,1,0,17
965547,655983,2017-05-31,Assembly,"AB 940 WEBER Assembly Third Reading",75,0,5,0,80
965547,672629,2017-07-12,Senate,"Do pass as amended, but first amend, and re-refer to the Committee on [Appropriations]",8,0,1,0,9
965547,674285,2017-08-31,Senate,"Assembly 3rd Reading AB940 Weber By Pan",38,0,2,0,40
965547,674880,2017-09-05,Assembly,"AB 940 WEBER Concurrence in Senate Amendments",75,0,4,0,79
965549,637872,2017-05-03,Assembly,"Do pass. To Consent Calendar",7,0,0,0,7
965549,643579,2017-05-11,Assembly,"AB 995 LIMÓN Consent Calendar Second Day Regular Session",77,0,3,0,80
965549,661637,2017-06-12,Senate,"Do pass and be ordered to the Consent Calendar",5,0,0,0,5
965549,665062,2017-06-19,Senate,"Consent Calendar 2nd AB995 Limón",33,0,7,0,40
965550,642692,2017-05-10,Assembly,"Do pass as amended",7,0,0,0,7
965550,651574,2017-05-26,Assembly,"AB 894 FRAZIER Assembly Third Reading",76,0,4,0,80
965550,666985,2017-06-20,Senate,"Do pass, but first be re-referred to the Committee on [Public Safety]",5,0,0,0,5
965550,672228,2017-07-11,Senate,"Do pass as amended",7,0,0,0,7
965550,675119,2017-09-07,Senate,"Assembly 3rd Reading AB894 Frazier By Bradford",38,1,1,0,40
965550,675360,2017-09-11,Assembly,"AB 894 FRAZIER Concurrence in Senate Amendments",77,0,2,0,79
965551,613239,2017-03-27,Senate,"Do pass as amended, but first amend, and re-refer to the Committee on [Judiciary]",9,0,0,0,9
965551,628056,2017-04-18,Senate,"Do pass as amended, but first amend, and re-refer to the Committee on [Appropriations] with the recommendation: To Consent Calendar",7,0,0,0,7
965551,644420,2017-05-15,Senate,"Senate 3rd Reading SB486 Monning et al",39,0,1,0,40
965551,666899,2017-06-20,Assembly,"Do pass and be re-referred to the Committee on [Judiciary]",15,0,1,0,16
965551,672212,2017-07-11,Assembly,"Do pass and be re-referred to the Committee on [Appropriations] with recommendation: To Consent Calendar",11,0,0,0,11
965551,674042,2017-08-23,Assembly,"Do pass. To Consent Calendar",15,0,2,0,17
965551,674418,2017-08-31,Assembly,"SB 486 Monning Consent Calendar Second Day Regular Session",73,0,6,0,79
965552,612895,2017-03-27,Senate,"Do pass",9,0,0,0,9
965552,625988,2017-04-17,Senate,"Do pass",6,1,0,0,7
965552,625989,2017-04-17,Senate,"Senate 3rd Reading SB496 Cannella et al",34,2,4,0,40
965552,630285,2017-04-24,Assembly,"SB 496 Cannella Senate Third Reading By GRAY",47,15,18,0,80
965553,627004,2017-04-17,Assembly,"Do pass as amended and be re-referred to the Committee on [Appropriations]",7,0,3,0,10
965554,613977,2017-03-28,Senate,"Do pass, but first be re-referred to the Committee on [Appropriations] with the recommendation: To Consent Calendar",11,0,2,0,13
965554,629133,2017-04-20,Senate,"Consent Calendar 2nd SB495",36,0,4,0,40
965554,742415,2018-04-23,Assembly,"Be re-referred to the Committee on [Water, Parks, and Wildlife]",8,0,3,0,11
965554,762284,2018-06-12,Assembly,"Do pass and be re-referred to the Committee on [Appropriations]",15,0,0,0,15
965554,769062,2018-06-27,Assembly,"Do pass as amended. To Consent Calendar",16,0,1,0,17
965554,769792,2018-07-05,Assembly,"SB 495 Vidak Consent Calendar Second Day Regular Session",69,0,11,0,80
965554,770976,2018-08-07,Senate,"That the Assembly amendments be concurred in",9,0,0,0,9
965554,771153,2018-08-09,Senate,"Unfinished Business SB495 Vidak et al. Urgency Clause Concurrence",37,0,2,0,39
965556,617537,2017-04-03,Assembly,"Do pass and be re-referred to the Committee on [Appropriations]",13,0,1,0,14
965556,634069,2017-04-26,Assembly,"Do pass. To Consent Calendar",16,0,1,0,17
965556,638433,2017-05-04,Assembly,"AB 1027 ACOSTA Consent Calendar Second Day Regular Session",76,0,4,0,80
965556,659414,2017-06-06,Senate,"Do pass, but first be re-referred to the Committee on [Appropriations]",13,0,0,0,13
965556,673960,2017-08-21,Senate,"Assembly 3rd Reading AB1027 Acosta et al. By Wilk",39,0,1,0,40
965557,610935,2017-03-21,Assembly,"Do pass as amended and be re-referred to the Committee on [Appropriations]",7,0,0,0,7
965557,652155,2017-05-26,Assembly,"Do pass as amended",16,0,1,0,17
965557,655798,2017-05-31,Assembly,"AB 992 ARAMBULA Assembly Third Reading",77,0,3,0,80
965559,662757,2017-06-13,Senate,"Do pass as amended, but first amend, and re-refer to the Committee on [Appropriations]",9,0,0,0,9
965559,671844,2017-07-10,Senate,"Do pass",7,0,0,0,7
965559,672711,2017-07-17,Senate,"Senate 3rd Reading SB507 Hueso et al. Urgency Clause",39,0,1,0,40
965559,674000,2017-08-22,Assembly,"Do pass and be re-referred to the Committee on [Environmental Safety and Toxic Materials]",12,0,3,0,15
965559,674223,2017-08-29,Assembly,"Do pass and be re-referred to the Committee on [Appropriations]",6,0,1,0,7
965559,674743,2017-09-01,Assembly,"Do pass",16,0,1,0,17
965559,675107,2017-09-07,Assembly,"SB 507 Hueso Third Reading Urgency By GLORIA",79,0,0,0,79
965559,676180,2017-09-14,Senate,"Special Consent Calendar SB507 Hueso et al. Urgency Clause",40,0,0,0,40
965560,684734,2018-01-09,Assembly,"Do pass as amended, and be re-referred to the Committee on [Appropriations] with recommendation: To Consent Calendar",7,0,0,0,7
965560,686217,2018-01-18,Assembly,"Do pass",17,0,0,0,17
965560,690101,2018-01-29,Assembly,"AB 991 REYES Assembly Third Reading",77,0,0,0,77
965560,763024,2018-06-12,Senate,"Do pass as amended, but first amend, and re-refer to the Committee on [Appropriations]",6,0,1,0,7
965562,618672,2017-04-03,Assembly,"Do pass as amended and be re-referred to the Committee on [Appropriations]",10,0,0,0,10
965562,633367,2017-04-26,Assembly,"Do pass. To Consent Calendar",16,0,1,0,17
965562,638589,2017-05-04,Assembly,"AB 906 BLOOM Consent Calendar Second Day Regular Session",76,0,4,0,80
965562,667271,2017-06-21,Senate,"Do pass, but first be re-referred to the Committee on [Appropriations]",5,1,1,0,7
965562,674199,2017-08-28,Senate,"Placed on suspense file",7,0,0,0,7
965562,674458,2017-09-01,Senate,"Do pass",6,0,1,0,7
965562,675048,2017-09-06,Senate,"Assembly 3rd Reading AB906 Bloom By Skinner",28,9,3,0,40
965562,675336,2017-09-11,Assembly,"AB 906 BLOOM Concurrence in Senate Amendments",78,0,1,0,79
965563,634656,2017-04-26,Assembly,"Do pass and be re-referred to the Committee on [Appropriations]",12,0,1,0,13
965563,649427,2017-05-24,Assembly,"Do pass",16,0,1,0,17
965563,654262,2017-05-30,Assembly,"AB 1069 LOW Assembly Third Reading",75,1,4,0,80
965563,671293,2017-07-05,Senate,"Do pass, but first be re-referred to the Committee on [Transportation and Housing]",7,0,0,0,7
965563,672124,2017-07-11,Senate,"Do pass, but first be re-referred to the Committee on [Appropriations]",11,0,2,0,13
965563,674201,2017-08-28,Senate,"Do pass",6,0,1,0,7
965563,675792,2017-09-13,Senate,"Assembly 3rd Reading AB1069 Low By McGuire",39,0,1,0,40
965563,676128,2017-09-14,Assembly,"With recommendation: That Senate amendments be concurred in",12,0,1,0,13
965563,676541,2017-09-15,Assembly,"AB 1069 LOW Concurrence in Senate Amendments",75,0,4,0,79
965564,613903,2017-03-28,Assembly,"Do pass and be re-referred to the Committee on [Accountability and Administrative Review] with recommendation: To Consent Calendar",7,0,0,0,7
965564,633446,2017-04-26,Assembly,"Do pass and be re-referred to the Committee on [Appropriations] with recommendation: To Consent Calendar",7,0,0,0,7
965564,643170,2017-05-10,Assembly,"Do pass. To Consent Calendar",17,0,0,0,17
965564,646608,2017-05-18,Assembly,"AB 961 QUIRK-SILVA Consent Calendar Second Day Regular Session",69,0,11,0,80
965564,668972,2017-06-27,Senate,"Do pass, but first be re-referred to the Committee on [Appropriations]",7,0,0,0,7
965564,672012,2017-07-10,Senate,"Placed on suspense file",7,0,0,0,7
965564,674703,2017-09-01,Senate,"Do pass",7,0,0,0,7
965564,675409,2017-09-11,Senate,"Assembly 3rd Reading AB961 Quirk-Silva et al. By Newman",40,0,0,0,40
965564,675882,2017-09-13,Assembly,"AB 961 QUIRK-SILVA Concurrence in Senate Amendments",77,0,2,0,79
965565,615716,2017-03-29,Assembly,"Do pass and be re-referred to the Committee on [Appropriations] with recommendation: To Consent Calendar",20,0,1,0,21
965565,637519,2017-05-03,Assembly,"Do pass. To Consent Calendar",16,0,1,0,17
965565,643656,2017-05-11,Assembly,"AB 981 GRAY Consent Calendar Second Day Regular Session",77,0,3,0,80
965565,662512,2017-06-13,Senate,"Do pass, but first be re-referred to the Committee on [Appropriations] with the recommendation: To Consent Calendar",12,0,1,0,13
965566,634359,2017-04-26,Assembly,"Do pass and be re-referred to the Committee on [Appropriations]",4,1,2,0,7
965567,620098,2017-04-04,Senate,"Do pass, but first be re-referred to the Committee on [Governance and Finance]",9,0,4,0,13
965567,620099,2017-04-05,Senate,"Do pass as amended, but first amend, and re-refer to the Committee on [Environmental Quality]",7,0,0,0,7
965567,627960,2017-04-19,Senate,"Do pass, but first be re-referred to the Committee on [Appropriations]",6,0,1,0,7
965567,644446,2017-05-15,Senate,"Placed on suspense file",7,0,0,0,7
965567,650588,2017-05-25,Senate,"Do pass",6,1,0,0,7
965567,656795,2017-06-01,Senate,"Senate 3rd Reading SB540 Roth et al",33,7,0,0,40
965567,670287,2017-06-28,Assembly,"Do pass and be re-referred to the Committee on [Natural Resources]",9,0,0,0,9
965567,672052,2017-07-10,Assembly,"Do pass and be re-referred to the Committee on [Appropriations]",9,0,1,0,10
965567,676380,2017-09-14,Assembly,"SB 540 Roth Senate Third Reading By CHIU",70,8,1,0,79
965567,676524,2017-09-15,Senate,"Unfinished Business SB540 Roth et al. Concurrence",29,7,4,0,40
965568,683966,2018-01-04,Assembly,"Be re-referred to the Committee on [Business and Professions]",9,0,2,0,11
965568,684729,2018-01-09,Assembly,"Do pass and be re-referred to the Committee on [Appropriations]",15,0,1,0,16
965568,686154,2018-01-18,Assembly,"Do pass. To Consent Calendar",17,0,0,0,17
965568,690042,2018-01-29,Assembly,"AB 888 LOW Consent Calendar Second Day Regular Session",75,0,2,0,77
965568,768276,2018-06-26,Senate,"Do pass as amended, but first amend, and re-refer to the Committee on [Appropriations]",13,0,0,0,13
965568,770560,2018-08-06,Senate,"Placed on suspense file",7,0,0,0,7
965568,771611,2018-08-16,Senate,"Do pass as amended",7,0,0,0,7
965568,774235,2018-08-31,Assembly,"With recommendation: That Senate amendments be concurred in",14,2,4,0,20
965568,774236,2018-08-31,Senate,"Assembly 3rd Reading AB888 Low et al. By Wiener Urgency Clause",32,3,5,0,40
965568,774237,2018-08-31,Assembly,"AB 888 Low Concurrence - Urgency Added",61,11,8,0,80
965569,626982,2017-04-18,Assembly,"Do pass and be re-referred to the Committee on [Revenue and Taxation]",9,1,6,0,16
965569,631747,2017-04-24,Assembly,"Do pass and be re-referred to the Committee on [Appropriations]",7,2,1,0,10
965569,651902,2017-05-26,Assembly,"Do pass as amended",11,3,3,0,17
965574,616130,2017-03-29,Assembly,"Do pass and be re-referred to the Committee on [Appropriations]",6,1,0,0,7
965574,651810,2017-05-26,Assembly,"Do pass",12,5,0,0,17
965574,656821,2017-06-01,Assembly,"AB 1066 AGUIAR-CURRY Assembly Third Reading",51,24,5,0,80
965574,672347,2017-07-12,Senate,"Do pass, but first be re-referred to the Committee on [Appropriations]",4,1,0,0,5
965574,675855,2017-09-13,Senate,"Assembly 3rd Reading AB1066 Aguiar-Curry By Hill",27,12,1,0,40
965574,676453,2017-09-15,Assembly,"AB 1066 AGUIAR-CURRY Concurrence in Senate Amendments",53,25,1,0,79
965575,629326,2017-04-19,Senate,"Do pass as amended, but first amend, and re-refer to the Committee on [Appropriations]",7,1,1,0,9
965575,645014,2017-05-15,Senate,"Placed on suspense file",7,0,0,0,7
965575,650815,2017-05-25,Senate,"Do pass",6,0,1,0,7
965575,654587,2017-05-30,Senate,"Senate 3rd Reading SB523 Hernandez et al. Urgency Clause",38,1,1,0,40
965575,672266,2017-07-11,Assembly,"Do pass and be re-referred to the Committee on [Appropriations]",15,0,0,0,15
965575,674626,2017-09-01,Assembly,"Do pass",15,1,1,0,17
965575,675201,2017-09-07,Assembly,"SB 523 Hernandez Third Reading Urgency By BIGELOW",72,4,3,0,79
965575,675508,2017-09-11,Senate,"Unfinished Business SB523 Hernandez et al. Urgency Clause Concurrence",37,2,1,0,40
965577,613746,2017-03-28,Assembly,"Do pass and be re-referred to the Committee on [Appropriations]",3,6,2,0,11
965577,613747,2017-03-28,Assembly,Reconsideration,11,0,0,0,11
965579,627867,2017-04-18,Assembly,"Do pass and be re-referred to the Committee on [Appropriations]",9,3,1,0,13
965580,627995,2017-04-19,Assembly,"Do pass and be re-referred to the Committee on [Judiciary]",5,2,0,0,7
965580,632042,2017-04-25,Assembly,"Do pass as amended and be re-referred to the Committee on [Appropriations]",11,0,0,0,11
965580,642675,2017-05-10,Assembly,"Do pass",16,0,1,0,17
965580,647838,2017-05-22,Assembly,"AB 1017 SANTIAGO Assembly Third Reading",74,2,4,0,80
965580,662032,2017-06-12,Senate,"Do pass, but first be re-referred to the Committee on [Judiciary]",4,0,1,0,5
965580,669938,2017-06-27,Senate,"Do pass as amended, but first amend, and re-refer to the Committee on [Appropriations]",6,0,1,0,7
965580,672798,2017-07-17,Senate,"Placed on suspense file",7,0,0,0,7
965580,674702,2017-09-01,Senate,"Do pass",7,0,0,0,7
965580,676080,2017-09-14,Senate,"Special Consent Calendar # AB1017",40,0,0,0,40
965581,615083,2017-03-29,Senate,"Do pass, but first be re-referred to the Committee on [Appropriations]",7,0,0,0,7
965581,626328,2017-04-17,Senate,"Placed on suspense file",7,0,0,0,7
965581,650704,2017-05-25,Senate,"Do pass",7,0,0,0,7
965581,656051,2017-05-31,Senate,"Special Consent Calendar # SB527",40,0,0,0,40
965581,672561,2017-07-12,Assembly,"Do pass and be re-referred to the Committee on [Appropriations] with recommendation: To Consent Calendar",7,0,0,0,7
965581,674447,2017-09-01,Assembly,"Do pass",16,0,1,0,17
965581,675128,2017-09-07,Assembly,"SB 527 Galgiani Senate Third Reading By CERVANTES",77,0,2,0,79
965581,676268,2017-09-14,Senate,"Special Consent Calendar SB527",40,0,0,0,40
965582,631869,2017-04-25,Assembly,"Do pass and be re-referred to the Committee on [Appropriations] with recommendation: To Consent Calendar",11,0,0,0,11
965582,642584,2017-05-10,Assembly,"Do pass. To Consent Calendar",17,0,0,0,17
965582,646418,2017-05-18,Assembly,"AB 953 BAKER Consent Calendar Second Day Regular Session",69,0,11,0,80
965582,669757,2017-06-27,Senate,"Do pass, but first be re-referred to the Committee on [Appropriations]",6,0,1,0,7
965582,672784,2017-07-17,Senate,"Placed on suspense file",7,0,0,0,7
965582,674554,2017-09-01,Senate,"Do pass as amended",7,0,0,0,7
965582,675162,2017-09-07,Senate,"Assembly 3rd Reading AB953 Baker et al. By Leyva",39,0,1,0,40
965582,675446,2017-09-11,Assembly,"AB 953 BAKER Concurrence in Senate Amendments",78,0,1,0,79
965583,626059,2017-04-17,Senate,"Do pass",7,0,0,0,7
965583,630450,2017-04-24,Senate,"Senate 3rd Reading SB535 Lara Urgency Clause",30,6,4,0,40
965583,645930,2017-05-17,Assembly,"Do pass",17,0,0,0,17
965583,648015,2017-05-22,Assembly,"SB 535 Lara Third Reading Urgency By GONZALEZ FLETCHER",76,1,3,0,80
965585,631852,2017-04-25,Assembly,"Do pass as amended and be re-referred to the Committee on [Appropriations]",14,1,1,0,16
965585,651887,2017-05-26,Assembly,"Do pass as amended",14,1,2,0,17
965585,655840,2017-05-31,Assembly,"AB 967 GLORIA Assembly Third Reading",71,3,6,0,80
965585,669113,2017-06-26,Senate,"Do pass as amended, but first amend, and re-refer to the Committee on [Environmental Quality]",9,0,0,0,9
965585,671361,2017-07-05,Senate,"Do pass as amended, but first amend, and re-refer to the Committee on [Appropriations]",7,0,0,0,7
965585,673891,2017-08-21,Senate,"Do pass",5,1,1,0,7
965585,676428,2017-09-15,Senate,"Assembly 3rd Reading AB967 Gloria By Hill",32,5,3,0,40
965585,676429,2017-09-16,Assembly,"AB 967 GLORIA Concurrence in Senate Amendments",67,6,6,0,79
965585,774567,2017-07-05,Senate,Noes:,9,0,0,0,9
965586,633295,2017-04-26,Assembly,"Do pass and be re-referred to the Committee on [Appropriations]",7,6,2,0,15
965587,627910,2017-04-19,Senate,"Do pass as amended, but first amend, and re-refer to the Committee on [Appropriations]",7,0,0,0,7
965587,644280,2017-05-15,Senate,"Placed on suspense file",7,0,0,0,7
965587,650430,2017-05-25,Senate,"Do pass",5,2,0,0,7
965587,654191,2017-05-30,Senate,"Senate 3rd Reading SB539 De León et al",39,0,1,0,40
965587,758600,2018-05-31,Assembly,"Be re-referred to the Committee on [Revenue and Taxation]",7,0,4,0,11
965587,769679,2018-07-02,Assembly,"Do pass and be re-referred to the Committee on [Appropriations]",6,0,4,0,10
965587,771553,2018-08-16,Assembly,"Do pass as amended",11,1,5,0,17
965587,772906,2018-08-27,Assembly,"Do pass",12,0,1,0,13
965587,773960,2018-08-31,Senate,"That the Assembly amendments be concurred in",6,0,1,0,7
965587,774118,2018-08-31,Senate,"Unfinished Business SB539 De León et al. Concurrence",37,1,2,0,40
965587,774119,2018-08-31,Assembly,"SB 539 De León Senate Third Reading By QUIRK-SILVA",70,1,9,0,80
965588,613636,2017-03-28,Assembly,"Do pass as amended. To Consent Calendar",11,0,0,0,11
965588,621350,2017-04-06,Assembly,"AB 929 RUBIO Consent Calendar Second Day",77,0,3,0,80
965588,769684,2018-07-03,Senate,"Do pass as amended, and be ordered to the Consent Calendar",7,0,0,0,7
965588,771292,2018-08-13,Senate,"Consent Calendar AB929",37,0,3,0,40
965588,772197,2018-08-20,Assembly,"AB 929 RUBIO Concurrence in Senate Amendments",80,0,0,0,80
965591,618799,2017-04-04,Senate,"Do pass, but first be re-referred to the Committee on [Appropriations]",8,3,0,0,11
965591,626290,2017-04-17,Senate,"Placed on suspense file",7,0,0,0,7
965591,650645,2017-05-25,Senate,"Do pass as amended",5,2,0,0,7
965591,656778,2017-06-01,Senate,"Senate 3rd Reading SB520 Mitchell",23,12,5,0,40
965591,672373,2017-07-12,Assembly,"Do pass as amended and be re-referred to the Committee on [Appropriations]",10,5,0,0,15
965591,777393,2017-04-17,Senate,"Placed on suspense filtr>",8,3,0,0,11
965594,626952,2017-04-18,Senate,"Do pass, but first be re-referred to the Committee on [Appropriations] with the recommendation: To Consent Calendar",7,0,0,0,7
965594,635808,2017-05-01,Senate,"Placed on suspense file",7,0,0,0,7
965594,650567,2017-05-25,Senate,"Do pass",6,1,0,0,7
965594,654421,2017-05-30,Senate,"Senate 3rd Reading SB502 Portantino",40,0,0,0,40
965594,740722,2018-04-16,Assembly,"Be re-referred to the Committees on [Transportation] and [Judiciary]",9,0,2,0,11
965594,761681,2018-06-11,Assembly,"Do pass and be re-referred to the Committee on [Judiciary] with recommendation: To Consent Calendar",14,0,0,0,14
965594,765185,2018-06-19,Assembly,"Do pass as amended, and be re-referred to the Committee on [Appropriations] with recommendation: To Consent Calendar",10,0,0,0,10
965594,771573,2018-08-16,Assembly,"Do pass",17,0,0,0,17
965594,772572,2018-08-23,Assembly,"Do pass",9,1,4,0,14
965594,773970,2018-08-31,Senate,"That the Assembly amendments be concurred in",12,0,1,0,13
965594,774233,2018-08-31,Senate,"Unfinished Business SB502 Portantino et al. Concurrence",39,0,1,0,40
965594,774234,2018-08-31,Assembly,"SB 502 Portantino Senate Third Reading By FRAZIER",80,0,0,0,80
965594,774585,2018-08-23,Assembly,,17,0,4,0,21
965595,632930,2017-04-25,Assembly,"Do pass and be re-referred to the Committee on [Appropriations] with recommendation: To Consent Calendar",15,0,0,0,15
965595,637534,2017-05-03,Assembly,"Do pass. To Consent Calendar",16,0,1,0,17
965595,643625,2017-05-11,Assembly,"AB 931 MCCARTY Consent Calendar Second Day Regular Session",77,0,3,0,80
965595,765155,2018-06-19,Senate,"Do pass as amended, but first amend, and re-refer to the Committee on [Appropriations]",5,2,0,0,7
965595,770517,2018-08-06,Senate,"Placed on suspense file",7,0,0,0,7
965596,633392,2017-04-26,Senate,"Do pass as amended, but first amend, and re-refer to the Committee on [Appropriations] with the recommendation: To Consent Calendar",7,0,0,0,7
965596,654465,2017-05-30,Senate,"Senate 3rd Reading SB468 Leyva",40,0,0,0,40
965596,667125,2017-06-21,Assembly,"Do pass and be re-referred to the Committee on [Appropriations] with recommendation: To Consent Calendar",6,0,1,0,7
965596,669849,2017-06-28,Assembly,"Do pass. To Consent Calendar",14,0,3,0,17
965596,674148,2017-08-24,Assembly,"SB 468 Leyva Senate Third Reading By THURMOND",75,1,3,0,79
965596,674411,2017-08-31,Senate,"Special Consent Calendar # SB468",37,0,3,0,40
965597,637250,2017-05-03,Assembly,"Do pass",20,0,1,0,21
965597,644528,2017-05-15,Assembly,"AB 1067 GRAY Assembly Third Reading",74,0,6,0,80
965597,662324,2017-06-13,Senate,"Do pass and be ordered to the Consent Calendar",12,0,1,0,13
965597,665150,2017-06-19,Senate,"Consent Calendar 2nd AB1067",33,0,7,0,40
965600,615289,2017-03-29,Senate,"Do pass as amended, but first amend, and re-refer to the Committee on [Appropriations] with the recommendation: To Consent Calendar",7,0,0,0,7
965600,626743,2017-04-17,Senate,"Placed on suspense file",7,0,0,0,7
965601,685052,2018-01-11,Assembly,"Do pass and be re-referred to the Committee on [Appropriations]",2,0,5,0,7
965604,618621,2017-04-03,Assembly,"Do pass and be re-referred to the Committee on [Appropriations] with recommendation: To Consent Calendar",10,0,0,0,10
965604,634023,2017-04-26,Assembly,"Do pass. To Consent Calendar",16,0,1,0,17
965604,638705,2017-05-04,Assembly,"AB 1036 MCCARTY Consent Calendar Second Day Regular Session",76,0,4,0,80
965606,613477,2017-03-28,Assembly,"Do pass as amended",5,2,0,0,7
965606,654523,2017-05-30,Assembly,"AB 878 GIPSON Assembly Third Reading",41,30,9,0,80
965606,668950,2017-06-27,Senate,"Do pass",5,2,0,0,7
965606,675364,2017-09-11,Senate,"Assembly 3rd Reading AB878 Gipson By Jackson",21,14,5,0,40
965606,675766,2017-09-13,Assembly,"AB 878 GIPSON Concurrence in Senate Amendments",43,31,5,0,79
965607,643327,2017-05-09,Senate,"Do pass and be ordered to the Consent Calendar",7,0,0,0,7
965607,648010,2017-05-22,Senate,"Consent Calendar 2nd SB543",37,0,3,0,40
965607,662443,2017-06-13,Assembly,"Do pass. To Consent Calendar",11,0,0,0,11
965607,665169,2017-06-19,Assembly,"SB 543 Morrell Consent Calendar Second Day Regular Session",74,0,6,0,80
965608,615462,2017-03-29,Senate,"Do pass as amended, but first amend, and re-refer to the Committee on [Appropriations] with the recommendation: To Consent Calendar",7,0,0,0,7
965608,629196,2017-04-20,Senate,"Consent Calendar 2nd SB455",36,0,4,0,40
965608,667766,2017-06-21,Assembly,"Do pass and be re-referred to the Committee on [Appropriations] with recommendation: To Consent Calendar",6,0,1,0,7
965608,672525,2017-07-11,Assembly,"Do pass and be re-referred to the Committee on [Appropriations]",9,0,1,0,10
965608,672898,2017-07-19,Assembly,"Do pass. To Consent Calendar",16,0,1,0,17
965608,674143,2017-08-24,Assembly,"SB 455 Newman Consent Calendar Second Day Regular Session",76,0,3,0,79
965609,633693,2017-04-26,Senate,"Do pass as amended, but first amend, and re-refer to the Committee on [Appropriations]",8,0,1,0,9
965609,644507,2017-05-15,Senate,"Do pass",7,0,0,0,7
965609,654307,2017-05-30,Senate,"Senate 3rd Reading SB488 Bradford",38,0,2,0,40
965609,672403,2017-07-12,Assembly,"Do pass as amended and be re-referred to the Committee on [Appropriations]",8,0,5,0,13
965609,777247,2017-04-26,Senate,"Do pass as amended, but first amend, and re-refer to the Committe",0,0,1,0,1
965610,614119,2017-03-28,Assembly,"Do pass and be re-referred to the Committee on [Appropriations]",7,0,0,0,7
965610,686218,2018-01-18,Assembly,"Do pass as amended",17,0,0,0,17
965610,689945,2018-01-29,Assembly,"AB 900 GONZALEZ FLETCHER Assembly Third Reading",76,0,1,0,77
965610,753276,2018-05-15,Senate,"Do pass, but first be re-referred to the Committee on [Appropriations] with the recommendation: To Consent Calendar",7,0,0,0,7
965610,767873,2018-06-25,Senate,"Placed on suspense file",7,0,0,0,7
965610,771855,2018-08-16,Senate,"Do pass",7,0,0,0,7
965610,772986,2018-08-27,Senate,"Assembly 3rd Reading AB900 Gonzalez Fletcher et al. By Bates",39,0,1,0,40
965610,773645,2018-08-29,Assembly,"AB 900 GONZALEZ FLETCHER Concurrence in Senate Amendments",79,0,1,0,80
965611,645052,2017-05-15,Assembly,"Do pass as amended and be re-referred to the Committee on [Appropriations]",8,1,1,0,10
965612,610292,2017-03-22,Assembly,"Do pass and be re-referred to the Committee on [Appropriations] with recommendation: To Consent Calendar",7,0,0,0,7
965612,652107,2017-05-26,Assembly,"Do pass",17,0,0,0,17
965612,654339,2017-05-30,Assembly,"AB 939 LOW Assembly Third Reading",77,0,3,0,80
965612,672658,2017-07-12,Senate,"Do pass, but first be re-referred to the Committee on [Appropriations] with the recommendation: To Consent Calendar",5,0,0,0,5
965612,766125,2018-06-20,Senate,"Do pass as amended, but first amend, and re-refer to the Committee on [Transportation and Housing]",7,0,0,0,7
965612,768235,2018-06-26,Senate,"Do pass, but first be re-referred to the Committee on [Appropriations]",12,0,1,0,13
965612,773243,2018-08-28,Senate,"Assembly 3rd Reading AB939 Low By McGuire",39,0,1,0,40
965612,773713,2018-08-30,Assembly,"With recommendation: That Senate amendments be concurred in",12,0,1,0,13
965612,774030,2018-08-31,Assembly,"AB 939 LOW Concurrence in Senate Amendments",80,0,0,0,80
965613,621068,2017-04-05,Assembly,"Do pass as amended and be re-referred to the Committee on [Appropriations]",6,0,1,0,7
965613,652154,2017-05-26,Assembly,"Do pass",17,0,0,0,17
965613,655814,2017-05-31,Assembly,"AB 1029 WEBER Assembly Third Reading",75,1,4,0,80
965613,670095,2017-06-28,Senate,"Do pass, but first be re-referred to the Committee on [Appropriations]",7,0,0,0,7
965613,672011,2017-07-10,Senate,"Placed on suspense file",7,0,0,0,7
965613,674547,2017-09-01,Senate,"Do pass",7,0,0,0,7
965613,675343,2017-09-11,Senate,"Assembly 3rd Reading AB1029 Weber By Leyva",40,0,0,0,40
965614,641787,2017-05-09,Senate,"Do pass as amended",11,0,2,0,13
965614,647999,2017-05-22,Senate,"Senate 3rd Reading SB531 Galgiani",37,0,3,0,40
965614,766229,2018-06-20,Assembly,"Do pass",18,0,3,0,21
965614,771424,2018-08-13,Assembly,"SB 531 Galgiani Senate Third Reading By EGGMAN Amendment Set #1",76,0,4,0,80
965614,772144,2018-08-20,Assembly,"SB 531 Galgiani Senate Third Reading By EGGMAN",79,0,1,0,80
965614,772320,2018-08-21,Senate,"Unfinished Business SB531 Galgiani Concurrence",39,0,1,0,40
965616,613890,2017-03-28,Assembly,"Do pass as amended and be re-referred to the Committee on [Appropriations]",11,0,0,0,11
965616,634072,2017-04-26,Assembly,"Do pass as amended",16,0,1,0,17
965616,638692,2017-05-04,Assembly,"AB 926 IRWIN Assembly Third Reading",75,0,5,0,80
965616,671900,2017-07-10,Senate,"Do pass, but first be re-referred to the Committee on [Appropriations]",9,0,0,0,9
965616,673847,2017-08-21,Senate,"Do pass",7,0,0,0,7
965616,675055,2017-09-06,Senate,"Assembly 3rd Reading AB926 Irwin By Wiener",40,0,0,0,40
965616,675386,2017-09-11,Assembly,"AB 926 IRWIN Concurrence in Senate Amendments",78,0,1,0,79
965617,634421,2017-04-25,Assembly,"Do pass and be re-referred to the Committee on [Appropriations]",11,1,1,0,13
965617,651643,2017-05-26,Assembly,"Do pass",12,0,5,0,17
965617,655842,2017-05-31,Assembly,"AB 1064 CALDERON Assembly Third Reading",73,1,6,0,80
965617,671366,2017-07-05,Senate,"Do pass as amended, but first amend, and re-refer to the Committee on [Appropriations]",6,0,1,0,7
965617,673860,2017-08-21,Senate,"Placed on suspense file",7,0,0,0,7
965617,674755,2017-09-01,Senate,"Do pass",7,0,0,0,7
965617,675093,2017-09-06,Senate,"Assembly 3rd Reading AB1064 Calderon By Wiener",40,0,0,0,40
965617,675452,2017-09-11,Assembly,"AB 1064 CALDERON Concurrence in Senate Amendments",79,0,0,0,79
965618,627889,2017-04-19,Senate,"Do pass, but first be re-referred to the Committee on [Governance and Finance]",7,0,0,0,7
965618,634594,2017-04-26,Senate,"Do pass as amended, but first amend, and re-refer to the Committee on [Appropriations]",4,1,2,0,7
965618,644448,2017-05-15,Senate,"Placed on suspense file",7,0,0,0,7
965619,637282,2017-05-03,Assembly,"Do pass and be re-referred to the Committee on [Appropriations]",5,2,0,0,7
965619,651560,2017-05-26,Assembly,"Do pass as amended",11,6,0,0,17
965619,656828,2017-06-01,Assembly,"AB 1008 MCCARTY Assembly Third Reading",41,33,6,0,80
965619,669731,2017-06-28,Senate,"Do pass, but first be re-referred to the Committee on [Judiciary]",3,1,1,0,5
965619,672369,2017-07-11,Senate,"Do pass as amended, but first amend, and re-refer to the Committee on [Appropriations]",5,1,1,0,7
965619,673840,2017-08-21,Senate,"Placed on suspense file",7,0,0,0,7
965619,674629,2017-09-01,Senate,"Do pass as amended",5,2,0,0,7
965619,675819,2017-09-13,Senate,"Assembly 3rd Reading AB1008 McCarty et al. By Bradford",27,13,0,0,40
965619,676481,2017-09-15,Assembly,"AB 1008 MCCARTY Concurrence in Senate Amendments",42,30,7,0,79
965620,618624,2017-04-04,Assembly,"Do pass and be re-referred to the Committee on [Natural Resources] with recommendation: To Consent Calendar",14,0,1,0,15
965620,631631,2017-04-24,Assembly,"Do pass and be re-referred to the Committee on [Appropriations] with recommendation: To Consent Calendar",10,0,0,0,10
965620,637579,2017-05-03,Assembly,"Do pass. To Consent Calendar",16,0,1,0,17
965620,643450,2017-05-11,Assembly,"AB 1014 COOPER Consent Calendar Second Day Regular Session",77,0,3,0,80
965620,663181,2017-06-14,Senate,"Do pass, but first be re-referred to the Committee on [Environmental Quality] with the recommendation: To Consent Calendar",9,0,0,0,9
965620,667085,2017-06-21,Senate,"Do pass, but first be re-referred to the Committee on [Appropriations] with the recommendation: To Consent Calendar",6,0,1,0,7
965620,672587,2017-07-13,Senate,"Consent Calendar 2nd AB1014",39,0,1,0,40
965621,632755,2017-04-25,Assembly,"Do pass as amended and be re-referred to the Committee on [Appropriations]",7,0,0,0,7
965621,646065,2017-05-17,Assembly,"Do pass. To Consent Calendar",17,0,0,0,17
965621,651578,2017-05-26,Assembly,"AB 916 QUIRK-SILVA Consent Calendar Second Day Regular Session",76,0,4,0,80
965621,771056,2018-08-08,Senate,"Do pass, but first be re-referred to the Committee on [Appropriations]",7,0,0,0,7
965621,771371,2018-08-13,Senate,"Placed on suspense file",7,0,0,0,7
965623,613593,2017-03-28,Senate,"Do pass, but first be re-referred to the Committee on [Energy, Utilities and Communications]",9,0,0,0,9
965623,627172,2017-04-18,Senate,"Do pass, but first be re-referred to the Committee on [Appropriations]",10,1,0,0,11
965623,638640,2017-05-04,Senate,"Senate 3rd Reading SB492 Beall et al",39,0,1,0,40
965623,662838,2017-06-13,Assembly,"Do pass and be re-referred to the Committee on [Utilities and Energy]",13,0,2,0,15
965623,672395,2017-07-12,Assembly,"Do pass and be re-referred to the Committee on [Appropriations]",14,0,1,0,15
965623,674036,2017-08-23,Assembly,"Do pass",15,0,2,0,17
965623,674320,2017-08-31,Assembly,"SB 492 Beall Senate Third Reading By STONE",69,6,4,0,79
965623,777244,2017-08-23,Assembly,"Do p"" class=""columnField"" style=""text-align:left"">",14,0,2,0,16
965625,608472,2017-03-21,Assembly,"Do pass as amended and be re-referred to the Committee on [Appropriations]",8,1,2,0,11
965626,632000,2017-04-25,Assembly,"Do pass and be re-referred to the Committee on [Appropriations]",15,0,0,0,15
965628,634400,2017-04-25,Assembly,"Do pass and be re-referred to the Committee on [Appropriations]",12,0,1,0,13
965628,651507,2017-05-26,Assembly,"Do pass",17,0,0,0,17
965628,654497,2017-05-30,Assembly,"AB 1018 REYES Assembly Third Reading",75,0,5,0,80
965628,671427,2017-07-05,Senate,"Do pass, but first be re-referred to the Committee on [Appropriations]",6,0,1,0,7
965628,672726,2017-07-17,Senate,"Placed on suspense file",7,0,0,0,7
965628,674634,2017-09-01,Senate,"Do pass as amended",6,0,1,0,7
965628,675691,2017-09-12,Senate,"Assembly 3rd Reading AB1018 Reyes et al. By Galgiani",35,1,4,0,40
965628,676275,2017-09-14,Assembly,"AB 1018 REYES Concurrence in Senate Amendments",67,0,12,0,79
965629,618363,2017-04-04,Assembly,"Do pass as amended and be re-referred to the Committee on [Privacy and Consumer Protection]",8,3,0,0,11
965629,636591,2017-05-02,Assembly,"Do pass",6,3,1,0,10
965630,633504,2017-04-26,Assembly,"Do pass and be re-referred to the Committee on [Appropriations] with recommendation: To Consent Calendar",7,0,0,0,7
965630,686261,2018-01-18,Assembly,"Do pass",5,12,0,0,17
965632,633565,2017-04-26,Assembly,"Do pass as amended and be re-referred to the Committee on [Local Government]",5,2,0,0,7
965632,642527,2017-05-10,Assembly,"Do pass",6,3,0,0,9
965632,656869,2017-06-01,Assembly,"AB 915 TING Assembly Third Reading",41,28,11,0,80
965632,672817,2017-07-18,Senate,"Do pass as amended",7,4,2,0,13
965632,674179,2017-08-28,Senate,"Placed on suspense file",7,0,0,0,7
965634,631958,2017-04-25,Senate,"Do pass as amended, but first amend, and re-refer to the Committee on [Appropriations]",6,0,1,0,7
965634,644291,2017-05-15,Senate,"Placed on suspense file",7,0,0,0,7
965634,650268,2017-05-25,Senate,"Do pass",7,0,0,0,7
965634,656014,2017-05-31,Senate,"Special Consent Calendar # SB505",40,0,0,0,40
965634,669200,2017-06-27,Assembly,"Do pass and be re-referred to the Committee on [Appropriations]",5,0,2,0,7
965635,638135,2017-05-03,Assembly,"Do pass and be re-referred to the Committee on [Appropriations]",11,0,2,0,13
965635,651870,2017-05-26,Assembly,"Do pass as amended",15,0,2,0,17
965635,655961,2017-05-31,Assembly,"AB 1028 BOCANEGRA Assembly Third Reading",71,5,4,0,80
965635,672480,2017-07-12,Senate,"Do pass, but first be re-referred to the Committee on [Appropriations]",5,0,0,0,5
965635,673988,2017-08-21,Senate,"Placed on suspense file",7,0,0,0,7
965636,631923,2017-04-25,Assembly,"Do pass and be re-referred to the Committee on [Appropriations]",10,5,0,0,15
965636,651557,2017-05-26,Assembly,"Do pass as amended",12,5,0,0,17
965636,656127,2017-05-31,Assembly,"AB 1000 FRIEDMAN Assembly Third Reading",57,18,5,0,80
965636,672184,2017-07-11,Senate,"Do pass, but first be re-referred to the Committee on [Appropriations]",6,2,1,0,9
965636,674198,2017-08-28,Senate,"Placed on suspense file",7,0,0,0,7
965637,613813,2017-03-28,Senate,"Do pass, but first be re-referred to the Committee on [Appropriations]",5,2,0,0,7
965637,630479,2017-04-24,Senate,"Senate 3rd Reading SB536 Pan",25,13,2,0,40
965637,662319,2017-06-13,Assembly,"Do pass and be re-referred to the Committee on [Appropriations]",5,2,0,0,7
965637,669697,2017-06-28,Assembly,"Do pass",10,4,3,0,17
965637,674869,2017-09-05,Assembly,"SB 536 Pan Senate Third Reading By QUIRK",48,23,8,0,79
965637,675036,2017-09-06,Senate,"Unfinished Business SB536 Pan et al. Concurrence",26,13,1,0,40
965638,608465,2017-03-21,Assembly,"Do pass and be re-referred to the Committee on [Appropriations] with recommendation: To Consent Calendar",7,0,0,0,7
965638,651899,2017-05-26,Assembly,"Do pass as amended",16,0,1,0,17
965638,655740,2017-05-31,Assembly,"AB 1065 JONES-SAWYER Assembly Third Reading",77,0,3,0,80
965638,722155,2018-03-13,Senate,"Do pass, but first be re-referred to the Committee on [Appropriations]",7,0,0,0,7
965638,756189,2018-05-25,Senate,"Placed on suspense file",7,0,0,0,7
965638,756190,2018-05-25,Senate,"Do pass",5,0,2,0,7
965638,771460,2018-08-14,Senate,"That the measure be returned to Senate Floor for consideration. Ordered to third reading",7,0,0,0,7
965638,772229,2018-08-20,Senate,"Assembly 3rd Reading AB1065 Jones-Sawyer et al. By Skinner",39,0,1,0,40
965638,772508,2018-08-23,Assembly,"With recommendation: That Senate amendments be concurred in",6,0,1,0,7
965638,772896,2018-08-27,Assembly,"AB 1065 JONES-SAWYER Concurrence in Senate Amendments",68,6,6,0,80
965642,631485,2017-04-25,Assembly,"Do pass and be re-referred to the Committee on [Appropriations] with recommendation: To Consent Calendar",15,0,1,0,16
965642,637228,2017-05-03,Assembly,"Do pass. To Consent Calendar",16,0,1,0,17
965642,643388,2017-05-11,Assembly,"AB 1002 COOLEY Consent Calendar Second Day Regular Session",77,0,3,0,80
965642,661557,2017-06-12,Senate,"Do pass, but first be re-referred to the Committee on [Appropriations]",8,0,1,0,9
965642,673796,2017-08-21,Senate,"Placed on suspense file",7,0,0,0,7
965643,619644,2017-04-05,Assembly,"Do pass as amended and be re-referred to the Committee on [Natural Resources]",5,2,0,0,7
965643,631544,2017-04-24,Assembly,"Do pass and be re-referred to the Committee on [Appropriations]",7,2,1,0,10
965643,651889,2017-05-26,Assembly,"Do pass",11,6,0,0,17
965643,656830,2017-06-01,Assembly,"AB 890 MEDINA Assembly Third Reading",44,32,4,0,80
965643,672855,2017-07-19,Senate,"Do pass as amended, but first amend, and re-refer to the Committee on [Appropriations]",5,2,0,0,7
965643,675034,2017-09-06,Senate,"Assembly 3rd Reading AB890 Medina et al. By Hertzberg",22,15,3,0,40
965643,675617,2017-09-12,Assembly,"With recommendation: That Senate amendments be concurred in",6,3,0,0,9
965643,675913,2017-09-13,Assembly,"AB 890 MEDINA Concurrence in Senate Amendments",45,30,4,0,79
965644,627935,2017-04-18,Assembly,"Do pass and be re-referred to the Committee on [Jobs, Economic Development, and the Economy]",13,0,0,0,13
965644,632034,2017-04-25,Assembly,"Do pass as amended and be re-referred to the Committee on [Appropriations]",7,0,0,0,7
965644,651595,2017-05-26,Assembly,"Do pass",17,0,0,0,17
965644,654182,2017-05-30,Assembly,"AB 957 LEVINE Assembly Third Reading",77,0,3,0,80
965644,667261,2017-06-21,Senate,"Do pass as amended, but first amend, and re-refer to the Committee on [Appropriations]",6,0,1,0,7
965644,671901,2017-07-10,Senate,"Placed on suspense file",7,0,0,0,7
965644,674530,2017-09-01,Senate,"Do pass",7,0,0,0,7
965644,676043,2017-09-14,Senate,"Special Consent Calendar # AB957",40,0,0,0,40
965644,676228,2017-09-14,Assembly,"AB 957 Levine Special Consent Calendar 1st Day Regular Session",79,0,0,0,79
965645,632021,2017-04-25,Assembly,"Do pass and be re-referred to the Committee on [Appropriations]",10,0,1,0,11
965645,642572,2017-05-10,Assembly,"Do pass",16,0,1,0,17
965645,644283,2017-05-15,Assembly,"AB 984 CALDERON Assembly Third Reading",73,1,6,0,80
965645,669591,2017-06-27,Senate,"Do pass",6,0,1,0,7
965645,672968,2017-07-20,Senate,"Assembly 3rd Reading AB984 Calderon By Hertzberg Urgency Clause",38,0,2,0,40
965645,672969,2017-07-20,Assembly,"AB 984 CALDERON Concurrence - Urgency Added",70,0,9,0,79
965646,613698,2017-03-28,Senate,"Do pass, but first be re-referred to the Committee on [Judiciary] with the recommendation: To Consent Calendar",12,0,1,0,13
965646,628497,2017-04-18,Senate,"Do pass as amended, but first amend, and re-refer to the Committee on [Appropriations] with the recommendation: To Consent Calendar",7,0,0,0,7
965646,644470,2017-05-15,Senate,"Do pass",7,0,0,0,7
965646,654543,2017-05-30,Senate,"Senate 3rd Reading SB542 Leyva",40,0,0,0,40
965646,669864,2017-06-28,Assembly,"Do pass and be re-referred to the Committee on [Judiciary]",7,0,0,0,7
965646,672062,2017-07-11,Assembly,"Do pass and be re-referred to the Committee on [Appropriations] with recommendation: To Consent Calendar",11,0,0,0,11
965646,674021,2017-08-23,Assembly,"Do pass. To Consent Calendar",15,0,2,0,17
965646,674397,2017-08-31,Assembly,"SB 542 Leyva Consent Calendar Second Day Regular Session",73,0,6,0,79
965646,674923,2017-09-05,Senate,"Special Consent SB542",40,0,0,0,40
965647,627979,2017-04-18,Assembly,"Do pass and be re-referred to the Committee on [Health]",13,0,0,0,13
965647,631423,2017-04-25,Assembly,"Do pass and be re-referred to the Committee on [Appropriations] with recommendation: To Consent Calendar",15,0,0,0,15
965649,633598,2017-04-25,Senate,"Do pass, but first be re-referred to the Committee on [Appropriations]",7,0,0,0,7
965649,644473,2017-05-15,Senate,"Senate 3rd Reading SB462 Atkins",39,0,1,0,40
965649,666089,2017-06-20,Assembly,"Do pass and be re-referred to the Committee on [Appropriations] with recommendation: To Consent Calendar",11,0,0,0,11
965649,672863,2017-07-19,Assembly,"Do pass. To Consent Calendar",16,0,1,0,17
965649,674961,2017-09-05,Assembly,"SB 462 Atkins Senate Third Reading By WEBER",76,0,3,0,79
965649,675198,2017-09-07,Senate,"Special Consent Calendar # SB462",40,0,0,0,40
965650,619849,2017-04-04,Assembly,"Do pass and be re-referred to the Committee on [Appropriations]",7,0,0,0,7
965650,652136,2017-05-26,Assembly,"Do pass",13,3,1,0,17
965650,656109,2017-05-31,Assembly,"AB 910 RIDLEY-THOMAS Assembly Third Reading",66,2,12,0,80
965650,672446,2017-07-11,Senate,"Do pass, but first be re-referred to the Committee on [Appropriations]",7,0,0,0,7
965650,674393,2017-08-31,Senate,"Assembly 3rd Reading AB910 Ridley-Thomas By Nguyen",38,0,2,0,40
965650,675555,2017-09-11,Assembly,"AB 910 RIDLEY-THOMAS Concurrence in Senate Amendments",77,1,1,0,79
965651,619944,2017-04-05,Assembly,"Do pass and be re-referred to the Committee on [Appropriations]",6,0,1,0,7
965651,651808,2017-05-26,Assembly,"Do pass as amended",13,4,0,0,17
965651,655937,2017-05-31,Assembly,"AB 918 BONTA Assembly Third Reading",61,11,8,0,80
965651,672557,2017-07-12,Senate,"Do pass, but first be re-referred to the Committee on [Appropriations]",4,1,0,0,5
965651,674204,2017-08-28,Senate,"Placed on suspense file",7,0,0,0,7
965651,674560,2017-09-01,Senate,"Do pass",5,2,0,0,7
965651,675692,2017-09-12,Senate,"Assembly 3rd Reading AB918 Bonta et al. By Lara",31,8,1,0,40
965651,676261,2017-09-14,Assembly,"AB 918 BONTA Concurrence in Senate Amendments",61,12,6,0,79
965652,630398,2017-04-24,Assembly,"Be re-referred to the Committee on [Transportation]",11,0,0,0,11
965652,684163,2018-01-08,Assembly,"Do pass",11,0,3,0,14
965652,685434,2018-01-16,Assembly,"AB 1041 LEVINE Assembly Third Reading",68,0,9,0,77
965652,753190,2018-05-15,Senate,"Do pass and be ordered to the Consent Calendar",11,0,2,0,13
965652,754948,2018-05-21,Senate,"Consent Calendar AB1041",39,0,0,0,39
965653,614684,2017-03-28,Senate,"Do pass, but first be re-referred to the Committee on [Environmental Quality]",5,3,5,0,13
965653,614685,2017-03-28,Senate,"[First] hearing set for [03-28-2017]: Failed passage in Committee. Reconsideration granted",11,0,2,0,13
965656,627003,2017-04-18,Senate,"Do pass as amended, but first amend, and re-refer to the Committee on [Appropriations]",5,2,0,0,7
965656,644286,2017-05-15,Senate,"Placed on suspense file",7,0,0,0,7
965656,650607,2017-05-25,Senate,"Do pass",5,2,0,0,7
965656,654413,2017-05-30,Senate,"Senate 3rd Reading SB497 Portantino et al",25,13,2,0,40
965656,669169,2017-06-27,Assembly,"Do pass and be re-referred to the Committee on [Appropriations]",4,2,1,0,7
965656,674697,2017-09-01,Assembly,"Do pass as amended",11,5,1,0,17
965656,675904,2017-09-13,Assembly,"SB 497 Portantino Senate Third Reading By GIPSON",53,21,5,0,79
965656,676094,2017-09-14,Senate,"That the Assembly amendments be concurred in",7,0,0,0,7
965656,676500,2017-09-15,Senate,"Unfinished Business SB497 Portantino et al. Concurrence",33,4,3,0,40
965658,642093,2017-05-08,Assembly,"Do pass as amended and be re-referred to the Committee on [Appropriations]",9,0,1,0,10
965660,618553,2017-04-04,Assembly,"Do pass as amended and be re-referred to the Committee on [Appropriations]",9,1,5,0,15
965662,628833,2017-04-19,Senate,"Do pass as amended, but first amend, and re-refer to the Committee on [Appropriations]",7,0,0,0,7
965662,672796,2017-07-17,Senate,"Senate 3rd Reading SB558 Glazer",39,0,1,0,40
965662,685460,2018-01-16,Assembly,"Do pass and be re-referred to the Committee on [Appropriations]",7,0,3,0,10
965662,686197,2018-01-18,Assembly,"Do pass",17,0,0,0,17
965662,690172,2018-01-29,Senate,"W/O REF. TO FILE SB558 Glazer Concurrence",39,0,1,0,40
965662,690173,2018-01-29,Assembly,"SB 558 Glazer Senate Third Reading By GONZALEZ FLETCHER",76,0,1,0,77
965663,631691,2017-04-24,Senate,"Do pass and be ordered to the Consent Calendar",9,0,0,0,9
965663,635739,2017-05-01,Senate,"Consent Calendar 2nd SB554 Stone",36,0,4,0,40
965663,666363,2017-06-20,Assembly,"Do pass and be re-referred to the Committee on [Appropriations]",15,0,1,0,16
965663,672688,2017-07-17,Assembly,"SB 554 Stone Senate Third Reading By GALLAGHER",78,0,1,0,79
965663,674091,2017-08-24,Senate,"Special Consent Calendar # SB554",38,0,2,0,40
965664,627173,2017-04-18,Assembly,"Do pass and be re-referred to the Committee on [Utilities and Energy] with recommendation: To Consent Calendar",10,0,0,0,10
965664,633037,2017-04-26,Assembly,"Do pass as amended and be re-referred to the Committee on [Appropriations]",14,0,1,0,15
965664,651786,2017-05-26,Assembly,"Do pass",17,0,0,0,17
965664,654377,2017-05-30,Assembly,"AB 1070 GONZALEZ FLETCHER Assembly Third Reading",77,0,3,0,80
965664,669139,2017-06-26,Senate,"Do pass, but first be re-referred to the Committee on [Energy, Utilities and Communications]",9,0,0,0,9
965664,671968,2017-07-10,Senate,"Do pass as amended, but first amend, and re-refer to the Committee on [Appropriations]",11,0,0,0,11
965664,673952,2017-08-21,Senate,"Placed on suspense file",7,0,0,0,7
965664,674709,2017-09-01,Senate,"Do pass as amended",5,0,2,0,7
965664,675218,2017-09-07,Senate,"Assembly 3rd Reading AB1070 Gonzalez Fletcher By Hueso",40,0,0,0,40
965664,675447,2017-09-11,Assembly,"AB 1070 GONZALEZ FLETCHER Concurrence in Senate Amendments",77,0,2,0,79
965665,613913,2017-03-27,Assembly,"Do pass as amended, and be re-referred to the Committee on [Appropriations] with recommendation: To Consent Calendar",10,0,0,0,10
965665,642399,2017-05-10,Assembly,"Do pass. To Consent Calendar",17,0,0,0,17
965665,646469,2017-05-18,Assembly,"AB 1031 WALDRON Consent Calendar Second Day Regular Session",69,0,11,0,80
965665,663219,2017-06-14,Senate,"Do pass, but first be re-referred to the Committee on [Natural Resources and Water] with the recommendation: To Consent Calendar",6,0,1,0,7
965665,669064,2017-06-27,Senate,"Do pass, but first be re-referred to the Committee on [Appropriations] with the recommendation: To Consent Calendar",8,0,1,0,9
965665,671834,2017-07-10,Senate,"Do pass",7,0,0,0,7
965665,674363,2017-08-31,Senate,"That the measure be returned to Senate Floor for consideration. Ordered to third reading",5,0,2,0,7
965665,675053,2017-09-06,Senate,"Assembly 3rd Reading AB1031 Waldron et al. By Atkins",40,0,0,0,40
965665,675350,2017-09-11,Assembly,"AB 1031 WALDRON Concurrence in Senate Amendments",78,0,1,0,79
965665,774568,2017-08-31,Senate,?,7,0,2,0,9
965666,626755,2017-04-17,Senate,"Do pass as amended, but first amend, and re-refer to the Committee on [Appropriations]",9,0,0,0,9
965666,645036,2017-05-15,Senate,"Do pass",7,0,0,0,7
965666,654915,2017-05-30,Senate,"Senate 3rd Reading SB528 Stone",40,0,0,0,40
965666,666095,2017-06-20,Assembly,"Do pass and be re-referred to the Committee on [Appropriations]",15,0,1,0,16
965667,621193,2017-04-05,Assembly,"Do pass as amended and be re-referred to the Committee on [Environmental Safety and Toxic Materials]",5,0,2,0,7
965667,632621,2017-04-25,Assembly,"Do pass as amended and be re-referred to the Committee on [Appropriations]",5,2,0,0,7
965668,685050,2018-01-11,Senate,"Do pass, but first be re-referred to the Committee on [Appropriations]",7,2,2,0,11
965668,685461,2018-01-16,Senate,"Placed on suspense file",7,0,0,0,7
965668,686166,2018-01-18,Senate,"Do pass",5,2,0,0,7
965668,688135,2018-01-24,Senate,"That the measure be returned to Senate Floor for consideration. Ordered to third reading",5,2,0,0,7
965668,690082,2018-01-29,Senate,"Senate 3rd Reading SB460 De León",21,12,7,0,40
965668,772438,2018-08-22,Assembly,"Do pass and be re-referred to the Committee on [Privacy and Consumer Protection]",9,3,1,0,13
965668,772564,2018-08-23,Assembly,"Do pass and be re-referred to the Committee on [Appropriations]",7,2,1,0,10
965668,772942,2018-08-27,Assembly,"Do pass as amended",11,5,1,0,17
965668,774246,2018-08-31,Assembly,"SB 460 De León Senate Third Reading By BONTA",28,37,15,0,80
965668,777931,2018-08-27,Assembly,,7,5,1,0,13
965670,626994,2017-04-17,Assembly,"Do pass as amended and be re-referred to the Committee on [Appropriations]",8,1,1,0,10
965670,642747,2017-05-10,Assembly,"Do pass",12,4,1,0,17
965670,656065,2017-05-31,Assembly,"AB 948 BONTA Assembly Third Reading",64,9,7,0,80
965670,671315,2017-07-05,Senate,"Do pass as amended, but first amend, and re-refer to the Committee on [Appropriations]",6,1,0,0,7
965670,673832,2017-08-21,Senate,"Placed on suspense file",7,0,0,0,7
965672,632019,2017-04-25,Assembly,"Do pass as amended and be re-referred to the Committee on [Appropriations]",16,0,0,0,16
965673,608474,2017-03-21,Assembly,"Do pass and be re-referred to the Committee on [Appropriations]",13,0,2,0,15
965673,686219,2018-01-18,Assembly,"Do pass as amended",17,0,0,0,17
965673,689901,2018-01-29,Assembly,"AB 986 GALLAGHER Assembly Third Reading",75,0,2,0,77
965673,763563,2018-06-12,Senate,"Do pass as amended, but first amend, and re-refer to the Committee on [Veterans Affairs]",9,0,0,0,9
965673,768165,2018-06-26,Senate,"Do pass, but first be re-referred to the Committee on [Appropriations]",6,0,0,0,6
965673,770273,2018-08-06,Senate,"Placed on suspense file",7,0,0,0,7
965678,619838,2017-04-05,Assembly,"Do pass and be re-referred to the Committee on [Appropriations] with recommendation: To Consent Calendar",9,0,1,0,10
965678,634011,2017-04-26,Assembly,"Do pass. To Consent Calendar",16,0,1,0,17
965678,638678,2017-05-04,Assembly,"AB 933 AGRI. Consent Calendar Second Day Regular Session",76,0,4,0,80
965678,666336,2017-06-20,Senate,"Do pass, but first be re-referred to the Committee on [Appropriations] with the recommendation: To Consent Calendar",5,0,0,0,5
965678,672547,2017-07-13,Senate,"Consent Calendar 2nd AB933 AGRI",39,0,1,0,40
965678,672715,2017-07-17,Assembly,"AB 933 AGRI. Concurrence in Senate Amendments By CABALLERO",78,0,1,0,79
965679,627202,2017-04-18,Senate,"Do pass as amended, but first amend, and re-refer to the Committee on [Appropriations]",10,0,1,0,11
965679,647971,2017-05-22,Senate,"Placed on suspense file",7,0,0,0,7
965680,631943,2017-04-24,Senate,"Do pass as amended, but first amend, and re-refer to the Committee on [Appropriations]",7,0,2,0,9
965680,647926,2017-05-22,Senate,"Placed on suspense file",7,0,0,0,7
965680,650735,2017-05-25,Senate,"Do pass",7,0,0,0,7
965680,654504,2017-05-30,Senate,"Senate 3rd Reading SB501 Glazer",36,0,4,0,40
965680,672147,2017-07-11,Assembly,"Do pass and be re-referred to the Committee on [Appropriations]",16,0,0,0,16
965680,771843,2018-08-16,Assembly,"Do pass as amended",12,0,5,0,17
965680,773512,2018-08-29,Assembly,"SB 501 Glazer Senate Third Reading By LOW",77,2,1,0,80
965680,773681,2018-08-30,Senate,"Unfinished Business SB501 Glazer Concurrence",39,0,1,0,40
965681,621016,2017-04-06,Assembly,"Be re-referred to the Committee on [Health]",9,0,2,0,11
965681,632598,2017-04-25,Assembly,"Do pass and be re-referred to the Committee on [Appropriations]",14,0,1,0,15
965681,651748,2017-05-26,Assembly,"Do pass",17,0,0,0,17
965681,654570,2017-05-30,Assembly,"AB 954 CHIU Assembly Third Reading",76,0,4,0,80
965681,666351,2017-06-20,Senate,"Do pass, but first be re-referred to the Committee on [Health]",3,1,1,0,5
965681,671553,2017-07-05,Senate,"Do pass, but first be re-referred to the Committee on [Appropriations]",9,0,0,0,9
965681,672775,2017-07-17,Senate,"Placed on suspense file",7,0,0,0,7
965681,674615,2017-09-01,Senate,"Do pass",5,2,0,0,7
965681,675416,2017-09-11,Senate,"Assembly 3rd Reading AB954 Chiu By Dodd",33,6,1,0,40
965681,675761,2017-09-13,Assembly,"AB 954 CHIU Concurrence in Senate Amendments",79,0,0,0,79
965682,628846,2017-04-18,Senate,"Do pass",5,2,0,0,7
965682,630524,2017-04-24,Senate,"Senate 3rd Reading SB484 Roth",25,13,2,0,40
965684,607136,2017-03-20,Assembly,"Do pass and be re-referred to the Committee on [Communications and Conveyance]",10,3,1,0,14
965685,633756,2017-04-25,Assembly,"Do pass and be re-referred to the Committee on [Appropriations]",12,0,1,0,13
965686,616028,2017-03-29,Assembly,"Do pass and be re-referred to the Committee on [Appropriations]",5,1,1,0,7
965686,633379,2017-04-26,Assembly,"Do pass",11,4,2,0,17
965686,651500,2017-05-26,Assembly,"AB 978 LIMÓN Assembly Third Reading Amend By LIMÓN Set #1",49,23,8,0,80
965686,656003,2017-05-31,Assembly,"AB 978 LIMÓN Assembly Third Reading",46,26,8,0,80
965686,669738,2017-06-28,Senate,"Do pass, but first be re-referred to the Committee on [Appropriations]",3,1,1,0,5
965686,675029,2017-09-06,Senate,"Assembly 3rd Reading AB978 Limón By Jackson",24,13,3,0,40
965686,675509,2017-09-11,Assembly,"AB 978 LIMÓN Concurrence in Senate Amendments",46,28,5,0,79
965686,777403,2017-09-06,Senate,"Assembly 3rd Reading AB978 L",3,13,3,0,19
965688,684731,2018-01-09,Senate,"Do pass, but first be re-referred to the Committee on [Appropriations]",5,2,0,0,7
965688,685426,2018-01-16,Senate,"Placed on suspense file",7,0,0,0,7
965688,686185,2018-01-18,Senate,"Do pass as amended",5,2,0,0,7
965688,690114,2018-01-29,Senate,"Senate 3rd Reading SB459 Portantino",24,14,2,0,40
965688,758472,2018-05-31,Assembly,"Be re-referred to the Committee on [Public Employees, Retirement, and Social Security]",7,0,4,0,11
965689,631909,2017-04-24,Assembly,"Do pass and be re-referred to the Committee on [Appropriations]",5,8,1,0,14
965689,631910,2017-04-24,Assembly,Reconsideration,14,0,0,0,14
965690,631706,2017-04-25,Assembly,"Do pass as amended and be re-referred to the Committee on [Appropriations]",15,0,0,0,15
965690,649552,2017-05-24,Assembly,"Do pass",16,0,1,0,17
965690,654544,2017-05-30,Assembly,"AB 944 LIMÓN Assembly Third Reading",71,4,5,0,80
965690,666171,2017-06-20,Senate,"Do pass, but first be re-referred to the Committee on [Judiciary]",5,0,0,0,5
965690,672313,2017-07-11,Senate,"Do pass as amended, but first amend, and re-refer to the Committee on [Appropriations]",5,2,0,0,7
965690,673881,2017-08-21,Senate,"Do pass",6,0,1,0,7
965690,675101,2017-09-06,Senate,"Assembly 3rd Reading AB944 Limón By Atkins",31,6,3,0,40
965690,675484,2017-09-11,Assembly,"AB 944 LIMÓN Concurrence in Senate Amendments",69,6,4,0,79
965691,627876,2017-04-19,Assembly,"Do pass as amended and be re-referred to the Committee on [Appropriations]",12,0,1,0,13
965691,643016,2017-05-10,Assembly,"Do pass. To Consent Calendar",17,0,0,0,17
965691,646540,2017-05-18,Assembly,"AB 938 COOLEY Consent Calendar Second Day Regular Session",69,0,11,0,80
965691,669823,2017-06-28,Senate,"Do pass, but first be re-referred to the Committee on [Appropriations] with the recommendation: To Consent Calendar",9,0,4,0,13
965691,674070,2017-08-24,Senate,"Consent Calendar 2nd AB938 Cooley Urgency Clause",38,0,2,0,40
965692,610196,2017-03-21,Assembly,"Do pass and be re-referred to the Committee on [Accountability and Administrative Review] with recommendation: To Consent Calendar",10,0,0,0,10
965692,620042,2017-04-05,Assembly,"Do pass and be re-referred to the Committee on [Appropriations] with recommendation: To Consent Calendar",7,0,0,0,7
965692,634073,2017-04-26,Assembly,"Do pass. To Consent Calendar",16,0,1,0,17
965692,638509,2017-05-04,Assembly,"AB 1057 WEBER Consent Calendar Second Day Regular Session",76,0,4,0,80
965692,662483,2017-06-13,Senate,"Do pass, but first be re-referred to the Committee on [Veterans Affairs]",12,0,1,0,13
965692,669259,2017-06-27,Senate,"Do pass, but first be re-referred to the Committee on [Appropriations] with the recommendation: To Consent Calendar",7,0,0,0,7
965692,672636,2017-07-13,Senate,"Consent Calendar 2nd AB1057",39,0,1,0,40
965694,613702,2017-03-28,Senate,"Do pass as amended, but first amend, and re-refer to the Committee on [Appropriations] with the recommendation: To Consent Calendar",9,0,0,0,9
965694,629059,2017-04-20,Senate,"Consent Calendar 2nd SB506",36,0,4,0,40
965694,662473,2017-06-13,Assembly,"Do pass and be re-referred to the Committee on [Appropriations]",14,0,1,0,15
965694,669735,2017-06-28,Assembly,"Do pass. To Consent Calendar",14,0,3,0,17
965694,671563,2017-07-06,Assembly,"SB 506 Nielsen Consent Calendar Second Day Regular Session",74,0,6,0,80
965694,671893,2017-07-10,Senate,"Unfinished Business SB506 Nielsen et al. Concurrence",38,0,2,0,40
965695,631967,2017-04-25,Assembly,"Do pass and be re-referred to the Committee on [Appropriations] with recommendation: To Consent Calendar",7,0,0,0,7
965696,631449,2017-04-25,Senate,"Do pass, but first be re-referred to the Committee on [Appropriations]",5,2,2,0,9
965696,644918,2017-05-15,Senate,"Placed on suspense file",7,0,0,0,7
965698,614507,2017-03-27,Assembly,"Do pass and be re-referred to the Committee on [Appropriations] with recommendation: To Consent Calendar",10,0,0,0,10
965698,651589,2017-05-26,Assembly,"Do pass as amended",16,0,1,0,17
965698,656240,2017-05-31,Assembly,"AB 1085 CALDERON Assembly Third Reading",77,0,3,0,80
965698,771057,2018-08-08,Senate,"Do pass, but first be re-referred to the Committee on [Appropriations]",7,0,0,0,7
965698,771410,2018-08-13,Senate,"Placed on suspense file",7,0,0,0,7
965699,620073,2017-04-05,Assembly,"Do pass as amended and be re-referred to the Committee on [Appropriations]",7,0,0,0,7
965699,633269,2017-04-26,Assembly,"Do pass. To Consent Calendar",16,0,1,0,17
965699,638578,2017-05-04,Assembly,"AB 895 QUIRK Consent Calendar Second Day Regular Session",76,0,4,0,80
965699,659395,2017-06-06,Senate,"Do pass, but first be re-referred to the Committee on [Appropriations] with the recommendation: To Consent Calendar",4,0,1,0,5
965699,670976,2017-07-03,Senate,"Consent Calendar 2nd AB895",33,0,7,0,40
965700,684901,2018-01-10,Senate,"Do pass, but first be re-referred to the Committee on [Appropriations] with the recommendation: To Consent Calendar",7,0,0,0,7
965700,690794,2018-01-29,Senate,"Consent Calendar SB522",39,0,1,0,40
965700,763285,2018-06-13,Assembly,"Do pass and be re-referred to the Committee on [Appropriations] with recommendation: To Consent Calendar",7,0,2,0,9
965700,768863,2018-06-27,Assembly,"Do pass. To Consent Calendar",16,0,1,0,17
965700,769769,2018-07-05,Assembly,"SB 522 Glazer Consent Calendar Second Day Regular Session",69,0,11,0,80
965701,633143,2017-04-26,Assembly,"Do pass and be re-referred to the Committee on [Appropriations]",7,0,0,0,7
965701,651932,2017-05-26,Assembly,"Do pass",12,5,0,0,17
965701,655819,2017-05-31,Assembly,"AB 1080 GONZALEZ FLETCHER Assembly Third Reading",59,17,4,0,80
965701,669385,2017-06-27,Senate,"Do pass as amended, but first amend, and re-refer to the Committee on [Labor and Industrial Relations]",10,2,1,0,13
965701,672382,2017-07-12,Senate,"Do pass, but first be re-referred to the Committee on [Appropriations]",4,1,0,0,5
965701,673866,2017-08-21,Senate,"Placed on suspense file",7,0,0,0,7
965701,674473,2017-09-01,Senate,"Do pass",5,2,0,0,7
965701,773535,2018-08-29,Senate,"Assembly 3rd Reading AB1080 Gonzalez Fletcher By Cannella",28,10,2,0,40
965701,773688,2018-08-30,Assembly,"AB 1080 GONZALEZ FLETCHER Concurrence in Senate Amendments",61,19,0,0,80
965701,774449,2018-08-29,Senate,,5,10,2,0,17
965702,619281,2017-04-04,Assembly,"Do pass as amended and be re-referred to the Committee on [Appropriations]",13,0,2,0,15
965702,633518,2017-04-26,Assembly,"Do pass. To Consent Calendar",16,0,1,0,17
965702,638513,2017-05-04,Assembly,"AB 908 DABABNEH Consent Calendar Second Day Regular Session",76,0,4,0,80
965702,671689,2017-07-05,Senate,"Do pass as amended, but first amend, and re-refer to the Committee on [Appropriations]",9,0,0,0,9
965702,675577,2017-09-12,Senate,"Assembly 3rd Reading AB908 Dababneh et al. By Stern",40,0,0,0,40
965702,676246,2017-09-14,Assembly,"With recommendation: That Senate amendments be concurred in",11,0,3,0,14
965702,676494,2017-09-15,Assembly,"AB 908 DABABNEH Concurrence in Senate Amendments",77,0,2,0,79
965703,627342,2017-04-18,Senate,"Do pass, but first be re-referred to the Committee on [Appropriations]",11,0,2,0,13
965703,636069,2017-05-01,Senate,"Placed on suspense file",7,0,0,0,7
965703,650807,2017-05-25,Senate,"Do pass",7,0,0,0,7
965703,655953,2017-05-31,Senate,"Special Consent Calendar # SB493",40,0,0,0,40
965703,668595,2017-06-26,Assembly,"Do pass and be re-referred to the Committee on [Appropriations]",14,0,0,0,14
965705,632636,2017-04-25,Senate,"Do pass, but first be re-referred to the Committee on [Appropriations]",4,0,1,0,5
965705,644676,2017-05-15,Senate,"Placed on suspense file",7,0,0,0,7
965706,633273,2017-04-25,Assembly,"Do pass and be re-referred to the Committee on [Appropriations]",12,0,1,0,13
965706,642407,2017-05-10,Assembly,"Do pass",17,0,0,0,17
965706,644335,2017-05-15,Assembly,"AB 1062 LEVINE Assembly Third Reading",75,0,5,0,80
965706,667247,2017-06-21,Senate,"Do pass as amended, but first amend, and re-refer to the Committee on [Appropriations]",6,0,1,0,7
965706,671978,2017-07-10,Senate,"Placed on suspense file",7,0,0,0,7
965706,674769,2017-09-01,Senate,"Do pass",6,1,0,0,7
965706,768774,2018-06-27,Senate,"Do pass as amended, but first amend, and re-refer to the Committee on [Appropriations] with the recommendation: To Consent Calendar",7,0,0,0,7
965706,771314,2018-08-13,Senate,"Consent Calendar AB1062",37,0,3,0,40
965706,772837,2018-08-27,Assembly,"With recommendation: That Senate amendments be concurred in, but first be re-referred to Com. on [Appropriations]",13,0,0,0,13
965706,773268,2018-08-29,Assembly,"With recommendation: That Senate amendments be concurred in",16,0,1,0,17
965706,774044,2018-08-31,Assembly,"AB 1062 LEVINE Concurrence in Senate Amendments",80,0,0,0,80
965707,627972,2017-04-19,Assembly,"Do pass and be re-referred to the Committee on [Judiciary]",7,0,0,0,7
965707,631986,2017-04-25,Assembly,"Do pass and be re-referred to the Committee on [Appropriations] with recommendation: To Consent Calendar",11,0,0,0,11
965707,645843,2017-05-17,Assembly,"Do pass as amended. To Consent Calendar",17,0,0,0,17
965707,654559,2017-05-30,Assembly,"AB 932 TING Assembly Third Reading",76,0,4,0,80
965707,666217,2017-06-20,Senate,"Do pass as amended, but first amend, and re-refer to the Committee on [Judiciary]",12,0,1,0,13
965707,672405,2017-07-11,Senate,"Do pass as amended, but first amend, and re-refer to the Committee on [Appropriations] with the recommendation: To Consent Calendar",7,0,0,0,7
965707,673878,2017-08-21,Senate,"Placed on suspense file",7,0,0,0,7
965707,674564,2017-09-01,Senate,"Do pass as amended",7,0,0,0,7
965707,676181,2017-09-14,Senate,"Special Consent Calendar # AB932",40,0,0,0,40
965707,676182,2017-09-14,Assembly,"AB 932 Ting Special Consent Calendar 1st Day Regular Session",79,0,0,0,79
965708,642780,2017-05-10,Assembly,"Do pass",5,2,0,0,7
965708,644497,2017-05-15,Assembly,"AB 901 GLORIA Assembly Third Reading",53,26,1,0,80
965708,666140,2017-06-20,Senate,"Do pass",4,1,0,0,5
965708,674430,2017-08-31,Senate,"Assembly 3rd Reading AB901 Gloria et al. By Atkins",23,14,3,0,40
965709,634857,2017-04-26,Assembly,"Do pass and be re-referred to the Committee on [Appropriations] with recommendation: To Consent Calendar",9,0,0,0,9
965709,642749,2017-05-10,Assembly,"Do pass. To Consent Calendar",17,0,0,0,17
965709,646512,2017-05-18,Assembly,"AB 1019 CHIU Consent Calendar Second Day Regular Session",69,0,11,0,80
965709,663304,2017-06-14,Senate,"Do pass, but first be re-referred to the Committee on [Appropriations] with the recommendation: To Consent Calendar",6,0,1,0,7
965709,668896,2017-06-26,Senate,"Placed on suspense file",7,0,0,0,7
965709,674806,2017-09-01,Senate,"Do pass",7,0,0,0,7
965709,675525,2017-09-11,Senate,"Assembly 3rd Reading AB1019 Chiu By Hertzberg",40,0,0,0,40
965710,634975,2017-04-27,Assembly,"Do pass and be re-referred to the Committee on [Appropriations]",20,0,1,0,21
965710,642812,2017-05-10,Assembly,"Do pass. To Consent Calendar",17,0,0,0,17
965710,646564,2017-05-18,Assembly,"AB 880 GRAY Consent Calendar Second Day Regular Session",69,0,11,0,80
965710,672210,2017-07-11,Senate,"Do pass, but first be re-referred to the Committee on [Appropriations] with the recommendation: To Consent Calendar",13,0,0,0,13
965710,768396,2018-06-26,Senate,"Pursuant to Senate Rule 29.10, that the measure be re-referred to the Committee on Appropriations pursuant to Joint Rule 10.5",13,0,0,0,13
965710,770388,2018-08-06,Senate,"Placed on suspense file",7,0,0,0,7
965710,771989,2018-08-16,Senate,"Do pass as amended",7,0,0,0,7
965710,772476,2018-08-22,Senate,"Assembly 3rd Reading AB880 Gray By Dodd",39,0,1,0,40
965710,773075,2018-08-28,Assembly,"With recommendation: That Senate amendments be concurred in",17,0,3,0,20
965710,773729,2018-08-30,Assembly,"AB 880 GRAY Concurrence in Senate Amendments",79,0,1,0,80
965711,609966,2017-03-20,Assembly,"Do pass as amended and be re-referred to the Committee on [Appropriations]",7,3,0,0,10
965711,620038,2017-04-05,Assembly,"Do pass",11,5,1,0,17
965711,638494,2017-05-04,Assembly,"AB 975 FRIEDMAN Assembly Third Reading Amend By FRIEDMAN Set #1",47,21,12,0,80
965712,629339,2017-04-19,Senate,"Do pass as amended, but first amend, and re-refer to the Committee on [Appropriations] with the recommendation: To Consent Calendar",9,0,0,0,9
965712,644417,2017-05-15,Senate,"Placed on suspense file",7,0,0,0,7
965712,650688,2017-05-25,Senate,"Do pass",7,0,0,0,7
965712,655820,2017-05-31,Senate,"Special Consent Calendar # SB456",40,0,0,0,40
965712,662186,2017-06-13,Assembly,"Do pass as amended, and be re-referred to the Committee on [Appropriations] with recommendation: To Consent Calendar",14,0,1,0,15
965712,771836,2018-08-16,Assembly,"Do pass as amended",12,0,5,0,17
965714,631970,2017-04-25,Assembly,"Do pass as amended and be re-referred to the Committee on [Appropriations]",7,0,0,0,7
965714,651510,2017-05-26,Assembly,"Do pass as amended",11,0,6,0,17
965714,655940,2017-05-31,Assembly,"AB 935 STONE Assembly Third Reading",68,1,11,0,80
965714,672057,2017-07-11,Senate,"Do pass as amended, but first amend, and re-refer to the Committee on [Appropriations]",5,0,2,0,7
965714,673811,2017-08-21,Senate,"Placed on suspense file",7,0,0,0,7
965714,674614,2017-09-01,Senate,"Do pass as amended",5,2,0,0,7
965714,675683,2017-09-12,Senate,"Assembly 3rd Reading AB935 Mark Stone By Mitchell",33,6,1,0,40
965714,675813,2017-09-13,Assembly,"AB 935 Mark Stone Concurrence in Senate Amendments",70,2,7,0,79
965715,627099,2017-04-18,Assembly,"Do pass",6,1,0,0,7
965715,634589,2017-04-27,Assembly,"AB 887 COOPER Assembly Third Reading",60,6,14,0,80
965715,669164,2017-06-27,Senate,"Do pass as amended, but first amend, and re-refer to the Committee on [Appropriations]",6,0,1,0,7
965716,613740,2017-03-28,Assembly,"Do pass",7,0,0,0,7
965716,617516,2017-04-03,Assembly,"AB 1024 KILEY Assembly Third Reading",77,0,3,0,80
965716,662440,2017-06-13,Senate,"Do pass as amended, but first amend, and re-refer to the Committee on [Appropriations]",7,0,0,0,7
965716,672760,2017-07-17,Senate,"Special Consent Calendar # AB1024 Kiley et al",38,0,2,0,40
965716,673872,2017-08-21,Assembly,"AB 1024 KILEY Concurrence in Senate Amendments",77,0,2,0,79
965717,608456,2017-03-21,Assembly,"Do pass and be re-referred to the Committee on [Appropriations] with recommendation: To Consent Calendar",15,0,0,0,15
965717,620188,2017-04-05,Assembly,"Do pass. To Consent Calendar",17,0,0,0,17
965717,629119,2017-04-20,Assembly,"AB 911 WOOD Consent Calendar Second Day Regular Session",74,0,6,0,80
965717,660271,2017-06-07,Senate,"Do pass, but first be re-referred to the Committee on [Appropriations] with the recommendation: To Consent Calendar",7,0,0,0,7
965717,670975,2017-07-03,Senate,"Consent Calendar 2nd AB911",33,0,7,0,40
965717,671876,2017-07-10,Assembly,"AB 911 WOOD Concurrence in Senate Amendments",77,0,3,0,80
965717,777395,2017-07-03,Senate,,7,0,7,0,14
965719,607111,2017-03-20,Assembly,"Be adopted. To Consent Calendar",14,0,0,0,14
965719,611152,2017-03-23,Assembly,"ACR 24 DAHLE Consent Calendar Second Day Regular Session",76,0,4,0,80
965719,672131,2017-07-11,Senate,"Be adopted, but first be re-referred to the Committee on [Appropriations] with recommendation: To Consent Calendar",11,0,2,0,13
965719,674128,2017-08-24,Senate,"Consent Calendar 2nd ACR24",38,0,2,0,40
966560,684889,2018-01-10,Senate,"Do pass, but first be re-referred to the Committee on [Elections and Constitutional Amendments]",5,0,2,0,7
966560,685468,2018-01-16,Senate,"Do pass as amended",4,0,1,0,5
966560,691117,2018-01-30,Senate,"Senate 3rd Reading SB561 Gaines et al",36,0,4,0,40
966560,766096,2018-06-20,Assembly,"Do pass as amended and be re-referred to the Committee on [Elections and Redistricting]",8,0,1,0,9
966564,609212,2017-03-21,Assembly,"Do pass as amended and be re-referred to the Committee on [Privacy and Consumer Protection]",11,0,0,0,11
966564,636614,2017-05-02,Assembly,"Do pass as amended. To Consent Calendar",10,0,0,0,10
966564,643368,2017-05-11,Assembly,"AB 1108 DALY Consent Calendar Second Day Regular Session",77,0,3,0,80
966564,672851,2017-07-18,Senate,"Do pass and be ordered to the Consent Calendar",7,0,0,0,7
966564,674095,2017-08-24,Senate,"Consent Calendar 2nd AB1108 Daly",38,0,2,0,40
966568,610249,2017-03-22,Assembly,"Do pass and be re-referred to the Committee on [Appropriations]",6,1,0,0,7
966572,633542,2017-04-26,Senate,"Do pass as amended, but first amend, and re-refer to the Committee on [Appropriations]",7,0,0,0,7
966572,644656,2017-05-15,Senate,"Do pass",7,0,0,0,7
966572,655963,2017-05-31,Senate,"Senate 3rd Reading SB583 Stone et al",40,0,0,0,40
966572,667337,2017-06-21,Assembly,"Do pass as amended and be re-referred to the Committee on [Appropriations]",6,0,1,0,7
966581,645825,2017-05-17,Senate,"Do pass, but first be re-referred to the Committee on [Appropriations]",5,2,0,0,7
966585,627791,2017-04-19,Senate,"Do pass, but first be re-referred to the Committee on [Appropriations]",5,2,0,0,7
966585,635999,2017-05-01,Senate,"Placed on suspense file",7,0,0,0,7
966585,650710,2017-05-25,Senate,"Do pass",5,2,0,0,7
966585,655874,2017-05-31,Senate,"Senate 3rd Reading SB563 Lara",27,12,1,0,40
966585,668728,2017-06-26,Assembly,"Do pass as amended and be re-referred to the Committee on [Appropriations]",10,0,0,0,10
966585,674667,2017-09-01,Assembly,"Do pass",15,0,2,0,17
966585,675165,2017-09-07,Assembly,"SB 563 Lara Senate Third Reading By MCCARTY",67,4,8,0,79
966585,675439,2017-09-11,Senate,"Unfinished Business SB563 Lara et al. Concurrence",28,11,1,0,40
966590,617587,2017-04-03,Senate,"Do pass, but first be re-referred to the Committee on [Judiciary]",9,0,0,0,9
966590,642505,2017-05-09,Senate,"Do pass as amended, and be ordered to the Consent Calendar",7,0,0,0,7
966590,647862,2017-05-22,Senate,"Consent Calendar 2nd SB579 Galgiani et al. Urgency Clause",37,0,3,0,40
966590,672024,2017-07-11,Assembly,"Do pass and be re-referred to the Committee on [Judiciary]",10,0,0,0,10
966590,672807,2017-07-18,Assembly,"Do pass as amended",11,0,0,0,11
966593,626989,2017-04-18,Senate,"Do pass, but first be re-referred to the Committee on [Appropriations]",5,0,0,0,5
966593,638630,2017-05-04,Senate,"Senate 3rd Reading SB568 Lara",32,6,2,0,40
966593,663070,2017-06-14,Assembly,"Do pass as amended and be re-referred to the Committee on [Appropriations]",4,1,2,0,7
966593,672857,2017-07-19,Assembly,"Do pass",12,4,1,0,17
966593,676507,2017-09-15,Assembly,"SB 568 Lara Senate Third Reading By MULLIN",55,21,3,0,79
966593,676508,2017-09-16,Senate,"Unfinished Business SB568 Lara et al. Concurrence",26,10,4,0,40
966598,613773,2017-03-28,Assembly,"Do pass",4,9,2,0,15
966602,631770,2017-04-25,Assembly,"Do pass and be re-referred to the Committee on [Appropriations]",15,0,0,0,15
966602,649273,2017-05-24,Assembly,"Do pass as amended",17,0,0,0,17
966602,656148,2017-05-31,Assembly,"AB 1090 CUNNINGHAM Assembly Third Reading",75,0,5,0,80
966602,669791,2017-06-28,Senate,"Do pass, but first be re-referred to the Committee on [Appropriations]",7,0,2,0,9
966602,673880,2017-08-21,Senate,"Placed on suspense file",7,0,0,0,7
966607,618610,2017-04-04,Assembly,"Do pass and be re-referred to the Committee on [Appropriations] with recommendation: To Consent Calendar",7,0,0,0,7
966611,613642,2017-03-28,Senate,"Do pass, but first be re-referred to the Committee on [Judiciary]",8,1,0,0,9
966611,644491,2017-05-15,Senate,"Placed on suspense file",7,0,0,0,7
966611,650626,2017-05-25,Senate,"Do pass",7,0,0,0,7
966611,654366,2017-05-30,Senate,"Senate 3rd Reading SB588 Hertzberg",30,4,6,0,40
966611,669194,2017-06-27,Assembly,"Do pass and be re-referred to the Committee on [Natural Resources]",12,2,1,0,15
966617,631692,2017-04-25,Assembly,"Do pass as amended and be re-referred to the Committee on [Appropriations]",10,2,3,0,15
966619,626169,2017-04-17,Assembly,"Do pass and be re-referred to the Committee on [Appropriations] with recommendation: To Consent Calendar",13,0,1,0,14
966619,633537,2017-04-26,Assembly,"Do pass. To Consent Calendar",16,0,1,0,17
966619,638495,2017-05-04,Assembly,"AB 1113 BLOOM Consent Calendar Second Day Regular Session",76,0,4,0,80
966619,658893,2017-06-06,Senate,"Do pass, but first be re-referred to the Committee on [Appropriations] with the recommendation: To Consent Calendar",13,0,0,0,13
966619,670994,2017-07-03,Senate,"Consent Calendar 2nd AB1113 Bloom Urgency Clause",33,0,7,0,40
966619,671586,2017-07-06,Assembly,"AB 1113 BLOOM Concurrence - Urgency Added",76,0,4,0,80
966622,641793,2017-05-09,Assembly,"Do pass as amended. To Consent Calendar",11,0,0,0,11
966622,646411,2017-05-18,Assembly,"AB 1093 CHEN Consent Calendar Second Day Regular Session",69,0,11,0,80
966622,669784,2017-06-27,Senate,"Do pass and be ordered to the Consent Calendar",6,0,1,0,7
966622,671940,2017-07-10,Senate,"Consent Calendar 2nd AB1093",40,0,0,0,40
966622,672524,2017-07-10,Senate,"Consent Calendar 2nd AB1093 Chen",40,0,0,0,40
966628,618300,2017-04-04,Assembly,"Do pass",5,2,0,0,7
966628,638520,2017-05-04,Assembly,"AB 1115 JONES-SAWYER Assembly Third Reading",41,28,11,0,80
966628,662175,2017-06-13,Senate,"Do pass",5,2,0,0,7
966628,673778,2017-08-21,Senate,"Assembly 3rd Reading AB1115 Jones-Sawyer By Bradford",26,11,3,0,40
966631,615963,2017-03-29,Senate,"Do pass, but first be re-referred to the Committee on [Appropriations]",7,0,2,0,9
966631,635831,2017-05-01,Senate,"Senate 3rd Reading SB565 Portantino",37,0,3,0,40
966631,668990,2017-06-27,Assembly,"Do pass and be re-referred to the Committee on [Appropriations] with recommendation: To Consent Calendar",15,0,0,0,15
966631,672916,2017-07-19,Assembly,"Do pass. To Consent Calendar",16,0,1,0,17
966631,674153,2017-08-24,Assembly,"SB 565 Portantino Consent Calendar Second Day Regular Session",76,0,3,0,79
966635,629235,2017-04-19,Senate,"Do pass",9,0,0,0,9
966635,654278,2017-05-30,Senate,"Senate 3rd Reading SB581 De León",40,0,0,0,40
966635,666893,2017-06-20,Assembly,"Do pass. To Consent Calendar",15,0,0,0,15
966635,760991,2018-06-07,Assembly,"Be re-referred to the Committees on [Revenue and Taxation] and [Budget]",6,0,5,0,11
966641,620568,2017-04-04,Senate,"Do pass, but first be re-referred to the Committee on [Public Safety]",11,0,2,0,13
966641,627656,2017-04-18,Senate,"Do pass as amended, but first amend, and re-refer to the Committee on [Appropriations]",7,0,0,0,7
966641,644921,2017-05-15,Senate,"Placed on suspense file",7,0,0,0,7
966641,650315,2017-05-25,Senate,"Do pass as amended",7,0,0,0,7
966641,655905,2017-05-31,Senate,"Senate 3rd Reading SB587 Atkins",40,0,0,0,40
966641,671954,2017-07-10,Assembly,"Do pass and be re-referred to the Committee on [Appropriations]",14,0,0,0,14
966641,674048,2017-08-23,Assembly,"Do pass. To Consent Calendar",15,0,2,0,17
966641,674300,2017-08-31,Assembly,"SB 587 Atkins Consent Calendar Second Day Regular Session",73,0,6,0,79
966641,674911,2017-09-05,Senate,"Special Consent SB587",40,0,0,0,40
966645,626828,2017-04-18,Senate,"Do pass, but first be re-referred to the Committee on [Appropriations]",2,5,0,0,7
966655,627927,2017-04-19,Senate,"Do pass, but first be re-referred to the Committee on [Judiciary]",5,2,0,0,7
966655,633632,2017-04-25,Senate,"Do pass as amended, but first amend, and re-refer to the Committee on [Appropriations]",5,2,0,0,7
966655,644313,2017-05-15,Senate,"Placed on suspense file",7,0,0,0,7
966655,650773,2017-05-25,Senate,"Do pass",5,2,0,0,7
966655,655809,2017-05-31,Senate,"Senate 3rd Reading SB573 Lara",28,12,0,0,40
966655,669178,2017-06-27,Assembly,"Do pass as amended and be re-referred to the Committee on [Higher Education]",7,2,2,0,11
966655,672206,2017-07-11,Assembly,"Do pass and be re-referred to the Committee on [Appropriations]",10,3,0,0,13
966655,674670,2017-09-01,Assembly,"Do pass as amended",11,5,1,0,17
966672,632047,2017-04-25,Assembly,"Do pass and be re-referred to the Committee on [Elections and Redistricting]",9,0,1,0,10
966672,642446,2017-05-10,Assembly,"Do pass",6,1,0,0,7
966672,656210,2017-05-31,Assembly,"AB 1104 CHAU Assembly Third Reading",73,2,5,0,80
966672,669778,2017-06-27,Senate,"Do pass, but first be re-referred to the Committee on [Elections and Constitutional Amendments]",6,0,1,0,7
966672,672549,2017-07-12,Senate,"Do pass, but first be re-referred to the Committee on [Appropriations]",5,0,0,0,5
966672,673743,2017-08-21,Senate,"Placed on suspense file",7,0,0,0,7
966672,674641,2017-09-01,Senate,"Do pass",7,0,0,0,7
966672,675513,2017-09-11,Senate,"Assembly 3rd Reading AB1104 Chau By Allen",40,0,0,0,40
966675,613893,2017-03-28,Assembly,"Do pass and be re-referred to the Committee on [Judiciary]",9,1,5,0,15
966675,631527,2017-04-25,Assembly,"Do pass and be re-referred to the Committee on [Appropriations]",11,0,0,0,11
966675,649387,2017-05-24,Assembly,"Do pass",17,0,0,0,17
966675,651397,2017-05-26,Assembly,"AB 1102 RODRIGUEZ Assembly Third Reading",75,0,5,0,80
966675,667295,2017-06-21,Senate,"Do pass, but first be re-referred to the Committee on [Judiciary]",9,0,0,0,9
966675,672338,2017-07-11,Senate,"Do pass, but first be re-referred to the Committee on [Appropriations]",6,0,1,0,7
966675,674310,2017-08-31,Senate,"Assembly 3rd Reading AB1102 Rodriguez By Jackson",38,0,2,0,40
966685,610514,2017-03-21,Assembly,"Do pass as amended, and be re-referred to the Committee on [Appropriations] with recommendation: To Consent Calendar",7,0,0,0,7
966685,651883,2017-05-26,Assembly,"Do pass",17,0,0,0,17
966685,654239,2017-05-30,Assembly,"AB 1106 WEBER Assembly Third Reading",77,0,3,0,80
966685,667474,2017-06-21,Senate,"Do pass, but first be re-referred to the Committee on [Human Services] with the recommendation: To Consent Calendar",6,0,1,0,7
966685,672296,2017-07-11,Senate,"Do pass, but first be re-referred to the Committee on [Appropriations] with the recommendation: To Consent Calendar",7,0,0,0,7
966685,673790,2017-08-21,Senate,"Placed on suspense file",7,0,0,0,7
966685,674768,2017-09-01,Senate,"Do pass as amended",7,0,0,0,7
966685,675130,2017-09-07,Senate,"Assembly 3rd Reading AB1106 Weber et al. By Dodd",40,0,0,0,40
966685,675530,2017-09-11,Assembly,"AB 1106 WEBER Concurrence in Senate Amendments",78,0,1,0,79
966690,620187,2017-04-05,Senate,"Do pass as amended",7,0,0,0,7
966690,630533,2017-04-24,Senate,"Senate 3rd Reading SB564 McGuire et al",38,0,2,0,40
966690,672623,2017-07-12,Assembly,"Do pass as amended",9,0,0,0,9
966690,675213,2017-09-07,Assembly,"SB 564 McGuire Senate Third Reading By WOOD",77,0,2,0,79
966690,675716,2017-09-12,Senate,"Unfinished Business SB564 McGuire et al. Concurrence",38,0,2,0,40
966694,614305,2017-03-28,Senate,"Do pass, but first be re-referred to the Committee on [Appropriations] with the recommendation: To Consent Calendar",9,0,0,0,9
966694,625903,2017-04-17,Senate,"Placed on suspense file",7,0,0,0,7
966694,650605,2017-05-25,Senate,"Do pass",7,0,0,0,7
966694,656084,2017-05-31,Senate,"Special Consent Calendar # SB580",40,0,0,0,40
966694,669455,2017-06-27,Assembly,"Do pass and be re-referred to the Committee on [Appropriations]",15,0,0,0,15
966694,674820,2017-09-01,Assembly,"Do pass",16,0,1,0,17
966694,675712,2017-09-12,Assembly,"SB 580 Pan Senate Third Reading By COOLEY",79,0,0,0,79
966708,618237,2017-04-04,Assembly,"Do pass as amended, and be re-referred to the Committee on [Appropriations] with recommendation: To Consent Calendar",7,0,0,0,7
966708,637617,2017-05-03,Assembly,"Do pass. To Consent Calendar",16,0,1,0,17
966708,643482,2017-05-11,Assembly,"AB 1091 QUIRK Consent Calendar Second Day Regular Session",77,0,3,0,80
966708,666302,2017-06-20,Senate,"Do pass, but first be re-referred to the Committee on [Appropriations] with the recommendation: To Consent Calendar",7,0,0,0,7
966708,672585,2017-07-13,Senate,"Consent Calendar 2nd AB1091",39,0,1,0,40
966712,621082,2017-04-05,Assembly,"Do pass as amended and be re-referred to the Committee on [Appropriations]",5,1,1,0,7
966716,645080,2017-05-15,Assembly,"Do pass as amended and be re-referred to the Committee on [Appropriations]",9,1,0,0,10
966719,630443,2017-04-24,Senate,"Do pass, but first be re-referred to the Committee on [Appropriations]",3,2,0,0,5
966719,644479,2017-05-15,Senate,"Placed on suspense file",7,0,0,0,7
966726,684723,2018-01-09,Assembly,"Do pass and be re-referred to the Committee on [Appropriations]",10,4,1,0,15
966726,686256,2018-01-18,Assembly,"Do pass",12,5,0,0,17
966726,686257,2018-01-18,Assembly,"Set, [First] hearing. Referred to suspense file",12,5,0,0,17
966726,689963,2018-01-29,Assembly,"AB 1097 LEVINE Assembly Third Reading",46,24,7,0,77
966726,763621,2018-06-12,Senate,"Do pass as amended, but first amend, and re-refer to the Committee on [Appropriations]",7,2,0,0,9
966726,769582,2018-07-02,Senate,"Placed on suspense file",7,0,0,0,7
966726,771981,2018-08-16,Senate,"Do pass as amended",5,2,0,0,7
966726,773569,2018-08-29,Senate,"Assembly 3rd Reading AB1097 Levine et al. By Glazer",27,12,1,0,40
966726,774136,2018-08-31,Assembly,"AB 1097 LEVINE Concurrence in Senate Amendments",57,22,1,0,80
966730,620421,2017-04-05,Senate,"Do pass, but first be re-referred to the Committee on [Appropriations]",4,2,1,0,7
966730,626295,2017-04-17,Senate,"Placed on suspense file",7,0,0,0,7
966730,650816,2017-05-25,Senate,"Do pass",5,2,0,0,7
966730,655962,2017-05-31,Senate,"Senate 3rd Reading SB574 Lara",26,13,1,0,40
966730,671398,2017-07-05,Assembly,"Do pass and be re-referred to the Committee on [Higher Education]",4,1,2,0,7
966730,672029,2017-07-11,Assembly,"Do pass and be re-referred to the Committee on [Appropriations]",8,4,1,0,13
966730,674464,2017-09-01,Assembly,"Do pass as amended",10,5,2,0,17
966730,676367,2017-09-14,Assembly,"SB 574 Lara Senate Third Reading By CHIU",50,26,3,0,79
966730,676594,2017-09-15,Senate,"Unfinished Business SB574 Lara et al. Concurrence",26,11,3,0,40
966738,633228,2017-04-26,Senate,"Do pass, but first be re-referred to the Committee on [Appropriations] with the recommendation: To Consent Calendar",9,0,0,0,9
966738,644695,2017-05-15,Senate,"Placed on suspense file",7,0,0,0,7
966738,650897,2017-05-25,Senate,"Do pass as amended",7,0,0,0,7
966738,656145,2017-05-31,Senate,"Senate 3rd Reading SB569 Monning",40,0,0,0,40
966738,672482,2017-07-12,Assembly,"Do pass as amended, and be re-referred to the Committee on [Appropriations] with recommendation: To Consent Calendar",12,0,1,0,13
966738,674051,2017-08-23,Assembly,"Do pass. To Consent Calendar",15,0,2,0,17
966738,674974,2017-09-05,Assembly,"SB 569 Monning Senate Third Reading By AGUIAR-CURRY",76,0,3,0,79
966738,675182,2017-09-07,Senate,"Special Consent Calendar # SB569",40,0,0,0,40
966742,627047,2017-04-17,Assembly,"Do pass as amended and be re-referred to the Committee on [Utilities and Energy]",7,2,1,0,10
966742,633224,2017-04-26,Assembly,"Do pass as amended and be re-referred to the Committee on [Appropriations]",13,1,1,0,15
966742,651707,2017-05-26,Assembly,"Do pass",12,4,1,0,17
966742,655804,2017-05-31,Assembly,"AB 1088 EGGMAN Assembly Third Reading By BURKE",60,15,5,0,80
966742,671001,2017-07-03,Senate,"Do pass as amended, but first amend, and re-refer to the Committee on [Transportation and Housing]",9,0,2,0,11
966742,672120,2017-07-11,Senate,"Do pass as amended, but first amend, and re-refer to the Committee on [Appropriations]",11,1,1,0,13
966742,674184,2017-08-28,Senate,"Placed on suspense file",7,0,0,0,7
966742,777326,2017-04-26,Assembly,,7,2,1,0,10
966746,628244,2017-04-18,Senate,"Do pass as amended, but first amend, and re-refer to the Committee on [Appropriations]",5,1,1,0,7
966746,645002,2017-05-15,Senate,"Placed on suspense file",7,0,0,0,7
966751,627990,2017-04-19,Senate,"Do pass",7,0,0,0,7
966751,635781,2017-05-01,Senate,"Senate 3rd Reading SB585 Mendoza",37,0,3,0,40
966751,667727,2017-06-21,Assembly,"Do pass. To Consent Calendar",6,0,1,0,7
966751,676218,2017-09-14,Assembly,"SB 585 McGuire Third Reading Urgency By GARCIA, C",79,0,0,0,79
966751,676427,2017-09-15,Senate,"Unfinished Business SB585 McGuire et al. Urgency Clause Concurrence",37,0,3,0,40
966755,631464,2017-04-25,Senate,"Do pass as amended, but first amend, and re-refer to the Committee on [Appropriations] with the recommendation: To Consent Calendar",5,0,0,0,5
966755,644744,2017-05-15,Senate,"Placed on suspense file",7,0,0,0,7
966755,650788,2017-05-25,Senate,"Do pass",7,0,0,0,7
966755,655932,2017-05-31,Senate,"Special Consent Calendar # SB570",40,0,0,0,40
966755,669265,2017-06-27,Assembly,"Do pass as amended and be re-referred to the Committee on [Appropriations]",7,0,0,0,7
966755,674677,2017-09-01,Assembly,"Do pass",16,0,1,0,17
966755,675222,2017-09-07,Assembly,"SB 570 Newman Senate Third Reading By RUBIO",78,0,1,0,79
966755,676054,2017-09-14,Senate,"Special Consent Calendar SB570",40,0,0,0,40
966764,618543,2017-04-04,Assembly,"Do pass and be re-referred to the Committee on [Appropriations]",14,0,1,0,15
966764,652005,2017-05-26,Assembly,"Do pass as amended",16,0,1,0,17
966764,655964,2017-05-31,Assembly,"AB 1092 COOLEY Assembly Third Reading",77,0,3,0,80
966764,769028,2018-06-27,Senate,"Do pass as amended, but first amend, and re-refer to the Committee on [Appropriations]",9,0,0,0,9
966764,772823,2018-08-27,Senate,"Assembly 3rd Reading AB1092 Cooley et al. By Nielsen",39,0,1,0,40
966764,773282,2018-08-29,Assembly,"With recommendation: That Senate amendments be concurred in",13,0,2,0,15
966764,773856,2018-08-30,Assembly,"AB 1092 COOLEY Concurrence in Senate Amendments",79,0,1,0,80
966769,616201,2017-03-29,Senate,"Do pass as amended, but first amend, and re-refer to the Committee on [Judiciary]",6,0,3,0,9
966769,633487,2017-04-25,Senate,"Do pass, but first be re-referred to the Committee on [Appropriations]",6,0,1,0,7
966769,644496,2017-05-15,Senate,"Senate 3rd Reading SB575 Leyva",33,5,2,0,40
966769,662385,2017-06-13,Assembly,"Do pass and be re-referred to the Committee on [Privacy and Consumer Protection]",14,0,1,0,15
966769,666333,2017-06-20,Assembly,"Do pass and be re-referred to the Committee on [Appropriations]",9,0,1,0,10
966769,669662,2017-06-28,Assembly,"Do pass. To Consent Calendar",14,0,3,0,17
966769,676265,2017-09-14,Assembly,"SB 575 Leyva Senate Third Reading By QUIRK-SILVA",79,0,0,0,79
966769,676553,2017-09-15,Senate,"Unfinished Business SB575 Leyva Concurrence",36,2,2,0,40
966772,619744,2017-04-05,Senate,"Do pass as amended, but first amend, and re-refer to the Committee on [Appropriations]",5,0,2,0,7
966772,635708,2017-05-01,Senate,"Placed on suspense file",7,0,0,0,7
966772,650731,2017-05-25,Senate,"Do pass as amended",6,1,0,0,7
966772,656165,2017-05-31,Senate,"Senate 3rd Reading SB577 Dodd et al",37,2,1,0,40
966772,765015,2018-06-19,Assembly,"Do pass as amended and be re-referred to the Committee on [Appropriations]",13,0,0,0,13
966772,771548,2018-08-16,Assembly,"Do pass as amended",12,0,5,0,17
966772,773641,2018-08-29,Assembly,"SB 577 Dodd Senate Third Reading By GALLAGHER",79,0,1,0,80
966772,773889,2018-08-30,Senate,"That the Assembly amendments be concurred in",6,0,1,0,7
966772,774109,2018-08-31,Senate,"Unfinished Business SB577 Dodd et al. Concurrence",39,0,1,0,40
966782,634576,2017-04-26,Senate,"Do pass, but first be re-referred to the Committee on [Appropriations]",5,2,2,0,9
966782,647830,2017-05-22,Senate,"Placed on suspense file",7,0,0,0,7
966782,650352,2017-05-25,Senate,"Do pass as amended",5,2,0,0,7
966782,656594,2017-06-01,Senate,"Senate 3rd Reading SB562 Lara et al",23,14,3,0,40
966786,618281,2017-04-04,Assembly,"Do pass and be re-referred to the Committee on [Appropriations] with recommendation: To Consent Calendar",7,0,0,0,7
966786,651529,2017-05-26,Assembly,"Do pass as amended",17,0,0,0,17
966786,656045,2017-05-31,Assembly,"AB 1098 MCCARTY Assembly Third Reading",77,0,3,0,80
966786,672050,2017-07-11,Senate,"Do pass, but first be re-referred to the Committee on [Appropriations] with the recommendation: To Consent Calendar",7,0,0,0,7
966786,673770,2017-08-21,Senate,"Placed on suspense file",7,0,0,0,7
966789,632060,2017-04-25,Assembly,"Do pass as amended and be re-referred to the Committee on [Appropriations]",7,0,0,0,7
966789,651645,2017-05-26,Assembly,"Do pass",17,0,0,0,17
966789,654226,2017-05-30,Assembly,"AB 1111 GARCIA, E. Assembly Third Reading",77,0,3,0,80
966789,672357,2017-07-12,Senate,"Do pass, but first be re-referred to the Committee on [Appropriations]",4,0,1,0,5
966789,673885,2017-08-21,Senate,"Placed on suspense file",7,0,0,0,7
966789,674501,2017-09-01,Senate,"Do pass as amended",6,0,1,0,7
966789,675863,2017-09-13,Senate,"Assembly 3rd Reading AB1111 Eduardo Garcia By Bradford",38,1,1,0,40
966789,676467,2017-09-15,Assembly,"AB 1111 GARCIA, E. Concurrence in Senate Amendments",76,0,3,0,79
966789,694725,2017-09-14,Assembly,"With recommendation: That Senate amendments be concurred in",5,0,2,0,7
966794,632692,2017-04-24,Assembly,"Do pass and be re-referred to the Committee on [Appropriations] with recommendation: To Consent Calendar",14,0,0,0,14
966794,637484,2017-05-03,Assembly,"Do pass. To Consent Calendar",16,0,1,0,17
966794,643635,2017-05-11,Assembly,"AB 1094 CHOI Consent Calendar Second Day Regular Session",77,0,3,0,80
966794,669336,2017-06-27,Senate,"Do pass, but first be re-referred to the Committee on [Appropriations] with the recommendation: To Consent Calendar",12,0,1,0,13
966794,672010,2017-07-10,Senate,"Placed on suspense file",7,0,0,0,7
966794,674526,2017-09-01,Senate,"Do pass",7,0,0,0,7
966794,675049,2017-09-06,Senate,"Assembly 3rd Reading AB1094 Choi By Stone",40,0,0,0,40
966797,613925,2017-03-28,Senate,"Do pass, but first be re-referred to the Committee on [Appropriations]",11,0,2,0,13
966797,629124,2017-04-20,Senate,"Senate 3rd Reading SB582 Bradford et al",39,0,1,0,40
966797,671330,2017-07-05,Assembly,"Do pass and be re-referred to the Committee on [Appropriations]",21,0,0,0,21
966797,672838,2017-07-19,Assembly,"Do pass. To Consent Calendar",16,0,1,0,17
966797,675902,2017-09-13,Assembly,"SB 582 Bradford Senate Third Reading By BURKE",78,0,1,0,79
966797,676061,2017-09-14,Senate,"Unfinished Business SB582 Bradford et al. Concurrence",39,0,1,0,40
966799,629574,2017-04-19,Assembly,"Do pass and be re-referred to the Committee on [Appropriations]",5,2,0,0,7
966799,652160,2017-05-26,Assembly,"Do pass as amended",11,5,1,0,17
966799,655898,2017-05-31,Assembly,"AB 1099 GONZALEZ FLETCHER Assembly Third Reading",46,25,9,0,80
966882,684872,2018-01-10,Senate,"Do pass, but first be re-referred to the Committee on [Appropriations]",8,0,1,0,9
966882,690049,2018-01-29,Senate,"Senate 3rd Reading SB688 Moorlach",39,0,1,0,40
966882,762151,2018-06-12,Assembly,"Do pass as amended, and be re-referred to the Committee on [Appropriations] with recommendation: To Consent Calendar",13,0,2,0,15
966882,768957,2018-06-27,Assembly,"Do pass. To Consent Calendar",16,0,1,0,17
966882,771773,2018-08-16,Assembly,"SB 688 Moorlach Senate Third Reading By COOLEY",76,0,4,0,80
966882,772203,2018-08-20,Senate,"Unfinished Business SB688 Moorlach Concurrence",36,0,4,0,40
966884,627859,2017-04-19,Senate,"Do pass as amended, but first amend, and re-refer to the Committee on [Appropriations]",6,0,1,0,7
966884,644478,2017-05-15,Senate,"Placed on suspense file",7,0,0,0,7
966885,627020,2017-04-18,Assembly,"Do pass and be re-referred to the Committee on [Public Employees, Retirement, and Social Security]",7,0,0,0,7
966885,627758,2017-04-19,Assembly,"Do pass and be re-referred to the Committee on [Appropriations]",7,0,0,0,7
966885,651807,2017-05-26,Assembly,"Do pass",17,0,0,0,17
966885,654368,2017-05-30,Assembly,"AB 1428 LOW Assembly Third Reading",76,0,4,0,80
966885,668952,2017-06-27,Senate,"Do pass as amended, but first amend, and re-refer to the Committee on [Appropriations]",7,0,0,0,7
966885,673767,2017-08-21,Senate,"Placed on suspense file",7,0,0,0,7
966886,618591,2017-04-04,Senate,"Do pass",4,0,1,0,5
966886,640536,2017-05-08,Senate,"Senate 3rd Reading SB665 Moorlach et al",38,0,2,0,40
966886,663398,2017-06-14,Assembly,"Do pass as amended. To Consent Calendar",6,0,1,0,7
966886,667947,2017-06-22,Assembly,"SB 665 Moorlach Consent Calendar Second Day Regular Session",74,0,6,0,80
966886,670319,2017-06-29,Senate,"Unfinished Business SB665 Moorlach et al. Concurrence",36,0,4,0,40
966887,632053,2017-04-25,Assembly,"Do pass and be re-referred to the Committee on [Appropriations]",15,0,0,0,15
966887,651660,2017-05-26,Assembly,"Do pass",17,0,0,0,17
966887,654441,2017-05-30,Assembly,"AB 1228 BLOOM Assembly Third Reading",77,0,3,0,80
966887,672215,2017-07-11,Senate,"Do pass as amended, but first amend, and re-refer to the Committee on [Appropriations] with the recommendation: To Consent Calendar",9,0,0,0,9
966887,673771,2017-08-21,Senate,"Placed on suspense file",7,0,0,0,7
966887,674756,2017-09-01,Senate,"Do pass",7,0,0,0,7
966887,676099,2017-09-14,Senate,"Special Consent Calendar # AB1228",40,0,0,0,40
966887,676372,2017-09-14,Assembly,"AB 1228 Bloom Special Consent Calendar 1st Day Regular Session",79,0,0,0,79
966888,627951,2017-04-18,Assembly,"Do pass and be re-referred to the Committee on [Appropriations]",10,3,0,0,13
966889,684732,2018-01-09,Senate,"Do pass, but first be re-referred to the Committee on [Appropriations] with the recommendation: To Consent Calendar",7,0,0,0,7
966889,690076,2018-01-29,Senate,"Consent Calendar SB746",39,0,1,0,40
966889,762085,2018-06-12,Assembly,"Do pass as amended and be re-referred to the Committee on [Appropriations]",4,1,2,0,7
966889,771560,2018-08-16,Assembly,"Do pass as amended",12,1,4,0,17
966889,773463,2018-08-29,Assembly,"SB 746 Portantino Senate Third Reading By QUIRK",59,10,11,0,80
966889,773804,2018-08-30,Senate,"Unfinished Business SB746 Portantino Concurrence",33,2,5,0,40
966890,626968,2017-04-18,Senate,"Do pass",7,0,0,0,7
966890,638533,2017-05-04,Senate,"Senate 3rd Reading SB725 Jackson Urgency Clause",39,0,1,0,40
966890,662337,2017-06-13,Assembly,"Do pass",6,0,1,0,7
966890,672778,2017-07-17,Assembly,"SB 725 Jackson Third Reading Urgency By JONES-SAWYER",64,2,13,0,79
966890,672960,2017-07-20,Senate,"Unfinished Business SB725 Jackson et al. Urgency Clause Concurrence",38,0,2,0,40
966892,636579,2017-05-02,Assembly,"Do pass",8,3,0,0,11
966892,654033,2017-05-30,Assembly,"AB 1455 BOCANEGRA Assembly Third Reading",51,24,5,0,80
966892,668548,2017-06-26,Senate,"Do pass, but first be re-referred to the Committee on [Judiciary]",3,2,0,0,5
966892,672872,2017-07-18,Senate,"Do pass",5,2,0,0,7
966892,674362,2017-08-31,Senate,"Assembly 3rd Reading AB1455 Bocanegra By Hertzberg",26,13,1,0,40
966893,634714,2017-04-26,Assembly,"Do pass as amended and be re-referred to the Committee on [Appropriations]",9,0,0,0,9
966893,649379,2017-05-24,Assembly,"Do pass. To Consent Calendar",17,0,0,0,17
966893,654426,2017-05-30,Assembly,"AB 1523 OBERNOLTE Consent Calendar Second Day Regular Session",77,0,3,0,80
966893,666298,2017-06-20,Senate,"Do pass, but first be re-referred to the Committee on [Appropriations] with the recommendation: To Consent Calendar",12,0,1,0,13
966893,672640,2017-07-13,Senate,"Consent Calendar 2nd AB1523",39,0,1,0,40
966894,628973,2017-04-19,Assembly,"Do pass and be re-referred to the Committee on [Appropriations]",5,2,0,0,7
966894,637585,2017-05-03,Assembly,"Do pass",11,5,1,0,17
966894,640592,2017-05-08,Assembly,"AB 1425 KALRA Assembly Third Reading",52,23,5,0,80
966894,663158,2017-06-14,Senate,"Do pass, but first be re-referred to the Committee on [Appropriations]",4,1,0,0,5
966895,634695,2017-04-26,Assembly,"Do pass as amended and be re-referred to the Committee on [Appropriations]",7,0,0,0,7
966895,651974,2017-05-26,Assembly,"Do pass",17,0,0,0,17
966895,654490,2017-05-30,Assembly,"AB 1321 WEBER Assembly Third Reading",77,0,3,0,80
966895,672348,2017-07-12,Senate,"Do pass as amended, but first amend, and re-refer to the Committee on [Appropriations]",7,0,0,0,7
966895,673977,2017-08-21,Senate,"Placed on suspense file",7,0,0,0,7
966896,642061,2017-05-08,Assembly,"Do pass and be re-referred to the Committee on [Appropriations]",9,0,1,0,10
966896,645948,2017-05-17,Assembly,"Do pass. To Consent Calendar",17,0,0,0,17
966896,651498,2017-05-26,Assembly,"AB 1171 OBERNOLTE Consent Calendar Second Day Regular Session",76,0,4,0,80
966897,627962,2017-04-19,Senate,"Do pass as amended, but first amend, and re-refer to the Committee on [Appropriations]",7,0,0,0,7
966897,644333,2017-05-15,Senate,"Placed on suspense file",7,0,0,0,7
966897,650687,2017-05-25,Senate,"Do pass",7,0,0,0,7
966897,654271,2017-05-30,Senate,"Senate 3rd Reading SB623 Monning et al",39,0,1,0,40
966897,672065,2017-07-11,Assembly,"Do pass and be re-referred to the Committee on [Appropriations]",5,1,1,0,7
966897,674440,2017-09-01,Assembly,"Without recommendation, and be re-referred to Committee on [Rules]",11,0,6,0,17
966898,641507,2017-05-09,Senate,"Do pass as amended, and be ordered to the Consent Calendar",13,0,0,0,13
966898,648193,2017-05-22,Senate,"Consent Calendar 2nd SB622 Wiener et al",37,0,3,0,40
966898,670558,2017-06-28,Assembly,"Do pass and be re-referred to the Committee on [Transportation]",8,0,1,0,9
966898,671991,2017-07-10,Assembly,"Do pass",14,0,0,0,14
966898,674922,2017-09-05,Assembly,"SB 622 Wiener Senate Third Reading By TING",76,0,3,0,79
966898,675168,2017-09-07,Senate,"Special Consent Calendar # SB622",40,0,0,0,40
966899,621049,2017-04-05,Assembly,"Do pass as amended, and be re-referred to the Committee on [Appropriations] with recommendation: To Consent Calendar",7,0,0,0,7
966899,651962,2017-05-26,Assembly,"Do pass as amended",16,0,1,0,17
966899,655834,2017-05-31,Assembly,"AB 1217 BOCANEGRA Assembly Third Reading",77,0,3,0,80
966899,670050,2017-06-28,Senate,"Do pass, but first be re-referred to the Committee on [Appropriations]",7,0,0,0,7
966899,672404,2017-07-12,Senate,"Do pass as amended, but first amend, and re-refer to the Committee on [Appropriations]",6,1,0,0,7
966899,673989,2017-08-21,Senate,"Placed on suspense file",7,0,0,0,7
966899,674636,2017-09-01,Senate,"Do pass as amended",5,0,2,0,7
966899,768143,2018-06-26,Senate,"Do pass as amended, but first amend, and re-refer to the Committee on [Appropriations]",13,0,0,0,13
966899,771342,2018-08-13,Senate,"Assembly 3rd Reading AB1217 Santiago By De León",35,0,5,0,40
966899,773092,2018-08-28,Assembly,"With recommendation: That Senate amendments be concurred in",17,0,3,0,20
966899,773388,2018-08-29,Assembly,"AB 1217 SANTIAGO Concurrence in Senate Amendments",80,0,0,0,80
966900,634679,2017-04-26,Senate,"Do pass as amended, but first amend, and re-refer to the Committee on [Appropriations]",7,2,0,0,9
966900,646467,2017-05-18,Senate,"Senate 3rd Reading SB790 McGuire et al",23,13,4,0,40
966900,669015,2017-06-27,Assembly,"Do pass as amended",8,3,4,0,15
966900,773112,2018-08-28,Assembly,"Do pass",14,0,1,0,15
966900,774240,2018-08-31,Senate,"That the Assembly amendments be concurred in",8,0,1,0,9
966900,774241,2018-08-31,Senate,"Unfinished Business SB790 McGuire et al. Concurrence",39,0,1,0,40
966900,774242,2018-08-31,Assembly,"SB 790 McGuire Senate Third Reading By LEVINE",78,1,1,0,80
966901,684724,2018-01-09,Senate,"Do pass, but first be re-referred to the Committee on [Appropriations]",4,1,0,0,5
966901,685430,2018-01-16,Senate,"Placed on suspense file",7,0,0,0,7
966901,686245,2018-01-18,Senate,"Do pass",5,2,0,0,7
966901,690085,2018-01-29,Senate,"Senate 3rd Reading SB759 McGuire",27,12,1,0,40
966901,768901,2018-06-27,Assembly,"Do pass as amended and be re-referred to the Committee on [Appropriations]",5,2,0,0,7
966901,771082,2018-08-08,Assembly,"Do pass",12,5,0,0,17
966901,771737,2018-08-16,Assembly,"SB 759 McGuire Senate Third Reading By MULLIN Amendment Set #1",53,25,2,0,80
966901,772575,2018-08-23,Assembly,"SB 759 McGuire Third Reading Urgency By MULLIN",53,24,3,0,80
966901,772786,2018-08-27,Assembly,"SB 759 McGuire Third Reading Urgency By MULLIN",55,25,0,0,80
966901,773151,2018-08-28,Senate,"Unfinished Business SB759 McGuire et al. Urgency Clause Concurrence",27,11,2,0,40
966902,637398,2017-05-03,Assembly,"Do pass",13,0,0,0,13
966902,653956,2017-05-30,Assembly,"AB 1398 KALRA Assembly Third Reading",77,0,3,0,80
966902,672375,2017-07-12,Senate,"Do pass and be ordered to the Consent Calendar",10,0,3,0,13
966902,672978,2017-07-20,Senate,"Consent Calendar 2nd AB1398 Kalra",38,0,2,0,40
966902,674178,2017-08-28,Assembly,"AB 1398 KALRA Concurrence in Senate Amendments",73,0,6,0,79
966904,628843,2017-04-19,Assembly,"Do pass as amended and be re-referred to the Committee on [Appropriations]",5,3,1,0,9
966904,649481,2017-05-24,Assembly,"Do pass",13,3,1,0,17
966904,654351,2017-05-30,Assembly,"AB 1414 FRIEDMAN Assembly Third Reading",61,12,7,0,80
966904,671374,2017-07-05,Senate,"Do pass, but first be re-referred to the Committee on [Appropriations]",6,1,0,0,7
966904,675104,2017-09-06,Senate,"Assembly 3rd Reading AB1414 Friedman By McGuire",29,11,0,0,40
966904,675520,2017-09-11,Assembly,"AB 1414 FRIEDMAN Concurrence in Senate Amendments",57,15,7,0,79
966905,626973,2017-04-18,Assembly,"Do pass as amended",7,0,0,0,7
966905,643638,2017-05-11,Assembly,"AB 1192 LACKEY Third Reading Urgency",70,1,9,0,80
966905,753218,2018-05-15,Senate,"Do pass",6,0,1,0,7
966905,763364,2018-06-14,Senate,"Assembly 3rd Reading AB1192 Lackey By Anderson",34,0,5,0,39
966905,767133,2018-06-21,Assembly,"AB 1192 LACKEY Concurrence in Senate Amendments",62,2,16,0,80
966907,631477,2017-04-25,Assembly,"Do pass as amended and be re-referred to the Committee on [Appropriations]",11,0,0,0,11
966907,651854,2017-05-26,Assembly,"Do pass",16,0,1,0,17
966907,654430,2017-05-30,Assembly,"AB 1479 BONTA Assembly Third Reading",71,1,8,0,80
966907,672302,2017-07-11,Senate,"Do pass as amended, but first amend, and re-refer to the Committee on [Appropriations]",6,1,0,0,7
966907,673838,2017-08-21,Senate,"Placed on suspense file",7,0,0,0,7
966907,674659,2017-09-01,Senate,"Do pass as amended",7,0,0,0,7
966907,675016,2017-09-06,Senate,"Assembly 3rd Reading AB1479 Bonta et al. By Wieckowski",39,0,1,0,40
966907,675322,2017-09-11,Assembly,"AB 1479 BONTA Concurrence in Senate Amendments",76,0,3,0,79
966907,775193,2017-09-06,Senate,,7,0,1,0,8
966908,613669,2017-03-28,Senate,"Do pass as amended, but first amend, and re-refer to the Committee on [Environmental Quality]",7,2,0,0,9
966908,627957,2017-04-19,Senate,"Do pass as amended, but first amend, and re-refer to the Committee on [Appropriations]",5,2,0,0,7
966908,647964,2017-05-22,Senate,"Placed on suspense file",7,0,0,0,7
966909,627871,2017-04-18,Senate,"Do pass, but first be re-referred to the Committee on [Human Services]",5,2,0,0,7
966909,632073,2017-04-25,Senate,"Do pass as amended, but first amend, and re-refer to the Committee on [Appropriations]",3,1,1,0,5
966909,644625,2017-05-15,Senate,"Placed on suspense file",7,0,0,0,7
966911,618418,2017-04-04,Senate,"Do pass, but first be re-referred to the Committee on [Judiciary]",4,0,1,0,5
966912,627025,2017-04-18,Assembly,"Do pass as amended, and be re-referred to the Committee on [Appropriations] with recommendation: To Consent Calendar",11,0,0,0,11
966912,637239,2017-05-03,Assembly,"Do pass. To Consent Calendar",16,0,1,0,17
966912,643541,2017-05-11,Assembly,"AB 1450 OBERNOLTE Consent Calendar Second Day Regular Session",77,0,3,0,80
966912,669667,2017-06-27,Senate,"Do pass, but first be re-referred to the Committee on [Appropriations] with the recommendation: To Consent Calendar",6,0,1,0,7
966912,675684,2017-09-12,Senate,"Assembly 3rd Reading AB1450 Obernolte By Hertzberg",40,0,0,0,40
966912,675788,2017-09-13,Assembly,"AB 1450 Obernolte Concurrence in Senate Amendments",77,1,1,0,79
966912,775184,2017-09-12,Senate,"Assembly 3rd Reading AB145",6,0,0,0,6
966914,634439,2017-04-26,Assembly,"Do pass as amended and be re-referred to the Committee on [Appropriations]",9,0,0,0,9
966914,649428,2017-05-24,Assembly,"Do pass. To Consent Calendar",17,0,0,0,17
966914,654452,2017-05-30,Assembly,"AB 1156 TING Consent Calendar Second Day Regular Session",77,0,3,0,80
966915,634242,2017-04-25,Assembly,"Do pass as amended and be re-referred to the Committee on [Appropriations]",5,1,1,0,7
966915,651689,2017-05-26,Assembly,"Do pass as amended",12,4,1,0,17
966915,655855,2017-05-31,Assembly,"AB 1380 SANTIAGO Assembly Third Reading",46,23,11,0,80
966915,672381,2017-07-11,Senate,"Do pass, but first be re-referred to the Committee on [Appropriations]",4,3,0,0,7
966915,673757,2017-08-21,Senate,"Placed on suspense file",7,0,0,0,7
966916,627366,2017-04-18,Senate,"Do pass as amended, but first amend, and re-refer to the Committee on [Appropriations]",5,0,0,0,5
966916,654034,2017-05-30,Senate,"Senate 3rd Reading SB679 Morrell",38,0,2,0,40
966916,669925,2017-06-28,Assembly,"Do pass and be re-referred to the Committee on [Appropriations]",7,0,0,0,7
966917,627154,2017-04-18,Senate,"Do pass as amended, but first amend, and re-refer to the Committee on [Appropriations]",5,0,0,0,5
966917,628053,2017-04-18,Senate,"Do pass as amended, but first amend, and re-refer to the Committee on [Transportation and Housing]",5,0,0,0,5
966917,632166,2017-04-25,Senate,"Do pass, but first be re-referred to the Committee on [Appropriations]",13,0,0,0,13
966917,647960,2017-05-22,Senate,"Placed on suspense file",7,0,0,0,7
966918,620453,2017-04-05,Assembly,"Do pass and be re-referred to the Committee on [Appropriations]",9,0,1,0,10
966918,633516,2017-04-26,Assembly,"Do pass",16,0,1,0,17
966918,638310,2017-05-04,Assembly,"AB 1486 CABALLERO Assembly Third Reading",71,0,9,0,80
966918,659239,2017-06-06,Senate,"Do pass, but first be re-referred to the Committee on [Appropriations]",4,0,1,0,5
966918,672789,2017-07-17,Senate,"Assembly 3rd Reading AB1486 Caballero By Dodd",39,1,0,0,40
966919,633127,2017-04-26,Assembly,"Do pass and be re-referred to the Committee on [Appropriations]",9,0,1,0,10
966919,652122,2017-05-26,Assembly,"Do pass",14,1,2,0,17
966919,655735,2017-05-31,Assembly,"AB 1348 AGUIAR-CURRY Assembly Third Reading",72,4,4,0,80
966919,671711,2017-07-06,Senate,"Do pass, but first be re-referred to the Committee on [Appropriations]",4,0,1,0,5
966919,672791,2017-07-17,Senate,"Placed on suspense file",7,0,0,0,7
966919,674834,2017-09-01,Senate,"Do pass",5,2,0,0,7
966919,675030,2017-09-06,Senate,"Assembly 3rd Reading AB1348 Aguiar-Curry et al. By Galgiani",31,8,1,0,40
966919,675342,2017-09-11,Assembly,"AB 1348 AGUIAR-CURRY Concurrence in Senate Amendments",72,5,2,0,79
966920,631774,2017-04-24,Senate,"Do pass, but first be re-referred to the Committee on [Appropriations]",8,0,1,0,9
966920,644315,2017-05-15,Senate,"Placed on suspense file",7,0,0,0,7
966920,650512,2017-05-25,Senate,"Do pass as amended",7,0,0,0,7
966920,656010,2017-05-31,Senate,"Senate 3rd Reading SB797 Hill",40,0,0,0,40
966920,668581,2017-06-26,Assembly,"Be re-referred to the Committee on [Local Government]",9,0,2,0,11
966920,672526,2017-07-12,Assembly,"Do pass",6,3,0,0,9
966920,674706,2017-09-01,Assembly,"SB 797 Hill Senate Third Reading By BERMAN",48,27,4,0,79
966920,675132,2017-09-07,Senate,"That the Assembly amendments be concurred in",9,1,3,0,13
966920,675453,2017-09-11,Senate,"Unfinished Business SB797 Hill et al. Concurrence",26,12,2,0,40
966921,613644,2017-03-28,Assembly,"Do pass as amended and be re-referred to the Committee on [Appropriations]",6,0,1,0,7
966921,651884,2017-05-26,Assembly,"Do pass",16,0,1,0,17
966921,654460,2017-05-30,Assembly,"AB 1408 CALDERON Assembly Third Reading",72,0,8,0,80
966921,669083,2017-06-27,Senate,"Do pass, but first be re-referred to the Committee on [Appropriations]",5,0,2,0,7
966921,672700,2017-07-17,Senate,"Placed on suspense file",7,0,0,0,7
966921,674472,2017-09-01,Senate,"Do pass",7,0,0,0,7
966921,675704,2017-09-12,Senate,"Assembly 3rd Reading AB1408 Calderon et al. By Mendoza",39,0,1,0,40
966921,675862,2017-09-13,Assembly,"AB 1408 Calderon Concurrence in Senate Amendments",78,0,1,0,79
966922,633091,2017-04-26,Assembly,"Do pass and be re-referred to the Committee on [Appropriations]",6,1,0,0,7
966923,615710,2017-03-29,Assembly,"Do pass and be re-referred to the Committee on [Appropriations]",18,0,3,0,21
966923,633271,2017-04-26,Assembly,"Do pass. To Consent Calendar",16,0,1,0,17
966923,638422,2017-05-04,Assembly,"AB 1285 GIPSON Consent Calendar Second Day Regular Session",76,0,4,0,80
966923,669228,2017-06-27,Senate,"Do pass, but first be re-referred to the Committee on [Appropriations] with the recommendation: To Consent Calendar",13,0,0,0,13
966923,672645,2017-07-13,Senate,"Consent Calendar 2nd AB1285",39,0,1,0,40
966923,673759,2017-08-21,Assembly,"AB 1285 GIPSON Concurrence in Senate Amendments",77,0,2,0,79
966925,627847,2017-04-19,Assembly,"Do pass and be re-referred to the Committee on [Appropriations]",7,0,0,0,7
966925,651526,2017-05-26,Assembly,"Do pass",17,0,0,0,17
966925,655884,2017-05-31,Assembly,"AB 1528 ACOSTA Assembly Third Reading",63,8,9,0,80
966925,671399,2017-07-05,Senate,"Do pass, but first be re-referred to the Committee on [Appropriations]",3,2,2,0,7
966925,671400,2017-07-05,Senate,"[First] hearing set for [07-05-2017]: Failed passage in Committee. Reconsideration granted",6,0,1,0,7
966925,672448,2017-07-12,Senate,"Do pass, but first be re-referred to the Committee on [Appropriations]",5,1,1,0,7
966925,674194,2017-08-28,Senate,"Placed on suspense file",7,0,0,0,7
966926,608486,2017-03-21,Assembly,"Do pass as amended and be re-referred to the Committee on [Appropriations]",6,0,1,0,7
966926,619915,2017-04-05,Assembly,"Do pass. To Consent Calendar",17,0,0,0,17
966926,629219,2017-04-20,Assembly,"AB 1480 QUIRK Consent Calendar Second Day Regular Session",74,0,6,0,80
966926,660307,2017-06-07,Senate,"Do pass, but first be re-referred to the Committee on [Judiciary] with the recommendation: To Consent Calendar",7,0,0,0,7
966926,666288,2017-06-20,Senate,"Do pass, but first be re-referred to the Committee on [Appropriations] with the recommendation: To Consent Calendar",7,0,0,0,7
966926,672558,2017-07-13,Senate,"Consent Calendar 2nd AB1480",39,0,1,0,40
966927,633328,2017-04-26,Assembly,"Do pass as amended and be re-referred to the Committee on [Appropriations]",7,0,0,0,7
966927,651885,2017-05-26,Assembly,"Do pass as amended",16,0,1,0,17
966927,655853,2017-05-31,Assembly,"AB 1239 HOLDEN Assembly Third Reading",70,4,6,0,80
966927,672034,2017-07-11,Senate,"Do pass as amended, but first amend, and re-refer to the Committee on [Appropriations]",12,1,0,0,13
966927,673858,2017-08-21,Senate,"Placed on suspense file",7,0,0,0,7
966927,674491,2017-09-01,Senate,"Do pass as amended",7,0,0,0,7
966927,675037,2017-09-06,Senate,"Assembly 3rd Reading AB1239 Holden By Wieckowski",39,0,1,0,40
966927,675502,2017-09-11,Assembly,"AB 1239 HOLDEN Concurrence in Senate Amendments",76,1,2,0,79
966928,631646,2017-04-25,Assembly,"Do pass as amended and be re-referred to the Committee on [Appropriations]",7,3,0,0,10
966929,613638,2017-03-28,Assembly,"Do pass as amended and be re-referred to the Committee on [Appropriations]",7,0,0,0,7
966929,651850,2017-05-26,Assembly,"Do pass as amended",15,0,2,0,17
966929,655972,2017-05-31,Assembly,"AB 1312 GONZALEZ FLETCHER Assembly Third Reading",77,0,3,0,80
966929,672173,2017-07-11,Senate,"Do pass, but first be re-referred to the Committee on [Appropriations] with the recommendation: To Consent Calendar",7,0,0,0,7
966929,673810,2017-08-21,Senate,"Placed on suspense file",7,0,0,0,7
966929,674551,2017-09-01,Senate,"Do pass as amended",7,0,0,0,7
966929,675171,2017-09-07,Senate,"Assembly 3rd Reading AB1312 Gonzalez Fletcher By Skinner",40,0,0,0,40
966929,675494,2017-09-11,Assembly,"AB 1312 GONZALEZ FLETCHER Concurrence in Senate Amendments",77,0,2,0,79
966930,627778,2017-04-18,Assembly,"Do pass and be re-referred to the Committee on [Health]",3,1,3,0,7
966930,627779,2017-04-18,Assembly,Reconsideration,6,0,1,0,7
966930,630337,2017-04-24,Assembly,"Do pass and be re-referred to the Committee on [Health]",6,0,1,0,7
966930,631496,2017-04-25,Assembly,"Do pass as amended and be re-referred to the Committee on [Appropriations]",14,0,1,0,15
966930,649284,2017-05-24,Assembly,"Do pass. To Consent Calendar",17,0,0,0,17
966930,654345,2017-05-30,Assembly,"AB 1335 KALRA Consent Calendar Second Day Regular Session",77,0,3,0,80
966930,768911,2018-06-27,Senate,"Do pass as amended, but first amend, and re-refer to the Committee on [Appropriations]",6,2,1,0,9
966930,770251,2018-08-06,Senate,"Placed on suspense file",7,0,0,0,7
966932,627266,2017-04-18,Assembly,"Do pass and be re-referred to the Committee on [Appropriations]",15,0,1,0,16
966932,637395,2017-05-03,Assembly,"Do pass. To Consent Calendar",16,0,1,0,17
966932,643367,2017-05-11,Assembly,"AB 1277 DALY Consent Calendar Second Day Regular Session",77,0,3,0,80
966932,665346,2017-06-19,Senate,"Do pass, but first be re-referred to the Committee on [Appropriations] with the recommendation: To Consent Calendar",9,0,0,0,9
966932,675136,2017-09-07,Senate,"Assembly 3rd Reading AB1277 Daly By Newman",39,0,1,0,40
966932,675401,2017-09-11,Assembly,"AB 1277 DALY Concurrence in Senate Amendments",78,0,1,0,79
966933,627094,2017-04-18,Senate,"Do pass, but first be re-referred to the Committee on [Appropriations]",2,5,0,0,7
966933,627095,2017-04-18,Senate,"[Second] hearing set for [04-18-2017]: Failed passage in Committee. Reconsideration granted",7,0,0,0,7
966935,627242,2017-04-18,Senate,"Do pass, but first be re-referred to the Committee on [Appropriations]",1,3,1,0,5
966935,627243,2017-04-18,Senate,"[04-18-2017] hearing: Motion to Reconsider. [Reconsideration Granted.]",4,0,1,0,5
966935,628143,2017-04-18,Senate,"[First] hearing set for [04-19-2017]: Failed passage in Committee. Reconsideration granted",0,4,1,0,5
966936,684866,2018-01-09,Senate,"Do pass",2,1,4,0,7
966936,684867,2018-01-09,Senate,"[Second] hearing set for [01-09-2018]: Failed passage in Committee. Reconsideration granted",7,0,0,0,7
966938,627841,2017-04-19,Assembly,"Do pass and be re-referred to the Committee on [Appropriations]",2,5,0,0,7
966940,620133,2017-04-05,Senate,"Do pass as amended",6,1,0,0,7
966940,640622,2017-05-08,Senate,"Senate 3rd Reading SB607 Skinner et al",29,9,2,0,40
966940,667211,2017-06-21,Assembly,"Do pass as amended",6,1,0,0,7
966940,772563,2018-08-23,Assembly,"SB 607 Skinner Senate Third Reading By GONZALEZ FLETCHER Amendment Set #1",51,21,8,0,80
966940,774179,2018-08-31,Senate,"Unfinished Business SB607 Skinner et al. Concurrence",28,11,1,0,40
966940,774180,2018-08-31,Assembly,"SB 607 Skinner Senate Third Reading By GONZALEZ FLETCHER",55,23,2,0,80
966941,626943,2017-04-18,Senate,"Do pass",11,0,2,0,13
966941,630462,2017-04-24,Senate,"Senate 3rd Reading SB680 Wieckowski",35,2,3,0,40
966941,668654,2017-06-26,Assembly,"Do pass",10,2,2,0,14
966941,671528,2017-07-06,Assembly,"SB 680 Wieckowski Senate Third Reading By GRAYSON",56,14,10,0,80
966943,633493,2017-04-26,Senate,"Do pass, but first be re-referred to the Committee on [Appropriations]",4,1,0,0,5
966943,644512,2017-05-15,Senate,"Senate 3rd Reading SB772 Leyva",26,12,2,0,40
966943,667249,2017-06-21,Assembly,"Do pass and be re-referred to the Committee on [Appropriations]",5,2,0,0,7
966943,672867,2017-07-19,Assembly,"Do pass",12,4,1,0,17
966944,627442,2017-04-17,Assembly,"Do pass and be re-referred to the Committee on [Veterans Affairs]",10,0,0,0,10
966944,633490,2017-04-25,Assembly,"Do pass and be re-referred to the Committee on [Appropriations]",10,0,0,0,10
966944,651973,2017-05-26,Assembly,"Do pass",17,0,0,0,17
966944,654482,2017-05-30,Assembly,"AB 1249 GRAY Assembly Third Reading",77,0,3,0,80
966944,663005,2017-06-14,Senate,"Do pass, but first be re-referred to the Committee on [Appropriations]",6,0,1,0,7
966944,668860,2017-06-26,Senate,"Placed on suspense file",7,0,0,0,7
966944,674753,2017-09-01,Senate,"Do pass",7,0,0,0,7
966944,675147,2017-09-07,Senate,"Assembly 3rd Reading AB1249 Gray et al. By Anderson",39,0,1,0,40
966945,613709,2017-03-28,Senate,"Do pass, but first be re-referred to the Committee on [Business, Professions and Economic Development]",7,0,0,0,7
966945,618387,2017-03-28,Senate,"Do pass as amended, but first amend, and re-refer to the Committee on [Business, Professions and Economic Development]",7,0,0,0,7
966945,631834,2017-04-24,Senate,"Do pass, but first be re-referred to the Committee on [Appropriations]",8,0,1,0,9
966945,644460,2017-05-15,Senate,"Senate 3rd Reading SB631 Nielsen",39,0,1,0,40
966945,667928,2017-06-22,Assembly,"Be re-referred to the Committees on [Business and Professions] and [Judiciary]",9,0,2,0,11
966945,669141,2017-06-27,Assembly,"Do pass as amended and be re-referred to the Committee on [Judiciary]",16,0,0,0,16
966946,626207,2017-04-17,Assembly,"Do pass and be re-referred to the Committee on [Appropriations] with recommendation: To Consent Calendar",13,0,1,0,14
966946,651971,2017-05-26,Assembly,"Do pass",17,0,0,0,17
966946,655854,2017-05-31,Assembly,"AB 1633 FRAZIER Assembly Third Reading",76,0,4,0,80
966946,669289,2017-06-27,Senate,"Do pass, but first be re-referred to the Committee on [Appropriations] with the recommendation: To Consent Calendar",12,0,1,0,13
966946,672541,2017-07-13,Senate,"Consent Calendar 2nd AB1633",39,0,1,0,40
966947,627169,2017-04-18,Assembly,"Do pass and be re-referred to the Committee on [Appropriations]",15,0,1,0,16
966947,637744,2017-05-03,Assembly,"Do pass. To Consent Calendar",16,0,1,0,17
966947,651448,2017-05-26,Assembly,"AB 1153 LOW Assembly Third Reading",75,0,5,0,80
966947,671020,2017-07-03,Senate,"Do pass, but first be re-referred to the Committee on [Appropriations]",6,0,3,0,9
966947,675518,2017-09-11,Senate,"Assembly 3rd Reading AB1153 Low By Wilk",40,0,0,0,40
966947,675711,2017-09-12,Assembly,"AB 1153 LOW Concurrence in Senate Amendments",79,0,0,0,79
966948,628160,2017-04-19,Assembly,"Do pass and be re-referred to the Committee on [Appropriations]",6,1,0,0,7
966948,637990,2017-05-03,Assembly,"Do pass",11,4,2,0,17
966948,640711,2017-05-08,Assembly,"AB 1487 RODRIGUEZ Assembly Third Reading",56,17,7,0,80
966948,661658,2017-06-12,Senate,"Do pass, but first be re-referred to the Committee on [Appropriations]",3,2,0,0,5
966948,673870,2017-08-21,Senate,"Assembly 3rd Reading AB1487 Rodriguez By Atkins",29,10,1,0,40
966948,674073,2017-08-24,Assembly,"AB 1487 RODRIGUEZ Concurrence in Senate Amendments",56,21,2,0,79
966949,617663,2017-04-03,Assembly,"Do pass as amended",13,0,1,0,14
966949,629144,2017-04-20,Assembly,"AB 1303 MCCARTY Assembly Third Reading",75,0,5,0,80
966949,658828,2017-06-06,Senate,"Do pass and be ordered to the Consent Calendar",13,0,0,0,13
966949,673816,2017-08-21,Senate,"Assembly 3rd Reading AB1303 McCarty By Pan",39,0,1,0,40
966949,674104,2017-08-24,Assembly,"AB 1303 MCCARTY Concurrence in Senate Amendments",77,0,2,0,79
966951,632023,2017-04-25,Assembly,"Do pass and be re-referred to the Committee on [Appropriations]",16,0,0,0,16
966951,637601,2017-05-03,Assembly,"Do pass. To Consent Calendar",16,0,1,0,17
966951,643681,2017-05-11,Assembly,"AB 1340 MAIENSCHEIN Consent Calendar Second Day Regular Session",77,0,3,0,80
966951,661887,2017-06-12,Senate,"Do pass as amended, but first amend, and re-refer to the Committee on [Appropriations]",9,0,0,0,9
966951,674915,2017-09-05,Senate,"Assembly 3rd Reading AB1340 Maienschein et al. By Pan",40,0,0,0,40
966951,675138,2017-09-07,Assembly,"AB 1340 MAIENSCHEIN Concurrence in Senate Amendments",79,0,0,0,79
966952,620174,2017-04-05,Senate,"Do pass",6,1,0,0,7
966952,630487,2017-04-24,Senate,"Senate 3rd Reading SB628 Lara",32,5,3,0,40
966952,666906,2017-06-20,Assembly,"Do pass and be re-referred to the Committee on [Elections and Redistricting]",13,0,0,0,13
966952,672516,2017-07-12,Assembly,"Do pass",5,1,1,0,7
966952,674108,2017-08-24,Assembly,"SB 628 Lara Senate Third Reading By BOCANEGRA",67,8,4,0,79
966954,634754,2017-04-27,Assembly,"Do pass and be re-referred to the Committee on [Appropriations]",20,0,1,0,21
966954,651942,2017-05-26,Assembly,"Do pass as amended",12,0,5,0,17
966954,656173,2017-05-31,Assembly,"AB 1499 GRAY Assembly Third Reading",72,0,8,0,80
966954,671441,2017-07-05,Senate,"Do pass as amended, but first amend, and re-refer to the Committee on [Appropriations]",6,0,1,0,7
966954,673938,2017-08-21,Senate,"Placed on suspense file",7,0,0,0,7
966954,674778,2017-09-01,Senate,"Do pass",6,0,1,0,7
966954,675651,2017-09-12,Senate,"Assembly 3rd Reading AB1499 Gray et al. By Cannella",39,0,1,0,40
966954,675927,2017-09-13,Assembly,"AB 1499 Gray Concurrence in Senate Amendments",75,0,4,0,79
966955,634699,2017-04-26,Senate,"Do pass, but first be re-referred to the Committee on [Appropriations]",6,1,0,0,7
966955,647829,2017-05-22,Senate,"Placed on suspense file",7,0,0,0,7
966955,650855,2017-05-25,Senate,"Do pass",5,2,0,0,7
966955,656005,2017-05-31,Senate,"Senate 3rd Reading SB693 Mendoza",25,9,6,0,40
966955,670370,2017-06-28,Assembly,"Do pass as amended and be re-referred to the Committee on [Water, Parks, and Wildlife]",6,1,2,0,9
966955,672153,2017-07-11,Assembly,"Do pass and be re-referred to the Committee on [Appropriations]",10,4,1,0,15
966955,674665,2017-09-01,Assembly,"Do pass",11,5,1,0,17
966955,675598,2017-09-12,Assembly,"SB 693 Mendoza Senate Third Reading By GARCIA, C",56,20,3,0,79
966955,675946,2017-09-13,Senate,"Unfinished Business SB693 Mendoza Concurrence",27,11,2,0,40
966956,633710,2017-04-25,Assembly,"Do pass and be re-referred to the Committee on [Appropriations]",12,0,1,0,13
966956,652153,2017-05-26,Assembly,"Do pass as amended",13,0,4,0,17
966956,655768,2017-05-31,Assembly,"AB 1299 GIPSON Assembly Third Reading",75,0,5,0,80
966956,672518,2017-07-12,Senate,"Do pass, but first be re-referred to the Committee on [Appropriations]",7,0,0,0,7
966956,675045,2017-09-06,Senate,"Assembly 3rd Reading AB1299 Gipson et al. By Bradford",40,0,0,0,40
966956,675533,2017-09-11,Assembly,"AB 1299 GIPSON Concurrence in Senate Amendments",78,0,1,0,79
966957,633160,2017-04-26,Assembly,"Do pass as amended and be re-referred to the Committee on [Appropriations]",5,2,0,0,7
966957,651584,2017-05-26,Assembly,"Do pass as amended",11,5,1,0,17
966957,656180,2017-05-31,Assembly,"AB 1269 STONE Assembly Third Reading",44,24,12,0,80
966957,672385,2017-07-11,Senate,"Do pass, but first be re-referred to the Committee on [Appropriations]",5,2,0,0,7
966957,673855,2017-08-21,Senate,"Placed on suspense file",7,0,0,0,7
966957,674534,2017-09-01,Senate,"Do pass as amended",5,2,0,0,7
966957,675811,2017-09-13,Senate,"Assembly 3rd Reading AB1269 Mark Stone By Jackson",21,16,3,0,40
966957,676511,2017-09-15,Assembly,"AB 1269 STONE Concurrence in Senate Amendments",42,27,10,0,79
966957,777232,2017-05-31,Assembly,"AB 1269 STOh, Chávez, Chen, Dababneh, Flora, Fong, Frazier, Gallagher, Harper, Irwin, Kiley, Lackey, Low, Maienschein, Mathis, Mayes, Obernolte, Patterson, Salas, Waldron",11,5,12,0,28
966960,632089,2017-04-24,Assembly,"Do pass as amended and be re-referred to the Committee on [Appropriations]",10,1,3,0,14
966961,684750,2018-01-09,Assembly,"Do pass and be re-referred to the Committee on [Appropriations]",1,5,1,0,7
966962,627086,2017-04-18,Assembly,"Do pass as amended and be re-referred to the Committee on [Appropriations]",11,0,0,0,11
966963,631847,2017-04-25,Senate,"Do pass, but first be re-referred to the Committee on [Appropriations]",4,0,3,0,7
966963,644264,2017-05-15,Senate,"Placed on suspense file",7,0,0,0,7
966964,632058,2017-04-24,Assembly,"Do pass as amended and be re-referred to the Committee on [Appropriations]",7,1,2,0,10
966964,646049,2017-05-17,Assembly,"Do pass",12,5,0,0,17
966964,647985,2017-05-22,Assembly,"AB 1288 EGGMAN Assembly Third Reading",58,13,9,0,80
966965,626133,2017-04-17,Assembly,"Be re-referred to the Committee on [Human Services]",9,0,2,0,11
966965,633305,2017-04-25,Assembly,"Do pass and be re-referred to the Committee on [Appropriations]",5,2,0,0,7
966965,643174,2017-05-10,Assembly,"Do pass",12,5,0,0,17
966965,648334,2017-05-22,Assembly,"AB 1513 KALRA Assembly Third Reading",49,27,4,0,80
966965,672452,2017-07-11,Senate,"Do pass as amended, but first amend, and re-refer to the Committee on [Appropriations]",4,3,0,0,7
966965,673957,2017-08-21,Senate,"Placed on suspense file",7,0,0,0,7
966965,674772,2017-09-01,Senate,"Do pass",5,2,0,0,7
966965,675458,2017-09-11,Senate,"Assembly 3rd Reading AB1513 Kalra By Leyva",21,16,3,0,40
966965,675867,2017-09-13,Assembly,"AB 1513 KALRA Concurrence in Senate Amendments",49,28,2,0,79
966966,626793,2017-04-18,Assembly,"Do pass and be re-referred to the Committee on [Appropriations]",7,0,0,0,7
966966,635651,2017-05-01,Assembly,"AB 1459 QUIRK-SILVA Assembly Third Reading",73,0,7,0,80
966966,662179,2017-06-13,Senate,"Do pass",7,0,0,0,7
966966,672731,2017-07-17,Senate,"Assembly 3rd Reading AB1459 Quirk-Silva et al. By Newman",40,0,0,0,40
966966,673785,2017-08-21,Assembly,"AB 1459 QUIRK-SILVA Concurrence in Senate Amendments",78,0,1,0,79
966967,626778,2017-04-18,Assembly,"Do pass and be re-referred to the Committee on [Judiciary]",1,5,1,0,7
966967,626779,2017-04-18,Assembly,Reconsideration,2,5,0,0,7
966969,620106,2017-04-04,Senate,"Do pass and be ordered to the Consent Calendar",6,0,1,0,7
966969,654819,2017-05-30,Senate,"Senate 3rd Reading SB690 Jackson Urgency Clause",40,0,0,0,40
966969,672814,2017-07-18,Assembly,"Do pass as amended",11,0,0,0,11
966969,674827,2017-09-01,Assembly,"SB 690 Jackson Third Reading Urgency By STONE",77,0,2,0,79
966969,675150,2017-09-07,Senate,"Unfinished Business SB690 Jackson Urgency Clause Concurrence",40,0,0,0,40
966970,619980,2017-04-05,Assembly,"Do pass as amended and be re-referred to the Committee on [Local Government]",13,0,0,0,13
966970,634387,2017-04-26,Assembly,"Do pass as amended and be re-referred to the Committee on [Appropriations]",9,0,0,0,9
966970,645879,2017-05-17,Assembly,"Do pass",17,0,0,0,17
966970,651385,2017-05-26,Assembly,"AB 1145 QUIRK Assembly Third Reading",76,0,4,0,80
966970,666097,2017-06-20,Senate,"Do pass as amended, but first amend, and re-refer to the Committee on [Governance and Finance]",9,0,2,0,11
966970,672397,2017-07-12,Senate,"Do pass as amended, but first amend, and re-refer to the Committee on [Appropriations]",7,0,0,0,7
966970,673879,2017-08-21,Senate,"Do pass",7,0,0,0,7
966970,674367,2017-08-31,Senate,"Special Consent Calendar # AB1145",37,0,3,0,40
966970,674886,2017-09-05,Assembly,"AB 1145 QUIRK Concurrence in Senate Amendments",77,0,2,0,79
966971,620214,2017-04-05,Assembly,"Do pass and be re-referred to the Committee on [Appropriations]",7,0,3,0,10
966971,633582,2017-04-26,Assembly,"Do pass",13,3,1,0,17
966971,643900,2017-05-11,Assembly,"AB 1351 CABALLERO Assembly Third Reading",56,20,4,0,80
966971,666142,2017-06-20,Senate,"Do pass, but first be re-referred to the Committee on [Appropriations]",3,0,2,0,5
966971,674415,2017-08-31,Senate,"Assembly 3rd Reading AB1351 Caballero By Galgiani",28,8,4,0,40
966971,674861,2017-09-05,Assembly,"AB 1351 CABALLERO Concurrence in Senate Amendments",55,21,3,0,79
966972,627023,2017-04-18,Senate,"Do pass, but first be re-referred to the Committee on [Environmental Quality]",11,0,0,0,11
966972,628014,2017-04-19,Senate,"Do pass as amended, but first amend, and re-refer to the Committee on [Appropriations]",7,0,0,0,7
966972,647952,2017-05-22,Senate,"Senate 3rd Reading SB618 Bradford",37,0,3,0,40
966972,667092,2017-06-21,Assembly,"Do pass and be re-referred to the Committee on [Natural Resources]",11,0,4,0,15
966972,672064,2017-07-10,Assembly,"Do pass as amended and be re-referred to the Committee on [Appropriations]",10,0,0,0,10
966972,674027,2017-08-23,Assembly,"Do pass. To Consent Calendar",15,0,2,0,17
966972,675121,2017-09-07,Assembly,"SB 618 Bradford Senate Third Reading By GARCIA, E",75,0,4,0,79
966972,676117,2017-09-14,Senate,"Special Consent Calendar SB618",40,0,0,0,40
966973,612942,2017-03-27,Senate,"Do pass, but first be re-referred to the Committee on [Appropriations]",2,3,0,0,5
966974,684720,2018-01-09,Assembly,"Do pass and be re-referred to the Committee on [Appropriations] with recommendation: To Consent Calendar",7,0,0,0,7
966974,686202,2018-01-18,Assembly,"Do pass",17,0,0,0,17
966974,686203,2018-01-18,Assembly,"Set, [First] hearing. Referred to suspense file",17,0,0,0,17
966974,690036,2018-01-29,Assembly,"AB 1511 LOW Assembly Third Reading",77,0,0,0,77
966974,753325,2018-05-15,Senate,"Do pass as amended, but first amend, and re-refer to the Committee on [Appropriations]",5,0,2,0,7
966974,767923,2018-06-25,Senate,"Placed on suspense file",7,0,0,0,7
966974,771667,2018-08-16,Senate,"Do pass",7,0,0,0,7
966974,772666,2018-08-24,Senate,"Special Consent AB1511 Low et al. By Jackson Urgency Clause",39,0,1,0,40
966974,773515,2018-08-29,Assembly,"AB 1511 LOW Concurrence - Urgency Added",78,0,2,0,80
966975,627917,2017-04-19,Assembly,"Do pass as amended and be re-referred to the Committee on [Appropriations]",7,0,0,0,7
966975,637512,2017-05-03,Assembly,"Do pass. To Consent Calendar",16,0,1,0,17
966975,643526,2017-05-11,Assembly,"AB 1137 MAIENSCHEIN Consent Calendar Second Day Regular Session",77,0,3,0,80
966975,658639,2017-06-06,Senate,"Do pass, but first be re-referred to the Committee on [Appropriations] with the recommendation: To Consent Calendar",13,0,0,0,13
966975,668582,2017-06-26,Senate,"Placed on suspense file",7,0,0,0,7
966975,674459,2017-09-01,Senate,"Do pass as amended",7,0,0,0,7
966975,675396,2017-09-11,Senate,"Assembly 3rd Reading AB1137 Maienschein By Jackson",39,0,1,0,40
966975,675807,2017-09-13,Assembly,"AB 1137 MAIENSCHEIN Concurrence in Senate Amendments",79,0,0,0,79
966975,777479,2017-09-11,Senate,,7,0,1,0,8
966976,620045,2017-04-04,Assembly,"Do pass as amended and be re-referred to the Committee on [Aging and Long-Term Care]",7,0,0,0,7
966976,630435,2017-04-24,Assembly,"Do pass and be re-referred to the Committee on [Appropriations] with recommendation: To Consent Calendar",6,0,1,0,7
966976,649460,2017-05-24,Assembly,"Do pass. To Consent Calendar",17,0,0,0,17
966976,654280,2017-05-30,Assembly,"AB 1437 PATTERSON Consent Calendar Second Day Regular Session",77,0,3,0,80
966976,669112,2017-06-27,Senate,"Do pass, but first be re-referred to the Committee on [Appropriations] with the recommendation: To Consent Calendar",5,0,0,0,5
966976,772813,2018-08-27,Senate,"That the measure be returned to Senate Floor for consideration. Ordered to third reading",6,0,1,0,7
966976,773479,2018-08-29,Senate,"Assembly 3rd Reading AB1437 Patterson et al. By Wiener",39,0,1,0,40
966976,773897,2018-08-30,Assembly,"With recommendation: That Senate amendments be concurred in",5,0,2,0,7
966976,774086,2018-08-31,Assembly,"AB 1437 PATTERSON Concurrence in Senate Amendments",77,2,1,0,80
966977,627751,2017-04-19,Senate,"Do pass as amended, but first amend, and re-refer to the Committee on [Business, Professions and Economic Development]",7,0,0,0,7
966977,644304,2017-05-15,Senate,"Senate 3rd Reading SB764 Moorlach",39,0,1,0,40
966977,669003,2017-06-27,Assembly,"Do pass and be re-referred to the Committee on [Appropriations]",15,0,1,0,16
966977,672944,2017-07-19,Assembly,"Do pass. To Consent Calendar",16,0,1,0,17
966977,674152,2017-08-24,Assembly,"SB 764 Moorlach Consent Calendar Second Day Regular Session",76,0,3,0,79
966978,685053,2018-01-11,Assembly,"Do pass and be re-referred to the Committee on [Appropriations]",2,5,0,0,7
966978,685054,2018-01-11,Assembly,Reconsideration,7,0,0,0,7
966979,631736,2017-04-24,Assembly,"Do pass and be re-referred to the Committee on [Appropriations]",10,0,0,0,10
966983,662115,2017-06-13,Senate,"Do pass as amended, but first amend, and re-refer to the Committee on [Appropriations]",7,2,0,0,9
966983,671842,2017-07-10,Senate,"Do pass",5,2,0,0,7
966983,690938,2018-01-30,Senate,"Senate 3rd Reading SB714 Newman et al. Urgency Clause",27,11,2,0,40
966984,631576,2017-04-24,Senate,"Do pass, but first be re-referred to the Committee on [Appropriations]",8,0,1,0,9
966984,644574,2017-05-15,Senate,"Placed on suspense file",7,0,0,0,7
966984,650254,2017-05-25,Senate,"Do pass as amended",7,0,0,0,7
966984,656194,2017-05-31,Senate,"Senate 3rd Reading SB796 Hill",40,0,0,0,40
966984,672092,2017-07-11,Assembly,"Do pass as amended and be re-referred to the Committee on [Appropriations]",16,0,0,0,16
966984,674590,2017-09-01,Assembly,"Do pass as amended",16,0,1,0,17
966984,675846,2017-09-13,Assembly,"SB 796 Hill Senate Third Reading By LOW",76,1,2,0,79
966984,676170,2017-09-14,Senate,"Unfinished Business SB796 Hill Concurrence",40,0,0,0,40
966985,684776,2018-01-09,Assembly,"Do pass and be re-referred to the Committee on [Appropriations]",7,0,0,0,7
966985,686277,2018-01-18,Assembly,"Do pass",17,0,0,0,17
966985,690086,2018-01-29,Assembly,"AB 1262 GARCIA, E. Assembly Third Reading",75,0,2,0,77
966985,753231,2018-05-15,Senate,"Do pass, but first be re-referred to the Committee on [Appropriations] with the recommendation: To Consent Calendar",7,0,0,0,7
966985,767882,2018-06-25,Senate,"Placed on suspense file",7,0,0,0,7
966986,618340,2017-04-04,Assembly,"Do pass as amended, and be re-referred to the Committee on [Human Services] with recommendation: To Consent Calendar",11,0,0,0,11
966986,633111,2017-04-25,Assembly,"Do pass as amended, and be re-referred to the Committee on [Appropriations] with recommendation: To Consent Calendar",7,0,0,0,7
966986,645924,2017-05-17,Assembly,"Do pass. To Consent Calendar",17,0,0,0,17
966986,651484,2017-05-26,Assembly,"AB 1371 STONE Consent Calendar Second Day Regular Session",76,0,4,0,80
966986,669177,2017-06-27,Senate,"Do pass as amended, but first amend, and re-refer to the Committee on [Judiciary] with the recommendation: To Consent Calendar",5,0,0,0,5
966986,672376,2017-07-11,Senate,"Do pass, but first be re-referred to the Committee on [Appropriations] with the recommendation: To Consent Calendar",7,0,0,0,7
966986,673851,2017-08-21,Senate,"Placed on suspense file",7,0,0,0,7
966986,674539,2017-09-01,Senate,"Do pass",7,0,0,0,7
966986,676137,2017-09-14,Senate,"Special Consent Calendar # AB1371",40,0,0,0,40
966986,676363,2017-09-14,Assembly,"AB 1371 Mark Stone Special Consent Calendar 1st Day Regular Session",79,0,0,0,79
966988,633835,2017-04-26,Assembly,"Do pass and be re-referred to the Committee on [Appropriations]",5,2,0,0,7
966988,642903,2017-05-10,Assembly,"Do pass",12,5,0,0,17
966988,648038,2017-05-22,Assembly,"AB 1407 MCCARTY Assembly Third Reading",53,24,3,0,80
966988,666464,2017-06-20,Senate,"Do pass, but first be re-referred to the Committee on [Transportation and Housing]",4,1,0,0,5
966988,666465,2017-06-20,Senate,"Do pass, but first be re-referred to the Committee on [Transportation and Housing]",4,1,0,0,5
966988,672275,2017-07-11,Senate,"Do pass, but first be re-referred to the Committee on [Appropriations]",9,3,1,0,13
966988,697663,2018-02-08,Senate,"Assembly 3rd Reading AB1407 McCarty et al. By Stern",25,12,3,0,40
966988,705694,2018-02-20,Assembly,"AB 1407 MCCARTY Concurrence in Senate Amendments",46,22,9,0,77
966989,642741,2017-05-10,Assembly,"Do pass",5,3,1,0,9
966989,647904,2017-05-22,Assembly,"AB 1436 LEVINE Assembly Third Reading",44,28,8,0,80
966989,764801,2018-06-18,Senate,"Do pass as amended, but first amend, and re-refer to the Committee on [Appropriations]",9,0,0,0,9
966989,772168,2018-08-20,Senate,"Assembly 3rd Reading AB1436 Levine et al. By Hill",39,0,1,0,40
966989,773115,2018-08-28,Assembly,"With recommendation: That Senate amendments be concurred in",15,2,2,0,19
966989,773544,2018-08-29,Assembly,"AB 1436 LEVINE Concurrence in Senate Amendments",77,0,3,0,80
966992,642192,2017-05-09,Assembly,"Do pass",9,2,0,0,11
966992,644540,2017-05-15,Assembly,"AB 1159 CHIU Assembly Third Reading",54,24,2,0,80
966992,666290,2017-06-20,Senate,"Do pass",6,1,0,0,7
966992,674407,2017-08-31,Senate,"Assembly 3rd Reading AB1159 Chiu By McGuire",31,8,1,0,40
966992,674914,2017-09-05,Assembly,"AB 1159 CHIU Concurrence in Senate Amendments",55,22,2,0,79
966994,631997,2017-04-25,Senate,"Do pass as amended, but first amend, and re-refer to the Committee on [Appropriations]",5,0,2,0,7
966994,644255,2017-05-15,Senate,"Placed on suspense file",7,0,0,0,7
966995,630231,2017-04-24,Senate,"Do pass as amended, but first amend, and re-refer to the Committee on [Appropriations]",9,1,1,0,11
966995,656931,2017-06-01,Senate,"Senate 3rd Reading SB801 Stern Urgency Clause",28,11,1,0,40
966995,672406,2017-07-12,Assembly,"Do pass as amended and be re-referred to the Committee on [Appropriations]",15,0,0,0,15
966995,674247,2017-08-30,Assembly,"Do pass as amended",10,0,7,0,17
966995,675655,2017-09-12,Assembly,"SB 801 Stern Senate Third Reading By DABABNEH",68,1,10,0,79
966995,675786,2017-09-13,Senate,"Unfinished Business SB801 Stern Concurrence",29,11,0,0,40
966996,613494,2017-03-28,Assembly,"Do pass. To Consent Calendar",11,0,0,0,11
966996,617684,2017-04-03,Assembly,"AB 1139 REYES Consent Calendar Second Day",78,0,2,0,80
966996,658780,2017-06-06,Senate,"Do pass",6,0,1,0,7
966996,668663,2017-06-26,Senate,"Special Consent Calendar # AB1139",39,0,1,0,40
966996,672767,2017-07-17,Assembly,"AB 1139 REYES Concurrence in Senate Amendments",78,0,1,0,79
967000,626832,2017-04-18,Assembly,"Do pass as amended. To Consent Calendar",11,0,0,0,11
967000,642656,2017-05-10,Assembly,"Do pass. To Consent Calendar",17,0,0,0,17
967000,646398,2017-05-18,Assembly,"AB 1401 MAIENSCHEIN Consent Calendar Second Day Regular Session",69,0,11,0,80
967000,662242,2017-06-13,Senate,"Do pass, but first be re-referred to the Committee on [Judiciary]",4,0,1,0,5
967000,672344,2017-07-11,Senate,"Do pass, but first be re-referred to the Committee on [Appropriations] with the recommendation: To Consent Calendar",7,0,0,0,7
967000,674284,2017-08-31,Senate,"Assembly 3rd Reading AB1401 Maienschein By Wiener",37,0,3,0,40
967000,674933,2017-09-05,Assembly,"AB 1401 MAIENSCHEIN Concurrence in Senate Amendments",77,0,2,0,79
967002,618573,2017-04-04,Assembly,"Do pass as amended and be re-referred to the Committee on [Health]",14,0,2,0,16
967002,627125,2017-04-18,Assembly,"Do pass and be re-referred to the Committee on [Appropriations]",14,0,1,0,15
967002,651609,2017-05-26,Assembly,"Do pass as amended",16,0,1,0,17
967002,656067,2017-05-31,Assembly,"AB 1188 NAZARIAN Third Reading Urgency",74,1,5,0,80
967002,665023,2017-06-19,Senate,"Do pass, but first be re-referred to the Committee on [Health]",9,0,0,0,9
967002,672565,2017-07-12,Senate,"Do pass, but first be re-referred to the Committee on [Appropriations]",7,1,1,0,9
967002,673801,2017-08-21,Senate,"Placed on suspense file",7,0,0,0,7
967002,674623,2017-09-01,Senate,"Do pass",6,1,0,0,7
967002,675170,2017-09-07,Senate,"Assembly 3rd Reading AB1188 Nazarian By Hill Urgency Clause",32,7,1,0,40
967002,775304,2017-05-31,Assembly,,16,1,5,0,22
967003,613554,2017-03-28,Senate,"Do pass as amended, but first amend, and re-refer to the Committee on [Appropriations]",11,0,2,0,13
967003,626284,2017-04-17,Senate,"Placed on suspense file",7,0,0,0,7
967003,650465,2017-05-25,Senate,"Do pass as amended",7,0,0,0,7
967003,656186,2017-05-31,Senate,"Senate 3rd Reading SB702 Stern",40,0,0,0,40
967003,672507,2017-07-12,Assembly,"Do pass and be re-referred to the Committee on [Appropriations] with recommendation: To Consent Calendar",6,0,1,0,7
967003,674694,2017-09-01,Assembly,"Do pass",16,0,1,0,17
967003,675432,2017-09-11,Assembly,"SB 702 Stern Senate Third Reading By FRIEDMAN",75,0,4,0,79
967003,676038,2017-09-14,Senate,"Special Consent Calendar SB702",40,0,0,0,40
967005,627108,2017-04-18,Senate,"Do pass",7,0,0,0,7
967005,630369,2017-04-24,Senate,"Senate 3rd Reading SB610 Nguyen",38,0,2,0,40
967005,662134,2017-06-13,Assembly,"Do pass as amended",7,0,0,0,7
967005,670258,2017-06-29,Assembly,"SB 610 Nguyen Senate Third Reading By LACKEY",73,0,7,0,80
967005,671007,2017-07-03,Senate,"Unfinished Business SB610 Nguyen et al. Concurrence",33,0,7,0,40
967007,632063,2017-04-25,Assembly,"Do pass and be re-referred to the Committee on [Appropriations]",15,0,0,0,15
967007,651841,2017-05-26,Assembly,"Do pass as amended",16,0,1,0,17
967007,655981,2017-05-31,Assembly,"AB 1136 EGGMAN Assembly Third Reading By WOOD",75,0,5,0,80
967007,768811,2018-06-27,Senate,"Do pass as amended, but first amend, and re-refer to the Committee on [Appropriations]",9,0,0,0,9
967007,770440,2018-08-06,Senate,"Placed on suspense file",7,0,0,0,7
967008,626275,2017-04-17,Assembly,"Do pass and be re-referred to the Committee on [Natural Resources]",10,3,1,0,14
967008,632014,2017-04-24,Assembly,"Do pass as amended and be re-referred to the Committee on [Appropriations]",7,3,0,0,10
967010,628086,2017-04-19,Senate,"Do pass, but first be re-referred to the Committee on [Appropriations]",7,0,0,0,7
967010,635929,2017-05-01,Senate,"Do pass as amended",7,0,0,0,7
967010,640436,2017-05-08,Senate,"Senate 3rd Reading SB751 Hill et al",38,0,2,0,40
967010,672571,2017-07-12,Assembly,"Do pass and be re-referred to the Committee on [Appropriations]",7,0,0,0,7
967010,674017,2017-08-23,Assembly,"Do pass",15,0,2,0,17
967010,675444,2017-09-11,Assembly,"SB 751 Hill Senate Third Reading By O'DONNELL",73,0,6,0,79
967010,675781,2017-09-13,Senate,"That the Assembly amendments be concurred in",6,0,1,0,7
967010,676113,2017-09-14,Senate,"Unfinished Business SB751 Hill et al. Concurrence",39,0,1,0,40
967011,627107,2017-04-18,Assembly,"Do pass and be re-referred to the Committee on [Appropriations]",15,0,1,0,16
967011,651623,2017-05-26,Assembly,"Do pass",14,3,0,0,17
967011,655882,2017-05-31,Assembly,"AB 1127 CALDERON Assembly Third Reading",70,6,4,0,80
967011,669202,2017-06-27,Senate,"Do pass as amended, but first amend, and re-refer to the Committee on [Appropriations]",12,0,1,0,13
967011,673834,2017-08-21,Senate,"Placed on suspense file",7,0,0,0,7
967011,674559,2017-09-01,Senate,"Do pass",6,1,0,0,7
967011,676183,2017-09-14,Senate,"Assembly 3rd Reading AB1127 Calderon et al. By Lara",37,2,1,0,40
967011,676556,2017-09-15,Assembly,"AB 1127 Calderon Concurrence in Senate Amendments",72,0,7,0,79
967011,777390,2017-05-31,Assembly,"colspan=""5"" headers=""noes 05/31/17"" class=""columnField"" style=""text-align:left"">",14,6,4,0,24
967012,627248,2017-04-18,Assembly,"Do pass and be re-referred to the Committee on [Appropriations]",13,0,2,0,15
967013,684881,2018-01-10,Senate,"Do pass",7,0,0,0,7
967013,686912,2018-01-22,Senate,"Senate 3rd Reading SB726 Wiener",38,0,2,0,40
967013,768724,2018-06-26,Assembly,"Do pass as amended and be re-referred to the Committee on [Appropriations]",7,0,0,0,7
967013,771546,2018-08-16,Assembly,"Do pass as amended",12,1,4,0,17
967013,773289,2018-08-29,Assembly,"SB 726 Wiener Senate Third Reading By CARRILLO",64,11,5,0,80
967013,773866,2018-08-30,Senate,"That the Assembly amendments be concurred in",6,0,1,0,7
967013,774158,2018-08-31,Senate,"Unfinished Business SB726 Wiener Concurrence",36,3,1,0,40
967014,633318,2017-04-26,Assembly,"Do pass and be re-referred to the Committee on [Judiciary]",7,0,0,0,7
967014,641449,2017-05-09,Assembly,"Do pass as amended. To Consent Calendar",11,0,0,0,11
967014,646534,2017-05-18,Assembly,"AB 1412 CHOI Consent Calendar Second Day Regular Session",69,0,11,0,80
967014,662290,2017-06-13,Senate,"Do pass, but first be re-referred to the Committee on [Judiciary] with the recommendation: To Consent Calendar",13,0,0,0,13
967014,672870,2017-07-18,Senate,"Do pass and be ordered to the Consent Calendar",7,0,0,0,7
967014,674082,2017-08-24,Senate,"Consent Calendar 2nd AB1412",38,0,2,0,40
967014,674332,2017-08-31,Assembly,"AB 1412 CHOI Concurrence in Senate Amendments",77,0,2,0,79
967015,684742,2018-01-09,Assembly,"Do pass and be re-referred to the Committee on [Appropriations]",10,3,0,0,13
967015,686251,2018-01-18,Assembly,"Do pass",12,5,0,0,17
967015,686252,2018-01-18,Assembly,"Set, [First] hearing. Referred to suspense file",12,5,0,0,17
967015,690078,2018-01-29,Assembly,"AB 1231 WEBER Assembly Third Reading",54,20,3,0,77
967015,751202,2018-05-09,Senate,"Do pass as amended, but first amend, and re-refer to the Committee on [Appropriations]",6,0,0,0,6
967015,767833,2018-06-25,Senate,"Placed on suspense file",7,0,0,0,7
967015,771593,2018-08-16,Senate,"Do pass as amended",5,2,0,0,7
967015,772524,2018-08-23,Senate,"Assembly 3rd Reading AB1231 Weber By Leyva",29,8,3,0,40
967015,773054,2018-08-28,Assembly,"AB 1231 WEBER Concurrence in Senate Amendments",56,22,2,0,80
967017,684908,2018-01-10,Senate,"Do pass as amended, and be ordered to the Consent Calendar",6,0,1,0,7
967017,689925,2018-01-29,Senate,"Consent Calendar SB720",39,0,1,0,40
967017,765115,2018-06-18,Assembly,"Do pass as amended and be re-referred to the Committee on [Education]",9,0,1,0,10
967017,768802,2018-06-27,Assembly,"Do pass as amended and be re-referred to the Committee on [Appropriations]",6,0,1,0,7
967017,771492,2018-08-15,Assembly,"Do pass",12,1,4,0,17
967017,773848,2018-08-30,Assembly,"SB 720 Allen Senate Third Reading By THURMOND",69,7,4,0,80
967017,773971,2018-08-31,Senate,"That the Assembly amendments be concurred in",7,0,0,0,7
967017,774126,2018-08-31,Senate,"Unfinished Business SB720 Allen et al. Concurrence",39,0,1,0,40
967019,627297,2017-04-18,Assembly,"Do pass as amended, and be re-referred to the Committee on [Appropriations] with recommendation: To Consent Calendar",15,0,0,0,15
967019,627964,2017-04-18,Assembly,"Do pass as amended. To Consent Calendar",15,0,0,0,15
967019,638592,2017-05-04,Assembly,"AB 1456 LOW Third Reading Urgency",74,0,6,0,80
967019,669840,2017-06-28,Senate,"Do pass, but first be re-referred to the Committee on [Appropriations] with the recommendation: To Consent Calendar",7,0,2,0,9
967019,671942,2017-07-10,Senate,"Consent Calendar 2nd AB1456 Low Urgency Clause",40,0,0,0,40
967019,672787,2017-07-17,Assembly,"AB 1456 LOW Concurrence in Senate Amendments",76,0,3,0,79
967020,608506,2017-03-21,Assembly,"Do pass as amended, and be re-referred to the Committee on [Appropriations] with recommendation: To Consent Calendar",7,0,0,0,7
967020,620058,2017-04-05,Assembly,"Do pass. To Consent Calendar",17,0,0,0,17
967020,629577,2017-04-20,Assembly,"AB 1439 E.S. & T.M. Consent Calendar Second Day Regular Session",74,0,6,0,80
967020,667213,2017-06-21,Senate,"Do pass, but first be re-referred to the Committee on [Appropriations] with the recommendation: To Consent Calendar",6,0,1,0,7
967020,674334,2017-08-31,Senate,"Assembly 3rd Reading AB1439 E.S. & T.M. (Quirk) By Hill",40,0,0,0,40
967021,618242,2017-04-04,Senate,"Do pass, but first be re-referred to the Committee on [Appropriations]",4,0,1,0,5
967021,634659,2017-04-27,Senate,"Senate 3rd Reading SB651 Allen",28,9,3,0,40
967021,672319,2017-07-12,Assembly,"Do pass and be re-referred to the Committee on [Appropriations]",5,0,2,0,7
967021,674012,2017-08-23,Assembly,"Do pass",10,5,2,0,17
967021,777940,2017-04-04,Senate,,0,0,1,0,1
967022,633186,2017-04-25,Assembly,"Do pass and be re-referred to the Committee on [Appropriations]",6,0,1,0,7
967022,651905,2017-05-26,Assembly,"Do pass as amended",14,0,3,0,17
967022,656860,2017-06-01,Assembly,"AB 1520 BURKE Assembly Third Reading",78,0,2,0,80
967022,672304,2017-07-11,Senate,"Do pass as amended, but first amend, and re-refer to the Committee on [Appropriations]",7,0,0,0,7
967022,673948,2017-08-21,Senate,"Placed on suspense file",7,0,0,0,7
967022,674829,2017-09-01,Senate,"Do pass as amended",7,0,0,0,7
967022,675764,2017-09-13,Senate,"Assembly 3rd Reading AB1520 Burke et al. By Mitchell",40,0,0,0,40
967022,676575,2017-09-15,Assembly,"AB 1520 BURKE Concurrence in Senate Amendments",79,0,0,0,79
967023,621171,2017-04-05,Assembly,"Do pass and be re-referred to the Committee on [Judiciary]",5,2,0,0,7
967023,641821,2017-05-09,Assembly,"Do pass",8,3,0,0,11
967023,690090,2018-01-29,Assembly,"AB 1478 JONES-SAWYER Assembly Third Reading",27,26,24,0,77
967026,641945,2017-05-08,Assembly,"Do pass as amended and be re-referred to the Committee on [Appropriations]",9,0,1,0,10
967026,649480,2017-05-24,Assembly,"Do pass. To Consent Calendar",17,0,0,0,17
967026,654567,2017-05-30,Assembly,"AB 1165 GLORIA Consent Calendar Second Day Regular Session",77,0,3,0,80
967026,671380,2017-07-05,Senate,"Do pass, but first be re-referred to the Committee on [Appropriations]",7,0,0,0,7
967026,769196,2018-06-28,Senate,"Do pass as amended, but first amend, and re-refer to the Committee on [Appropriations]",4,0,1,0,5
967026,770964,2018-08-06,Senate,"Placed on suspense file",7,0,0,0,7
967026,771992,2018-08-16,Senate,"Do pass as amended",7,0,0,0,7
967026,772903,2018-08-27,Senate,"Assembly 3rd Reading AB1165 Caballero By Wilk",29,4,7,0,40
967026,774169,2018-08-31,Assembly,"AB 1165 Caballero Concurrence in Senate Amendments",65,5,10,0,80
967026,775267,2018-08-31,Assembly,"With recommendation: That Senate amendments be concurred in",10,0,0,0,10
967027,618535,2017-04-04,Assembly,"Do pass as amended",11,0,0,0,11
967027,629202,2017-04-20,Assembly,"AB 1286 FRIEDMAN Assembly Third Reading",75,0,5,0,80
967027,666189,2017-06-20,Senate,"Do pass and be ordered to the Consent Calendar",7,0,0,0,7
967027,674322,2017-08-31,Senate,"Assembly 3rd Reading AB1286 Friedman By Allen",36,4,0,0,40
967027,674960,2017-09-05,Assembly,"AB 1286 FRIEDMAN Concurrence in Senate Amendments",75,1,3,0,79
967028,684877,2018-01-09,Senate,"Do pass as amended, but first amend, and re-refer to the Committee on [Appropriations] with the recommendation: To Consent Calendar",7,0,0,0,7
967028,690060,2018-01-29,Senate,"Consent Calendar SB766",39,0,1,0,40
967028,762174,2018-06-12,Assembly,"Do pass and be re-referred to the Committee on [Appropriations] with recommendation: To Consent Calendar",9,0,1,0,10
967028,768900,2018-06-27,Assembly,"Do pass. To Consent Calendar",16,0,1,0,17
967028,769787,2018-07-05,Assembly,"SB 766 Monning Consent Calendar Second Day Regular Session",69,0,11,0,80
967029,633267,2017-04-26,Senate,"Do pass, but first be re-referred to the Committee on [Appropriations]",9,0,0,0,9
967029,644974,2017-05-15,Senate,"Placed on suspense file",7,0,0,0,7
967029,650787,2017-05-25,Senate,"Do pass",7,0,0,0,7
967029,656098,2017-05-31,Senate,"Senate 3rd Reading SB788 Lara",39,0,1,0,40
967029,672437,2017-07-12,Assembly,"Do pass and be re-referred to the Committee on [Appropriations]",9,0,4,0,13
967029,674260,2017-08-30,Assembly,"Do pass as amended",15,0,2,0,17
967029,676587,2017-09-15,Assembly,"SB 788 Lara Senate Third Reading By CABALLERO",76,2,1,0,79
967029,676588,2017-09-15,Senate,"Unfinished Business SB788 Lara Concurrence",38,0,2,0,40
967031,632094,2017-04-25,Senate,"Do pass, but first be re-referred to the Committee on [Appropriations] with the recommendation: To Consent Calendar",13,0,0,0,13
967031,644444,2017-05-15,Senate,"Consent Calendar 2nd SB629",39,0,1,0,40
967031,769246,2018-06-28,Assembly,"Do pass and be re-referred to the Committee on [Appropriations] with recommendation: To Consent Calendar",21,0,0,0,21
967031,771110,2018-08-08,Assembly,"Do pass. To Consent Calendar",17,0,0,0,17
967031,771599,2018-08-16,Assembly,"SB 629 McGuire Consent Calendar Second Day Regular Session",76,0,4,0,80
967032,620632,2017-04-04,Assembly,"Do pass and be re-referred to the Committee on [Health]",4,2,1,0,7
967032,631956,2017-04-25,Assembly,"Do pass as amended and be re-referred to the Committee on [Appropriations]",14,1,0,0,15
967032,651538,2017-05-26,Assembly,"Do pass",15,0,2,0,17
967032,654388,2017-05-30,Assembly,"AB 1316 QUIRK Assembly Third Reading",69,3,8,0,80
967032,669755,2017-06-28,Senate,"Do pass as amended, but first amend, and re-refer to the Committee on [Environmental Quality]",7,0,2,0,9
967032,671378,2017-07-05,Senate,"Do pass, but first be re-referred to the Committee on [Appropriations]",7,0,0,0,7
967032,673824,2017-08-21,Senate,"Placed on suspense file",7,0,0,0,7
967032,674463,2017-09-01,Senate,"Do pass as amended",7,0,0,0,7
967032,675059,2017-09-06,Senate,"Assembly 3rd Reading AB1316 Quirk et al. By Skinner",40,0,0,0,40
967032,675390,2017-09-11,Assembly,"AB 1316 QUIRK Concurrence in Senate Amendments",79,0,0,0,79
967034,621453,2017-04-05,Assembly,"Do pass as amended and be re-referred to the Committee on [Higher Education]",7,0,0,0,7
967034,633560,2017-04-25,Assembly,"Do pass and be re-referred to the Committee on [Appropriations]",12,0,1,0,13
967036,615646,2017-03-29,Senate,"Do pass as amended, but first amend, and re-refer to the Committee on [Rules]",7,0,0,0,7
967036,636137,2017-05-01,Senate,"Placed on suspense file",7,0,0,0,7
967037,618306,2017-04-04,Assembly,"Do pass and be re-referred to the Committee on [Public Safety]",11,0,0,0,11
967037,631748,2017-04-25,Assembly,"Do pass and be re-referred to the Committee on [Appropriations] with recommendation: To Consent Calendar",7,0,0,0,7
967037,642423,2017-05-10,Assembly,"Do pass. To Consent Calendar",17,0,0,0,17
967037,646409,2017-05-18,Assembly,"AB 1443 LEVINE Consent Calendar Second Day Regular Session",69,0,11,0,80
967037,669746,2017-06-27,Senate,"Do pass, but first be re-referred to the Committee on [Appropriations] with the recommendation: To Consent Calendar",6,0,1,0,7
967037,672976,2017-07-20,Senate,"Consent Calendar 2nd AB1443",38,0,2,0,40
967038,628322,2017-04-19,Senate,"Do pass as amended, but first amend, and re-refer to the Committee on [Appropriations]",7,0,0,0,7
967038,645008,2017-05-15,Senate,"Placed on suspense file",7,0,0,0,7
967038,650837,2017-05-25,Senate,"Do pass as amended",6,1,0,0,7
967038,655968,2017-05-31,Senate,"Senate 3rd Reading SB778 Hertzberg",38,1,1,0,40
967038,672051,2017-07-11,Assembly,"Do pass as amended and be re-referred to the Committee on [Appropriations]",7,0,0,0,7
967039,631479,2017-04-25,Assembly,"Do pass and be re-referred to the Committee on [Appropriations]",15,0,0,0,15
967039,651730,2017-05-26,Assembly,"Do pass",17,0,0,0,17
967039,654463,2017-05-30,Assembly,"AB 1270 GALLAGHER Assembly Third Reading",77,0,3,0,80
967039,669126,2017-06-27,Senate,"Do pass as amended, but first amend, and re-refer to the Committee on [Appropriations] with the recommendation: To Consent Calendar",8,0,1,0,9
967039,673925,2017-08-21,Senate,"Placed on suspense file",7,0,0,0,7
967039,694738,2018-02-05,Senate,"Assembly 3rd Reading AB1270 Gallagher et al. By Nielsen Urgency Clause",38,0,2,0,40
967039,699637,2018-02-12,Assembly,"AB 1270 GALLAGHER Concurrence - Urgency Added",71,0,6,0,77
967040,618436,2017-04-03,Assembly,"Do pass as amended and be re-referred to the Committee on [Appropriations]",10,0,0,0,10
967040,634117,2017-04-26,Assembly,"Do pass. To Consent Calendar",16,0,1,0,17
967040,638307,2017-05-04,Assembly,"AB 1191 BIGELOW Consent Calendar Second Day Regular Session",76,0,4,0,80
967040,662925,2017-06-13,Senate,"Do pass, but first be re-referred to the Committee on [Appropriations] with the recommendation: To Consent Calendar",9,0,0,0,9
967040,670997,2017-07-03,Senate,"Consent Calendar 2nd AB1191 Bigelow Urgency Clause",33,0,7,0,40
967041,633543,2017-04-26,Assembly,"Do pass as amended and be re-referred to the Committee on [Appropriations]",7,0,0,0,7
967041,642719,2017-05-10,Assembly,"Do pass",13,1,3,0,17
967041,656865,2017-06-01,Assembly,"AB 1194 DABABNEH Assembly Third Reading Motion to Postpone to a Time Cer By KILEY Motion to Lay on the Table By CALDERON",50,24,6,0,80
967041,656866,2017-06-01,Assembly,"AB 1194 DABABNEH Assembly Third Reading",70,4,6,0,80
967041,669865,2017-06-28,Senate,"Do pass, but first be re-referred to the Committee on [Elections and Constitutional Amendments]",7,0,0,0,7
967041,672626,2017-07-12,Senate,"Do pass, but first be re-referred to the Committee on [Appropriations]",4,0,1,0,5
967041,675038,2017-09-06,Senate,"Assembly 3rd Reading AB1194 Dababneh et al. By McGuire",31,3,6,0,40
967041,675438,2017-09-11,Assembly,"AB 1194 DABABNEH Concurrence in Senate Amendments",70,0,9,0,79
967043,629234,2017-04-19,Assembly,"Do pass and be re-referred to the Committee on [Appropriations]",5,2,0,0,7
967043,651972,2017-05-26,Assembly,"Do pass as amended",11,6,0,0,17
967043,656007,2017-05-31,Assembly,"AB 1209 GONZALEZ FLETCHER Assembly Third Reading",48,19,13,0,80
967043,672326,2017-07-12,Senate,"Do pass as amended, but first amend, and re-refer to the Committee on [Appropriations]",4,1,0,0,5
967043,673882,2017-08-21,Senate,"Placed on suspense file",7,0,0,0,7
967043,674569,2017-09-01,Senate,"Do pass as amended",5,2,0,0,7
967043,675148,2017-09-07,Senate,"Assembly 3rd Reading AB1209 Gonzalez Fletcher By Galgiani",23,13,4,0,40
967043,675488,2017-09-11,Assembly,"AB 1209 GONZALEZ FLETCHER Concurrence in Senate Amendments",47,23,9,0,79
967045,637526,2017-05-02,Senate,"Do pass as amended",6,0,1,0,7
967045,648003,2017-05-22,Senate,"Senate 3rd Reading SB755 Beall et al",37,0,3,0,40
967045,662546,2017-06-13,Assembly,"Do pass as amended",11,0,0,0,11
967045,671609,2017-07-06,Assembly,"SB 755 Beall Senate Third Reading By REYES",75,0,5,0,80
967045,671957,2017-07-10,Senate,"Unfinished Business SB755 Beall Concurrence",39,0,1,0,40
967046,626001,2017-04-17,Assembly,"Do pass and be re-referred to the Committee on [Appropriations] with recommendation: To Consent Calendar",13,0,1,0,14
967046,638036,2017-05-03,Assembly,"Do pass. To Consent Calendar",16,0,1,0,17
967046,643692,2017-05-11,Assembly,"AB 1317 GRAY Consent Calendar Second Day Regular Session",77,0,3,0,80
967046,669223,2017-06-27,Senate,"Do pass, but first be re-referred to the Committee on [Environmental Quality]",12,0,1,0,13
967046,671390,2017-07-05,Senate,"Do pass, but first be re-referred to the Committee on [Appropriations]",6,0,1,0,7
967046,673964,2017-08-21,Senate,"Placed on suspense file",7,0,0,0,7
967046,674754,2017-09-01,Senate,"Do pass",7,0,0,0,7
967046,675020,2017-09-06,Senate,"Assembly 3rd Reading AB1317 Gray By Cannella",39,0,1,0,40
967047,615210,2017-03-29,Senate,"Do pass, but first be re-referred to the Committee on [Appropriations] with the recommendation: To Consent Calendar",7,0,0,0,7
967047,626271,2017-04-17,Senate,"Do pass",7,0,0,0,7
967047,654227,2017-05-30,Senate,"Senate 3rd Reading SB771 De León",40,0,0,0,40
967047,672274,2017-07-10,Assembly,"Do pass as amended and be re-referred to the Committee on [Appropriations]",8,0,2,0,10
967047,674499,2017-09-01,Assembly,"Do pass",12,3,2,0,17
967048,637597,2017-05-03,Senate,"Do pass as amended",6,0,1,0,7
967048,648076,2017-05-22,Senate,"Senate 3rd Reading SB624 Galgiani",37,0,3,0,40
967048,669537,2017-06-26,Assembly,"Do pass",9,0,1,0,10
967048,672801,2017-07-17,Assembly,"SB 624 Galgiani Senate Third Reading By RIDLEY-THOMAS",78,0,1,0,79
967049,634538,2017-04-26,Assembly,"Do pass and be re-referred to the Committee on [Appropriations]",8,3,2,0,13
967049,651788,2017-05-26,Assembly,"Do pass as amended",12,5,0,0,17
967049,656889,2017-06-01,Assembly,"AB 1184 TING Assembly Third Reading",45,30,5,0,80
967049,670983,2017-07-03,Senate,"Do pass, but first be re-referred to the Committee on [Environmental Quality]",7,2,2,0,11
967049,671368,2017-07-05,Senate,"Do pass, but first be re-referred to the Committee on [Rules]",5,1,1,0,7
967049,674714,2017-09-01,Senate,"Placed on suspense file",7,0,0,0,7
967049,674715,2017-09-01,Senate,"Do pass as amended",5,2,0,0,7
967049,773968,2018-08-31,Senate,"Do pass",4,2,1,0,7
967049,774218,2018-08-31,Assembly,"With recommendation: That Senate amendments be concurred in",7,6,0,0,13
967049,774219,2018-08-31,Senate,"W/O REF. TO FILE AB1184 Ting By Wiener",23,12,5,0,40
967049,774220,2018-08-31,Assembly,"AB 1184 Ting Concurrence in Senate Amendments",45,30,5,0,80
967049,774583,2017-09-01,Senate,?,7,2,0,0,9
967050,685037,2018-01-11,Assembly,"Do pass",3,2,2,0,7
967051,641831,2017-05-09,Assembly,"Do pass",10,0,1,0,11
967051,656105,2017-05-31,Assembly,"AB 1396 BURKE Assembly Third Reading",66,6,8,0,80
967051,672906,2017-07-18,Senate,"Do pass",7,0,0,0,7
967051,674403,2017-08-31,Senate,"Assembly 3rd Reading AB1396 Burke By Jackson",38,1,1,0,40
967051,674996,2017-09-05,Assembly,"AB 1396 BURKE Concurrence in Senate Amendments",74,0,5,0,79
967052,636521,2017-05-02,Assembly,"Do pass",13,0,3,0,16
967052,638535,2017-05-04,Assembly,"AB 1162 BOCANEGRA Assembly Third Reading",75,0,5,0,80
967052,669248,2017-06-26,Senate,"Do pass",9,0,0,0,9
967053,633433,2017-04-26,Assembly,"Do pass as amended and be re-referred to the Committee on [Appropriations]",10,4,1,0,15
967053,651664,2017-05-26,Assembly,"Do pass",11,6,0,0,17
967053,657000,2017-06-01,Assembly,"AB 1405 MULLIN Assembly Third Reading",43,31,6,0,80
967053,671920,2017-07-10,Senate,"Do pass as amended, but first amend, and re-refer to the Committee on [Appropriations]",8,2,1,0,11
967053,673815,2017-08-21,Senate,"Placed on suspense file",7,0,0,0,7
967053,674541,2017-09-01,Senate,"Do pass as amended",5,2,0,0,7
967055,642777,2017-05-10,Senate,"Do pass, but first be re-referred to the Committee on [Education]",6,0,1,0,7
967055,647832,2017-05-22,Senate,"Placed on suspense file",7,0,0,0,7
967059,614780,2017-03-29,Senate,"Do pass, but first be re-referred to the Committee on [Appropriations]",7,0,0,0,7
967059,626191,2017-04-17,Senate,"Placed on suspense file",7,0,0,0,7
967060,612821,2017-03-27,Assembly,"Do pass and be re-referred to the Committee on [Appropriations] with recommendation: To Consent Calendar",14,0,0,0,14
967060,651508,2017-05-26,Assembly,"Do pass",17,0,0,0,17
967060,654333,2017-05-30,Assembly,"AB 1172 ACOSTA Assembly Third Reading",77,0,3,0,80
967060,666170,2017-06-20,Senate,"Do pass, but first be re-referred to the Committee on [Appropriations] with the recommendation: To Consent Calendar",12,0,1,0,13
967060,671838,2017-07-10,Senate,"Placed on suspense file",7,0,0,0,7
967060,674807,2017-09-01,Senate,"Do pass",7,0,0,0,7
967060,676085,2017-09-14,Senate,"Special Consent Calendar # AB1172",40,0,0,0,40
967062,684167,2018-01-08,Senate,"Do pass, but first be re-referred to the Committee on [Appropriations]",5,0,0,0,5
967062,686905,2018-01-22,Senate,"Senate 3rd Reading SB783 Pan",38,0,2,0,40
967062,766042,2018-06-20,Assembly,"Do pass and be re-referred to the Committee on [Appropriations]",5,0,2,0,7
967063,635015,2017-04-26,Assembly,"Do pass and be re-referred to the Committee on [Appropriations]",5,2,0,0,7
967063,651611,2017-05-26,Assembly,"Do pass as amended",12,5,0,0,17
967063,655788,2017-05-31,Assembly,"AB 1360 BONTA Assembly Third Reading",69,2,9,0,80
967063,669659,2017-06-28,Senate,"Do pass as amended, but first amend, and re-refer to the Committee on [Appropriations]",7,0,0,0,7
967063,672762,2017-07-17,Senate,"Placed on suspense file",7,0,0,0,7
967063,674617,2017-09-01,Senate,"Do pass",6,0,1,0,7
967063,675910,2017-09-13,Senate,"Assembly 3rd Reading AB1360 Bonta By Allen",34,6,0,0,40
967063,676495,2017-09-15,Assembly,"AB 1360 BONTA Concurrence in Senate Amendments",70,8,1,0,79
967064,631897,2017-04-24,Senate,"Do pass, but first be re-referred to the Committee on [Appropriations]",8,0,1,0,9
967064,644583,2017-05-15,Senate,"Placed on suspense file",7,0,0,0,7
967064,650853,2017-05-25,Senate,"Do pass as amended",7,0,0,0,7
967064,656040,2017-05-31,Senate,"Senate 3rd Reading SB798 Hill",36,4,0,0,40
967064,674230,2017-08-29,Assembly,"Do pass and be re-referred to the Committee on [Appropriations]",11,0,5,0,16
967064,674710,2017-09-01,Assembly,"Do pass as amended",10,4,3,0,17
967064,675662,2017-09-12,Assembly,"SB 798 Hill Senate Third Reading By LOW",60,14,5,0,79
967064,675797,2017-09-13,Senate,"Unfinished Business SB798 Hill Concurrence",38,1,1,0,40
967065,619537,2017-04-04,Senate,"Do pass, but first be re-referred to the Committee on [Appropriations]",5,0,2,0,7
967065,630982,2017-04-24,Senate,"Placed on suspense file",7,0,0,0,7
967065,650755,2017-05-25,Senate,"Do pass as amended",5,1,1,0,7
967065,655896,2017-05-31,Senate,"Senate 3rd Reading SB625 Atkins",29,3,8,0,40
967065,672192,2017-07-11,Assembly,"Do pass and be re-referred to the Committee on [Appropriations]",5,1,1,0,7
967065,674019,2017-08-23,Assembly,"Do pass",10,5,2,0,17
967065,675314,2017-09-11,Assembly,"SB 625 Atkins Senate Third Reading By JONES-SAWYER",53,21,5,0,79
967065,675669,2017-09-12,Senate,"Unfinished Business SB625 Atkins Concurrence",31,9,0,0,40
967067,620808,2017-04-05,Senate,"Do pass, but first be re-referred to the Committee on [Banking and Financial Institutions]",7,0,0,0,7
967067,633596,2017-04-26,Senate,"Do pass as amended, but first amend, and re-refer to the Committee on [Appropriations]",5,0,2,0,7
967067,644423,2017-05-15,Senate,"Placed on suspense file",7,0,0,0,7
967068,632061,2017-04-25,Assembly,"Do pass and be re-referred to the Committee on [Appropriations] with recommendation: To Consent Calendar",7,0,0,0,7
967068,643034,2017-05-10,Assembly,"Do pass. To Consent Calendar",17,0,0,0,17
967068,646430,2017-05-18,Assembly,"AB 1418 O'DONNELL Consent Calendar Second Day Regular Session",69,0,11,0,80
967068,666598,2017-06-20,Senate,"Do pass, but first be re-referred to the Committee on [Appropriations] with the recommendation: To Consent Calendar",7,0,0,0,7
967068,674419,2017-08-31,Senate,"Assembly 3rd Reading AB1418 O'Donnell By Lara",39,0,1,0,40
967068,674862,2017-09-05,Assembly,"AB 1418 O'DONNELL Concurrence in Senate Amendments",77,0,2,0,79
967069,632065,2017-04-25,Senate,"Do pass, but first be re-referred to the Committee on [Appropriations] with the recommendation: To Consent Calendar",13,0,0,0,13
967069,644494,2017-05-15,Senate,"Consent Calendar 2nd SB685",39,0,1,0,40
967071,614302,2017-03-28,Senate,"Do pass, but first be re-referred to the Committee on [Governance and Finance]",7,0,2,0,9
967071,634374,2017-04-26,Senate,"Do pass as amended, but first amend, and re-refer to the Committee on [Appropriations]",6,0,1,0,7
967071,644533,2017-05-15,Senate,"Placed on suspense file",7,0,0,0,7
967071,650762,2017-05-25,Senate,"Do pass",7,0,0,0,7
967071,655849,2017-05-31,Senate,"Senate 3rd Reading SB634 Wilk",34,0,6,0,40
967071,670447,2017-06-28,Assembly,"Do pass and be re-referred to the Committee on [Water, Parks, and Wildlife]",9,0,0,0,9
967071,672187,2017-07-11,Assembly,"Do pass as amended and be re-referred to the Committee on [Appropriations]",13,2,0,0,15
967071,674742,2017-09-01,Assembly,"Do pass as amended",14,0,3,0,17
967071,675849,2017-09-13,Assembly,"SB 634 Wilk Senate Third Reading By LACKEY",62,13,4,0,79
967071,676087,2017-09-14,Senate,"Unfinished Business SB634 Wilk Concurrence",34,1,5,0,40
967072,618580,2017-04-03,Assembly,"Do pass and be re-referred to the Committee on [Appropriations]",10,0,0,0,10
967073,634461,2017-04-26,Assembly,"Do pass and be re-referred to the Committee on [Appropriations]",9,0,0,0,9
967073,642618,2017-05-10,Assembly,"Do pass. To Consent Calendar",17,0,0,0,17
967073,646406,2017-05-18,Assembly,"AB 1423 CHIU Consent Calendar Second Day Regular Session",69,0,11,0,80
967073,763440,2018-06-12,Senate,"Do pass as amended, but first amend, and re-refer to the Committee on [Appropriations]",9,0,0,0,9
967073,772461,2018-08-22,Senate,"Assembly 3rd Reading AB1423 Chiu By Wiener",39,0,1,0,40
967073,772462,2018-08-22,Senate,"Assembly 3rd Reading AB1423 Chiu By Wiener Reconsider",39,0,1,0,40
967073,772585,2018-08-23,Senate,"Assembly 3rd Reading AB1423 Chiu By Wiener",38,0,2,0,40
967073,773099,2018-08-28,Assembly,"With recommendation: That Senate amendments be concurred in",10,0,0,0,10
967073,773618,2018-08-29,Assembly,"AB 1423 CHIU Concurrence in Senate Amendments",79,0,1,0,80
967074,631597,2017-04-25,Senate,"Do pass, but first be re-referred to the Committee on [Appropriations]",4,2,1,0,7
967074,646554,2017-05-18,Senate,"Senate 3rd Reading SB620 Bradford",22,14,4,0,40
967074,662418,2017-06-13,Assembly,"Do pass as amended and be re-referred to the Committee on [Appropriations]",5,2,0,0,7
967074,669635,2017-06-28,Assembly,"Do pass",9,5,3,0,17
967074,671853,2017-07-10,Assembly,"SB 620 Bradford Senate Third Reading By WEBER",31,34,15,0,80
967074,675699,2017-09-12,Assembly,"SB 620 Bradford Senate Third Reading By WEBER",42,33,4,0,79
967074,675894,2017-09-13,Senate,"Unfinished Business SB620 Bradford Concurrence",22,13,5,0,40
967076,631476,2017-04-25,Assembly,"Do pass and be re-referred to the Committee on [Appropriations]",11,0,0,0,11
967076,651521,2017-05-26,Assembly,"Do pass",16,0,1,0,17
967076,656936,2017-06-01,Assembly,"AB 1379 THURMOND Assembly Third Reading",69,4,7,0,80
967076,669151,2017-06-27,Senate,"Do pass, but first be re-referred to the Committee on [Judiciary]",10,2,1,0,13
967076,672426,2017-07-11,Senate,"Do pass, but first be re-referred to the Committee on [Appropriations]",5,1,1,0,7
967076,673901,2017-08-21,Senate,"Do pass",5,2,0,0,7
967076,674975,2017-09-05,Senate,"Assembly 3rd Reading AB1379 Thurmond By Jackson",30,10,0,0,40
967078,631668,2017-04-25,Senate,"Do pass as amended, but first amend, and re-refer to the Committee on [Appropriations]",7,0,0,0,7
967078,647986,2017-05-22,Senate,"Senate 3rd Reading SB784 Galgiani et al",37,0,3,0,40
967078,662264,2017-06-13,Assembly,"Do pass and be re-referred to the Committee on [Privacy and Consumer Protection] with recommendation: To Consent Calendar",7,0,0,0,7
967078,666304,2017-06-20,Assembly,"Do pass and be re-referred to the Committee on [Appropriations]",9,0,1,0,10
967078,669725,2017-06-28,Assembly,"Do pass. To Consent Calendar",14,0,3,0,17
967078,676443,2017-09-15,Assembly,"SB 784 Galgiani Senate Third Reading By DABABNEH",76,0,3,0,79
967078,777943,2017-06-28,Assembly,,9,0,3,0,12
967079,620115,2017-04-05,Senate,"Do pass, but first be re-referred to the Committee on [Appropriations]",5,0,0,0,5
967079,630242,2017-04-24,Senate,"Senate 3rd Reading SB789 Newman et al",38,0,2,0,40
967079,660623,2017-06-07,Assembly,"Do pass and be re-referred to the Committee on [Appropriations] with recommendation: To Consent Calendar",7,0,0,0,7
967079,669889,2017-06-28,Assembly,"Do pass. To Consent Calendar",14,0,3,0,17
967079,674561,2017-09-01,Assembly,"SB 789 Newman Senate Third Reading Amend By GIPSON Set #1",50,24,5,0,79
967079,675264,2017-09-08,Assembly,"Do pass and be re-referred to the Committee on [Local Government]",4,5,1,0,10
967079,675265,2017-09-08,Assembly,Reconsideration,10,0,0,0,10
967081,632055,2017-04-25,Assembly,"Do pass and be re-referred to the Committee on [Appropriations]",5,2,0,0,7
967081,642561,2017-05-10,Assembly,"Do pass",9,7,1,0,17
967081,656809,2017-06-01,Assembly,"AB 1308 STONE Assembly Third Reading",41,36,3,0,80
967081,668989,2017-06-27,Senate,"Do pass, but first be re-referred to the Committee on [Appropriations]",6,1,0,0,7
967081,672745,2017-07-17,Senate,"Placed on suspense file",7,0,0,0,7
967081,674451,2017-09-01,Senate,"Do pass",5,2,0,0,7
967081,675610,2017-09-12,Senate,"Assembly 3rd Reading AB1308 Mark Stone By Bradford",23,14,3,0,40
967082,637531,2017-05-03,Assembly,"Do pass as amended",16,0,5,0,21
967082,651602,2017-05-26,Assembly,"AB 1168 GIPSON Assembly Third Reading",58,2,20,0,80
967082,672049,2017-07-11,Senate,"Do pass",8,1,4,0,13
967082,773026,2018-08-27,Senate,"Assembly 3rd Reading AB1168 Gipson By Lara",28,4,8,0,40
967083,628272,2017-04-19,Senate,"Do pass, but first be re-referred to the Committee on [Appropriations]",5,2,0,0,7
967083,635782,2017-05-01,Senate,"Placed on suspense file",7,0,0,0,7
967083,650873,2017-05-25,Senate,"Do pass",5,2,0,0,7
967083,656806,2017-06-01,Senate,"Senate 3rd Reading SB774 Leyva",27,13,0,0,40
967083,672178,2017-07-11,Assembly,"Do pass as amended and be re-referred to the Committee on [Appropriations]",5,2,0,0,7
967083,674576,2017-09-01,Assembly,"Do pass",11,5,1,0,17
967083,675269,2017-09-08,Assembly,"SB 774 Leyva Senate Third Reading By QUIRK Amendment Set #1",46,27,6,0,79
967083,675643,2017-09-12,Assembly,"Do pass",5,2,0,0,7
967083,772817,2018-08-27,Assembly,"Do pass",16,0,1,0,17
967083,772818,2018-08-27,Assembly,"Do pass and be re-referred to the Committee on [Appropriations]",13,0,0,0,13
967083,774201,2018-08-31,Senate,"That the Assembly amendments be concurred in",7,0,0,0,7
967083,774202,2018-08-31,Senate,"Unfinished Business SB774 Leyva et al. Concurrence",38,0,2,0,40
967083,774203,2018-08-31,Assembly,"SB 774 Leyva Senate Third Reading By FLORA",79,1,0,0,80
967084,610078,2017-03-22,Assembly,"Do pass and be re-referred to the Committee on [Appropriations] with recommendation: To Consent Calendar",10,0,0,0,10
967084,620837,2017-04-05,Assembly,"Do pass. To Consent Calendar",17,0,0,0,17
967084,629129,2017-04-20,Assembly,"AB 1131 LACKEY Consent Calendar Second Day Regular Session",74,0,6,0,80
967084,658829,2017-06-06,Senate,"Do pass, but first be re-referred to the Committee on [Appropriations]",4,0,1,0,5
967084,675195,2017-09-07,Senate,"Assembly 3rd Reading AB1131 Lackey et al. By Wilk",40,0,0,0,40
967084,675339,2017-09-11,Assembly,"AB 1131 LACKEY Concurrence in Senate Amendments",78,0,1,0,79
967086,598256,2017-03-06,Senate,"Senate 3rd Reading SR19 Leyva et al",38,0,2,0,40
967087,614482,2017-03-28,Assembly,"Do pass and be re-referred to the Committee on [Governmental Organization]",9,1,0,0,10
967087,627924,2017-04-19,Assembly,"Do pass and be re-referred to the Committee on [Appropriations]",20,0,1,0,21
967087,651959,2017-05-26,Assembly,"Do pass",17,0,0,0,17
967087,654290,2017-05-30,Assembly,"AB 1306 OBERNOLTE Assembly Third Reading",73,1,6,0,80
967087,672198,2017-07-11,Senate,"Do pass as amended, but first amend, and re-refer to the Committee on [Appropriations]",13,0,0,0,13
967087,673836,2017-08-21,Senate,"Placed on suspense file",7,0,0,0,7
967087,674777,2017-09-01,Senate,"Do pass as amended",7,0,0,0,7
967087,676317,2017-09-14,Senate,"Special Consent Calendar # AB1306",40,0,0,0,40
967087,676318,2017-09-14,Assembly,"AB 1306 Obernolte Special Consent Calendar 1st Day Regular Session",79,0,0,0,79
967088,627776,2017-04-19,Senate,"Do pass, but first be re-referred to the Committee on [Veterans Affairs]",7,0,0,0,7
967088,632057,2017-04-25,Senate,"Do pass as amended, but first amend, and re-refer to the Committee on [Appropriations]",6,0,1,0,7
967088,644321,2017-05-15,Senate,"Placed on suspense file",7,0,0,0,7
967088,650794,2017-05-25,Senate,"Do pass",7,0,0,0,7
967088,656191,2017-05-31,Senate,"Special Consent Calendar # SB694",40,0,0,0,40
967090,631650,2017-04-24,Senate,"Do pass, but first be re-referred to the Committee on [Appropriations] with the recommendation: To Consent Calendar",9,0,0,0,9
967090,644413,2017-05-15,Senate,"Placed on suspense file",7,0,0,0,7
967090,650717,2017-05-25,Senate,"Do pass",7,0,0,0,7
967090,656250,2017-05-31,Senate,"Special Consent Calendar # SB762",40,0,0,0,40
967090,768407,2018-06-26,Assembly,"Do pass as amended, and be re-referred to the Committee on [Appropriations] with recommendation: To Consent Calendar",19,0,0,0,19
967090,771129,2018-08-08,Assembly,"Do pass. To Consent Calendar",17,0,0,0,17
967090,771558,2018-08-16,Assembly,"SB 762 Hernandez Consent Calendar Second Day Regular Session",76,0,4,0,80
967090,772472,2018-08-22,Senate,"That the Assembly amendments be concurred in",9,0,0,0,9
967090,772726,2018-08-24,Senate,"Unfinished Business SB762 Hernandez et al. Urgency Clause Concurrence",39,0,1,0,40
967091,684739,2018-01-08,Assembly,"Do pass",11,0,0,0,11
967091,685828,2018-01-17,Assembly,"Do pass. To Consent Calendar",10,0,0,0,10
967091,690043,2018-01-29,Assembly,"AB 1526 KALRA Consent Calendar Second Day",75,0,2,0,77
967091,769687,2018-07-03,Senate,"Do pass and be ordered to the Consent Calendar",7,0,0,0,7
967091,771317,2018-08-13,Senate,"Consent Calendar AB1526",37,0,3,0,40
967091,772185,2018-08-20,Assembly,"AB 1526 KALRA Concurrence in Senate Amendments",79,0,1,0,80
967093,633265,2017-04-26,Assembly,"Do pass and be re-referred to the Committee on [Appropriations]",5,2,0,0,7
967093,651665,2017-05-26,Assembly,"Do pass",12,5,0,0,17
967093,654197,2017-05-30,Assembly,"AB 1521 BLOOM Assembly Second Reading Amendment Set #1",51,23,6,0,80
967093,656820,2017-06-01,Assembly,"AB 1521 BLOOM Assembly Third Reading",50,24,6,0,80
967093,672082,2017-07-11,Senate,"Do pass, but first be re-referred to the Committee on [Appropriations]",9,4,0,0,13
967093,672702,2017-07-17,Senate,"Do pass",5,0,2,0,7
967093,676515,2017-09-15,Senate,"Assembly 3rd Reading AB1521 Bloom et al. By Wiener",27,11,2,0,40
967093,676516,2017-09-15,Assembly,"AB 1521 BLOOM Concurrence in Senate Amendments",54,25,0,0,79
967095,610060,2017-03-22,Assembly,"Do pass and be re-referred to the Committee on [Appropriations] with recommendation: To Consent Calendar",7,0,0,0,7
967095,620843,2017-04-05,Assembly,"Do pass. To Consent Calendar",17,0,0,0,17
967095,629394,2017-04-20,Assembly,"AB 1354 KILEY Consent Calendar Second Day Regular Session",74,0,6,0,80
967095,660193,2017-06-07,Senate,"Do pass as amended, but first amend, and re-refer to the Committee on [Appropriations] with the recommendation: To Consent Calendar",7,0,0,0,7
967095,670967,2017-07-03,Senate,"Consent Calendar 2nd AB1354",33,0,7,0,40
967095,671896,2017-07-10,Assembly,"AB 1354 KILEY Concurrence in Senate Amendments",77,0,3,0,80
967096,633513,2017-04-26,Senate,"Do pass as amended, but first amend, and re-refer to the Committee on [Appropriations] with the recommendation: To Consent Calendar",7,0,0,0,7
967096,644591,2017-05-15,Senate,"Placed on suspense file",7,0,0,0,7
967096,650586,2017-05-25,Senate,"Do pass as amended",7,0,0,0,7
967096,656332,2017-05-31,Senate,"Senate 3rd Reading SB730 Pan et al",40,0,0,0,40
967096,672539,2017-07-12,Assembly,"Do pass and be re-referred to the Committee on [Appropriations]",7,0,0,0,7
967096,674044,2017-08-23,Assembly,"Do pass. To Consent Calendar",15,0,2,0,17
967096,674421,2017-08-31,Assembly,"SB 730 Pan Consent Calendar Second Day Regular Session",73,0,6,0,79
967096,674967,2017-09-05,Senate,"Special Consent SB730",40,0,0,0,40
967097,633315,2017-04-26,Senate,"Do pass as amended, but first amend, and re-refer to the Committee on [Appropriations]",7,0,0,0,7
967097,636570,2017-04-26,Senate,"Do pass, but first be re-referred to the Committee on [Appropriations]",7,0,0,0,7
967097,644309,2017-05-15,Senate,"Placed on suspense file",7,0,0,0,7
967097,650636,2017-05-25,Senate,"Do pass as amended",6,1,0,0,7
967097,656205,2017-05-31,Senate,"Senate 3rd Reading SB769 Hill et al",38,2,0,0,40
967097,672027,2017-07-11,Assembly,"Do pass as amended and be re-referred to the Committee on [Appropriations]",12,1,0,0,13
967098,633327,2017-04-25,Assembly,"Do pass and be re-referred to the Committee on [Appropriations]",9,0,1,0,10
967098,651875,2017-05-26,Assembly,"Do pass as amended",16,0,1,0,17
967098,655779,2017-05-31,Assembly,"AB 1361 GARCIA, E. Assembly Third Reading",77,0,3,0,80
967098,672903,2017-07-19,Senate,"Do pass as amended",6,0,1,0,7
967098,674906,2017-09-05,Senate,"Assembly 3rd Reading AB1361 Eduardo Garcia et al. By Hertzberg",39,1,0,0,40
967098,675666,2017-09-12,Senate,"Assembly 3rd Reading AB1361 Eduardo Garcia By Hertzberg",38,1,1,0,40
967098,676095,2017-09-14,Assembly,"With recommendation: That Senate amendments be concurred in",6,0,3,0,9
967098,676550,2017-09-15,Assembly,"AB 1361 GARCIA, E. Concurrence in Senate Amendments",77,0,2,0,79
967099,637478,2017-05-02,Senate,"Do pass",5,1,1,0,7
967099,640530,2017-05-08,Senate,"Senate 3rd Reading SB632 Monning",29,9,2,0,40
967099,666247,2017-06-20,Assembly,"Do pass as amended",8,1,2,0,11
967100,684164,2018-01-08,Senate,"Do pass, but first be re-referred to the Committee on [Appropriations]",8,1,0,0,9
967100,685428,2018-01-16,Senate,"Placed on suspense file",7,0,0,0,7
967100,686210,2018-01-18,Senate,"Do pass as amended",5,0,2,0,7
967100,690056,2018-01-29,Senate,"Senate 3rd Reading SB635 Hueso",34,1,5,0,40
967100,765073,2018-06-19,Assembly,"Do pass as amended and be re-referred to the Committee on [Appropriations]",6,0,1,0,7
967100,771739,2018-08-16,Assembly,"Do pass",14,2,1,0,17
967100,774165,2018-08-31,Senate,"Unfinished Business SB635 Hueso et al. Concurrence",38,0,2,0,40
967100,774166,2018-08-31,Assembly,"SB 635 Hueso Senate Third Reading By GONZALEZ FLETCHER",80,0,0,0,80
967101,629304,2017-04-19,Assembly,"Do pass and be re-referred to the Committee on [Appropriations]",7,0,0,0,7
967102,620447,2017-04-04,Assembly,"Do pass and be re-referred to the Committee on [Appropriations]",10,0,0,0,10
967102,651735,2017-05-26,Assembly,"Do pass",17,0,0,0,17
967102,654327,2017-05-30,Assembly,"AB 1275 IRWIN Assembly Third Reading",75,0,5,0,80
967102,669211,2017-06-27,Senate,"Do pass, but first be re-referred to the Committee on [Appropriations]",7,0,0,0,7
967102,673987,2017-08-21,Senate,"Placed on suspense file",7,0,0,0,7
967104,684864,2018-01-09,Senate,"Do pass as amended",5,2,0,0,7
967104,689954,2018-01-29,Senate,"Senate 3rd Reading SB691 Lara et al",30,9,1,0,40
967104,768303,2018-06-26,Assembly,"Do pass as amended and be re-referred to the Committee on [Appropriations]",9,1,0,0,10
967104,771088,2018-08-08,Assembly,"Do pass",12,5,0,0,17
967104,772228,2018-08-20,Assembly,"SB 691 Lara Senate Third Reading By ARAMBULA",58,19,3,0,80
967105,632405,2017-04-24,Assembly,"Do pass as amended and be re-referred to the Committee on [Appropriations]",8,2,0,0,10
967105,649468,2017-05-24,Assembly,"Do pass",12,5,0,0,17
967105,654249,2017-05-30,Assembly,"AB 1273 GALLAGHER Assembly Third Reading",59,12,9,0,80
967105,671495,2017-07-05,Senate,"Do pass, but first be re-referred to the Committee on [Natural Resources and Water]",4,1,2,0,7
967105,672136,2017-07-11,Senate,"Do pass, but first be re-referred to the Committee on [Appropriations]",3,0,6,0,9
967106,684745,2018-01-09,Senate,"Do pass as amended, but first amend, and re-refer to the Committee on [Appropriations]",8,3,2,0,13
967106,685449,2018-01-16,Senate,"Placed on suspense file",7,0,0,0,7
967106,686200,2018-01-18,Senate,"Do pass as amended",5,2,0,0,7
967106,690053,2018-01-29,Senate,"Senate 3rd Reading SB760 Wiener et al",30,7,3,0,40
967107,627009,2017-04-17,Assembly,"Do pass as amended and be re-referred to the Committee on [Environmental Safety and Toxic Materials]",7,3,0,0,10
967107,632270,2017-04-25,Assembly,"Do pass and be re-referred to the Committee on [Appropriations]",4,2,1,0,7
967107,651970,2017-05-26,Assembly,"Do pass as amended",11,6,0,0,17
967107,655795,2017-05-31,Assembly,"AB 1180 HOLDEN Assembly Third Reading",47,25,8,0,80
967107,672871,2017-07-19,Senate,"Do pass as amended",5,2,0,0,7
967107,674326,2017-08-31,Senate,"Assembly 3rd Reading AB1180 Holden et al. By Hernandez",23,13,4,0,40
967107,675640,2017-09-12,Assembly,"With recommendation: That Senate amendments be concurred in",6,2,1,0,9
967107,675770,2017-09-13,Assembly,"AB 1180 HOLDEN Concurrence in Senate Amendments",46,30,3,0,79
967108,620352,2017-04-04,Assembly,"Do pass as amended and be re-referred to the Committee on [Appropriations]",7,0,0,0,7
967108,643606,2017-05-11,Assembly,"AB 1446 COOLEY Assembly Third Reading",77,0,3,0,80
967108,662596,2017-06-13,Senate,"Do pass as amended, but first amend, and re-refer to the Committee on [Judiciary] with the recommendation: To Consent Calendar",4,0,1,0,5
967108,669887,2017-06-27,Senate,"Do pass as amended, but first amend, and re-refer to the Committee on [Rules] with the recommendation: To Consent Calendar",6,0,1,0,7
967108,673971,2017-08-21,Senate,"Placed on suspense file",7,0,0,0,7
967108,674734,2017-09-01,Senate,"Do pass as amended",7,0,0,0,7
967109,613611,2017-03-28,Senate,"Do pass as amended, but first amend, and re-refer to the Committee on [Appropriations]",7,0,0,0,7
967109,647820,2017-05-22,Senate,"Senate 3rd Reading SB644 Stone",37,0,3,0,40
967109,662234,2017-06-13,Assembly,"Do pass as amended, and be re-referred to the Committee on [Appropriations] with recommendation: To Consent Calendar",7,0,0,0,7
967109,669580,2017-06-28,Assembly,"Do pass. To Consent Calendar",14,0,3,0,17
967109,671579,2017-07-06,Assembly,"SB 644 Stone Consent Calendar Second Day Regular Session",74,0,6,0,80
967109,671936,2017-07-10,Senate,"Unfinished Business SB644 Stone Concurrence",39,0,1,0,40
967110,619960,2017-04-05,Assembly,"Do pass as amended and be re-referred to the Committee on [Veterans Affairs]",6,1,0,0,7
967110,633251,2017-04-25,Assembly,"Do pass as amended and be re-referred to the Committee on [Appropriations]",8,1,1,0,10
967110,651511,2017-05-26,Assembly,"Do pass as amended",17,0,0,0,17
967110,655864,2017-05-31,Assembly,"AB 1403 OBERNOLTE Assembly Third Reading",76,1,3,0,80
967110,672639,2017-07-12,Senate,"Do pass, but first be re-referred to the Committee on [Appropriations]",5,0,0,0,5
967110,674209,2017-08-28,Senate,"Placed on suspense file",7,0,0,0,7
967110,674537,2017-09-01,Senate,"Do pass as amended",7,0,0,0,7
967110,675721,2017-09-12,Senate,"Assembly 3rd Reading AB1403 Obernolte By Anderson",40,0,0,0,40
967110,676313,2017-09-14,Assembly,"With recommendation: That Senate amendments be concurred in",6,0,1,0,7
967110,676548,2017-09-15,Assembly,"AB 1403 OBERNOLTE Concurrence in Senate Amendments",79,0,0,0,79
967111,641970,2017-05-08,Assembly,"Do pass as amended and be re-referred to the Committee on [Appropriations]",8,1,1,0,10
967112,642697,2017-05-10,Assembly,"Do pass. To Consent Calendar",7,0,0,0,7
967112,646513,2017-05-18,Assembly,"AB 1154 NAZARIAN Consent Calendar Second Day Regular Session",69,0,11,0,80
967112,666707,2017-06-20,Senate,"Do pass and be ordered to the Consent Calendar",5,0,0,0,5
967112,670990,2017-07-03,Senate,"Consent Calendar AB1154 Nazarian",33,0,7,0,40
967114,631884,2017-04-25,Assembly,"Do pass and be re-referred to the Committee on [Appropriations]",14,1,1,0,16
967114,637515,2017-05-03,Assembly,"Do pass",15,1,1,0,17
967114,644346,2017-05-15,Assembly,"AB 1527 COOLEY Assembly Third Reading",77,0,3,0,80
967114,750029,2018-05-07,Senate,"Do pass",8,0,1,0,9
967114,767102,2018-06-21,Senate,"Assembly 3rd Reading AB1527 Jones-Sawyer et al. By Hertzberg Urgency Clause",36,0,3,0,39
967114,768279,2018-06-26,Assembly,"With recommendation: That Senate amendments be concurred in",19,0,0,0,19
967114,769248,2018-06-28,Assembly,"AB 1527 JONES-SAWYER Concurrence - Urgency Added",74,0,6,0,80
967115,618383,2017-04-04,Senate,"Do pass, but first be re-referred to the Committee on [Public Safety]",3,1,1,0,5
967115,631977,2017-04-25,Senate,"Do pass",5,2,0,0,7
967115,656072,2017-05-31,Senate,"Senate 3rd Reading SB613 De León",26,13,1,0,40
967115,672825,2017-07-18,Assembly,"Do pass",8,2,1,0,11
967115,676483,2017-09-15,Assembly,"SB 613 De León Senate Third Reading By KALRA",52,23,4,0,79
967117,627032,2017-04-17,Assembly,"Do pass and be re-referred to the Committee on [Appropriations]",7,3,0,0,10
967117,645896,2017-05-17,Assembly,"Do pass",9,7,1,0,17
967118,626798,2017-04-18,Assembly,"Do pass and be re-referred to the Committee on [Appropriations]",5,2,0,0,7
967118,645737,2017-05-17,Assembly,"Do pass",12,5,0,0,17
967118,654292,2017-05-30,Assembly,"AB 1344 WEBER Assembly Third Reading",46,27,7,0,80
967118,666121,2017-06-20,Senate,"Do pass, but first be re-referred to the Committee on [Appropriations]",5,2,0,0,7
967118,674976,2017-09-05,Senate,"Assembly 3rd Reading AB1344 Weber et al. By Hertzberg",27,11,2,0,40
967118,675487,2017-09-11,Assembly,"AB 1344 WEBER Concurrence in Senate Amendments",48,28,3,0,79
967118,777176,2017-09-05,Senate,"Assembly 3rd Reading AB1344 colspan=""2""> ?",5,11,2,0,18
967119,610546,2017-03-22,Assembly,"Do pass. To Consent Calendar",10,0,0,0,10
967119,616148,2017-03-30,Assembly,"AB 1126 AGRI. Consent Calendar Second Day Regular Session",74,0,6,0,80
967119,659382,2017-06-06,Senate,"Do pass, but first be re-referred to the Committee on [Environmental Quality] with the recommendation: To Consent Calendar",4,0,1,0,5
967119,667599,2017-06-21,Senate,"Do pass as amended, and be ordered to the Consent Calendar",6,0,1,0,7
967119,671006,2017-07-03,Senate,"Consent Calendar 2nd AB1126 AGRI",33,0,7,0,40
967119,671605,2017-07-06,Assembly,"AB 1126 AGRI. Concurrence in Senate Amendments By CABALLERO",75,0,5,0,80
967120,634539,2017-04-25,Assembly,"Do pass and be re-referred to the Committee on [Appropriations]",2,4,10,0,16
967123,631782,2017-04-25,Senate,"Do pass",5,2,0,0,7
967123,635690,2017-05-01,Senate,"Senate 3rd Reading SB630 Skinner",22,14,4,0,40
967123,662201,2017-06-13,Assembly,"Do pass",5,2,0,0,7
967123,675051,2017-09-06,Assembly,"Do pass and be re-referred to the Committee on [Appropriations]",5,0,2,0,7
967124,627975,2017-04-19,Assembly,"Do pass and be re-referred to the Committee on [Local Government]",5,2,0,0,7
967124,634429,2017-04-26,Assembly,"Do pass and be re-referred to the Committee on [Appropriations]",6,0,3,0,9
967124,649391,2017-05-24,Assembly,"Do pass",11,5,1,0,17
967124,655780,2017-05-31,Assembly,"AB 1397 LOW Assembly Third Reading",51,25,4,0,80
967124,672105,2017-07-11,Senate,"Do pass, but first be re-referred to the Committee on [Appropriations]",9,1,3,0,13
967124,672754,2017-07-17,Senate,"Do pass",5,2,0,0,7
967124,676533,2017-09-15,Senate,"Assembly 3rd Reading AB1397 Low et al. By Wiener",24,11,5,0,40
967124,676534,2017-09-15,Assembly,"AB 1397 LOW Concurrence in Senate Amendments",49,25,5,0,79
967125,628863,2017-04-19,Assembly,"Do pass and be re-referred to the Committee on [Appropriations]",6,0,1,0,7
967125,637386,2017-05-03,Assembly,"Do pass. To Consent Calendar",16,0,1,0,17
967125,643444,2017-05-11,Assembly,"AB 1283 RODRIGUEZ Consent Calendar Second Day Regular Session",77,0,3,0,80
967125,669869,2017-06-28,Senate,"Do pass, but first be re-referred to the Committee on [Appropriations]",4,0,1,0,5
967126,633574,2017-04-25,Senate,"Do pass, but first be re-referred to the Committee on [Education]",2,1,4,0,7
967126,633575,2017-04-25,Senate,"[First] hearing set for [04-26-2017]: Failed passage in Committee. Reconsideration granted",7,0,0,0,7
967127,633494,2017-04-26,Senate,"Do pass and be ordered to the Consent Calendar",7,0,0,0,7
967127,638613,2017-05-04,Senate,"Consent Calendar 2nd SB596 Stern",38,0,2,0,40
967127,672531,2017-07-12,Assembly,"Do pass and be re-referred to the Committee on [Appropriations]",7,0,0,0,7
967127,674607,2017-09-01,Assembly,"Do pass as amended",12,4,1,0,17
967127,676399,2017-09-15,Senate,"That the Assembly amendments be concurred in",5,2,0,0,7
967127,676554,2017-09-15,Assembly,"SB 596 Stern Senate Third Reading By WEBER",61,16,2,0,79
967127,676555,2017-09-15,Senate,"Unfinished Business SB596 Stern et al. Concurrence",27,11,2,0,40
967128,630252,2017-04-24,Senate,"Do pass, but first be re-referred to the Committee on [Appropriations]",10,0,1,0,11
967128,644275,2017-05-15,Senate,"Do pass",7,0,0,0,7
967128,647852,2017-05-22,Senate,"Senate 3rd Reading SB711 Hill",37,0,3,0,40
967128,671339,2017-07-05,Assembly,"Do pass as amended and be re-referred to the Committee on [Appropriations]",13,0,2,0,15
967128,674572,2017-09-01,Assembly,"Do pass as amended",16,0,1,0,17
967128,675934,2017-09-13,Assembly,"SB 711 Hill Senate Third Reading By PATTERSON",79,0,0,0,79
967128,676082,2017-09-14,Senate,"Unfinished Business SB711 Hill Concurrence",40,0,0,0,40
967129,632179,2017-04-25,Senate,"Do pass, but first be re-referred to the Committee on [Appropriations]",7,2,0,0,9
967129,644775,2017-05-15,Senate,"Placed on suspense file",7,0,0,0,7
967129,650802,2017-05-25,Senate,"Do pass",5,2,0,0,7
967129,655956,2017-05-31,Senate,"Senate 3rd Reading SB667 Atkins",27,12,1,0,40
967129,669225,2017-06-27,Assembly,"Do pass and be re-referred to the Committee on [Appropriations]",11,3,1,0,15
967129,674492,2017-09-01,Assembly,"Do pass",11,5,1,0,17
967129,675658,2017-09-12,Assembly,"SB 667 Atkins Senate Third Reading By BOCANEGRA",55,22,2,0,79
967129,675903,2017-09-13,Senate,"Unfinished Business SB667 Atkins Concurrence",28,11,1,0,40
967130,642057,2017-05-08,Senate,"Do pass, but first be re-referred to the Committee on [Appropriations]",3,1,1,0,5
967130,647824,2017-05-22,Senate,"Placed on suspense file",7,0,0,0,7
967130,650723,2017-05-25,Senate,"Do pass",5,2,0,0,7
967130,654347,2017-05-30,Senate,"Senate 3rd Reading SB646 Galgiani",28,11,1,0,40
967130,667321,2017-06-21,Assembly,"Do pass",5,1,1,0,7
967131,633546,2017-04-26,Senate,"Do pass, but first be re-referred to the Committee on [Appropriations]",5,2,0,0,7
967131,644991,2017-05-15,Senate,"Placed on suspense file",7,0,0,0,7
967133,618601,2017-04-04,Assembly,"Do pass and be re-referred to the Committee on [Human Services] with recommendation: To Consent Calendar",11,0,0,0,11
967133,633621,2017-04-25,Assembly,"Do pass and be re-referred to the Committee on [Appropriations] with recommendation: To Consent Calendar",7,0,0,0,7
967133,637565,2017-05-03,Assembly,"Do pass. To Consent Calendar",16,0,1,0,17
967133,643489,2017-05-11,Assembly,"AB 1332 BLOOM Consent Calendar Second Day Regular Session",77,0,3,0,80
967133,662124,2017-06-13,Senate,"Do pass, but first be re-referred to the Committee on [Judiciary]",4,0,1,0,5
967133,669813,2017-06-27,Senate,"Do pass, but first be re-referred to the Committee on [Appropriations] with the recommendation: To Consent Calendar",6,0,1,0,7
967133,675628,2017-09-12,Senate,"Assembly 3rd Reading AB1332 Bloom By Jackson",40,0,0,0,40
967133,676195,2017-09-14,Assembly,"AB 1332 BLOOM Concurrence in Senate Amendments",79,0,0,0,79
967137,618564,2017-04-04,Assembly,"Do pass and be re-referred to the Committee on [Appropriations]",6,0,1,0,7
967137,651682,2017-05-26,Assembly,"Do pass",13,1,3,0,17
967137,656848,2017-06-01,Assembly,"AB 1120 COOPER Assembly Third Reading",66,1,13,0,80
967137,672143,2017-07-11,Senate,"Do pass as amended, but first amend, and re-refer to the Committee on [Appropriations]",4,2,1,0,7
967137,673864,2017-08-21,Senate,"Placed on suspense file",7,0,0,0,7
967137,674520,2017-09-01,Senate,"Do pass as amended",6,1,0,0,7
967137,674521,2017-09-01,Senate,"[09-01-2017] set for [First] hearing: Reconsideration of favorable vote granted",7,0,0,0,7
967137,674522,2017-09-01,Senate,"Do pass as amended",7,0,0,0,7
967137,675084,2017-09-06,Senate,"Assembly 3rd Reading AB1120 Cooper et al. By Pan",34,3,3,0,40
967137,675495,2017-09-11,Assembly,"AB 1120 COOPER Concurrence in Senate Amendments",76,0,3,0,79
967138,626004,2017-04-17,Assembly,"Do pass and be re-referred to the Committee on [Communications and Conveyance]",13,0,1,0,14
967138,642607,2017-05-10,Assembly,"Do pass",12,0,1,0,13
967138,654960,2017-05-30,Assembly,"AB 1160 BONTA Assembly Third Reading",75,0,5,0,80
967139,618604,2017-04-04,Assembly,"Do pass as amended and be re-referred to the Committee on [Appropriations]",15,0,0,0,15
967139,633158,2017-04-26,Assembly,"Do pass. To Consent Calendar",16,0,1,0,17
967139,638680,2017-05-04,Assembly,"AB 1387 ARAMBULA Consent Calendar Second Day Regular Session",76,0,4,0,80
967139,672554,2017-07-12,Senate,"Do pass, but first be re-referred to the Committee on [Appropriations] with the recommendation: To Consent Calendar",8,0,1,0,9
967139,674111,2017-08-24,Senate,"Consent Calendar 2nd AB1387",38,0,2,0,40
967140,614127,2017-03-28,Senate,"Do pass as amended, but first amend, and re-refer to the Committee on [Environmental Quality]",7,2,0,0,9
967140,627755,2017-04-19,Senate,"Do pass, but first be re-referred to the Committee on [Appropriations]",5,2,0,0,7
967140,635691,2017-05-01,Senate,"Placed on suspense file",7,0,0,0,7
967142,618349,2017-04-04,Assembly,"Do pass and be re-referred to the Committee on [Transportation]",9,5,1,0,15
967143,631952,2017-04-24,Assembly,"Do pass and be re-referred to the Committee on [Appropriations]",12,1,1,0,14
967145,626489,2017-04-17,Assembly,"Do pass and be re-referred to the Committee on [Appropriations] with recommendation: To Consent Calendar",13,0,1,0,14
967145,627058,2017-04-17,Assembly,"Do pass and be re-referred to the Committee on [Local Government] with recommendation: To Consent Calendar",13,0,1,0,14
967145,634607,2017-04-26,Assembly,"Do pass and be re-referred to the Committee on [Appropriations] with recommendation: To Consent Calendar",9,0,0,0,9
967145,643172,2017-05-10,Assembly,"Do pass. To Consent Calendar",17,0,0,0,17
967145,646522,2017-05-18,Assembly,"AB 1121 CHIU Consent Calendar Second Day Regular Session",69,0,11,0,80
967146,637435,2017-05-03,Senate,"Do pass and be ordered to the Consent Calendar",6,0,1,0,7
967146,644584,2017-05-15,Senate,"Consent Calendar 2nd SB606 McGuire",39,0,1,0,40
967146,670411,2017-06-29,Assembly,"Be re-referred to the Committee on [Revenue and Taxation]",8,0,3,0,11
967146,672820,2017-07-18,Assembly,"Do pass",10,0,5,0,15
967146,673970,2017-08-21,Assembly,"SB 606 Skinner Senate Third Reading By GARCIA, E. Amend By GARCIA, E. Set #1",49,17,13,0,79
967146,675295,2017-09-11,Assembly,"Do pass and be re-referred to the Committee on [Rules]",11,5,1,0,17
967146,752575,2018-05-14,Assembly,"SB 606 Hertzberg Senate Third Reading By RUBIO",46,28,4,0,78
967146,754284,2018-05-17,Senate,"Unfinished Business SB606 Hertzberg et al. Concurrence",25,12,2,0,39
967147,621161,2017-04-05,Assembly,"Do pass and be re-referred to the Committee on [Housing and Community Development]",6,3,0,0,9
967147,633296,2017-04-26,Assembly,"Do pass as amended",5,2,0,0,7
967147,638394,2017-05-04,Assembly,"AB 1505 BLOOM Assembly Third Reading",47,24,9,0,80
967147,658894,2017-06-06,Senate,"Do pass",7,4,2,0,13
967147,676434,2017-09-15,Senate,"Assembly 3rd Reading AB1505 Bloom et al. By Atkins",23,12,5,0,40
967147,676435,2017-09-15,Assembly,"AB 1505 BLOOM Concurrence in Senate Amendments",46,27,6,0,79
967148,631876,2017-04-25,Assembly,"Do pass and be re-referred to the Committee on [Appropriations]",15,0,0,0,15
967148,649439,2017-05-24,Assembly,"Do pass. To Consent Calendar",17,0,0,0,17
967148,654495,2017-05-30,Assembly,"AB 1133 DAHLE Consent Calendar Second Day Regular Session",77,0,3,0,80
967148,672107,2017-07-11,Senate,"Do pass as amended, but first amend, and re-refer to the Committee on [Appropriations] with the recommendation: To Consent Calendar",9,0,0,0,9
967148,674409,2017-08-31,Senate,"Consent Calendar 2nd AB1133 Dahle",37,0,3,0,40
967148,675001,2017-09-05,Assembly,"AB 1133 DAHLE Concurrence in Senate Amendments",77,0,2,0,79
967149,642562,2017-05-10,Senate,"Do pass, but first be re-referred to the Committee on [Appropriations] with the recommendation: To Consent Calendar",6,0,1,0,7
967149,651593,2017-05-26,Senate,"Consent Calendar 2nd SB668",37,0,3,0,40
967149,764311,2018-06-18,Assembly,"Be re-referred to the Committee on [Agriculture]",7,0,4,0,11
967149,769018,2018-06-27,Assembly,"Do pass and be re-referred to the Committee on [Appropriations]",9,0,1,0,10
967149,771119,2018-08-08,Assembly,"Do pass",13,0,4,0,17
967149,773720,2018-08-30,Assembly,"SB 668 McGuire Senate Third Reading By CABALLERO",72,0,8,0,80
967149,774078,2018-08-31,Senate,"That the Assembly amendments be concurred in",4,0,1,0,5
967149,774079,2018-08-31,Senate,"Unfinished Business SB668 McGuire Concurrence",33,4,3,0,40
967150,631934,2017-04-24,Assembly,"Do pass as amended and be re-referred to the Committee on [Appropriations]",9,1,0,0,10
967150,651963,2017-05-26,Assembly,"Do pass",13,4,0,0,17
967150,656078,2017-05-31,Assembly,"AB 1433 WOOD Assembly Third Reading",62,12,6,0,80
967150,671346,2017-07-05,Senate,"Do pass, but first be re-referred to the Committee on [Appropriations]",6,0,1,0,7
967150,672156,2017-07-11,Senate,"Do pass as amended, but first amend, and re-refer to the Committee on [Appropriations]",8,0,1,0,9
967150,673822,2017-08-21,Senate,"Placed on suspense file",7,0,0,0,7
967150,674540,2017-09-01,Senate,"Do pass",6,1,0,0,7
967150,744730,2018-04-26,Senate,"Assembly 3rd Reading AB1433 Wood et al. By McGuire Urgency Clause",34,0,5,0,39
967150,748703,2018-05-03,Assembly,"AB 1433 WOOD Concurrence - Urgency Added",73,0,5,0,78
967151,608481,2017-03-21,Assembly,"Do pass and be re-referred to the Committee on [Appropriations]",6,0,1,0,7
967151,633552,2017-04-26,Assembly,"Do pass",16,0,1,0,17
967151,635671,2017-05-01,Assembly,"AB 1441 E.S. & T.M. Assembly Third Reading By QUIRK",73,0,7,0,80
967151,667334,2017-06-21,Senate,"Do pass, but first be re-referred to the Committee on [Appropriations] with the recommendation: To Consent Calendar",6,0,1,0,7
967151,671850,2017-07-10,Senate,"Placed on suspense file",7,0,0,0,7
967151,674633,2017-09-01,Senate,"Do pass",7,0,0,0,7
967152,610159,2017-03-22,Assembly,"Do pass as amended",6,0,1,0,7
967152,629277,2017-04-20,Assembly,"AB 1196 HARPER Assembly Third Reading",73,0,7,0,80
967152,659909,2017-06-07,Senate,"Do pass as amended, but first amend, and re-refer to the Committee on [Governance and Finance] with the recommendation: To Consent Calendar",7,0,0,0,7
967152,672358,2017-07-12,Senate,"Do pass",3,3,1,0,7
967152,672359,2017-07-12,Senate,"[First] hearing set for [07-12-2017]: Failed passage in Committee. Reconsideration granted",7,0,0,0,7
967154,631596,2017-04-24,Assembly,"Do pass and be re-referred to the Committee on [Appropriations] with recommendation: To Consent Calendar",10,0,0,0,10
967154,649445,2017-05-24,Assembly,"Do pass. To Consent Calendar",17,0,0,0,17
967154,654380,2017-05-30,Assembly,"AB 1530 GONZALEZ FLETCHER Consent Calendar Second Day Regular Session",77,0,3,0,80
967154,669040,2017-06-27,Senate,"Do pass as amended, but first amend, and re-refer to the Committee on [Appropriations]",8,0,1,0,9
967154,673921,2017-08-21,Senate,"Placed on suspense file",7,0,0,0,7
967154,674635,2017-09-01,Senate,"Do pass as amended",7,0,0,0,7
967154,676115,2017-09-14,Senate,"Special Consent Calendar # AB1530",40,0,0,0,40
967154,676347,2017-09-14,Assembly,"AB 1530 Gonzalez Fletcher Special Consent Calendar 1st Day Regular Session",79,0,0,0,79
967155,645044,2017-05-16,Senate,"Do pass as amended, but first amend, and re-refer to the Committee on [Judiciary]",5,2,0,0,7
967155,672869,2017-07-18,Senate,"Do pass as amended",5,1,1,0,7
967155,674183,2017-08-28,Senate,"Senate 3rd Reading SB785 Wiener et al. Urgency Clause",32,7,1,0,40
967155,725670,2018-03-20,Assembly,"Do pass and be re-referred to the Committee on [Judiciary]",7,0,0,0,7
967155,739548,2018-04-17,Assembly,"Do pass as amended",10,0,0,0,10
967155,746102,2018-04-30,Assembly,"SB 785 Wiener Third Reading Urgency By GONZALEZ FLETCHER",69,1,8,0,78
967155,751901,2018-05-10,Senate,"Unfinished Business SB785 Wiener et al. Urgency Clause Concurrence",31,6,2,0,39
967156,634591,2017-04-26,Senate,"Do pass as amended, but first amend, and re-refer to the Committee on [Appropriations]",6,1,0,0,7
967156,647953,2017-05-22,Senate,"Placed on suspense file",7,0,0,0,7
967156,650854,2017-05-25,Senate,"Do pass as amended",5,2,0,0,7
967156,656317,2017-05-31,Senate,"Senate 3rd Reading SB732 Stern",28,11,1,0,40
967156,669631,2017-06-28,Assembly,"Do pass and be re-referred to the Committee on [Local Government]",7,1,2,0,10
967156,672649,2017-07-12,Assembly,"Do pass as amended and be re-referred to the Committee on [Appropriations]",7,1,1,0,9
967156,674037,2017-08-23,Assembly,"Do pass as amended",10,5,2,0,17
967156,675340,2017-09-11,Assembly,"SB 732 Stern Senate Third Reading By CABALLERO",56,18,5,0,79
967156,675914,2017-09-13,Senate,"Unfinished Business SB732 Stern Concurrence",28,12,0,0,40
967157,628875,2017-04-19,Assembly,"Do pass and be re-referred to the Committee on [Judiciary]",1,5,1,0,7
967159,626392,2017-04-17,Senate,"Do pass, but first be re-referred to the Committee on [Appropriations]",9,0,0,0,9
967159,635746,2017-05-01,Senate,"Do pass",7,0,0,0,7
967159,638305,2017-05-04,Senate,"Senate 3rd Reading SB752 Stone",39,0,1,0,40
967159,666360,2017-06-20,Assembly,"Do pass and be re-referred to the Committee on [Appropriations]",15,0,1,0,16
967159,672853,2017-07-19,Assembly,"Do pass. To Consent Calendar",16,0,1,0,17
967159,674106,2017-08-24,Assembly,"SB 752 Stone Consent Calendar Second Day Regular Session",76,0,3,0,79
967159,675411,2017-09-11,Assembly,"SB 752 Stone Senate Third Reading By WALDRON",76,0,3,0,79
967159,676163,2017-09-14,Senate,"Special Consent Calendar SB752",40,0,0,0,40
967160,626193,2017-04-17,Assembly,"Be re-referred to the Committee on [Water, Parks, and Wildlife]",9,0,2,0,11
967160,632070,2017-04-25,Assembly,"Do pass and be re-referred to the Committee on [Appropriations]",14,0,1,0,15
967160,637470,2017-05-03,Assembly,"Do pass. To Consent Calendar",16,0,1,0,17
967160,643538,2017-05-11,Assembly,"AB 1355 BOCANEGRA Consent Calendar Second Day Regular Session",77,0,3,0,80
967160,669362,2017-06-27,Senate,"Do pass as amended, but first amend, and re-refer to the Committee on [Appropriations] with the recommendation: To Consent Calendar",8,0,1,0,9
967160,672985,2017-07-20,Senate,"Consent Calendar 2nd AB1355",38,0,2,0,40
967160,673953,2017-08-21,Assembly,"AB 1355 BOCANEGRA Concurrence in Senate Amendments",76,0,3,0,79
967161,614502,2017-03-28,Senate,"Do pass, but first be re-referred to the Committee on [Appropriations]",8,0,1,0,9
967161,626797,2017-04-17,Senate,"Do pass",7,0,0,0,7
967161,640559,2017-05-08,Senate,"Senate 3rd Reading SB615 Hueso et al. Urgency Clause",37,0,3,0,40
967161,669154,2017-06-27,Assembly,"Do pass and be re-referred to the Committee on [Appropriations]",14,1,0,0,15
967161,674573,2017-09-01,Assembly,"Do pass as amended",11,0,6,0,17
967161,675601,2017-09-12,Assembly,"SB 615 Hueso Senate Third Reading By GARCIA, E",59,15,5,0,79
967161,675905,2017-09-13,Senate,"Unfinished Business SB615 Hueso et al. Concurrence",38,1,1,0,40
967162,627182,2017-04-18,Senate,"Do pass as amended, but first amend, and re-refer to the Committee on [Environmental Quality]",9,2,2,0,13
967162,654566,2017-05-30,Senate,"Senate 3rd Reading SB802 Skinner et al",26,12,2,0,40
967162,668685,2017-06-26,Assembly,"Do pass and be re-referred to the Committee on [Communications and Conveyance]",7,4,3,0,14
967162,668686,2017-06-26,Assembly,Reconsideration,14,0,0,0,14
967162,671903,2017-07-10,Assembly,"Do pass and be re-referred to the Committee on [Communications and Conveyance]",10,4,0,0,14
967162,672384,2017-07-12,Assembly,"Do pass and be re-referred to the Committee on [Appropriations]",9,3,1,0,13
967163,632197,2017-04-25,Assembly,"Do pass as amended and be re-referred to the Committee on [Appropriations]",4,1,2,0,7
967163,649298,2017-05-24,Assembly,"Do pass",12,4,1,0,17
967163,654370,2017-05-30,Assembly,"AB 1529 THURMOND Assembly Third Reading",53,23,4,0,80
967163,672292,2017-07-12,Senate,"Do pass as amended, but first amend, and re-refer to the Committee on [Appropriations]",5,2,0,0,7
967163,673753,2017-08-21,Senate,"Placed on suspense file",7,0,0,0,7
967163,674483,2017-09-01,Senate,"Do pass as amended",5,2,0,0,7
967163,676436,2017-09-15,Senate,"Assembly 3rd Reading AB1529 Thurmond et al. By Lara",10,21,9,0,40
967163,676437,2017-09-15,Senate,"Assembly 3rd Reading AB1529 Thurmond et al. By Lara Reconsider",38,0,2,0,40
967163,772321,2018-08-21,Senate,"Assembly 3rd Reading AB1529 Thurmond et al. By Lara",24,13,3,0,40
967163,772905,2018-08-27,Assembly,"AB 1529 THURMOND Concurrence in Senate Amendments",52,24,4,0,80
967164,618616,2017-04-03,Assembly,"Do pass as amended and be re-referred to the Committee on [Appropriations]",9,1,0,0,10
967164,651915,2017-05-26,Assembly,"Do pass",17,0,0,0,17
967164,654196,2017-05-30,Assembly,"AB 1197 LIMÓN Assembly Third Reading",74,3,3,0,80
967164,669317,2017-06-27,Senate,"Do pass, but first be re-referred to the Committee on [Environmental Quality]",7,1,1,0,9
967164,671394,2017-07-05,Senate,"Do pass, but first be re-referred to the Committee on [Appropriations]",6,0,1,0,7
967164,674189,2017-08-28,Senate,"Placed on suspense file",7,0,0,0,7
967164,674696,2017-09-01,Senate,"Do pass",6,0,1,0,7
967164,675090,2017-09-06,Senate,"Assembly 3rd Reading AB1197 Limón By Wiener",39,1,0,0,40
967164,675524,2017-09-11,Assembly,"AB 1197 LIMÓN Concurrence in Senate Amendments",76,2,1,0,79
967166,618503,2017-04-04,Senate,"Do pass, but first be re-referred to the Committee on [Appropriations]",11,0,0,0,11
967166,626312,2017-04-17,Senate,"Placed on suspense file",7,0,0,0,7
967166,650732,2017-05-25,Senate,"Do pass",7,0,0,0,7
967166,655883,2017-05-31,Senate,"Special Consent Calendar # SB598",40,0,0,0,40
967166,672378,2017-07-12,Assembly,"Do pass as amended and be re-referred to the Committee on [Appropriations]",10,0,5,0,15
967166,674662,2017-09-01,Assembly,"Do pass as amended",11,0,6,0,17
967166,676582,2017-09-15,Assembly,"SB 598 Hueso Senate Third Reading By ARAMBULA",56,19,4,0,79
967166,676583,2017-09-16,Senate,"Unfinished Business SB598 Hueso Concurrence",38,0,2,0,40
967167,619811,2017-04-04,Assembly,"Do pass as amended, and be re-referred to the Committee on [Appropriations] with recommendation: To Consent Calendar",7,0,0,0,7
967167,651849,2017-05-26,Assembly,"Do pass as amended",16,0,1,0,17
967167,655725,2017-05-31,Assembly,"AB 1164 THURMOND Assembly Third Reading",77,0,3,0,80
967168,631902,2017-04-24,Assembly,"Do pass and be re-referred to the Committee on [Appropriations]",9,1,0,0,10
967168,651842,2017-05-26,Assembly,"Do pass",16,1,0,0,17
967168,655865,2017-05-31,Assembly,"AB 1410 WOOD Assembly Third Reading",73,3,4,0,80
967168,672145,2017-07-11,Senate,"Do pass as amended, but first amend, and re-refer to the Committee on [Appropriations]",6,0,1,0,7
967168,673853,2017-08-21,Senate,"Placed on suspense file",7,0,0,0,7
967168,674728,2017-09-01,Senate,"Do pass as amended",7,0,0,0,7
967168,674729,2017-09-01,Senate,"[09-01-2017] set for [First] hearing: Reconsideration of favorable vote granted",7,0,0,0,7
967168,674730,2017-09-01,Senate,"Do pass as amended",5,0,2,0,7
967168,675689,2017-09-12,Senate,"Assembly 3rd Reading AB1410 Wood et al. By Cannella",30,6,4,0,40
967168,675818,2017-09-13,Assembly,"AB 1410 Wood Concurrence in Senate Amendments",79,0,0,0,79
967172,631670,2017-04-24,Assembly,"Do pass and be re-referred to the Committee on [Appropriations]",4,9,1,0,14
967172,631671,2017-04-24,Assembly,Reconsideration,14,0,0,0,14
967173,631540,2017-04-24,Assembly,"Do pass and be re-referred to the Committee on [Appropriations]",12,1,1,0,14
967173,652129,2017-05-26,Assembly,"Do pass",17,0,0,0,17
967173,654411,2017-05-30,Assembly,"AB 1421 DABABNEH Assembly Third Reading",74,2,4,0,80
967174,632059,2017-04-25,Assembly,"Do pass as amended",6,1,0,0,7
967174,638525,2017-05-04,Assembly,"AB 1206 BOCANEGRA Assembly Third Reading",69,1,10,0,80
967174,672081,2017-07-11,Senate,"Do pass",6,1,0,0,7
967174,674860,2017-09-05,Senate,"Assembly 3rd Reading AB1206 Bocanegra By Pan",37,1,2,0,40
967174,675499,2017-09-11,Assembly,"AB 1206 BOCANEGRA Concurrence in Senate Amendments",76,1,2,0,79
967175,614530,2017-03-28,Senate,"Do pass, but first be re-referred to the Committee on [Appropriations] with the recommendation: To Consent Calendar",11,0,2,0,13
967175,629176,2017-04-20,Senate,"Consent Calendar 2nd SB664",36,0,4,0,40
967175,671396,2017-07-05,Assembly,"Do pass and be re-referred to the Committee on [Appropriations]",21,0,0,0,21
967175,672932,2017-07-19,Assembly,"Do pass. To Consent Calendar",16,0,1,0,17
967175,674870,2017-09-05,Assembly,"SB 664 Dodd Senate Third Reading By TING",75,0,4,0,79
967175,675531,2017-09-11,Senate,"That the Assembly amendments be concurred in",11,0,2,0,13
967175,675760,2017-09-13,Senate,"SB664 Dodd et al",40,0,0,0,40
967177,614821,2017-03-29,Assembly,"Do pass and be re-referred to the Committee on [Appropriations] with recommendation: To Consent Calendar",20,0,1,0,21
967177,634086,2017-04-26,Assembly,"Do pass. To Consent Calendar",16,0,1,0,17
967177,638644,2017-05-04,Assembly,"AB 1167 GRAY Consent Calendar Second Day Regular Session",76,0,4,0,80
967177,662741,2017-06-13,Senate,"Do pass, but first be re-referred to the Committee on [Appropriations] with the recommendation: To Consent Calendar",12,0,1,0,13
967178,621060,2017-04-05,Assembly,"Do pass. To Consent Calendar",8,0,1,0,9
967178,629156,2017-04-20,Assembly,"AB 1226 MCCARTY Consent Calendar Second Day Regular Session",74,0,6,0,80
967178,667558,2017-06-21,Senate,"Do pass and be ordered to the Consent Calendar",7,0,0,0,7
967178,671046,2017-07-03,Senate,"Consent Calendar 2nd AB1226",33,0,7,0,40
967179,613962,2017-03-28,Senate,"Do pass, but first be re-referred to the Committee on [Governance and Finance]",7,2,0,0,9
967179,642805,2017-05-10,Senate,"Do pass as amended, but first amend, and re-refer to the Committee on [Appropriations]",4,2,1,0,7
967179,647968,2017-05-22,Senate,"Placed on suspense file",7,0,0,0,7
967179,650653,2017-05-25,Senate,"Do pass",5,2,0,0,7
967179,655927,2017-05-31,Senate,"Senate 3rd Reading SB701 Hueso et al. Urgency Clause",30,10,0,0,40
967179,669096,2017-06-27,Assembly,"Do pass as amended and be re-referred to the Committee on [Appropriations]",10,4,1,0,15
967180,631629,2017-04-25,Assembly,"Do pass and be re-referred to the Committee on [Appropriations]",15,0,0,0,15
967180,651803,2017-05-26,Assembly,"Do pass as amended",12,0,5,0,17
967180,656227,2017-05-31,Assembly,"AB 1323 WEBER Assembly Third Reading",74,1,5,0,80
967180,672129,2017-07-11,Senate,"Do pass, but first be re-referred to the Committee on [Appropriations]",9,0,0,0,9
967180,673926,2017-08-21,Senate,"Placed on suspense file",7,0,0,0,7
967183,684193,2018-01-08,Assembly,"Do pass as amended and be re-referred to the Committee on [Appropriations]",13,0,1,0,14
967183,686162,2018-01-18,Assembly,"Do pass as amended",17,0,0,0,17
967183,690185,2018-01-29,Assembly,"AB 1395 CHU Assembly Third Reading",62,12,3,0,77
967183,768178,2018-06-26,Senate,"Do pass, but first be re-referred to the Committee on [Appropriations]",9,2,2,0,13
967183,771242,2018-08-13,Senate,"Placed on suspense file",7,0,0,0,7
967184,631707,2017-04-25,Assembly,"Do pass",7,0,0,0,7
967184,651553,2017-05-26,Assembly,"AB 1440 KALRA Assembly Third Reading",58,3,19,0,80
967184,666216,2017-06-20,Senate,"Do pass",5,2,0,0,7
967184,670313,2017-06-29,Senate,"Assembly 3rd Reading AB1440 Kalra By Lara",27,8,5,0,40
967184,671557,2017-07-06,Assembly,"AB 1440 KALRA Concurrence in Senate Amendments",56,4,20,0,80
967184,774684,2017-06-29,Senate,,5,8,5,0,18
967187,620225,2017-04-05,Senate,"Do pass, but first be re-referred to the Committee on [Appropriations]",9,0,0,0,9
967187,644579,2017-05-15,Senate,"Placed on suspense file",7,0,0,0,7
967187,650821,2017-05-25,Senate,"Do pass",7,0,0,0,7
967187,655982,2017-05-31,Senate,"Special Consent Calendar # SB643",40,0,0,0,40
967187,669188,2017-06-27,Assembly,"Do pass and be re-referred to the Committee on [Appropriations] with recommendation: To Consent Calendar",15,0,0,0,15
967187,674656,2017-09-01,Assembly,"Do pass",16,0,1,0,17
967187,675332,2017-09-11,Assembly,"SB 643 Pan Senate Third Reading By ARAMBULA",77,0,2,0,79
967188,632007,2017-04-24,Senate,"Do pass as amended, but first amend, and re-refer to the Committee on [Appropriations]",8,0,1,0,9
967188,644472,2017-05-15,Senate,"Placed on suspense file",7,0,0,0,7
967188,650478,2017-05-25,Senate,"Do pass as amended",7,0,0,0,7
967188,655784,2017-05-31,Senate,"Senate 3rd Reading SB799 Hill",40,0,0,0,40
967188,674225,2017-08-29,Assembly,"Do pass and be re-referred to the Committee on [Appropriations]",9,0,7,0,16
967188,674732,2017-09-01,Assembly,"Do pass",16,0,1,0,17
967188,675129,2017-09-07,Assembly,"SB 799 Hill Senate Third Reading By LOW",71,0,8,0,79
967188,675784,2017-09-13,Senate,"Unfinished Business SB799 Hill Concurrence",40,0,0,0,40
967189,632294,2017-04-25,Senate,"Be adopted, but first be re-referred to the Committee on [Appropriations] with recommendation: To Consent Calendar",13,0,0,0,13
967189,644511,2017-05-15,Senate,"Consent Calendar 2nd SCR25",39,0,1,0,40
967189,671854,2017-07-10,Assembly,"Be adopted. To Consent Calendar",14,0,0,0,14
967189,672533,2017-07-13,Assembly,"SCR 25 Portantino Consent Calendar Second Day Regular Session",75,0,4,0,79
967190,618260,2017-04-04,Senate,"Do pass, but first be re-referred to the Committee on [Governance and Finance]",11,0,0,0,11
967190,634546,2017-04-26,Senate,"Do pass as amended, but first amend, and re-refer to the Committee on [Appropriations]",7,0,0,0,7
967190,644340,2017-05-15,Senate,"Placed on suspense file",7,0,0,0,7
967190,650380,2017-05-25,Senate,"Do pass",6,0,1,0,7
967190,655888,2017-05-31,Senate,"Senate 3rd Reading SB649 Hueso et al",32,1,7,0,40
967190,670353,2017-06-28,Assembly,"Do pass as amended and be re-referred to the Committee on [Communications and Conveyance]",6,2,1,0,9
967190,672421,2017-07-12,Assembly,"Do pass as amended and be re-referred to the Committee on [Appropriations]",10,0,3,0,13
967190,674581,2017-09-01,Assembly,"Do pass as amended",12,1,4,0,17
967190,675791,2017-09-13,Assembly,"SB 649 Hueso Senate Third Reading By QUIRK",46,16,17,0,79
967190,676039,2017-09-14,Senate,"Unfinished Business SB649 Hueso et al. Concurrence",22,10,8,0,40
967191,618562,2017-04-04,Senate,"Do pass, but first be re-referred to the Committee on [Rules]",6,0,1,0,7
967191,631468,2017-04-25,Senate,"Do pass as amended, but first amend, and re-refer to the Committee on [Appropriations] with the recommendation: To Consent Calendar",5,0,0,0,5
967191,644343,2017-05-15,Senate,"Placed on suspense file",7,0,0,0,7
967194,628077,2017-04-19,Assembly,"Do pass as amended and be re-referred to the Committee on [Appropriations]",11,2,2,0,15
967194,649270,2017-05-24,Assembly,"Do pass",14,3,0,0,17
967194,654217,2017-05-30,Assembly,"AB 1400 FRIEDMAN Assembly Third Reading",61,11,8,0,80
967194,666574,2017-06-20,Senate,"Do pass, but first be re-referred to the Committee on [Appropriations]",9,1,1,0,11
967194,675686,2017-09-12,Senate,"Assembly 3rd Reading AB1400 Friedman By Stern",39,0,1,0,40
967194,675930,2017-09-13,Assembly,"AB 1400 Friedman Concurrence in Senate Amendments",68,7,4,0,79
967196,684584,2018-01-08,Senate,"Do pass as amended, but first amend, and re-refer to the Committee on [Appropriations]",9,0,0,0,9
967196,686924,2018-01-22,Senate,"Senate 3rd Reading SB795 Galgiani",38,0,2,0,40
967196,768375,2018-06-26,Assembly,"Do pass as amended and be re-referred to the Committee on [Appropriations]",19,0,0,0,19
967196,771140,2018-08-08,Assembly,"Do pass. To Consent Calendar",17,0,0,0,17
967196,771765,2018-08-16,Assembly,"SB 795 Galgiani Consent Calendar Second Day Regular Session",76,0,4,0,80
967196,772323,2018-08-21,Senate,"Unfinished Business SB795 Galgiani Concurrence",38,0,2,0,40
967198,642969,2017-05-10,Assembly,"Do pass and be re-referred to the Committee on [Appropriations]",3,4,0,0,7
967198,642970,2017-05-10,Assembly,Reconsideration,7,0,0,0,7
967199,627981,2017-04-19,Assembly,"Do pass and be re-referred to the Committee on [Water, Parks, and Wildlife]",6,1,0,0,7
967199,631818,2017-04-25,Assembly,"Do pass and be re-referred to the Committee on [Appropriations]",10,5,0,0,15
967200,619207,2017-04-03,Assembly,"Do pass as amended, and be re-referred to the Committee on [Appropriations] with recommendation: To Consent Calendar",10,0,0,0,10
967201,620143,2017-04-04,Senate,"Do pass, but first be re-referred to the Committee on [Public Safety]",12,0,1,0,13
967201,631577,2017-04-25,Senate,"Do pass as amended, but first amend, and re-refer to the Committee on [Appropriations]",7,0,0,0,7
967201,644320,2017-05-15,Senate,"Placed on suspense file",7,0,0,0,7
967201,650462,2017-05-25,Senate,"Do pass as amended",7,0,0,0,7
967201,655848,2017-05-31,Senate,"Senate 3rd Reading SB699 Galgiani et al",40,0,0,0,40
967201,758588,2018-05-31,Assembly,"Be re-referred to the Committee on [Public Safety]",7,0,4,0,11
967202,627116,2017-04-18,Assembly,"Do pass as amended. To Consent Calendar",11,0,0,0,11
967202,634663,2017-04-27,Assembly,"AB 1290 OBERNOLTE Consent Calendar Second Day Regular Session",75,0,5,0,80
967202,672937,2017-07-18,Senate,"Do pass as amended",7,0,0,0,7
967202,773156,2018-08-28,Senate,"Assembly 3rd Reading AB1290 Obernolte By Jackson",38,1,1,0,40
967202,773401,2018-08-29,Assembly,"AB 1290 OBERNOLTE Concurrence in Senate Amendments",79,0,1,0,80
967203,621070,2017-04-05,Assembly,"Do pass as amended, and be re-referred to the Committee on [Appropriations] with recommendation: To Consent Calendar",7,0,0,0,7
967203,652164,2017-05-26,Assembly,"Do pass",17,0,0,0,17
967203,654192,2017-05-30,Assembly,"AB 1399 NAZARIAN Assembly Third Reading",76,0,4,0,80
967203,672519,2017-07-12,Senate,"Do pass, but first be re-referred to the Committee on [Appropriations]",7,0,0,0,7
967203,675737,2017-09-12,Senate,"Assembly 3rd Reading AB1399 Nazarian By Wilk",40,0,0,0,40
967203,676294,2017-09-14,Assembly,"AB 1399 NAZARIAN Concurrence in Senate Amendments",79,0,0,0,79
967205,633483,2017-04-26,Senate,"Do pass, but first be re-referred to the Committee on [Appropriations]",6,0,1,0,7
967205,644786,2017-05-15,Senate,"Placed on suspense file",7,0,0,0,7
967205,650825,2017-05-25,Senate,"Do pass as amended",7,0,0,0,7
967205,656249,2017-05-31,Senate,"Senate 3rd Reading SB805 Galgiani",26,7,7,0,40
967206,632277,2017-04-24,Senate,"Do pass as amended, but first amend, and re-refer to the Committee on [Appropriations]",8,0,1,0,9
967206,644328,2017-05-15,Senate,"Senate 3rd Reading SB716 Hernandez et al",39,0,1,0,40
967206,672150,2017-07-11,Assembly,"Do pass and be re-referred to the Committee on [Appropriations]",15,0,1,0,16
967207,631699,2017-04-25,Assembly,"Do pass and be re-referred to the Committee on [Appropriations]",14,0,1,0,15
967207,645919,2017-05-17,Assembly,"Do pass. To Consent Calendar",17,0,0,0,17
967207,651440,2017-05-26,Assembly,"AB 1372 LEVINE Consent Calendar Second Day Regular Session",76,0,4,0,80
967207,667283,2017-06-21,Senate,"Do pass, but first be re-referred to the Committee on [Appropriations]",9,0,0,0,9
967207,672766,2017-07-17,Senate,"Placed on suspense file",7,0,0,0,7
967207,674801,2017-09-01,Senate,"Do pass",7,0,0,0,7
967209,626813,2017-04-18,Senate,"Do pass, but first be re-referred to the Committee on [Education]",5,0,0,0,5
967209,633499,2017-04-26,Senate,"Do pass as amended, but first amend, and re-refer to the Committee on [Appropriations]",7,0,0,0,7
967209,644265,2017-05-15,Senate,"Placed on suspense file",7,0,0,0,7
967209,650616,2017-05-25,Senate,"Do pass as amended",7,0,0,0,7
967209,656119,2017-05-31,Senate,"Senate 3rd Reading SB782 Skinner et al",39,0,1,0,40
967209,763787,2018-06-14,Assembly,"Be re-referred to the Committee on [Utilities and Energy]",7,0,4,0,11
967209,769108,2018-06-27,Assembly,"Do pass as amended and be re-referred to the Committee on [Appropriations]",10,5,0,0,15
967209,771872,2018-08-16,Assembly,"Do pass as amended",12,0,5,0,17
967209,773839,2018-08-30,Assembly,"SB 782 Skinner Senate Third Reading By IRWIN",78,0,2,0,80
967209,773967,2018-08-31,Senate,"That the Assembly amendments be concurred in",11,0,0,0,11
967209,774176,2018-08-31,Senate,"Unfinished Business SB782 Skinner Concurrence",39,0,1,0,40
967210,631700,2017-04-24,Assembly,"Do pass as amended and be re-referred to the Committee on [Appropriations]",10,0,0,0,10
967211,615010,2017-03-29,Senate,"Do pass",5,2,0,0,7
967212,637394,2017-05-03,Assembly,"Do pass. To Consent Calendar",20,0,1,0,21
967212,643352,2017-05-11,Assembly,"AB 1378 GRAY Consent Calendar Second Day Regular Session",77,0,3,0,80
967212,662453,2017-06-13,Senate,"Do pass and be ordered to the Consent Calendar",12,0,1,0,13
967212,675015,2017-09-06,Senate,"Assembly 3rd Reading AB1378 Gray By Lara Urgency Clause",40,0,0,0,40
967212,675268,2017-09-08,Assembly,"AB 1378 GRAY Concurrence - Urgency Added",79,0,0,0,79
967214,613742,2017-03-28,Assembly,"Do pass as amended and be re-referred to the Committee on [Appropriations]",11,0,0,0,11
967214,633458,2017-04-26,Assembly,"Do pass",16,0,1,0,17
967214,638602,2017-05-04,Assembly,"AB 1219 EGGMAN Assembly Third Reading",74,0,6,0,80
967214,667195,2017-06-21,Senate,"Do pass, but first be re-referred to the Committee on [Judiciary] with the recommendation: To Consent Calendar",9,0,0,0,9
967214,672428,2017-07-11,Senate,"Do pass as amended, but first amend, and re-refer to the Committee on [Appropriations] with the recommendation: To Consent Calendar",7,0,0,0,7
967214,674061,2017-08-24,Senate,"Consent Calendar 2nd AB1219",38,0,2,0,40
967214,675459,2017-09-11,Senate,"Assembly 3rd Reading AB1219 Eggman et al. By Dodd",39,0,1,0,40
967214,675898,2017-09-13,Assembly,"AB 1219 EGGMAN Concurrence in Senate Amendments",79,0,0,0,79
967217,619118,2017-04-04,Assembly,"Do pass and be re-referred to the Committee on [Appropriations] with recommendation: To Consent Calendar",13,0,2,0,15
967217,633568,2017-04-26,Assembly,"Do pass. To Consent Calendar",16,0,1,0,17
967217,638687,2017-05-04,Assembly,"AB 1504 COOLEY Consent Calendar Second Day Regular Session",76,0,4,0,80
967217,669332,2017-06-27,Senate,"Do pass as amended, but first amend, and re-refer to the Committee on [Appropriations] with the recommendation: To Consent Calendar",8,0,1,0,9
967217,673000,2017-07-20,Senate,"Consent Calendar 2nd AB1504",38,0,2,0,40
967217,674149,2017-08-24,Assembly,"AB 1504 COOLEY Concurrence in Senate Amendments",78,0,1,0,79
967218,631839,2017-04-25,Assembly,"Do pass and be re-referred to the Committee on [Appropriations]",8,3,0,0,11
967219,626268,2017-04-17,Senate,"Do pass",9,0,0,0,9
967219,629019,2017-04-20,Senate,"Senate 3rd Reading SB663 Nielsen",39,0,1,0,40
967219,669165,2017-06-27,Assembly,"Do pass as amended and be re-referred to the Committee on [Business and Professions]",14,0,1,0,15
967219,672089,2017-07-11,Assembly,"Do pass as amended",16,0,0,0,16
967219,672764,2017-07-17,Assembly,"SB 663 Nielsen Senate Third Reading By CUNNINGHAM",77,0,2,0,79
967219,674079,2017-08-24,Senate,"Special Consent Calendar # SB663",38,0,2,0,40
967220,628017,2017-04-19,Senate,"Do pass as amended, but first amend, and re-refer to the Committee on [Appropriations]",7,0,0,0,7
967220,644488,2017-05-15,Senate,"Placed on suspense file",7,0,0,0,7
967222,631853,2017-04-25,Assembly,"Do pass and be re-referred to the Committee on [Appropriations]",15,0,0,0,15
967222,645792,2017-05-17,Assembly,"Do pass. To Consent Calendar",17,0,0,0,17
967222,651403,2017-05-26,Assembly,"AB 1254 WOOD Consent Calendar Second Day Regular Session",76,0,4,0,80
967222,669086,2017-06-27,Senate,"Do pass, but first be re-referred to the Committee on [Public Safety]",8,0,1,0,9
967222,673889,2017-08-21,Senate,"Placed on suspense file",7,0,0,0,7
967223,618700,2017-04-03,Assembly,"Do pass as amended and be re-referred to the Committee on [Appropriations]",9,0,1,0,10
967223,649329,2017-05-24,Assembly,"Do pass",16,0,1,0,17
967223,654456,2017-05-30,Assembly,"AB 1158 CHU Assembly Third Reading",73,2,5,0,80
967223,671365,2017-07-05,Senate,"Do pass as amended, but first amend, and re-refer to the Committee on [Appropriations]",6,0,1,0,7
967223,675665,2017-09-12,Senate,"Assembly 3rd Reading AB1158 Chu et al. By Beall",30,10,0,0,40
967223,676448,2017-09-15,Assembly,"AB 1158 CHU Concurrence in Senate Amendments",52,22,5,0,79
967223,698606,2017-09-13,Assembly,"With recommendation: That Senate amendments be concurred in",6,2,2,0,10
967224,613963,2017-03-28,Assembly,"Do pass as amended and be re-referred to the Committee on [Accountability and Administrative Review]",7,0,0,0,7
967224,633867,2017-04-26,Assembly,"Do pass and be re-referred to the Committee on [Appropriations]",7,0,0,0,7
967225,641816,2017-05-08,Assembly,"Do pass. To Consent Calendar",9,0,1,0,10
967225,646632,2017-05-18,Assembly,"AB 1205 RIDLEY-THOMAS Consent Calendar Second Day Regular Session",69,0,11,0,80
967225,669698,2017-06-28,Senate,"Do pass and be ordered to the Consent Calendar",7,0,0,0,7
967225,753564,2018-05-15,Senate,"Do pass",11,1,1,0,13
967225,772872,2018-08-27,Senate,"Assembly 3rd Reading AB1205 Jones-Sawyer By Allen",34,4,2,0,40
967225,774177,2018-08-31,Assembly,"With recommendation: That Senate amendments be concurred in",9,0,0,0,9
967225,774178,2018-08-31,Assembly,"AB 1205 Jones-Sawyer Concurrence in Senate Amendments",79,0,1,0,80
967227,642810,2017-05-10,Senate,"Do pass",4,2,1,0,7
967227,646371,2017-05-18,Senate,"Senate 3rd Reading SB703 Skinner",24,13,3,0,40
967227,670234,2017-06-28,Assembly,"Do pass and be re-referred to the Committee on [Revenue and Taxation]",6,3,0,0,9
967227,672221,2017-07-10,Assembly,"Do pass as amended",7,3,0,0,10
967227,675240,2017-09-07,Assembly,"SB 703 Skinner Senate Third Reading By CALDERON Amendment Set #1",51,26,2,0,79
967227,675356,2017-09-11,Assembly,"SB 703 Skinner Senate Third Reading By CALDERON",49,28,2,0,79
967227,675613,2017-09-12,Senate,"Unfinished Business SB703 Skinner et al. Concurrence",26,13,1,0,40
967229,641588,2017-05-08,Senate,"Do pass",5,0,0,0,5
967229,648382,2017-05-22,Senate,"Senate 3rd Reading SB671 Moorlach",37,0,3,0,40
967229,667415,2017-06-21,Assembly,"Do pass. To Consent Calendar",6,0,1,0,7
967229,670419,2017-06-29,Assembly,"SB 671 Moorlach Consent Calendar Second Day Regular Session",74,0,6,0,80
967230,620242,2017-04-05,Assembly,"Do pass as amended and be re-referred to the Committee on [Appropriations]",4,2,1,0,7
967230,642834,2017-05-10,Assembly,"Do pass",12,5,0,0,17
967230,656890,2017-06-01,Assembly,"AB 1458 FRIEDMAN Assembly Third Reading",53,17,10,0,80
967231,610451,2017-03-22,Assembly,"Do pass as amended, and be re-referred to the Committee on [Appropriations] with recommendation: To Consent Calendar",7,0,0,0,7
967231,634093,2017-04-26,Assembly,"Do pass. To Consent Calendar",16,0,1,0,17
967231,638727,2017-05-04,Assembly,"AB 1142 MEDINA Consent Calendar Second Day Regular Session",76,0,4,0,80
967231,667217,2017-06-21,Senate,"Do pass, but first be re-referred to the Committee on [Appropriations] with the recommendation: To Consent Calendar",6,0,1,0,7
967231,672594,2017-07-13,Senate,"Consent Calendar 2nd AB1142",39,0,1,0,40
967231,673979,2017-08-21,Assembly,"AB 1142 MEDINA Concurrence in Senate Amendments",78,0,1,0,79
967232,631594,2017-04-25,Senate,"Do pass, but first be re-referred to the Committee on [Appropriations] with the recommendation: To Consent Calendar",7,0,0,0,7
967232,644301,2017-05-15,Senate,"Consent Calendar 2nd SB747",39,0,1,0,40
967232,670160,2017-06-27,Assembly,"Do pass and be re-referred to the Committee on [Appropriations]",8,0,2,0,10
967232,672927,2017-07-19,Assembly,"Do pass. To Consent Calendar",16,0,1,0,17
967232,674147,2017-08-24,Assembly,"SB 747 Newman Consent Calendar Second Day Regular Session",76,0,3,0,79
967233,631775,2017-04-24,Assembly,"Do pass and be re-referred to the Committee on [Appropriations]",7,1,2,0,10
967233,651817,2017-05-26,Assembly,"Do pass as amended",11,5,1,0,17
967233,655751,2017-05-31,Assembly,"AB 1328 LIMÓN Assembly Third Reading",37,26,17,0,80
967233,656912,2017-06-01,Assembly,"AB 1328 LIMÓN Motion to Reconsider",46,20,14,0,80
967233,656913,2017-06-01,Assembly,"AB 1328 LIMÓN Assembly Third Reading",43,24,13,0,80
967233,669001,2017-06-27,Senate,"Do pass as amended, but first amend, and re-refer to the Committee on [Environmental Quality]",7,1,1,0,9
967233,671389,2017-07-05,Senate,"Do pass as amended, but first amend, and re-refer to the Committee on [Appropriations]",5,2,0,0,7
967233,675516,2017-09-11,Senate,"Assembly 3rd Reading AB1328 Limón By Hertzberg",31,8,1,0,40
967233,675656,2017-09-12,Assembly,"AB 1328 LIMÓN Concurrence in Senate Amendments",61,16,2,0,79
967234,637270,2017-05-02,Senate,"Do pass as amended",7,0,0,0,7
967234,644401,2017-05-15,Senate,"Senate 3rd Reading SB658 Wiener",39,0,1,0,40
967234,672835,2017-07-18,Assembly,"Do pass as amended",10,0,1,0,11
967234,674388,2017-08-31,Assembly,"SB 658 Wiener Senate Third Reading By BAKER",72,0,7,0,79
967234,674876,2017-09-05,Senate,"Special Consent SB658",40,0,0,0,40
967235,634780,2017-04-26,Assembly,"Do pass as amended and be re-referred to the Committee on [Appropriations]",7,0,0,0,7
967235,646088,2017-05-17,Assembly,"Do pass. To Consent Calendar",17,0,0,0,17
967235,651442,2017-05-26,Assembly,"AB 1261 BERMAN Consent Calendar Second Day Regular Session",76,0,4,0,80
967235,667270,2017-06-21,Senate,"Do pass, but first be re-referred to the Committee on [Appropriations] with the recommendation: To Consent Calendar",6,0,1,0,7
967235,672543,2017-07-13,Senate,"Consent Calendar 2nd AB1261",39,0,1,0,40
967236,684746,2018-01-09,Senate,"Do pass, but first be re-referred to the Committee on [Natural Resources and Water]",3,2,2,0,7
967237,627277,2017-04-17,Assembly,"Do pass and be re-referred to the Committee on [Appropriations] with recommendation: To Consent Calendar",10,0,0,0,10
967237,633272,2017-04-26,Assembly,"Do pass. To Consent Calendar",16,0,1,0,17
967237,638486,2017-05-04,Assembly,"AB 1210 RIDLEY-THOMAS Consent Calendar Second Day Regular Session",76,0,4,0,80
967240,633325,2017-04-26,Assembly,"Do pass and be re-referred to the Committee on [Appropriations]",6,1,0,0,7
967240,651627,2017-05-26,Assembly,"Do pass",12,5,0,0,17
967240,656276,2017-05-31,Assembly,"AB 1406 GLORIA Assembly Third Reading",59,17,4,0,80
967240,760408,2018-06-06,Senate,"Do pass and be ordered to the Consent Calendar",6,0,0,0,6
967240,763401,2018-06-14,Senate,"Consent Calendar AB1406",37,0,2,0,39
967240,768824,2018-06-27,Assembly,"With recommendation: That Senate amendments be concurred in",7,0,0,0,7
967240,771147,2018-08-09,Assembly,"AB 1406 GLORIA Concurrence in Senate Amendments",78,0,2,0,80
967241,631658,2017-04-25,Assembly,"Do pass and be re-referred to the Committee on [Appropriations]",0,6,1,0,7
967242,618285,2017-04-04,Assembly,"Do pass as amended",10,1,0,0,11
967242,643370,2017-05-11,Assembly,"AB 1491 CABALLERO Assembly Third Reading",63,10,7,0,80
967242,665032,2017-06-19,Senate,"Do pass, but first be re-referred to the Committee on [Judiciary]",9,0,0,0,9
967242,672888,2017-07-18,Senate,"Do pass",7,0,0,0,7
967242,674266,2017-08-31,Senate,"Assembly 3rd Reading AB1491 Caballero et al. By Atkins",37,0,3,0,40
967242,674857,2017-09-05,Assembly,"AB 1491 CABALLERO Concurrence in Senate Amendments",63,10,6,0,79
967244,641752,2017-05-09,Senate,"Do pass",6,0,1,0,7
967244,656251,2017-05-31,Senate,"Senate 3rd Reading SB626 Newman",40,0,0,0,40
967244,672372,2017-07-11,Assembly,"Do pass",9,0,1,0,10
967244,674866,2017-09-05,Assembly,"SB 626 Dodd Third Reading Urgency By AGUIAR-CURRY",76,0,3,0,79
967244,675141,2017-09-07,Senate,"Special Consent Calendar # SB626 Dodd et al. Urgency Clause",40,0,0,0,40
967245,631714,2017-04-25,Senate,"Do pass, but first be re-referred to the Committee on [Appropriations]",13,0,0,0,13
967245,644347,2017-05-15,Senate,"Senate 3rd Reading SB654 Dodd",37,0,3,0,40
967245,667429,2017-06-21,Assembly,"Do pass and be re-referred to the Committee on [Appropriations]",17,0,4,0,21
967245,672915,2017-07-19,Assembly,"Do pass. To Consent Calendar",16,0,1,0,17
967245,674145,2017-08-24,Assembly,"SB 654 Dodd Consent Calendar Second Day Regular Session",76,0,3,0,79
967246,632741,2017-04-25,Assembly,"Do pass and be re-referred to the Committee on [Appropriations]",10,5,0,0,15
967247,614257,2017-03-28,Assembly,"Do pass and be re-referred to the Committee on [Appropriations]",7,0,0,0,7
967247,651549,2017-05-26,Assembly,"Do pass as amended",13,0,4,0,17
967247,656859,2017-06-01,Assembly,"AB 1384 WEBER Assembly Third Reading",73,2,5,0,80
967247,669097,2017-06-27,Senate,"Do pass, but first be re-referred to the Committee on [Appropriations]",7,0,0,0,7
967247,671845,2017-07-10,Senate,"Placed on suspense file",7,0,0,0,7
967247,674787,2017-09-01,Senate,"Do pass as amended",7,0,0,0,7
967247,675018,2017-09-06,Senate,"Assembly 3rd Reading AB1384 Weber et al. By Wiener",40,0,0,0,40
967247,675362,2017-09-11,Assembly,"AB 1384 WEBER Concurrence in Senate Amendments",77,0,2,0,79
967249,628066,2017-04-19,Assembly,"Do pass and be re-referred to the Committee on [Appropriations]",3,3,1,0,7
967249,634528,2017-04-27,Assembly,"Do pass and be re-referred to the Committee on [Appropriations]",4,1,2,0,7
967249,651676,2017-05-26,Assembly,"Do pass as amended",9,5,3,0,17
967249,656825,2017-06-01,Assembly,"AB 1250 JONES-SAWYER Assembly Third Reading",45,30,5,0,80
967249,672279,2017-07-12,Senate,"Do pass, but first be re-referred to the Committee on [Rules]",4,2,1,0,7
967249,673827,2017-08-21,Senate,"Placed on suspense file",7,0,0,0,7
967249,674506,2017-09-01,Senate,"Do pass as amended, but first amend, and re-refer to the Committee on [Rules]",5,0,2,0,7
967249,774493,2017-05-26,Assembly,,4,1,3,0,8
967250,634462,2017-04-26,Senate,"Do pass, but first be re-referred to the Committee on [Appropriations]",7,0,0,0,7
967250,644469,2017-05-15,Senate,"Placed on suspense file",7,0,0,0,7
967250,650673,2017-05-25,Senate,"Do pass",7,0,0,0,7
967250,654340,2017-05-30,Senate,"Senate 3rd Reading SB653 Moorlach",39,0,1,0,40
967250,670379,2017-06-28,Assembly,"Do pass and be re-referred to the Committee on [Appropriations]",9,0,0,0,9
967250,674553,2017-09-01,Assembly,"Do pass",16,0,1,0,17
967250,675333,2017-09-11,Assembly,"SB 653 Moorlach Senate Third Reading By LACKEY",74,3,2,0,79
967251,684161,2018-01-08,Senate,"Do pass, but first be re-referred to the Committee on [Appropriations]",5,0,0,0,5
967251,685406,2018-01-16,Senate,"Placed on suspense file",7,0,0,0,7
967251,686234,2018-01-18,Senate,"Do pass as amended",7,0,0,0,7
967251,690095,2018-01-29,Senate,"Senate 3rd Reading SB656 Moorlach et al",38,0,2,0,40
967251,766088,2018-06-20,Assembly,"Do pass and be re-referred to the Committee on [Appropriations]",6,0,1,0,7
967251,771711,2018-08-16,Assembly,"Do pass",17,0,0,0,17
967251,773883,2018-08-30,Assembly,"SB 656 Moorlach Senate Third Reading By COOLEY",78,0,2,0,80
967251,774025,2018-08-31,Senate,"Unfinished Business SB656 Moorlach et al. Concurrence",39,0,1,0,40
967252,684158,2018-01-08,Senate,"Do pass, but first be re-referred to the Committee on [Appropriations]",2,3,0,0,5
967252,684159,2018-01-08,Senate,"[Second] hearing set for [01-08-2018]: Failed passage in Committee. Reconsideration granted",5,0,0,0,5
967253,629138,2017-04-19,Senate,"Do pass, but first be re-referred to the Committee on [Appropriations]",7,1,1,0,9
967253,654417,2017-05-30,Senate,"Senate 3rd Reading SB743 Hernandez et al",27,13,0,0,40
967253,669094,2017-06-27,Assembly,"Do pass and be re-referred to the Committee on [Appropriations]",12,3,0,0,15
967253,674603,2017-09-01,Assembly,"Do pass as amended",11,5,1,0,17
967253,675802,2017-09-13,Assembly,"SB 743 Hernandez Senate Third Reading By GONZALEZ FLETCHER",55,21,3,0,79
967253,676120,2017-09-14,Senate,"Unfinished Business SB743 Hernandez et al. Concurrence",27,12,1,0,40
967255,631741,2017-04-25,Assembly,"Do pass as amended and be re-referred to the Committee on [Appropriations]",13,0,3,0,16
967255,649314,2017-05-24,Assembly,"Do pass",16,0,1,0,17
967255,654622,2017-05-30,Assembly,"AB 1357 CHU Assembly Third Reading",54,17,9,0,80
967255,671952,2017-07-10,Senate,"Do pass, but first be re-referred to the Committee on [Appropriations]",7,1,1,0,9
967255,674386,2017-08-31,Senate,"Assembly 3rd Reading AB1357 Chu By Galgiani",36,1,3,0,40
967255,674877,2017-09-05,Assembly,"AB 1357 CHU Concurrence in Senate Amendments",64,7,8,0,79
967257,614996,2017-03-29,Assembly,"Do pass and be re-referred to the Committee on [Appropriations] with recommendation: To Consent Calendar",12,0,1,0,13
967257,620189,2017-04-05,Assembly,"Do pass. To Consent Calendar",17,0,0,0,17
967257,629407,2017-04-20,Assembly,"AB 1373 DALY Consent Calendar Second Day Regular Session",74,0,6,0,80
967257,769193,2018-06-27,Senate,"Do pass as amended, but first amend, and re-refer to the Committee on [Appropriations]",12,0,1,0,13
967257,771386,2018-08-13,Senate,"Assembly 3rd Reading AB1373 Daly By Lara",37,0,3,0,40
967257,772433,2018-08-22,Assembly,"With recommendation: That Senate amendments be concurred in",13,0,0,0,13
967257,772785,2018-08-27,Assembly,"AB 1373 DALY Concurrence in Senate Amendments",80,0,0,0,80
967258,634626,2017-04-26,Assembly,"Do pass and be re-referred to the Committee on [Appropriations]",5,3,1,0,9
967260,632108,2017-04-25,Senate,"Do pass, but first be re-referred to the Committee on [Appropriations]",9,0,0,0,9
967260,644603,2017-05-15,Senate,"Placed on suspense file",7,0,0,0,7
967260,650737,2017-05-25,Senate,"Do pass as amended",6,1,0,0,7
967260,655774,2017-05-31,Senate,"Senate 3rd Reading SB773 Stern",28,12,0,0,40
967260,740648,2018-04-16,Assembly,"Be re-referred to the Committee on [Public Safety]",9,0,2,0,11
967262,621018,2017-04-05,Assembly,"Do pass as amended and be re-referred to the Committee on [Appropriations]",6,0,1,0,7
967262,637412,2017-05-03,Assembly,"Do pass. To Consent Calendar",16,0,1,0,17
967262,643391,2017-05-11,Assembly,"AB 1264 GARCIA, E. Consent Calendar Second Day Regular Session",77,0,3,0,80
967262,663145,2017-06-14,Senate,"Do pass as amended, but first amend, and re-refer to the Committee on [Appropriations]",7,0,0,0,7
967262,671868,2017-07-10,Senate,"Placed on suspense file",7,0,0,0,7
967262,674479,2017-09-01,Senate,"Do pass as amended",7,0,0,0,7
967262,675153,2017-09-07,Senate,"Assembly 3rd Reading AB1264 Eduardo Garcia et al. By Wilk",39,0,1,0,40
967262,675512,2017-09-11,Assembly,"AB 1264 GARCIA, E. Concurrence in Senate Amendments",78,0,1,0,79
967263,618331,2017-04-04,Assembly,"Do pass and be re-referred to the Committee on [Judiciary]",14,0,1,0,15
967263,626942,2017-04-18,Assembly,"Do pass as amended and be re-referred to the Committee on [Appropriations]",11,0,0,0,11
967263,651918,2017-05-26,Assembly,"Do pass",17,0,0,0,17
967263,655777,2017-05-31,Assembly,"AB 1116 GRAYSON Assembly Third Reading",77,0,3,0,80
967263,671567,2017-07-05,Senate,"Do pass, but first be re-referred to the Committee on [Judiciary]",9,0,0,0,9
967263,672350,2017-07-11,Senate,"Do pass as amended, but first amend, and re-refer to the Committee on [Appropriations] with the recommendation: To Consent Calendar",7,0,0,0,7
967263,673821,2017-08-21,Senate,"Placed on suspense file",7,0,0,0,7
967263,674494,2017-09-01,Senate,"Do pass",7,0,0,0,7
967263,772158,2018-08-20,Senate,"Assembly 3rd Reading AB1116 Grayson et al. By Dodd",39,0,1,0,40
967263,772485,2018-08-23,Assembly,"AB 1116 GRAYSON Concurrence in Senate Amendments",79,0,1,0,80
967266,627287,2017-04-18,Assembly,"Do pass and be re-referred to the Committee on [Judiciary]",15,0,1,0,16
967266,632010,2017-04-25,Assembly,"Do pass as amended and be re-referred to the Committee on [Appropriations]",10,0,1,0,11
967266,649489,2017-05-24,Assembly,"Do pass. To Consent Calendar",17,0,0,0,17
967266,653960,2017-05-30,Assembly,"AB 1247 CHEN Consent Calendar Second Day Regular Session",77,0,3,0,80
967266,764846,2018-06-18,Senate,"Do pass as amended, but first amend, and re-refer to the Committee on [Judiciary]",7,0,2,0,9
967266,772832,2018-08-27,Senate,"Assembly 3rd Reading AB1247 Nazarian By Galgiani",30,7,3,0,40
967266,773285,2018-08-29,Assembly,"With recommendation: That Senate amendments be concurred in",16,2,1,0,19
967266,773867,2018-08-30,Assembly,"AB 1247 NAZARIAN Concurrence in Senate Amendments",62,11,7,0,80
967268,630500,2017-04-24,Senate,"Do pass, but first be re-referred to the Committee on [Appropriations] with the recommendation: To Consent Calendar",5,0,0,0,5
967268,644293,2017-05-15,Senate,"Consent Calendar 2nd SB599",39,0,1,0,40
967268,671544,2017-07-06,Assembly,"Do pass and be re-referred to the Committee on [Appropriations]",7,0,0,0,7
967268,672930,2017-07-19,Assembly,"Do pass. To Consent Calendar",16,0,1,0,17
967268,674314,2017-08-31,Assembly,"SB 599 Portantino Senate Third Reading By RODRIGUEZ",73,0,6,0,79
967268,674989,2017-09-05,Senate,"Special Consent SB599",40,0,0,0,40
967269,632632,2017-04-25,Senate,"Do pass as amended, but first amend, and re-refer to the Committee on [Appropriations]",7,0,0,0,7
967269,647908,2017-05-22,Senate,"Placed on suspense file",7,0,0,0,7
967271,629262,2017-04-19,Assembly,"Do pass and be re-referred to the Committee on [Appropriations] with recommendation: To Consent Calendar",9,0,0,0,9
967271,638011,2017-05-03,Assembly,"Do pass. To Consent Calendar",16,0,1,0,17
967271,647979,2017-05-22,Assembly,"AB 1330 REYES Third Reading Urgency",77,0,3,0,80
967271,672523,2017-07-12,Senate,"Do pass as amended, but first amend, and re-refer to the Committee on [Appropriations]",7,0,0,0,7
967271,772419,2018-08-22,Senate,"Assembly 3rd Reading AB1330 Reyes By Leyva Urgency Clause",39,0,1,0,40
967271,773629,2018-08-29,Senate,"Assembly 3rd Reading AB1330 Reyes By Leyva Urgency Clause",26,0,14,0,40
967271,773630,2018-08-29,Senate,"Assembly 3rd Reading AB1330 Reyes By Leyva Reconsider",38,0,2,0,40
967271,774129,2018-08-31,Senate,"Assembly 3rd Reading AB1330 Reyes By Leyva Urgency Clause",38,0,2,0,40
967271,774130,2018-08-31,Assembly,"AB 1330 Reyes Concurrence in Senate Amendments",79,0,1,0,80
967273,634507,2017-04-26,Assembly,"Do pass as amended and be re-referred to the Committee on [Appropriations]",6,1,0,0,7
967274,626326,2017-04-17,Assembly,"Do pass and be re-referred to the Committee on [Appropriations] with recommendation: To Consent Calendar",13,0,1,0,14
967274,651683,2017-05-26,Assembly,"Do pass",17,0,0,0,17
967274,656177,2017-05-31,Assembly,"AB 1282 MULLIN Assembly Third Reading",76,0,4,0,80
967274,669383,2017-06-27,Senate,"Do pass, but first be re-referred to the Committee on [Appropriations] with the recommendation: To Consent Calendar",12,0,1,0,13
967274,672963,2017-07-20,Senate,"Consent Calendar 2nd AB1282",38,0,2,0,40
967274,674331,2017-08-31,Assembly,"AB 1282 MULLIN Concurrence in Senate Amendments",77,0,2,0,79
967275,632786,2017-04-25,Senate,"Do pass as amended, but first amend, and re-refer to the Committee on [Appropriations] with the recommendation: To Consent Calendar",13,0,0,0,13
967275,634198,2017-04-25,Senate,"Do pass, but first be re-referred to the Committee on [Appropriations] with the recommendation: To Consent Calendar",13,0,0,0,13
967275,644714,2017-05-15,Senate,"Do pass as amended",7,0,0,0,7
967275,654326,2017-05-30,Senate,"Senate 3rd Reading SB673 Newman",40,0,0,0,40
967275,671829,2017-07-10,Assembly,"Do pass and be re-referred to the Committee on [Appropriations]",14,0,0,0,14
967275,674263,2017-08-30,Assembly,"Do pass. To Consent Calendar",15,0,2,0,17
967275,675389,2017-09-11,Assembly,"SB 673 Newman Senate Third Reading By O'DONNELL",77,0,2,0,79
967275,676103,2017-09-14,Senate,"Special Consent Calendar SB673",40,0,0,0,40
967276,618424,2017-04-04,Senate,"Do pass, but first be re-referred to the Committee on [Appropriations]",6,0,1,0,7
967276,635707,2017-05-01,Senate,"Senate 3rd Reading SB611 Hill",37,0,3,0,40
967276,668611,2017-06-26,Assembly,"Do pass and be re-referred to the Committee on [Appropriations]",14,0,0,0,14
967276,674466,2017-09-01,Assembly,"Do pass as amended",16,0,1,0,17
967276,675931,2017-09-13,Assembly,"SB 611 Hill Senate Third Reading By FRAZIER",78,0,1,0,79
967276,676058,2017-09-14,Senate,"That the Assembly amendments be concurred in",13,0,0,0,13
967276,676569,2017-09-15,Senate,"Unfinished Business SB611 Hill et al. Concurrence",37,0,3,0,40
967277,626790,2017-04-18,Assembly,"Do pass as amended and be re-referred to the Committee on [Appropriations]",11,0,0,0,11
967277,651571,2017-05-26,Assembly,"Do pass as amended",16,0,1,0,17
967277,655903,2017-05-31,Assembly,"AB 1495 MAIENSCHEIN Assembly Third Reading",75,0,5,0,80
967277,672328,2017-07-11,Senate,"Do pass as amended, but first amend, and re-refer to the Committee on [Appropriations]",7,0,0,0,7
967277,673930,2017-08-21,Senate,"Placed on suspense file",7,0,0,0,7
967278,684802,2018-01-09,Assembly,"Do pass as amended and be re-referred to the Committee on [Appropriations]",5,0,2,0,7
967278,686181,2018-01-18,Assembly,"Do pass",12,4,1,0,17
967278,690088,2018-01-29,Assembly,"AB 1419 QUIRK Assembly Third Reading",35,26,16,0,77
967280,628092,2017-04-19,Assembly,"Do pass as amended and be re-referred to the Committee on [Appropriations]",10,0,5,0,15
967281,632031,2017-04-25,Assembly,"Do pass as amended and be re-referred to the Committee on [Appropriations]",13,2,0,0,15
967281,651525,2017-05-26,Assembly,"Do pass as amended",12,5,0,0,17
967281,655886,2017-05-31,Assembly,"AB 1488 THURMOND Third Reading Urgency",67,0,13,0,80
967281,771450,2018-08-14,Senate,"Do pass, but first be re-referred to the Committee on [Appropriations]",5,2,0,0,7
967281,771860,2018-08-16,Senate,"Placed on suspense file",7,0,0,0,7
967282,642217,2017-05-08,Assembly,"Do pass. To Consent Calendar",9,0,1,0,10
967282,646435,2017-05-18,Assembly,"AB 1345 RIDLEY-THOMAS Consent Calendar Second Day Regular Session",69,0,11,0,80
967283,612947,2017-03-27,Assembly,"Do pass and be re-referred to the Committee on [Appropriations]",10,4,0,0,14
967283,633923,2017-04-26,Assembly,"Do pass",11,5,1,0,17
967283,635806,2017-05-01,Assembly,"AB 1452 MURATSUCHI Assembly Third Reading",51,22,7,0,80
967283,662397,2017-06-13,Senate,"Do pass, but first be re-referred to the Committee on [Appropriations]",10,3,0,0,13
967283,674280,2017-08-31,Senate,"Assembly 3rd Reading AB1452 Muratsuchi By Allen",26,12,2,0,40
967283,674981,2017-09-05,Assembly,"AB 1452 MURATSUCHI Concurrence in Senate Amendments",48,29,2,0,79
967286,683965,2018-01-04,Assembly,"Be re-referred to the Committees on [Education] and [Judiciary]",9,0,2,0,11
967286,684903,2018-01-10,Assembly,"Do pass and be re-referred to the Committee on [Judiciary]",6,0,1,0,7
967286,685846,2018-01-17,Assembly,"Do pass",10,0,0,0,10
967286,686975,2018-01-22,Assembly,"AB 1248 GLORIA Assembly Third Reading",69,1,7,0,77
967286,751738,2018-05-09,Senate,"Do pass, but first be re-referred to the Committee on [Judiciary]",5,0,1,0,6
967286,763006,2018-06-12,Senate,"Do pass",7,0,0,0,7
967286,773394,2018-08-29,Senate,"Assembly 3rd Reading AB1248 Gloria By Wilk",39,0,1,0,40
967286,773917,2018-08-30,Assembly,"AB 1248 GLORIA Concurrence in Senate Amendments",76,0,4,0,80
967287,628009,2017-04-19,Senate,"Do pass, but first be re-referred to the Committee on [Judiciary]",4,1,2,0,7
967287,633610,2017-04-25,Senate,"Do pass as amended, but first amend, and re-refer to the Committee on [Appropriations]",2,1,4,0,7
967287,633611,2017-04-25,Senate,"[First] hearing set for [04-26-2017]: Failed passage in Committee. Reconsideration granted",7,0,0,0,7
967288,637291,2017-05-02,Senate,"Do pass",6,0,1,0,7
967288,640544,2017-05-08,Senate,"Senate 3rd Reading SB642 Wieckowski",38,0,2,0,40
967288,662693,2017-06-13,Assembly,"Do pass as amended. To Consent Calendar",11,0,0,0,11
967290,625932,2017-04-17,Assembly,"Do pass and be re-referred to the Committee on [Appropriations]",11,1,2,0,14
967291,633092,2017-04-25,Senate,"Do pass, but first be re-referred to the Committee on [Appropriations]",2,1,4,0,7
967291,633093,2017-04-25,Senate,"[First] hearing set for [04-26-2017]: Failed passage in Committee. Reconsideration granted",7,0,0,0,7
967295,614128,2017-03-28,Senate,"Do pass as amended, but first amend, and re-refer to the Committee on [Environmental Quality]",11,0,2,0,13
967295,628067,2017-04-19,Senate,"Do pass, but first be re-referred to the Committee on [Appropriations]",6,0,1,0,7
967295,638653,2017-05-04,Senate,"Senate 3rd Reading SB660 Newman",39,0,1,0,40
967296,641813,2017-05-09,Senate,"Do pass",5,6,2,0,13
967296,658887,2017-06-06,Senate,"[06-06-2017] hearing: Motion to Reconsider. [Reconsideration Granted.]",13,0,0,0,13
967296,684753,2018-01-09,Senate,"Do pass",8,2,3,0,13
967296,686949,2018-01-22,Senate,"Senate 3rd Reading SB712 Anderson et al",16,16,8,0,40
967296,686950,2018-01-22,Senate,"Senate 3rd Reading SB712 Anderson et al. Reconsider",38,0,2,0,40
967296,690930,2018-01-30,Senate,"Senate 3rd Reading SB712 Anderson et al",12,18,10,0,40
967297,631854,2017-04-25,Assembly,"Do pass as amended and be re-referred to the Committee on [Appropriations]",16,0,0,0,16
967297,649403,2017-05-24,Assembly,"Do pass. To Consent Calendar",17,0,0,0,17
967297,654578,2017-05-30,Assembly,"AB 1229 LOW Consent Calendar Second Day Regular Session",77,0,3,0,80
967297,671884,2017-07-10,Senate,"Do pass, but first be re-referred to the Committee on [Appropriations]",9,0,0,0,9
967297,673844,2017-08-21,Senate,"Placed on suspense file",7,0,0,0,7
967297,674545,2017-09-01,Senate,"Do pass as amended",7,0,0,0,7
967297,676148,2017-09-14,Senate,"Special Consent Calendar # AB1229",40,0,0,0,40
967297,676441,2017-09-16,Assembly,"AB 1229 LOW Concurrence in Senate Amendments",77,1,1,0,79
967298,628044,2017-04-19,Senate,"Do pass as amended, but first amend, and re-refer to the Committee on [Appropriations]",5,0,2,0,7
967298,644431,2017-05-15,Senate,"Placed on suspense file",7,0,0,0,7
967299,631808,2017-04-24,Assembly,"Do pass and be re-referred to the Committee on [Appropriations] with recommendation: To Consent Calendar",14,0,0,0,14
967299,637373,2017-05-03,Assembly,"Do pass. To Consent Calendar",16,0,1,0,17
967299,643402,2017-05-11,Assembly,"AB 1222 QUIRK Consent Calendar Second Day Regular Session",77,0,3,0,80
967299,672179,2017-07-11,Senate,"Do pass, but first be re-referred to the Committee on [Appropriations]",12,0,1,0,13
967299,674381,2017-08-31,Senate,"Assembly 3rd Reading AB1222 Quirk By Cannella",38,0,2,0,40
967300,621281,2017-04-05,Assembly,"Do pass as amended, and be re-referred to the Committee on [Appropriations] with recommendation: To Consent Calendar",7,0,0,0,7
967300,637720,2017-05-03,Assembly,"Do pass. To Consent Calendar",16,0,1,0,17
967300,643544,2017-05-11,Assembly,"AB 1176 MULLIN Consent Calendar Second Day Regular Session",77,0,3,0,80
967300,663556,2017-06-14,Senate,"Do pass, but first be re-referred to the Committee on [Appropriations] with the recommendation: To Consent Calendar",7,0,0,0,7
967300,668605,2017-06-26,Senate,"Placed on suspense file",7,0,0,0,7
967300,674785,2017-09-01,Senate,"Do pass",7,0,0,0,7
967300,676198,2017-09-14,Senate,"Special Consent Calendar # AB1176",40,0,0,0,40
967301,626789,2017-04-18,Assembly,"Do pass and be re-referred to the Committee on [Business and Professions]",5,0,2,0,7
967302,642704,2017-05-10,Assembly,"Do pass as amended",7,0,0,0,7
967302,647837,2017-05-22,Assembly,"AB 1637 GLORIA Assembly Third Reading",76,0,4,0,80
967302,672818,2017-07-18,Senate,"Do pass and be ordered to the Consent Calendar",12,0,1,0,13
967302,675433,2017-09-11,Senate,"Assembly 3rd Reading AB1637 Gloria By Atkins",39,0,1,0,40
967302,676371,2017-09-14,Assembly,"AB 1637 GLORIA Concurrence in Senate Amendments",79,0,0,0,79
967307,615775,2017-03-28,Senate,"Do pass, but first be re-referred to the Committee on [Education]",7,0,0,0,7
967307,633489,2017-04-26,Senate,"Do pass as amended, and be ordered to the Consent Calendar",7,0,0,0,7
967307,640718,2017-05-08,Senate,"Consent Calendar 2nd SB731 Newman et al",38,0,2,0,40
967307,670008,2017-06-27,Assembly,"Do pass as amended and be re-referred to the Committee on [Education]",9,0,1,0,10
967307,672642,2017-07-12,Assembly,"Do pass and be re-referred to the Committee on [Appropriations]",7,0,0,0,7
967307,674678,2017-09-01,Assembly,"Do pass as amended",16,0,1,0,17
967307,675810,2017-09-13,Assembly,"SB 731 Newman Senate Third Reading By IRWIN",79,0,0,0,79
967307,676286,2017-09-14,Senate,"Unfinished Business SB731 Newman et al. Concurrence",40,0,0,0,40
967308,618556,2017-04-04,Assembly,"Do pass and be re-referred to the Committee on [Appropriations]",8,4,3,0,15
967308,651608,2017-05-26,Assembly,"Do pass as amended",12,5,0,0,17
967308,656201,2017-05-31,Assembly,"AB 1151 GLORIA Assembly Third Reading",56,18,6,0,80
967308,669149,2017-06-27,Senate,"Do pass, but first be re-referred to the Committee on [Appropriations]",6,2,1,0,9
967308,671881,2017-07-10,Senate,"Placed on suspense file",7,0,0,0,7
967308,674746,2017-09-01,Senate,"Do pass",5,2,0,0,7
967311,629324,2017-04-19,Senate,"Do pass, but first be re-referred to the Committee on [Appropriations]",9,0,0,0,9
967311,644973,2017-05-15,Senate,"Placed on suspense file",7,0,0,0,7
967311,650799,2017-05-25,Senate,"Do pass",7,0,0,0,7
967311,654325,2017-05-30,Senate,"Senate 3rd Reading SB608 Hernandez et al",39,0,1,0,40
967311,669192,2017-06-27,Assembly,"Do pass and be re-referred to the Committee on [Appropriations] with recommendation: To Consent Calendar",15,0,0,0,15
967313,627001,2017-04-18,Assembly,"Do pass and be re-referred to the Committee on [Appropriations]",7,0,0,0,7
967315,625879,2017-04-17,Assembly,"Do pass and be re-referred to the Committee on [Revenue and Taxation]",9,2,3,0,14
967315,632068,2017-04-24,Assembly,"Do pass as amended and be re-referred to the Committee on [Appropriations]",8,2,0,0,10
967316,629089,2017-04-19,Senate,"Do pass, but first be re-referred to the Committee on [Judiciary]",6,2,1,0,9
967316,633322,2017-04-25,Senate,"Do pass as amended, but first amend, and re-refer to the Committee on [Appropriations]",5,2,0,0,7
967316,644447,2017-05-15,Senate,"Placed on suspense file",7,0,0,0,7
967316,650672,2017-05-25,Senate,"Do pass",5,2,0,0,7
967316,655732,2017-05-31,Senate,"Senate 3rd Reading SB687 Skinner",27,12,1,0,40
967316,668996,2017-06-27,Assembly,"Do pass and be re-referred to the Committee on [Judiciary]",11,3,1,0,15
967316,672026,2017-07-11,Assembly,"Do pass as amended and be re-referred to the Committee on [Appropriations]",8,2,1,0,11
967316,674587,2017-09-01,Assembly,"Do pass",11,5,1,0,17
967316,676335,2017-09-14,Assembly,"SB 687 Skinner Senate Third Reading By WOOD",36,28,15,0,79
967316,676606,2017-09-15,Assembly,"SB 687 Skinner Senate Third Reading By WOOD",46,26,7,0,79
967316,676607,2017-09-15,Senate,"Unfinished Business SB687 Skinner Concurrence",26,11,3,0,40
967316,775123,2017-09-14,Assembly,,11,28,15,0,54
967317,626987,2017-04-17,Assembly,"Do pass as amended and be re-referred to the Committee on [Appropriations]",7,3,0,0,10
967317,647868,2017-05-22,Assembly,"AB 1132 GARCIA, C. Assembly Third Reading",55,13,12,0,80
967317,671375,2017-07-05,Senate,"Do pass as amended",6,1,0,0,7
967317,672705,2017-07-17,Senate,"Assembly 3rd Reading AB1132 Cristina Garcia By Lara",35,2,3,0,40
967317,672957,2017-07-20,Assembly,"AB 1132 GARCIA, C. Concurrence in Senate Amendments",61,0,18,0,79
967318,618561,2017-04-04,Senate,"Do pass, but first be re-referred to the Committee on [Veterans Affairs] with the recommendation: To Consent Calendar",6,0,1,0,7
967318,631429,2017-04-25,Senate,"Do pass, but first be re-referred to the Committee on [Appropriations]",6,0,1,0,7
967318,644344,2017-05-15,Senate,"Placed on suspense file",7,0,0,0,7
967318,650458,2017-05-25,Senate,"Do pass as amended",7,0,0,0,7
967318,655787,2017-05-31,Senate,"Senate 3rd Reading SB776 Newman",39,0,1,0,40
967318,669592,2017-06-27,Assembly,"Do pass as amended and be re-referred to the Committee on [Public Safety]",7,0,3,0,10
967318,672185,2017-07-11,Assembly,"Do pass and be re-referred to the Committee on [Appropriations]",7,0,0,0,7
967318,674717,2017-09-01,Assembly,"Do pass as amended",11,0,6,0,17
967318,675889,2017-09-13,Assembly,"SB 776 Newman Senate Third Reading By IRWIN",73,1,5,0,79
967318,676145,2017-09-14,Senate,"Unfinished Business SB776 Newman et al. Concurrence",39,0,1,0,40
967319,684911,2018-01-09,Assembly,"Do pass and be re-referred to the Committee on [Appropriations]",7,0,0,0,7
967320,627695,2017-04-18,Assembly,"Do pass as amended and be re-referred to the Committee on [Appropriations]",14,0,2,0,16
967320,642707,2017-05-10,Assembly,"Do pass. To Consent Calendar",17,0,0,0,17
967320,646576,2017-05-18,Assembly,"AB 1381 OBERNOLTE Consent Calendar Second Day Regular Session",69,0,11,0,80
967320,665249,2017-06-19,Senate,"Do pass, but first be re-referred to the Committee on [Appropriations] with the recommendation: To Consent Calendar",9,0,0,0,9
967320,672647,2017-07-13,Senate,"Consent Calendar 2nd AB1381",39,0,1,0,40
967321,618861,2017-04-03,Assembly,"Do pass as amended, and be re-referred to the Committee on [Appropriations] with recommendation: To Consent Calendar",10,0,0,0,10
967323,631698,2017-04-25,Senate,"Do pass as amended, but first amend, and re-refer to the Committee on [Appropriations]",4,0,1,0,5
967323,647905,2017-05-22,Senate,"Senate 3rd Reading SB612 Mitchell",37,0,3,0,40
967323,672401,2017-07-11,Assembly,"Do pass as amended, and be re-referred to the Committee on [Appropriations] with recommendation: To Consent Calendar",7,0,0,0,7
967323,674045,2017-08-23,Assembly,"Do pass. To Consent Calendar",15,0,2,0,17
967323,675400,2017-09-11,Assembly,"SB 612 Mitchell Senate Third Reading By RUBIO",75,0,4,0,79
967323,676116,2017-09-14,Senate,"Special Consent Calendar SB612",40,0,0,0,40
967324,631676,2017-04-25,Senate,"Do pass as amended, but first amend, and re-refer to the Committee on [Appropriations] with the recommendation: To Consent Calendar",5,0,0,0,5
967324,647990,2017-05-22,Senate,"Consent Calendar 2nd SB675",37,0,3,0,40
967324,663009,2017-06-13,Assembly,"Do pass and be re-referred to the Committee on [Appropriations]",6,0,1,0,7
967324,674026,2017-08-23,Assembly,"Do pass. To Consent Calendar",15,0,2,0,17
967325,629639,2017-04-19,Assembly,"Do pass and be re-referred to the Committee on [Appropriations]",7,0,0,0,7
967326,627174,2017-04-17,Assembly,"Do pass and be re-referred to the Committee on [Appropriations]",10,0,0,0,10
967326,643156,2017-05-10,Assembly,"Do pass. To Consent Calendar",17,0,0,0,17
967326,646508,2017-05-18,Assembly,"AB 1130 BOCANEGRA Consent Calendar Second Day Regular Session",69,0,11,0,80
967326,667288,2017-06-21,Senate,"Do pass as amended, but first amend, and re-refer to the Committee on [Appropriations]",7,0,0,0,7
967326,674980,2017-09-05,Senate,"Assembly 3rd Reading AB1130 Bocanegra et al. By Hertzberg",40,0,0,0,40
967326,675528,2017-09-11,Assembly,"AB 1130 BOCANEGRA Concurrence in Senate Amendments",78,0,1,0,79
967327,618493,2017-04-03,Assembly,"Do pass as amended and be re-referred to the Committee on [Appropriations]",7,1,2,0,10
967327,651554,2017-05-26,Assembly,"Do pass",17,0,0,0,17
967327,654264,2017-05-30,Assembly,"AB 1404 BERMAN Assembly Third Reading",73,1,6,0,80
967327,671341,2017-07-05,Senate,"Do pass as amended, but first amend, and re-refer to the Committee on [Appropriations]",6,0,1,0,7
967327,673845,2017-08-21,Senate,"Placed on suspense file",7,0,0,0,7
967327,774570,2017-04-03,Assembly,,0,0,2,0,2
967328,628076,2017-04-18,Assembly,"Do pass and be re-referred to the Committee on [Appropriations]",11,2,0,0,13
967328,638049,2017-05-03,Assembly,"Do pass",12,4,1,0,17
967328,640568,2017-05-08,Assembly,"AB 1424 LEVINE Assembly Third Reading",58,19,3,0,80
967328,669624,2017-06-28,Senate,"Do pass, but first be re-referred to the Committee on [Appropriations]",5,2,0,0,7
967328,674854,2017-09-05,Senate,"Assembly 3rd Reading AB1424 Levine et al. By Allen",28,12,0,0,40
967328,675114,2017-09-07,Assembly,"AB 1424 LEVINE Concurrence in Senate Amendments",58,19,2,0,79
967329,613763,2017-03-28,Assembly,"Do pass. To Consent Calendar",11,0,0,0,11
967329,617531,2017-04-03,Assembly,"AB 1148 STEINORTH Consent Calendar Second Day Regular Session",78,0,2,0,80
967329,658830,2017-06-06,Senate,"Do pass as amended",6,0,1,0,7
967329,668579,2017-06-26,Senate,"Special Consent Calendar # AB1148 Steinorth Urgency Clause",39,0,1,0,40
967329,671555,2017-07-06,Assembly,"AB 1148 STEINORTH Concurrence in Senate Amendments",76,0,4,0,80
967332,620119,2017-04-05,Senate,"Do pass, but first be re-referred to the Committee on [Appropriations]",5,0,0,0,5
967332,630391,2017-04-24,Senate,"Senate 3rd Reading SB621 Bradford",38,0,2,0,40
967332,660304,2017-06-07,Assembly,"Do pass and be re-referred to the Committee on [Appropriations]",7,0,0,0,7
967332,669885,2017-06-28,Assembly,"Do pass. To Consent Calendar",14,0,3,0,17
967332,671594,2017-07-06,Assembly,"SB 621 Bradford Consent Calendar Second Day Regular Session",74,0,6,0,80
967333,631427,2017-04-24,Assembly,"Do pass and be re-referred to the Committee on [Appropriations]",8,1,5,0,14
967334,633730,2017-04-26,Senate,"Do pass as amended, but first amend, and re-refer to the Committee on [Appropriations]",5,1,1,0,7
967334,644840,2017-05-15,Senate,"Placed on suspense file",7,0,0,0,7
967334,650791,2017-05-25,Senate,"Do pass as amended",7,0,0,0,7
967334,655728,2017-05-31,Senate,"Senate 3rd Reading SB765 Wiener",26,1,13,0,40
967334,655729,2017-05-31,Senate,"Senate 3rd Reading SB765 Wiener Reconsider",33,0,7,0,40
967334,655730,2017-05-31,Senate,"Senate 3rd Reading SB765 Wiener",33,1,6,0,40
967334,764209,2018-06-18,Assembly,"Be re-referred to the Committees on [Housing and Community Development] and [Local Government]",7,0,4,0,11
967334,768925,2018-06-27,Assembly,"Do pass and be re-referred to the Committee on [Local Government]",4,0,3,0,7
967334,768926,2018-06-27,Assembly,"Do pass as amended and be re-referred to the Committee on [Appropriations]",6,0,3,0,9
967334,771077,2018-08-08,Assembly,"Do pass",11,4,2,0,17
967334,773078,2018-08-28,Assembly,"Do pass",6,0,1,0,7
967334,773975,2018-08-31,Senate,"That the Assembly amendments be concurred in",10,2,1,0,13
967334,773976,2018-08-31,Senate,"Unfinished Business SB765 Wiener Concurrence",27,10,3,0,40
967334,773977,2018-08-31,Assembly,"SB 765 Wiener Senate Third Reading By BLOOM",57,14,9,0,80
967335,602468,2017-03-13,Senate,"Senate 3rd Reading SCR24 Fuller",37,0,3,0,40
967335,612471,2017-03-27,Assembly,"Be adopted. To Consent Calendar",11,0,0,0,11
967335,616081,2017-03-30,Assembly,"SCR 24 Fuller Consent Calendar Second Day Regular Session",74,0,6,0,80
967336,631988,2017-04-25,Assembly,"Do pass and be re-referred to the Committee on [Appropriations]",9,0,1,0,10
967336,643164,2017-05-10,Assembly,"Do pass. To Consent Calendar",17,0,0,0,17
967336,646615,2017-05-18,Assembly,"AB 1138 MAIENSCHEIN Consent Calendar Second Day Regular Session",69,0,11,0,80
967336,665387,2017-06-19,Senate,"Do pass, but first be re-referred to the Committee on [Public Safety]",9,0,0,0,9
967336,672209,2017-07-11,Senate,"Do pass, but first be re-referred to the Committee on [Appropriations]",6,0,1,0,7
967336,675012,2017-09-05,Senate,"Assembly 3rd Reading AB1138 Maienschein By Bradford",40,0,0,0,40
967337,684862,2018-01-10,Assembly,"Do pass",5,3,1,0,9
967337,689887,2018-01-29,Assembly,"AB 1324 GLORIA Assembly Third Reading Amend By GLORIA Set #1",48,24,5,0,77
967339,618559,2017-04-03,Assembly,"Do pass as amended and be re-referred to the Committee on [Appropriations]",10,0,0,0,10
967340,632822,2017-04-25,Senate,"Do pass, but first be re-referred to the Committee on [Appropriations]",12,0,1,0,13
967340,647967,2017-05-22,Senate,"Placed on suspense file",7,0,0,0,7
967344,628027,2017-04-19,Assembly,"Do pass and be re-referred to the Committee on [Appropriations] with recommendation: To Consent Calendar",7,0,0,0,7
967344,638055,2017-05-03,Assembly,"Do pass. To Consent Calendar",16,0,1,0,17
967344,643688,2017-05-11,Assembly,"AB 1325 GRAY Consent Calendar Second Day Regular Session",77,0,3,0,80
967344,671894,2017-07-10,Senate,"Do pass, but first be re-referred to the Committee on [Appropriations] with the recommendation: To Consent Calendar",5,0,0,0,5
967344,672989,2017-07-20,Senate,"Consent Calendar 2nd AB1325 Public Emplo",38,0,2,0,40
967344,674908,2017-09-05,Senate,"Assembly 3rd Reading AB1325 P.E., R., & S .S. (Rodriguez) By Pan",40,0,0,0,40
967344,675155,2017-09-07,Assembly,"AB 1325 P.E., R. & S.S. Concurrence in Senate Amendments By RODRIGUEZ",78,1,0,0,79
967344,775118,2017-05-11,Assembly,"AB 1325 GRAY Consent Calendar Seco""5"" headers=""noes 05/11/17"" class=""columnField"" style=""text-align:left"">",16,0,3,0,19
967346,627947,2017-04-19,Assembly,"Do pass and be re-referred to the Committee on [Natural Resources]",12,1,2,0,15
967346,631792,2017-04-24,Assembly,"Do pass as amended and be re-referred to the Committee on [Appropriations]",9,1,0,0,10
967347,641612,2017-05-08,Assembly,"Do pass as amended",6,0,4,0,10
967347,651471,2017-05-26,Assembly,"AB 1193 GLORIA Assembly Third Reading",75,0,5,0,80
967347,672325,2017-07-12,Senate,"Do pass as amended, but first amend, and re-refer to the Committee on [Appropriations]",7,0,0,0,7
967347,673777,2017-08-21,Senate,"Placed on suspense file",7,0,0,0,7
967347,674767,2017-09-01,Senate,"Do pass as amended",7,0,0,0,7
967347,675713,2017-09-12,Senate,"Assembly 3rd Reading AB1193 Gloria By Jackson",40,0,0,0,40
967347,676263,2017-09-14,Assembly,"AB 1193 GLORIA Concurrence in Senate Amendments",77,0,2,0,79
967349,628046,2017-04-19,Assembly,"Do pass as amended, and be re-referred to the Committee on [Appropriations] with recommendation: To Consent Calendar",13,0,0,0,13
967349,649471,2017-05-24,Assembly,"Do pass. To Consent Calendar",17,0,0,0,17
967349,654564,2017-05-30,Assembly,"AB 1422 DALY Consent Calendar Second Day Regular Session",77,0,3,0,80
967349,672390,2017-07-12,Senate,"Do pass, but first be re-referred to the Committee on [Appropriations] with the recommendation: To Consent Calendar",5,0,0,0,5
967349,675215,2017-09-07,Senate,"That the measure be returned to Senate Floor for consideration. Ordered to third reading",5,0,0,0,5
967349,675629,2017-09-12,Senate,"Assembly 3rd Reading AB1422 Daly By Bradford",40,0,0,0,40
967349,675871,2017-09-13,Assembly,"With recommendation: That Senate amendments be concurred in",9,0,4,0,13
967349,676334,2017-09-14,Assembly,"AB 1422 DALY Concurrence in Senate Amendments",79,0,0,0,79
967350,610855,2017-03-22,Assembly,"Do pass and be re-referred to the Committee on [Appropriations]",10,0,0,0,10
967351,613802,2017-03-28,Assembly,"Do pass as amended, and be re-referred to the Committee on [Privacy and Consumer Protection] with recommendation: To Consent Calendar",11,0,0,0,11
967351,636368,2017-05-02,Assembly,"Do pass as amended. To Consent Calendar",10,0,0,0,10
967351,643604,2017-05-11,Assembly,"AB 1185 O'DONNELL Consent Calendar Second Day Regular Session",77,0,3,0,80
967352,630530,2017-04-24,Assembly,"Do pass and be re-referred to the Committee on [Appropriations]",10,0,1,0,11
967352,642421,2017-05-10,Assembly,"Do pass",17,0,0,0,17
967352,654588,2017-05-30,Assembly,"AB 1636 AGUIAR-CURRY Assembly Third Reading",73,0,7,0,80
967352,672486,2017-07-12,Senate,"Do pass as amended, but first amend, and re-refer to the Committee on [Appropriations]",8,1,4,0,13
967352,675008,2017-09-05,Senate,"Assembly 3rd Reading AB1636 Aguiar-Curry et al. By Jackson",31,9,0,0,40
967352,675169,2017-09-07,Assembly,"AB 1636 AGUIAR-CURRY Concurrence in Senate Amendments",66,7,6,0,79
967353,627921,2017-04-18,Senate,"Do pass as amended, but first amend, and re-refer to the Committee on [Appropriations]",7,0,0,0,7
967353,644285,2017-05-15,Senate,"Placed on suspense file",7,0,0,0,7
967353,650264,2017-05-25,Senate,"Do pass as amended",7,0,0,0,7
967353,656243,2017-05-31,Senate,"Senate 3rd Reading SB597 Leyva",40,0,0,0,40
967353,666169,2017-06-20,Assembly,"Do pass as amended, and be re-referred to the Committee on [Appropriations] with recommendation: To Consent Calendar",11,0,0,0,11
967353,674605,2017-09-01,Assembly,"Do pass",16,0,1,0,17
967353,675143,2017-09-07,Assembly,"SB 597 Leyva Senate Third Reading By REYES",79,0,0,0,79
967353,676189,2017-09-14,Senate,"Special Consent Calendar SB597",40,0,0,0,40
967358,627754,2017-04-18,Senate,"Do pass, but first be re-referred to the Committee on [Judiciary]",7,0,0,0,7
967358,644979,2017-05-15,Senate,"Placed on suspense file",7,0,0,0,7
967358,650819,2017-05-25,Senate,"Do pass",7,0,0,0,7
967358,655830,2017-05-31,Senate,"Special Consent Calendar # SB641",40,0,0,0,40
967358,767124,2018-06-21,Assembly,"Be re-referred to the Committee on [Health]",9,0,2,0,11
967358,768271,2018-06-26,Assembly,"Do pass as amended and be re-referred to the Committee on [Appropriations]",15,0,0,0,15
967359,684899,2018-01-10,Senate,"Do pass, but first be re-referred to the Committee on [Appropriations]",7,0,2,0,9
967359,685411,2018-01-16,Senate,"Placed on suspense file",7,0,0,0,7
967359,686237,2018-01-18,Senate,"Do pass as amended",7,0,0,0,7
967359,689986,2018-01-29,Senate,"Senate 3rd Reading SB707 Cannella et al",39,0,1,0,40
967359,765858,2018-06-19,Assembly,"Do pass as amended and be re-referred to the Committee on [Appropriations]",15,0,0,0,15
967359,771862,2018-08-16,Assembly,"Do pass",17,0,0,0,17
967359,774266,2018-08-31,Senate,"Unfinished Business SB707 Cannella et al. Concurrence",39,0,1,0,40
967359,774267,2018-08-31,Assembly,"SB 707 Cannella Senate Third Reading By MAYES",79,0,1,0,80
967361,625892,2017-04-17,Assembly,"Do pass and be re-referred to the Committee on [Judiciary]",8,1,2,0,11
967361,632030,2017-04-25,Assembly,"Do pass and be re-referred to the Committee on [Appropriations]",9,0,2,0,11
967362,771470,2018-08-13,Senate,"Be adopted, but first be re-referred to the Committee on [Elections and Constitutional Amendments]",2,3,0,0,5
967362,771471,2018-08-13,Senate,"[Second] hearing set for [08-14-2018]: Failed passage in Committee. Reconsideration granted",5,0,0,0,5
967363,631954,2017-04-24,Senate,"Do pass, but first be re-referred to the Committee on [Appropriations]",8,0,1,0,9
967363,644422,2017-05-15,Senate,"Senate 3rd Reading SB794 Stern",37,0,3,0,40
967363,763474,2018-06-14,Assembly,"Be re-referred to the Committee on [Governmental Organization]",7,0,4,0,11
967364,618598,2017-04-04,Assembly,"Do pass and be re-referred to the Committee on [Appropriations]",7,0,0,0,7
967364,642650,2017-05-10,Assembly,"Do pass",12,5,0,0,17
967364,647978,2017-05-22,Assembly,"AB 1525 BAKER Assembly Third Reading",59,15,6,0,80
967364,666311,2017-06-20,Senate,"Do pass, but first be re-referred to the Committee on [Appropriations]",5,1,1,0,7
967364,671866,2017-07-10,Senate,"Do pass",5,2,0,0,7
967364,674318,2017-08-31,Senate,"Assembly 3rd Reading AB1525 Baker et al. By Pan",27,12,1,0,40
967365,634479,2017-04-26,Assembly,"Do pass and be re-referred to the Committee on [Appropriations]",4,1,2,0,7
967365,651750,2017-05-26,Assembly,"Do pass as amended",11,1,5,0,17
967365,656818,2017-06-01,Assembly,"AB 1220 WEBER Assembly Third Reading",60,5,15,0,80
967365,774743,2017-05-26,Assembly,"DoField"" style=""text-align:left"">",4,1,5,0,10
967366,627046,2017-04-18,Senate,"Do pass, but first be re-referred to the Committee on [Appropriations] with the recommendation: To Consent Calendar",12,0,1,0,13
967366,638359,2017-05-04,Senate,"Consent Calendar 2nd SB672",38,0,2,0,40
967366,668626,2017-06-26,Assembly,"Do pass and be re-referred to the Committee on [Appropriations] with recommendation: To Consent Calendar",14,0,0,0,14
967366,674586,2017-09-01,Assembly,"Do pass",16,0,1,0,17
967366,675668,2017-09-12,Assembly,"SB 672 Fuller Senate Third Reading By FONG",77,0,2,0,79
967367,642049,2017-05-09,Assembly,"Do pass. To Consent Calendar",14,0,1,0,15
967367,646635,2017-05-18,Assembly,"AB 1119 LIMÓN Consent Calendar Second Day",69,0,11,0,80
967367,663678,2017-06-14,Senate,"Do pass, but first be re-referred to the Committee on [Judiciary] with the recommendation: To Consent Calendar",9,0,0,0,9
967367,672931,2017-07-18,Senate,"Do pass and be ordered to the Consent Calendar",7,0,0,0,7
967367,675005,2017-09-05,Senate,"Assembly 3rd Reading AB1119 Limón By Monning",40,0,0,0,40
967367,675127,2017-09-07,Assembly,"AB 1119 LIMÓN Concurrence in Senate Amendments",78,1,0,0,79
967368,627976,2017-04-19,Assembly,"Do pass as amended and be re-referred to the Committee on [Appropriations]",14,0,1,0,15
967368,649455,2017-05-24,Assembly,"Do pass. To Consent Calendar",17,0,0,0,17
967368,654284,2017-05-30,Assembly,"AB 1292 PATTERSON Consent Calendar Second Day Regular Session",77,0,3,0,80
967368,667018,2017-06-20,Senate,"Do pass as amended, but first amend, and re-refer to the Committee on [Appropriations]",10,0,1,0,11
967368,742105,2018-04-23,Senate,"Assembly 3rd Reading AB1292 Patterson By Hill",38,0,1,0,39
967368,744814,2018-04-26,Assembly,"AB 1292 PATTERSON Concurrence in Senate Amendments",74,0,4,0,78
967370,633581,2017-04-26,Assembly,"Do pass as amended and be re-referred to the Committee on [Appropriations]",10,0,0,0,10
967370,651957,2017-05-26,Assembly,"Do pass as amended",16,0,1,0,17
967370,655758,2017-05-31,Assembly,"AB 1163 IRWIN Assembly Third Reading",76,0,4,0,80
967372,631922,2017-04-25,Assembly,"Do pass and be re-referred to the Committee on [Appropriations] with recommendation: To Consent Calendar",7,0,0,0,7
967372,645886,2017-05-17,Assembly,"Do pass. To Consent Calendar",17,0,0,0,17
967372,651499,2017-05-26,Assembly,"AB 1445 REYES Consent Calendar Second Day Regular Session",76,0,4,0,80
967372,769225,2018-06-27,Senate,"Do pass as amended",7,0,0,0,7
967372,772642,2018-08-24,Senate,"Assembly 3rd Reading AB1445 Reyes By McGuire",37,1,2,0,40
967372,773057,2018-08-28,Assembly,"With recommendation: That Senate amendments be concurred in",9,0,0,0,9
967372,773393,2018-08-29,Assembly,"AB 1445 REYES Concurrence in Senate Amendments",78,0,2,0,80
967374,634460,2017-04-26,Assembly,"Do pass and be re-referred to the Committee on [Appropriations]",5,1,1,0,7
967376,627100,2017-04-18,Assembly,"Do pass and be re-referred to the Committee on [Revenue and Taxation]",11,2,2,0,15
967377,633506,2017-04-26,Senate,"Do pass as amended, but first amend, and re-refer to the Committee on [Appropriations]",7,0,0,0,7
967377,647955,2017-05-22,Senate,"Senate 3rd Reading SB592 Nielsen",37,0,3,0,40
967377,666883,2017-06-20,Assembly,"Do pass and be re-referred to the Committee on [Appropriations]",13,0,0,0,13
967379,626896,2017-04-18,Senate,"Do pass, but first be re-referred to the Committee on [Appropriations]",7,0,0,0,7
967379,635868,2017-05-01,Senate,"Do pass",7,0,0,0,7
967379,638698,2017-05-04,Senate,"Senate 3rd Reading SB756 Stern",39,0,1,0,40
967379,662899,2017-06-13,Assembly,"Do pass and be re-referred to the Committee on [Appropriations]",7,0,0,0,7
967379,669862,2017-06-28,Assembly,"Do pass. To Consent Calendar",14,0,3,0,17
967379,671581,2017-07-06,Assembly,"SB 756 Stern Consent Calendar Second Day Regular Session",74,0,6,0,80
967380,627774,2017-04-19,Assembly,"Do pass and be re-referred to the Committee on [Environmental Safety and Toxic Materials]",7,0,0,0,7
967380,632335,2017-04-25,Assembly,"Do pass. To Consent Calendar",7,0,0,0,7
967380,638425,2017-05-04,Assembly,"AB 1343 CHEN Consent Calendar Second Day Regular Session",76,0,4,0,80
967380,663874,2017-06-14,Senate,"Do pass, but first be re-referred to the Committee on [Environmental Quality] with the recommendation: To Consent Calendar",7,0,0,0,7
967380,667064,2017-06-21,Senate,"Do pass and be ordered to the Consent Calendar",6,0,1,0,7
967380,671049,2017-07-03,Senate,"Consent Calendar 2nd AB1343",33,0,7,0,40
967381,628005,2017-04-19,Assembly,"Do pass as amended, and be re-referred to the Committee on [Appropriations] with recommendation: To Consent Calendar",7,0,0,0,7
967381,642786,2017-05-10,Assembly,"Do pass. To Consent Calendar",17,0,0,0,17
967381,646541,2017-05-18,Assembly,"AB 1453 GARCIA, E. Consent Calendar Second Day Regular Session",69,0,11,0,80
967381,663276,2017-06-14,Senate,"Do pass, but first be re-referred to the Committee on [Appropriations]",7,0,0,0,7
967381,672984,2017-07-20,Senate,"Assembly 3rd Reading AB1453 Eduardo Garcia By Stone",38,0,2,0,40
967383,632734,2017-04-25,Assembly,"Do pass and be re-referred to the Committee on [Appropriations] with recommendation: To Consent Calendar",7,0,0,0,7
967383,651954,2017-05-26,Assembly,"Do pass as amended",16,0,1,0,17
967383,655871,2017-05-31,Assembly,"AB 1207 BROUGH Assembly Third Reading",77,0,3,0,80
967384,630526,2017-04-24,Senate,"Do pass, but first be re-referred to the Committee on [Appropriations]",10,0,1,0,11
967384,644604,2017-05-15,Senate,"Placed on suspense file",7,0,0,0,7
967385,627914,2017-04-19,Senate,"Do pass and be ordered to the Consent Calendar",7,0,0,0,7
967385,634518,2017-04-27,Senate,"Consent Calendar 2nd SB742",36,0,4,0,40
967385,663034,2017-06-14,Assembly,"Do pass as amended",9,0,0,0,9
967385,670333,2017-06-29,Assembly,"SB 742 Moorlach Senate Third Reading By BERMAN",73,0,7,0,80
967385,670968,2017-07-03,Senate,"Unfinished Business SB742 Moorlach et al. Concurrence",31,0,9,0,40
967386,684759,2018-01-09,Assembly,"Do pass as amended and be re-referred to the Committee on [Appropriations]",10,0,0,0,10
967386,686229,2018-01-18,Assembly,"Do pass. To Consent Calendar",17,0,0,0,17
967386,689885,2018-01-29,Assembly,"AB 1289 ARAMBULA Consent Calendar Second Day Regular Session",75,0,2,0,77
967386,762923,2018-06-12,Senate,"Do pass as amended, but first amend, and re-refer to the Committee on [Banking and Financial Institutions]",7,0,0,0,7
967386,769264,2018-06-27,Senate,"Do pass as amended, but first amend, and re-refer to the Committee on [Appropriations]",6,0,1,0,7
967386,772442,2018-08-22,Senate,"Assembly 3rd Reading AB1289 Arambula By Hill",39,0,1,0,40
967386,773062,2018-08-28,Assembly,"AB 1289 ARAMBULA Concurrence in Senate Amendments",80,0,0,0,80
967390,626812,2017-04-18,Assembly,"Do pass and be re-referred to the Committee on [Appropriations]",5,2,0,0,7
967390,645817,2017-05-17,Assembly,"Do pass as amended",10,6,1,0,17
967390,656845,2017-06-01,Assembly,"AB 1448 WEBER Assembly Third Reading",41,33,6,0,80
967390,672066,2017-07-11,Senate,"Do pass, but first be re-referred to the Committee on [Appropriations]",4,2,1,0,7
967390,675313,2017-09-11,Senate,"Assembly 3rd Reading AB1448 Weber By Skinner",21,13,6,0,40
967390,675917,2017-09-13,Assembly,"AB 1448 WEBER Concurrence in Senate Amendments",45,31,3,0,79
967390,777237,2017-09-11,Senate,,4,13,6,0,23
967391,618567,2017-04-04,Assembly,"Do pass as amended, and be re-referred to the Committee on [Appropriations] with recommendation: To Consent Calendar",7,0,0,0,7
967391,623421,2017-04-04,Assembly,"Do pass and be re-referred to the Committee on [Appropriations] with recommendation: To Consent Calendar",7,0,0,0,7
967391,633246,2017-04-26,Assembly,"Do pass. To Consent Calendar",16,0,1,0,17
967391,638524,2017-05-04,Assembly,"AB 1339 CUNNINGHAM Consent Calendar Second Day Regular Session",76,0,4,0,80
967391,662169,2017-06-13,Senate,"Do pass, but first be re-referred to the Committee on [Appropriations] with the recommendation: To Consent Calendar",7,0,0,0,7
967391,671005,2017-07-03,Senate,"Consent Calendar 2nd AB1339",33,0,7,0,40
967391,775125,2017-04-26,Assembly,,7,0,1,0,8
967392,631974,2017-04-25,Assembly,"Do pass and be re-referred to the Committee on [Appropriations]",15,0,0,0,15
967392,651929,2017-05-26,Assembly,"Do pass",17,0,0,0,17
967392,655801,2017-05-31,Assembly,"AB 1420 AGUIAR-CURRY Assembly Third Reading",76,0,4,0,80
967392,669133,2017-06-27,Senate,"Do pass, but first be re-referred to the Committee on [Appropriations] with the recommendation: To Consent Calendar",8,0,1,0,9
967392,671924,2017-07-10,Senate,"Placed on suspense file",7,0,0,0,7
967393,616503,2017-03-29,Assembly,"Do pass and be re-referred to the Committee on [Jobs, Economic Development, and the Economy] with recommendation: To Consent Calendar",7,0,0,0,7
967393,631724,2017-04-25,Assembly,"Do pass and be re-referred to the Committee on [Appropriations]",7,0,0,0,7
967393,637561,2017-05-03,Assembly,"Do pass. To Consent Calendar",16,0,1,0,17
967393,643456,2017-05-11,Assembly,"AB 1149 ARAMBULA Consent Calendar Second Day Regular Session",77,0,3,0,80
967393,663140,2017-06-14,Senate,"Do pass, but first be re-referred to the Committee on [Appropriations]",5,0,0,0,5
967393,674336,2017-08-31,Senate,"Assembly 3rd Reading AB1149 Arambula et al. By Mendoza",40,0,0,0,40
967393,674955,2017-09-05,Assembly,"AB 1149 ARAMBULA Concurrence in Senate Amendments",77,0,2,0,79
967394,626866,2017-04-18,Assembly,"Do pass and be re-referred to the Committee on [Appropriations]",10,3,2,0,15
967394,649255,2017-05-24,Assembly,"Do pass",12,5,0,0,17
967394,656977,2017-06-01,Assembly,"AB 1461 THURMOND Assembly Third Reading",54,21,5,0,80
967394,672573,2017-07-12,Senate,"Do pass, but first be re-referred to the Committee on [Appropriations]",7,1,1,0,9
967394,674296,2017-08-31,Senate,"Assembly 3rd Reading AB1461 Thurmond By Newman",24,14,2,0,40
967395,628279,2017-04-18,Assembly,"Do pass as amended and be re-referred to the Committee on [Appropriations]",11,2,0,0,13
967395,651951,2017-05-26,Assembly,"Do pass as amended",12,5,0,0,17
967395,656061,2017-05-31,Assembly,"AB 1178 CALDERON Assembly Third Reading",64,12,4,0,80
967395,671295,2017-07-05,Senate,"Do pass as amended, but first amend, and re-refer to the Committee on [Appropriations]",4,2,1,0,7
967395,673919,2017-08-21,Senate,"Placed on suspense file",7,0,0,0,7
967395,674771,2017-09-01,Senate,"Do pass",5,2,0,0,7
967395,675023,2017-09-06,Senate,"Assembly 3rd Reading AB1178 Calderon et al. By Leyva",29,11,0,0,40
967395,675372,2017-09-11,Assembly,"AB 1178 CALDERON Concurrence in Senate Amendments",64,14,1,0,79
967396,632033,2017-04-25,Assembly,"Do pass and be re-referred to the Committee on [Appropriations] with recommendation: To Consent Calendar",15,0,0,0,15
967396,651968,2017-05-26,Assembly,"Do pass as amended",16,0,1,0,17
967396,655837,2017-05-31,Assembly,"AB 1386 WALDRON Assembly Third Reading",76,0,4,0,80
967396,672552,2017-07-12,Senate,"Do pass as amended, but first amend, and re-refer to the Committee on [Appropriations] with the recommendation: To Consent Calendar",8,0,1,0,9
967396,673929,2017-08-21,Senate,"Placed on suspense file",7,0,0,0,7
967396,674460,2017-09-01,Senate,"Do pass as amended",7,0,0,0,7
967396,675206,2017-09-07,Senate,"Assembly 3rd Reading AB1386 Waldron et al. By Leyva",40,0,0,0,40
967396,675351,2017-09-11,Assembly,"AB 1386 WALDRON Concurrence in Senate Amendments",78,0,1,0,79
967397,629103,2017-04-19,Senate,"Do pass, but first be re-referred to the Committee on [Governance and Finance]",8,0,1,0,9
967397,634511,2017-04-26,Senate,"Do pass, but first be re-referred to the Committee on [Appropriations]",7,0,0,0,7
967397,647965,2017-05-22,Senate,"Placed on suspense file",7,0,0,0,7
967397,650392,2017-05-25,Senate,"Do pass as amended",7,0,0,0,7
967397,655841,2017-05-31,Senate,"Senate 3rd Reading SB792 Wilk et al",39,0,1,0,40
967397,763425,2018-06-14,Assembly,"Be re-referred to the Committee on [Housing and Community Development]",7,0,4,0,11
967397,768959,2018-06-27,Assembly,"Do pass as amended and be re-referred to the Committee on [Appropriations]",7,0,0,0,7
967398,635803,2017-05-01,Senate,"Do pass",8,0,1,0,9
967398,638645,2017-05-04,Senate,"Senate 3rd Reading SB715 Newman",39,0,1,0,40
967398,666319,2017-06-20,Assembly,"Do pass and be re-referred to the Committee on [Appropriations]",15,0,1,0,16
967398,772694,2018-08-24,Assembly,"SB 715 Newman Senate Third Reading By CALDERON Amend By CERVANTES Set #1",50,24,6,0,80
967398,773409,2018-08-29,Assembly,"Do pass",10,3,1,0,14
967398,774087,2018-08-31,Senate,"That the Assembly amendments be concurred in",11,1,1,0,13
967398,774088,2018-08-31,Senate,"Unfinished Business SB715 Delgado Concurrence",28,2,10,0,40
967398,774089,2018-08-31,Assembly,"SB 715 Delgado Senate Third Reading By CALDERON",57,14,9,0,80
967398,774480,2018-08-24,Assembly,,15,24,6,0,45
967401,627121,2017-04-18,Assembly,"Do pass. To Consent Calendar",7,0,0,0,7
967401,634519,2017-04-27,Assembly,"AB 1518 WEBER Consent Calendar Second Day Regular Session",75,0,5,0,80
967401,672047,2017-07-11,Senate,"Do pass as amended",5,2,0,0,7
967401,674389,2017-08-31,Senate,"Assembly 3rd Reading AB1518 Weber By Mitchell",32,6,2,0,40
967401,675205,2017-09-07,Assembly,"AB 1518 WEBER Concurrence in Senate Amendments",78,0,1,0,79
967401,777234,2017-08-31,Senate,,5,6,2,0,13
967402,635815,2017-05-01,Assembly,"Do pass. To Consent Calendar",10,0,1,0,11
967402,640722,2017-05-08,Assembly,"AB 1460 DABABNEH Consent Calendar Second Day",77,0,3,0,80
967402,660073,2017-06-07,Senate,"Do pass as amended, but first amend, and re-refer to the Committee on [Rules]",11,0,2,0,13
967402,668604,2017-06-26,Senate,"Special Consent Calendar # AB1460",39,0,1,0,40
967402,670388,2017-06-29,Assembly,"AB 1460 DABABNEH Concurrence in Senate Amendments",74,0,6,0,80
967403,632658,2017-04-25,Assembly,"Do pass and be re-referred to the Committee on [Appropriations]",4,0,3,0,7
967403,651518,2017-05-26,Assembly,"Do pass",11,5,1,0,17
967403,655856,2017-05-31,Assembly,"AB 1179 KALRA Assembly Third Reading",50,17,13,0,80
967403,671325,2017-07-05,Senate,"Do pass, but first be re-referred to the Committee on [Appropriations]",5,2,0,0,7
967403,672788,2017-07-17,Senate,"Placed on suspense file",7,0,0,0,7
967403,674828,2017-09-01,Senate,"Do pass",5,2,0,0,7
967403,676057,2017-09-14,Senate,"Assembly 3rd Reading AB1179 Kalra By Wieckowski",28,12,0,0,40
967405,631735,2017-04-25,Senate,"Do pass, but first be re-referred to the Committee on [Appropriations] with the recommendation: To Consent Calendar",9,0,0,0,9
967405,647845,2017-05-22,Senate,"Consent Calendar 2nd SB704",37,0,3,0,40
967405,669008,2017-06-27,Assembly,"Do pass and be re-referred to the Committee on [Appropriations]",15,0,0,0,15
967405,672894,2017-07-19,Assembly,"Do pass. To Consent Calendar",16,0,1,0,17
967405,674150,2017-08-24,Assembly,"SB 704 Galgiani Consent Calendar Second Day Regular Session",76,0,3,0,79
967406,632008,2017-04-25,Assembly,"Do pass and be re-referred to the Committee on [Appropriations]",7,0,0,0,7
967406,651943,2017-05-26,Assembly,"Do pass as amended",16,0,1,0,17
967406,655826,2017-05-31,Assembly,"AB 1268 REYES Assembly Third Reading",77,0,3,0,80
967406,669278,2017-06-27,Senate,"Do pass as amended, but first amend, and re-refer to the Committee on [Appropriations]",7,0,0,0,7
967406,672805,2017-07-17,Senate,"Placed on suspense file",7,0,0,0,7
967407,642709,2017-05-10,Assembly,"Do pass and be re-referred to the Committee on [Appropriations]",7,0,0,0,7
967407,645897,2017-05-17,Assembly,"Do pass. To Consent Calendar",17,0,0,0,17
967407,651441,2017-05-26,Assembly,"AB 1157 MULLIN Consent Calendar Second Day Regular Session",76,0,4,0,80
967407,669842,2017-06-28,Senate,"Do pass, but first be re-referred to the Committee on [Governance and Finance]",6,1,0,0,7
967407,672393,2017-07-12,Senate,"Do pass, but first be re-referred to the Committee on [Appropriations]",7,0,0,0,7
967407,674969,2017-09-05,Senate,"Assembly 3rd Reading AB1157 Mullin et al. By Atkins",35,4,1,0,40
967407,675338,2017-09-11,Assembly,"AB 1157 MULLIN Concurrence in Senate Amendments",76,1,2,0,79
967409,645933,2017-05-17,Assembly,"Do pass",17,0,0,0,17
967409,648008,2017-05-22,Assembly,"AB 1492 GONZALEZ FLETCHER Third Reading Urgency",77,0,3,0,80
967409,668918,2017-06-26,Senate,"Do pass",7,0,0,0,7
967409,670420,2017-06-29,Senate,"Assembly 3rd Reading AB1492 Gonzalez Fletcher By Lara Urgency Clause",36,0,4,0,40
967410,631751,2017-04-24,Assembly,"Do pass and be re-referred to the Committee on [Appropriations]",11,2,1,0,14
967410,651622,2017-05-26,Assembly,"Do pass as amended",12,5,0,0,17
967410,656135,2017-05-31,Assembly,"AB 1274 O'DONNELL Assembly Third Reading",55,15,10,0,80
967410,669017,2017-06-27,Senate,"Do pass, but first be re-referred to the Committee on [Environmental Quality]",9,3,1,0,13
967410,671322,2017-07-05,Senate,"Do pass, but first be re-referred to the Committee on [Appropriations]",4,2,1,0,7
967410,673922,2017-08-21,Senate,"Placed on suspense file",7,0,0,0,7
967410,674452,2017-09-01,Senate,"Do pass as amended",5,2,0,0,7
967410,675605,2017-09-12,Senate,"Assembly 3rd Reading AB1274 O'Donnell By Lara Urgency Clause",27,12,1,0,40
967410,675884,2017-09-13,Assembly,"AB 1274 O'Donnell Concurrence - Urgency Added",55,19,5,0,79
967410,774537,2017-08-21,Senate,,4,0,0,0,4
967412,613643,2017-03-28,Senate,"Do pass, but first be re-referred to the Committee on [Appropriations] with the recommendation: To Consent Calendar",7,0,0,0,7
967412,629115,2017-04-20,Senate,"Consent Calendar 2nd SB670",36,0,4,0,40
967412,662188,2017-06-13,Assembly,"Do pass and be re-referred to the Committee on [Appropriations] with recommendation: To Consent Calendar",7,0,0,0,7
967412,669625,2017-06-28,Assembly,"Do pass. To Consent Calendar",14,0,3,0,17
967412,671523,2017-07-06,Assembly,"SB 670 Jackson Consent Calendar Second Day Regular Session",74,0,6,0,80
967412,674348,2017-08-31,Assembly,"SB 670 Jackson Senate Third Reading By LEVINE",75,0,4,0,79
967412,674957,2017-09-05,Senate,"Special Consent SB670",40,0,0,0,40
967414,630294,2017-04-24,Senate,"Do pass as amended, but first amend, and re-refer to the Committee on [Appropriations]",7,2,2,0,11
967414,644279,2017-05-15,Senate,"Placed on suspense file",7,0,0,0,7
967414,650508,2017-05-25,Senate,"Do pass as amended",5,2,0,0,7
967414,655756,2017-05-31,Senate,"Senate 3rd Reading SB700 Wiener",23,13,4,0,40
967414,766119,2018-06-20,Assembly,"Do pass as amended and be re-referred to the Committee on [Appropriations]",14,1,0,0,15
967414,766120,2018-06-20,Assembly,"Do pass as amended and be re-referred to the Committee on [Appropriations]",14,1,0,0,15
967414,771780,2018-08-16,Assembly,"Do pass as amended",12,0,5,0,17
967414,773477,2018-08-29,Assembly,"SB 700 Wiener Senate Third Reading By HOLDEN",57,18,5,0,80
967414,773747,2018-08-30,Senate,"Unfinished Business SB700 Wiener Concurrence",25,12,3,0,40
967416,631642,2017-04-25,Senate,"Do pass, but first be re-referred to the Committee on [Appropriations]",9,3,1,0,13
967416,644510,2017-05-15,Senate,"Placed on suspense file",7,0,0,0,7
967416,650856,2017-05-25,Senate,"Do pass as amended",5,2,0,0,7
967416,655762,2017-05-31,Senate,"Senate 3rd Reading SB595 Beall",27,12,1,0,40
967416,672579,2017-07-13,Assembly,"Do pass as amended and be re-referred to the Committee on [Appropriations]",10,2,2,0,14
967416,674536,2017-09-01,Assembly,"Do pass as amended",11,5,1,0,17
967416,675893,2017-09-13,Assembly,"SB 595 Beall Senate Third Reading By CHIU",43,31,5,0,79
967416,676282,2017-09-14,Senate,"Unfinished Business SB595 Beall et al. Concurrence",27,13,0,0,40
967418,632140,2017-04-25,Assembly,"Do pass and be re-referred to the Committee on [Appropriations]",9,3,3,0,15
967419,627214,2017-04-18,Assembly,"Do pass as amended, and be re-referred to the Committee on [Appropriations] with recommendation: To Consent Calendar",15,0,0,0,15
967419,628096,2017-04-18,Assembly,"Do pass as amended. To Consent Calendar",15,0,0,0,15
967419,634561,2017-04-27,Assembly,"AB 1368 CALDERON Consent Calendar Second Day Regular Session",75,0,5,0,80
967419,671576,2017-07-05,Senate,"Do pass, but first be re-referred to the Committee on [Appropriations]",9,0,0,0,9
967421,618499,2017-04-03,Assembly,"Do pass as amended and be re-referred to the Committee on [Appropriations]",9,1,0,0,10
967421,633348,2017-04-26,Assembly,"Do pass",16,0,1,0,17
967421,635627,2017-05-01,Assembly,"AB 1218 OBERNOLTE Assembly Third Reading",70,1,9,0,80
967421,667284,2017-06-21,Senate,"Do pass, but first be re-referred to the Committee on [Appropriations] with the recommendation: To Consent Calendar",6,0,1,0,7
967421,672563,2017-07-13,Senate,"Consent Calendar 2nd AB1218",39,0,1,0,40
967422,631771,2017-04-25,Senate,"Do pass, but first be re-referred to the Committee on [Appropriations]",2,2,3,0,7
967423,618344,2017-04-04,Senate,"Do pass as amended, but first amend, and re-refer to the Committee on [Appropriations]",8,2,1,0,11
967423,638618,2017-05-04,Senate,"Senate 3rd Reading SB692 Allen et al",25,13,2,0,40
967424,633520,2017-04-25,Assembly,"Do pass and be re-referred to the Committee on [Appropriations]",9,3,1,0,13
967424,640664,2017-05-08,Assembly,"AB 1468 CHIU Assembly Third Reading",55,22,3,0,80
967424,671353,2017-07-05,Senate,"Do pass as amended, but first amend, and re-refer to the Committee on [Appropriations]",5,1,1,0,7
967424,673837,2017-08-21,Senate,"Placed on suspense file",7,0,0,0,7
967425,626852,2017-04-18,Assembly,"Do pass as amended and be re-referred to the Committee on [Appropriations]",6,1,0,0,7
967425,642427,2017-05-10,Assembly,"Do pass",16,1,0,0,17
967425,656112,2017-05-31,Assembly,"AB 1298 SANTIAGO Assembly Third Reading",62,6,12,0,80
967426,618583,2017-04-04,Assembly,"Do pass and be re-referred to the Committee on [Appropriations] with recommendation: To Consent Calendar",14,0,1,0,15
967426,633623,2017-04-26,Assembly,"Do pass. To Consent Calendar",16,0,1,0,17
967426,638553,2017-05-04,Assembly,"AB 1134 GLORIA Consent Calendar Second Day Regular Session",76,0,4,0,80
967426,663063,2017-06-14,Senate,"Do pass as amended, but first amend, and re-refer to the Committee on [Appropriations]",9,0,0,0,9
967426,672770,2017-07-17,Senate,"Do pass",7,0,0,0,7
967426,674351,2017-08-31,Senate,"Special Consent Calendar # AB1134",37,0,3,0,40
967426,674858,2017-09-05,Assembly,"AB 1134 GLORIA Concurrence in Senate Amendments",77,0,2,0,79
967427,641954,2017-05-09,Assembly,"Do pass",14,0,1,0,15
967427,644443,2017-05-15,Assembly,"AB 1411 GARCIA, C. Assembly Third Reading",77,2,1,0,80
967427,672908,2017-07-19,Senate,"Do pass as amended",8,0,1,0,9
967427,675007,2017-09-05,Senate,"Assembly 3rd Reading AB1411 Cristina Garcia By Mendoza",40,0,0,0,40
967427,675352,2017-09-11,Assembly,"AB 1411 GARCIA, C. Concurrence in Senate Amendments",77,1,1,0,79
967428,627097,2017-04-18,Senate,"Do pass as amended, but first amend, and re-refer to the Committee on [Appropriations]",3,3,1,0,7
967428,627098,2017-04-18,Senate,"[First] hearing set for [04-18-2017]: Failed passage in Committee. Reconsideration granted",7,0,0,0,7
967428,684737,2018-01-09,Senate,"Do pass, but first be re-referred to the Committee on [Appropriations]",7,0,0,0,7
967428,685422,2018-01-16,Senate,"Placed on suspense file",7,0,0,0,7
967428,686188,2018-01-18,Senate,"Do pass as amended",7,0,0,0,7
967428,689978,2018-01-29,Senate,"Senate 3rd Reading SB757 Glazer et al",39,0,1,0,40
967428,768215,2018-06-26,Assembly,"Do pass and be re-referred to the Committee on [Appropriations]",2,3,2,0,7
967430,684892,2018-01-10,Senate,"Do pass, but first be re-referred to the Committee on [Appropriations]",4,0,3,0,7
967430,690024,2018-01-29,Senate,"Senate 3rd Reading SB695 Lara et al",30,7,3,0,40
967430,758570,2018-05-31,Assembly,"Be re-referred to the Committee on [Business and Professions]",7,0,4,0,11
967430,765134,2018-06-19,Assembly,"Do pass and be re-referred to the Committee on [Appropriations]",14,1,4,0,19
967430,771547,2018-08-16,Assembly,"Do pass as amended",12,0,5,0,17
967430,773482,2018-08-29,Assembly,"SB 695 Lara Senate Third Reading By CARRILLO",59,16,5,0,80
967430,773845,2018-08-30,Senate,"That the Assembly amendments be concurred in",9,0,0,0,9
967430,774185,2018-08-31,Senate,"Unfinished Business SB695 Lara et al. Concurrence",29,9,2,0,40
967430,774548,2018-06-19,Assembly,,7,1,4,0,12
967431,632092,2017-04-25,Senate,"Do pass as amended, but first amend, and re-refer to the Committee on [Appropriations]",7,3,3,0,13
967431,655126,2017-05-30,Senate,"Senate 3rd Reading SB744 Hueso",21,12,7,0,40
967432,619681,2017-04-04,Assembly,"Do pass as amended and be re-referred to the Committee on [Education]",7,0,0,0,7
967432,634347,2017-04-26,Assembly,"Do pass as amended, and be re-referred to the Committee on [Appropriations] with recommendation: To Consent Calendar",7,0,0,0,7
967432,651891,2017-05-26,Assembly,"Do pass",17,0,0,0,17
967432,654117,2017-05-30,Assembly,"AB 1227 BONTA Assembly Third Reading",77,0,3,0,80
967432,667061,2017-06-21,Senate,"Do pass, but first be re-referred to the Committee on [Human Services]",6,0,1,0,7
967432,672287,2017-07-11,Senate,"Do pass as amended, but first amend, and re-refer to the Committee on [Appropriations]",7,0,0,0,7
967432,673912,2017-08-21,Senate,"Placed on suspense file",7,0,0,0,7
967432,674693,2017-09-01,Senate,"Do pass",7,0,0,0,7
967432,676106,2017-09-14,Senate,"Special Consent Calendar # AB1227",40,0,0,0,40
967432,676330,2017-09-14,Assembly,"AB 1227 Bonta Special Consent Calendar 1st Day Regular Session",79,0,0,0,79
967434,634662,2017-04-26,Assembly,"Do pass and be re-referred to the Committee on [Appropriations] with recommendation: To Consent Calendar",7,0,0,0,7
967434,645921,2017-05-17,Assembly,"Do pass. To Consent Calendar",17,0,0,0,17
967434,651472,2017-05-26,Assembly,"AB 1122 LIMÓN Consent Calendar Second Day Regular Session",76,0,4,0,80
967434,671313,2017-07-05,Senate,"Do pass as amended, but first amend, and re-refer to the Committee on [Appropriations] with the recommendation: To Consent Calendar",6,0,1,0,7
967434,672971,2017-07-20,Senate,"Consent Calendar 2nd AB1122",38,0,2,0,40
967434,674355,2017-08-31,Assembly,"AB 1122 LIMÓN Concurrence in Senate Amendments",77,0,2,0,79
967435,615812,2017-03-29,Assembly,"Do pass and be re-referred to the Committee on [Appropriations]",7,0,0,0,7
967435,634149,2017-04-26,Assembly,"Do pass. To Consent Calendar",16,0,1,0,17
967435,638628,2017-05-04,Assembly,"AB 1243 ARAMBULA Consent Calendar Second Day Regular Session",76,0,4,0,80
967435,661681,2017-06-12,Senate,"Do pass, but first be re-referred to the Committee on [Appropriations]",5,0,0,0,5
967435,674435,2017-08-31,Senate,"Assembly 3rd Reading AB1243 Arambula By Vidak",39,0,1,0,40
967435,674994,2017-09-05,Assembly,"AB 1243 ARAMBULA Concurrence in Senate Amendments",76,0,3,0,79
967439,631990,2017-04-25,Assembly,"Do pass and be re-referred to the Committee on [Appropriations]",10,1,0,0,11
967441,627316,2017-04-18,Assembly,"Do pass and be re-referred to the Committee on [Higher Education]",5,2,0,0,7
967441,633597,2017-04-25,Assembly,"Do pass and be re-referred to the Committee on [Appropriations]",9,3,1,0,13
967441,651930,2017-05-26,Assembly,"Do pass as amended",12,4,1,0,17
967441,656189,2017-05-31,Assembly,"AB 1435 GONZALEZ FLETCHER Assembly Third Reading",51,23,6,0,80
967441,777222,2017-05-26,Assembly,,9,4,1,0,14
967442,634566,2017-04-26,Senate,"Do pass as amended, but first amend, and re-refer to the Committee on [Appropriations]",7,0,0,0,7
967442,644958,2017-05-15,Senate,"Placed on suspense file",7,0,0,0,7
967443,619835,2017-04-05,Assembly,"Do pass as amended and be re-referred to the Committee on [Local Government]",6,1,0,0,7
967443,634619,2017-04-26,Assembly,"Do pass and be re-referred to the Committee on [Appropriations]",7,0,2,0,9
967443,645887,2017-05-17,Assembly,"Do pass",17,0,0,0,17
967443,654762,2017-05-30,Assembly,"AB 1223 CABALLERO Assembly Third Reading",72,1,7,0,80
967443,672213,2017-07-11,Senate,"Do pass, but first be re-referred to the Committee on [Appropriations]",13,0,0,0,13
967443,675522,2017-09-11,Senate,"Assembly 3rd Reading AB1223 Caballero By Cannella",38,0,2,0,40
967443,675998,2017-09-13,Assembly,"AB 1223 CABALLERO Concurrence in Senate Amendments",76,2,1,0,79
967444,608376,2017-03-21,Assembly,"Do pass and be re-referred to the Committee on [Appropriations] with recommendation: To Consent Calendar",7,0,0,0,7
967444,633159,2017-04-26,Assembly,"Do pass. To Consent Calendar",16,0,1,0,17
967444,638562,2017-05-04,Assembly,"AB 1438 E.S. & T.M. Consent Calendar Second Day Regular Session",76,0,4,0,80
967444,660663,2017-06-07,Senate,"Do pass, but first be re-referred to the Committee on [Judiciary]",7,0,0,0,7
967444,666286,2017-06-20,Senate,"Do pass, but first be re-referred to the Committee on [Appropriations] with the recommendation: To Consent Calendar",7,0,0,0,7
967444,671856,2017-07-10,Senate,"Placed on suspense file",7,0,0,0,7
967444,674737,2017-09-01,Senate,"Do pass",7,0,0,0,7
967444,675096,2017-09-06,Senate,"Assembly 3rd Reading AB1438 E.S. & T.M. (Quirk) By Wieckowski",40,0,0,0,40
967446,627176,2017-04-18,Senate,"Do pass",11,0,2,0,13
967446,644349,2017-05-15,Senate,"Senate 3rd Reading SB614 Hertzberg",39,0,1,0,40
967446,668698,2017-06-26,Assembly,"Do pass",13,1,0,0,14
967446,673972,2017-08-21,Assembly,"SB 614 Hertzberg Senate Third Reading By BERMAN",68,1,10,0,79
967446,674090,2017-08-24,Senate,"Special Consent Calendar # SB614",38,0,2,0,40
967449,621003,2017-04-05,Assembly,"Do pass and be re-referred to the Committee on [Appropriations] with recommendation: To Consent Calendar",7,0,0,0,7
967449,634150,2017-04-26,Assembly,"Do pass. To Consent Calendar",16,0,1,0,17
967449,638603,2017-05-04,Assembly,"AB 1502 THURMOND Consent Calendar Second Day Regular Session",76,0,4,0,80
967449,660646,2017-06-07,Senate,"Do pass, but first be re-referred to the Committee on [Appropriations] with the recommendation: To Consent Calendar",7,0,0,0,7
967449,670992,2017-07-03,Senate,"Consent Calendar 2nd AB1502",33,0,7,0,40
967450,633288,2017-04-25,Assembly,"Do pass and be re-referred to the Committee on [Appropriations]",7,0,0,0,7
967450,651688,2017-05-26,Assembly,"Do pass as amended",13,0,4,0,17
967450,656162,2017-05-31,Assembly,"AB 1375 DABABNEH Assembly Third Reading",75,0,5,0,80
967450,672440,2017-07-11,Senate,"Do pass as amended, but first amend, and re-refer to the Committee on [Appropriations] with the recommendation: To Consent Calendar",7,0,0,0,7
967450,673976,2017-08-21,Senate,"Placed on suspense file",7,0,0,0,7
967451,613848,2017-03-28,Assembly,"Do pass. To Consent Calendar",11,0,0,0,11
967451,617606,2017-04-03,Assembly,"AB 1516 CUNNINGHAM Consent Calendar Second Day Regular Session",78,0,2,0,80
967451,658773,2017-06-06,Senate,"Do pass and be ordered to the Consent Calendar",6,0,1,0,7
967451,674321,2017-08-31,Senate,"Assembly 3rd Reading AB1516 Cunningham By Anderson",38,0,2,0,40
967451,674947,2017-09-05,Assembly,"AB 1516 CUNNINGHAM Concurrence in Senate Amendments",77,0,2,0,79
967452,619073,2017-04-04,Assembly,"Do pass and be re-referred to the Committee on [Appropriations] with recommendation: To Consent Calendar",13,0,2,0,15
967452,633559,2017-04-26,Assembly,"Do pass. To Consent Calendar",16,0,1,0,17
967452,638679,2017-05-04,Assembly,"AB 1337 PATTERSON Consent Calendar Second Day Regular Session",76,0,4,0,80
967452,668960,2017-06-27,Senate,"Do pass, but first be re-referred to the Committee on [Appropriations] with the recommendation: To Consent Calendar",8,0,1,0,9
967452,671832,2017-07-10,Senate,"Do pass",7,0,0,0,7
967452,742409,2018-04-23,Senate,"Assembly 3rd Reading AB1337 Patterson et al. By Galgiani",38,0,1,0,39
967453,606906,2017-03-20,Senate,"Senate 3rd Reading SCR26 Mendoza",39,0,1,0,40
967453,651455,2017-05-26,Assembly,"Be adopted. To Consent Calendar",9,0,2,0,11
967453,656033,2017-05-31,Assembly,"SCR 26 Mendoza Consent Calendar Second Day Regular Session",76,0,4,0,80
967454,632052,2017-04-25,Senate,"Do pass, but first be re-referred to the Committee on [Appropriations]",13,0,0,0,13
967454,645020,2017-05-15,Senate,"Placed on suspense file",7,0,0,0,7
967454,650781,2017-05-25,Senate,"Do pass as amended",7,0,0,0,7
967454,656308,2017-05-31,Senate,"Senate 3rd Reading SB605 Galgiani",39,0,1,0,40
967454,672122,2017-07-11,Assembly,"Do pass as amended and be re-referred to the Committee on [Appropriations]",6,0,1,0,7
967454,674669,2017-09-01,Assembly,"Do pass",16,0,1,0,17
967454,675630,2017-09-12,Assembly,"SB 605 Galgiani Senate Third Reading By GARCIA, E",78,0,1,0,79
967454,675872,2017-09-13,Senate,"Unfinished Business SB605 Galgiani Concurrence",40,0,0,0,40
967455,620504,2017-04-04,Assembly,"Do pass and be re-referred to the Committee on [Appropriations]",10,0,0,0,10
967455,651958,2017-05-26,Assembly,"Do pass",17,0,0,0,17
967455,654481,2017-05-30,Assembly,"AB 1365 REYES Assembly Third Reading",77,0,3,0,80
967455,672205,2017-07-11,Senate,"Do pass, but first be re-referred to the Committee on [Appropriations]",6,0,1,0,7
967455,673833,2017-08-21,Senate,"Placed on suspense file",7,0,0,0,7
967455,674765,2017-09-01,Senate,"Do pass",7,0,0,0,7
967455,676279,2017-09-14,Senate,"Special Consent Calendar # AB1365",40,0,0,0,40
967455,676280,2017-09-14,Assembly,"AB 1365 Reyes Special Consent Calendar 1st Day Regular Session",79,0,0,0,79
967456,612738,2017-03-27,Assembly,"Do pass and be re-referred to the Committee on [Appropriations]",14,0,0,0,14
967456,633454,2017-04-26,Assembly,"Do pass. To Consent Calendar",16,0,1,0,17
967456,638650,2017-05-04,Assembly,"AB 1393 FRIEDMAN Consent Calendar Second Day Regular Session",76,0,4,0,80
967456,666187,2017-06-20,Senate,"Do pass, but first be re-referred to the Committee on [Public Safety]",10,0,3,0,13
967456,672115,2017-07-11,Senate,"Do pass, but first be re-referred to the Committee on [Appropriations]",7,0,0,0,7
967456,675848,2017-09-13,Senate,"Assembly 3rd Reading AB1393 Friedman et al. By Mendoza",40,0,0,0,40
967456,676601,2017-09-15,Assembly,"AB 1393 FRIEDMAN Concurrence in Senate Amendments",77,0,2,0,79
967457,628073,2017-04-19,Senate,"Do pass, but first be re-referred to the Committee on [Appropriations]",7,0,0,0,7
967457,638671,2017-05-04,Senate,"Senate 3rd Reading SB793 Hill et al",39,0,1,0,40
967457,672665,2017-07-12,Assembly,"Do pass and be re-referred to the Committee on [Appropriations]",7,1,1,0,9
967457,674252,2017-08-30,Assembly,"Do pass",14,0,3,0,17
967457,675593,2017-09-12,Assembly,"Do pass",7,1,1,0,9
967457,676498,2017-09-15,Assembly,"SB 793 Hill Senate Third Reading By BERMAN",74,4,1,0,79
967457,676499,2017-09-16,Senate,"Unfinished Business SB793 Hill et al. Concurrence",38,0,2,0,40
967458,627971,2017-04-19,Assembly,"Do pass and be re-referred to the Committee on [Education]",5,1,1,0,7
967458,634530,2017-04-26,Assembly,"Do pass as amended and be re-referred to the Committee on [Appropriations]",5,1,1,0,7
967459,626013,2017-04-17,Assembly,"Do pass and be re-referred to the Committee on [Communications and Conveyance]",8,1,5,0,14
967460,627213,2017-04-18,Assembly,"Do pass and be re-referred to the Committee on [Judiciary]",14,0,2,0,16
967460,632009,2017-04-25,Assembly,"Do pass as amended and be re-referred to the Committee on [Appropriations]",11,0,0,0,11
967460,646075,2017-05-17,Assembly,"Do pass. To Consent Calendar",17,0,0,0,17
967460,651607,2017-05-26,Assembly,"AB 1278 LOW Consent Calendar Second Day Regular Session",76,0,4,0,80
967460,669168,2017-06-26,Senate,"Do pass, but first be re-referred to the Committee on [Judiciary]",9,0,0,0,9
967460,672312,2017-07-11,Senate,"Do pass, but first be re-referred to the Committee on [Appropriations]",5,1,1,0,7
967460,675100,2017-09-06,Senate,"Assembly 3rd Reading AB1278 Low By Hertzberg",40,0,0,0,40
967460,675407,2017-09-11,Assembly,"AB 1278 LOW Concurrence in Senate Amendments",78,0,1,0,79
967461,631622,2017-04-25,Senate,"Do pass, but first be re-referred to the Committee on [Appropriations]",13,0,0,0,13
967461,655918,2017-05-31,Senate,"Senate 3rd Reading SB666 Vidak",40,0,0,0,40
967461,671431,2017-07-05,Assembly,"Do pass and be re-referred to the Committee on [Appropriations]",21,0,0,0,21
967461,672901,2017-07-19,Assembly,"Do pass. To Consent Calendar",16,0,1,0,17
967461,674140,2017-08-24,Assembly,"SB 666 Vidak Consent Calendar Second Day Regular Session",76,0,3,0,79
967462,618468,2017-04-04,Assembly,"Do pass and be re-referred to the Committee on [Appropriations] with recommendation: To Consent Calendar",13,0,2,0,15
967462,652120,2017-05-26,Assembly,"Do pass as amended",17,0,0,0,17
967462,656136,2017-05-31,Assembly,"AB 1358 COOLEY Assembly Third Reading",77,0,3,0,80
967462,672218,2017-07-11,Senate,"Do pass, but first be re-referred to the Committee on [Appropriations] with the recommendation: To Consent Calendar",9,0,0,0,9
967462,673856,2017-08-21,Senate,"Placed on suspense file",7,0,0,0,7
967462,674493,2017-09-01,Senate,"Do pass",7,0,0,0,7
967462,675489,2017-09-11,Senate,"Assembly 3rd Reading AB1358 Cooley By Atkins",40,0,0,0,40
967464,620003,2017-04-05,Assembly,"Do pass and be re-referred to the Committee on [Appropriations]",6,0,1,0,7
967466,634438,2017-04-27,Assembly,"Do pass as amended and be re-referred to the Committee on [Appropriations]",19,0,2,0,21
967466,651863,2017-05-26,Assembly,"Do pass",14,0,3,0,17
967466,656079,2017-05-31,Assembly,"AB 1221 GONZALEZ FLETCHER Assembly Third Reading",70,1,9,0,80
967466,672099,2017-07-11,Senate,"Do pass as amended, but first amend, and re-refer to the Committee on [Appropriations]",12,1,0,0,13
967466,673820,2017-08-21,Senate,"Placed on suspense file",7,0,0,0,7
967466,674454,2017-09-01,Senate,"Do pass as amended",5,2,0,0,7
967466,675125,2017-09-07,Senate,"Assembly 3rd Reading AB1221 Gonzalez Fletcher By Pan",35,3,2,0,40
967466,675378,2017-09-11,Assembly,"AB 1221 GONZALEZ FLETCHER Concurrence in Senate Amendments",69,3,7,0,79
967468,633824,2017-04-24,Assembly,"Do pass and be re-referred to the Committee on [Appropriations]",3,6,1,0,10
967472,633512,2017-04-25,Assembly,"Do pass and be re-referred to the Committee on [Appropriations]",12,0,1,0,13
967472,638637,2017-05-04,Assembly,"AB 1284 CALDERON Assembly Third Reading",76,0,4,0,80
967472,660177,2017-06-07,Senate,"Do pass as amended, and be ordered to the Consent Calendar",7,0,0,0,7
967472,676417,2017-09-15,Senate,"Do pass, but first be re-referred to the Committee on [Appropriations]",10,0,3,0,13
967472,676418,2017-09-15,Senate,"Do pass",7,0,0,0,7
967472,676477,2017-09-15,Senate,"W/O REF. TO FILE AB1284 Dababneh By Skinner Urgency Clause",34,2,4,0,40
967472,676478,2017-09-16,Assembly,"With recommendation: That Senate amendments be concurred in",9,0,0,0,9
967472,676479,2017-09-16,Assembly,"AB 1284 DABABNEH Concurrence - Urgency Added",72,0,7,0,79
967473,627702,2017-04-17,Assembly,"Do pass as amended and be re-referred to the Committee on [Appropriations]",10,0,0,0,10
967474,615916,2017-03-29,Assembly,"Do pass and be re-referred to the Committee on [Jobs, Economic Development, and the Economy] with recommendation: To Consent Calendar",7,0,0,0,7
967474,632242,2017-04-25,Assembly,"Do pass as amended and be re-referred to the Committee on [Appropriations]",7,0,0,0,7
967474,642763,2017-05-10,Assembly,"Do pass. To Consent Calendar",17,0,0,0,17
967474,646652,2017-05-18,Assembly,"AB 1336 MULLIN Consent Calendar Second Day Regular Session",69,0,11,0,80
967474,663321,2017-06-14,Senate,"Do pass, but first be re-referred to the Committee on [Appropriations]",5,0,0,0,5
967474,673992,2017-08-21,Senate,"Assembly 3rd Reading AB1336 Mullin By Wieckowski",39,0,1,0,40
967478,620153,2017-04-05,Assembly,"Do pass and be re-referred to the Committee on [Appropriations] with recommendation: To Consent Calendar",7,0,0,0,7
967478,633539,2017-04-26,Assembly,"Do pass. To Consent Calendar",16,0,1,0,17
967478,638484,2017-05-04,Assembly,"AB 1367 BERMAN Consent Calendar Second Day Regular Session",76,0,4,0,80
967478,659248,2017-06-06,Senate,"Do pass, but first be re-referred to the Committee on [Appropriations]",4,0,1,0,5
967478,674395,2017-08-31,Senate,"Assembly 3rd Reading AB1367 Berman By Leyva",29,11,0,0,40
967478,674992,2017-09-05,Assembly,"AB 1367 BERMAN Concurrence in Senate Amendments",54,20,5,0,79
967480,632086,2017-04-25,Assembly,"Do pass and be re-referred to the Committee on [Appropriations]",5,0,2,0,7
967481,633500,2017-04-26,Senate,"Do pass, but first be re-referred to the Committee on [Rules]",2,2,3,0,7
967481,633501,2017-04-26,Senate,"[Second] hearing set for [04-26-2017]: Failed passage in Committee. Reconsideration granted",7,0,0,0,7
967482,620870,2017-04-05,Assembly,"Do pass",6,2,1,0,9
967482,628999,2017-04-20,Assembly,"AB 1189 GARCIA, E. Assembly Third Reading",50,22,8,0,80
967482,662878,2017-06-13,Senate,"Do pass, but first be re-referred to the Committee on [Governance and Finance]",9,3,1,0,13
967482,669979,2017-06-28,Senate,"Do pass",5,1,1,0,7
967482,674907,2017-09-05,Senate,"Assembly 3rd Reading AB1189 Eduardo Garcia By Beall",26,11,3,0,40
967482,675164,2017-09-07,Assembly,"AB 1189 GARCIA, E. Concurrence in Senate Amendments",50,27,2,0,79
967483,631863,2017-04-25,Senate,"Do pass as amended, but first amend, and re-refer to the Committee on [Appropriations]",9,0,0,0,9
967483,644987,2017-05-15,Senate,"Placed on suspense file",7,0,0,0,7
967483,650846,2017-05-25,Senate,"Do pass as amended",7,0,0,0,7
967483,655831,2017-05-31,Senate,"Senate 3rd Reading SB724 Lara",39,0,1,0,40
967483,672272,2017-07-10,Assembly,"Do pass and be re-referred to the Committee on [Appropriations]",10,0,0,0,10
967483,674748,2017-09-01,Assembly,"Do pass",16,0,1,0,17
967483,675676,2017-09-12,Assembly,"SB 724 Lara Senate Third Reading By CALDERON",78,0,1,0,79
967485,636552,2017-05-02,Assembly,"Do pass. To Consent Calendar",11,0,0,0,11
967485,640601,2017-05-08,Assembly,"AB 1214 STONE Consent Calendar Second Day Regular Session",77,0,3,0,80
967485,768114,2018-06-26,Senate,"Do pass, but first be re-referred to the Committee on [Appropriations]",6,0,1,0,7
967485,770570,2018-08-06,Senate,"Placed on suspense file",7,0,0,0,7
967485,771736,2018-08-16,Senate,"Do pass as amended",6,1,0,0,7
967485,772830,2018-08-27,Senate,"Assembly 3rd Reading AB1214 Mark Stone By Mitchell",28,9,3,0,40
967485,773091,2018-08-28,Assembly,"With recommendation: That Senate amendments be concurred in",5,0,2,0,7
967485,773447,2018-08-29,Assembly,"AB 1214 STONE Concurrence in Senate Amendments",50,21,9,0,80
967486,621057,2017-04-05,Assembly,"Do pass as amended, and be re-referred to the Committee on [Appropriations] with recommendation: To Consent Calendar",7,0,0,0,7
967486,637393,2017-05-03,Assembly,"Do pass. To Consent Calendar",16,0,1,0,17
967486,643440,2017-05-11,Assembly,"AB 1124 CERVANTES Assembly Third Reading",75,0,5,0,80
967486,667185,2017-06-21,Senate,"Do pass as amended, but first amend, and re-refer to the Committee on [Appropriations] with the recommendation: To Consent Calendar",6,0,1,0,7
967486,671828,2017-07-10,Senate,"Placed on suspense file",7,0,0,0,7
967486,674781,2017-09-01,Senate,"Do pass as amended",7,0,0,0,7
967486,676295,2017-09-14,Senate,"Special Consent Calendar # AB1124",40,0,0,0,40
967486,676296,2017-09-14,Assembly,"AB 1124 Cervantes Special Consent Calendar 1st Day Regular Session",79,0,0,0,79
967490,626940,2017-04-18,Assembly,"Do pass and be re-referred to the Committee on [Appropriations]",6,1,0,0,7
967491,619783,2017-04-05,Senate,"Do pass as amended, but first amend, and re-refer to the Committee on [Appropriations]",7,0,0,0,7
967491,654449,2017-05-30,Senate,"Senate 3rd Reading SB727 Galgiani",40,0,0,0,40
967491,672033,2017-07-11,Assembly,"Do pass as amended and be re-referred to the Committee on [Appropriations]",13,0,0,0,13
967491,674038,2017-08-23,Assembly,"Do pass. To Consent Calendar",15,0,2,0,17
967491,674279,2017-08-31,Assembly,"SB 727 Galgiani Consent Calendar Second Day Regular Session",73,0,6,0,79
967491,774849,2017-08-23,Assembly,,13,0,2,0,15
967492,628102,2017-04-19,Assembly,"Do pass and be re-referred to the Committee on [Appropriations]",7,0,0,0,7
967492,638060,2017-05-03,Assembly,"Do pass",16,0,1,0,17
967492,643644,2017-05-11,Assembly,"AB 1309 COOLEY Assembly Third Reading",72,5,3,0,80
967492,661882,2017-06-12,Senate,"Do pass, but first be re-referred to the Committee on [Appropriations]",5,0,0,0,5
967492,674344,2017-08-31,Senate,"Assembly 3rd Reading AB1309 Cooley By Leyva",40,0,0,0,40
967493,631879,2017-04-25,Senate,"Do pass as amended, but first amend, and re-refer to the Committee on [Appropriations]",13,0,0,0,13
967493,644977,2017-05-15,Senate,"Do pass",7,0,0,0,7
967493,647956,2017-05-22,Senate,"Senate 3rd Reading SB750 Hueso",37,0,3,0,40
967493,668573,2017-06-26,Assembly,"Do pass as amended, and be re-referred to the Committee on [Appropriations] with recommendation: To Consent Calendar",14,0,0,0,14
967494,613029,2017-03-27,Assembly,"Do pass and be re-referred to the Committee on [Appropriations] with recommendation: To Consent Calendar",14,0,0,0,14
967494,633657,2017-04-26,Assembly,"Do pass. To Consent Calendar",16,0,1,0,17
967494,638703,2017-05-04,Assembly,"AB 1338 LOW Consent Calendar Second Day Regular Session",76,0,4,0,80
967494,662402,2017-06-13,Senate,"Do pass, but first be re-referred to the Committee on [Appropriations] with the recommendation: To Consent Calendar",13,0,0,0,13
967494,670957,2017-07-03,Senate,"Consent Calendar 2nd AB1338",33,0,7,0,40
967495,627210,2017-04-17,Assembly,"Do pass as amended and be re-referred to the Committee on [Appropriations]",8,2,0,0,10
967495,637506,2017-05-03,Assembly,"Do pass",14,2,1,0,17
967495,644567,2017-05-15,Assembly,"AB 1472 LIMÓN Assembly Third Reading",74,4,2,0,80
967495,662330,2017-06-13,Senate,"Do pass, but first be re-referred to the Committee on [Appropriations] with the recommendation: To Consent Calendar",9,0,0,0,9
967495,671013,2017-07-03,Senate,"Consent Calendar 2nd AB1472",33,0,7,0,40
967496,618496,2017-04-03,Assembly,"Do pass as amended and be re-referred to the Committee on [Appropriations]",10,0,0,0,10
967496,633204,2017-04-26,Assembly,"Do pass. To Consent Calendar",16,0,1,0,17
967496,638620,2017-05-04,Assembly,"AB 1294 BERMAN Consent Calendar Second Day Regular Session",76,0,4,0,80
967496,660123,2017-06-07,Senate,"Do pass, but first be re-referred to the Committee on [Appropriations] with the recommendation: To Consent Calendar",7,0,0,0,7
967496,676193,2017-09-14,Senate,"Assembly 3rd Reading AB1294 Berman et al. By Hill",40,0,0,0,40
967499,633217,2017-04-26,Assembly,"Do pass as amended and be re-referred to the Committee on [Local Government]",7,0,0,0,7
967499,642662,2017-05-10,Assembly,"Do pass",7,1,1,0,9
967499,646525,2017-05-18,Assembly,"AB 1515 DALY Assembly Third Reading",68,1,11,0,80
967499,672142,2017-07-11,Senate,"Do pass, but first be re-referred to the Committee on [Rules]",10,1,2,0,13
967499,676578,2017-09-15,Senate,"Assembly 3rd Reading AB1515 Daly By Atkins",35,2,3,0,40
967499,676579,2017-09-15,Assembly,"AB 1515 DALY Concurrence in Senate Amendments",75,4,0,0,79
967501,626632,2017-04-17,Assembly,"Do pass and be re-referred to the Committee on [Communications and Conveyance]",9,1,4,0,14
967501,634673,2017-04-26,Assembly,"Do pass as amended and be re-referred to the Committee on [Appropriations]",10,0,3,0,13
967501,642830,2017-05-10,Assembly,"Do pass",12,1,4,0,17
967501,655164,2017-05-30,Assembly,"AB 1444 BAKER Assembly Third Reading",54,13,13,0,80
967501,669183,2017-06-27,Senate,"Do pass, but first be re-referred to the Committee on [Appropriations]",12,0,1,0,13
967501,674417,2017-08-31,Senate,"Assembly 3rd Reading AB1444 Baker et al. By Hill",37,1,2,0,40
967501,675003,2017-09-05,Assembly,"AB 1444 BAKER Concurrence in Senate Amendments",60,11,8,0,79
967502,621180,2017-04-06,Assembly,"Be re-referred to the Committees on [Labor and Employment] and [Judiciary]",9,0,2,0,11
967507,618319,2017-04-04,Assembly,"Do pass as amended and be re-referred to the Committee on [Appropriations]",5,0,2,0,7
967507,651851,2017-05-26,Assembly,"Do pass as amended",12,5,0,0,17
967507,656909,2017-06-01,Assembly,"AB 1320 BONTA Assembly Third Reading",62,16,2,0,80
967507,669089,2017-06-27,Senate,"Do pass, but first be re-referred to the Committee on [Appropriations]",6,1,0,0,7
967507,672734,2017-07-17,Senate,"Placed on suspense file",7,0,0,0,7
967507,674671,2017-09-01,Senate,"Do pass",5,2,0,0,7
967507,675690,2017-09-12,Senate,"Assembly 3rd Reading AB1320 Bonta et al. By Beall",35,5,0,0,40
967507,676278,2017-09-14,Assembly,"AB 1320 BONTA Concurrence in Senate Amendments",61,18,0,0,79
967510,617648,2017-04-03,Senate,"Do pass, but first be re-referred to the Committee on [Transportation and Housing]",8,0,1,0,9
967510,631984,2017-04-25,Senate,"Do pass as amended, but first amend, and re-refer to the Committee on [Appropriations]",10,1,2,0,13
967510,684882,2018-01-09,Senate,"Do pass as amended, but first amend, and re-refer to the Committee on [Appropriations]",5,2,0,0,7
967510,686941,2018-01-22,Senate,"Senate 3rd Reading SB721 Hill et al",30,7,3,0,40
967510,764948,2018-06-19,Assembly,"Do pass as amended and be re-referred to the Committee on [Housing and Community Development]",15,2,2,0,19
967510,768809,2018-06-27,Assembly,"Do pass as amended and be re-referred to the Committee on [Appropriations]",7,0,0,0,7
967510,771075,2018-08-08,Assembly,"Do pass",15,1,1,0,17
967510,772245,2018-08-20,Assembly,"SB 721 Hill Senate Third Reading By GIPSON",72,4,4,0,80
967510,772381,2018-08-21,Senate,"Unfinished Business SB721 Hill et al. Concurrence",32,3,5,0,40
967511,627796,2017-04-19,Senate,"Do pass as amended, but first amend, and re-refer to the Committee on [Appropriations]",4,2,1,0,7
967511,644390,2017-05-15,Senate,"Placed on suspense file",7,0,0,0,7
967511,650487,2017-05-25,Senate,"Do pass as amended",5,2,0,0,7
967511,656031,2017-05-31,Senate,"Senate 3rd Reading SB705 Allen et al",15,19,6,0,40
967511,656032,2017-05-31,Senate,"Senate 3rd Reading SB705 Allen et al. Reconsider",40,0,0,0,40
967511,690932,2018-01-30,Senate,"Senate 2nd Reading SB705 Allen et al",18,16,6,0,40
967512,641414,2017-05-09,Assembly,"Do pass. To Consent Calendar",14,0,1,0,15
967512,646460,2017-05-18,Assembly,"AB 1215 RIDLEY-THOMAS Consent Calendar Second Day Regular Session",69,0,11,0,80
967512,768963,2018-06-27,Senate,"Do pass and be ordered to the Consent Calendar",9,0,0,0,9
967512,769768,2018-07-05,Senate,"Consent Calendar AB1215",35,0,4,0,39
967512,771380,2018-08-13,Assembly,"AB 1215 WEBER Concurrence in Senate Amendments",77,0,3,0,80
967512,774577,2018-07-05,Senate,,9,0,4,0,13
967513,628299,2017-04-19,Senate,"Do pass, but first be re-referred to the Committee on [Appropriations]",7,0,0,0,7
967513,640449,2017-05-08,Senate,"Senate 3rd Reading SB639 Hertzberg",38,0,2,0,40
967513,667579,2017-06-19,Assembly,"Do pass and be re-referred to the Committee on [Appropriations]",9,0,1,0,10
967513,672887,2017-07-19,Assembly,"Do pass. To Consent Calendar",16,0,1,0,17
967513,674058,2017-08-24,Assembly,"SB 639 Hertzberg Consent Calendar Second Day Regular Session",76,0,3,0,79
967514,619685,2017-04-05,Assembly,"Do pass and be re-referred to the Committee on [Local Government]",7,0,0,0,7
967514,629070,2017-04-19,Assembly,"Do pass and be re-referred to the Committee on [Appropriations]",6,2,1,0,9
967515,626960,2017-04-18,Assembly,"Do pass as amended and be re-referred to the Committee on [Appropriations]",14,0,1,0,15
967515,651938,2017-05-26,Assembly,"Do pass as amended",13,0,4,0,17
967515,655833,2017-05-31,Assembly,"AB 1279 SALAS Assembly Third Reading",76,0,4,0,80
967515,671566,2017-07-05,Senate,"Do pass as amended, but first amend, and re-refer to the Committee on [Appropriations]",9,0,0,0,9
967515,673740,2017-08-21,Senate,"Placed on suspense file",7,0,0,0,7
967515,674731,2017-09-01,Senate,"Do pass as amended",7,0,0,0,7
967515,675324,2017-09-11,Senate,"Assembly 3rd Reading AB1279 Salas et al. By Fuller",40,0,0,0,40
967515,675922,2017-09-13,Assembly,"AB 1279 SALAS Concurrence in Senate Amendments",77,0,2,0,79
967516,633495,2017-04-26,Senate,"Do pass as amended, but first amend, and re-refer to the Committee on [Appropriations]",4,0,1,0,5
967516,645005,2017-05-15,Senate,"Placed on suspense file",7,0,0,0,7
967516,650847,2017-05-25,Senate,"Do pass as amended",7,0,0,0,7
967516,655987,2017-05-31,Senate,"Senate 3rd Reading SB617 Bradford",40,0,0,0,40
967516,672422,2017-07-12,Assembly,"Do pass and be re-referred to the Committee on [Appropriations]",12,0,1,0,13
967516,740728,2018-04-16,Assembly,"Be re-referred to the Committee on [Insurance]",9,0,2,0,11
967518,615541,2017-03-28,Senate,"Do pass, but first be re-referred to the Committee on [Public Employment and Retirement]",7,0,0,0,7
967518,630486,2017-04-24,Senate,"Do pass, but first be re-referred to the Committee on [Appropriations] with the recommendation: To Consent Calendar",5,0,0,0,5
967518,644849,2017-05-15,Senate,"Placed on suspense file",7,0,0,0,7
967518,650792,2017-05-25,Senate,"Do pass",7,0,0,0,7
967518,655816,2017-05-31,Senate,"Special Consent Calendar # SB728",40,0,0,0,40
967518,671565,2017-07-06,Assembly,"Do pass and be re-referred to the Committee on [Veterans Affairs]",7,0,0,0,7
967518,672439,2017-07-11,Assembly,"Do pass and be re-referred to the Committee on [Appropriations]",9,0,1,0,10
967518,674519,2017-09-01,Assembly,"Do pass",16,0,1,0,17
967518,675225,2017-09-07,Assembly,"SB 728 Newman Senate Third Reading By IRWIN",79,0,0,0,79
967518,676063,2017-09-14,Senate,"Special Consent Calendar SB728",40,0,0,0,40
967520,627872,2017-04-18,Assembly,"Do pass and be re-referred to the Committee on [Appropriations]",7,0,0,0,7
967520,651615,2017-05-26,Assembly,"Do pass",16,1,0,0,17
967520,656108,2017-05-31,Assembly,"AB 1200 CERVANTES Assembly Third Reading",73,4,3,0,80
967520,668959,2017-06-27,Senate,"Do pass as amended, but first amend, and re-refer to the Committee on [Health]",5,0,0,0,5
967520,672535,2017-07-12,Senate,"Do pass, but first be re-referred to the Committee on [Appropriations]",8,0,1,0,9
967520,673736,2017-08-21,Senate,"Placed on suspense file",7,0,0,0,7
967520,674471,2017-09-01,Senate,"Do pass as amended",7,0,0,0,7
967520,675451,2017-09-11,Senate,"Assembly 3rd Reading AB1200 Cervantes By Stern",39,1,0,0,40
967520,675801,2017-09-13,Assembly,"AB 1200 CERVANTES Concurrence in Senate Amendments",74,3,2,0,79
967522,631732,2017-04-25,Assembly,"Do pass as amended and be re-referred to the Committee on [Appropriations]",14,0,1,0,15
967522,651630,2017-05-26,Assembly,"Do pass as amended",14,1,2,0,17
967522,656886,2017-06-01,Assembly,"AB 1315 MULLIN Assembly Third Reading",76,0,4,0,80
967522,669767,2017-06-28,Senate,"Do pass, but first be re-referred to the Committee on [Appropriations]",7,0,2,0,9
967522,672757,2017-07-17,Senate,"Placed on suspense file",7,0,0,0,7
967522,674598,2017-09-01,Senate,"Do pass as amended",7,0,0,0,7
967522,675025,2017-09-06,Senate,"Assembly 3rd Reading AB1315 Mullin et al. By Wiener",40,0,0,0,40
967522,675497,2017-09-11,Assembly,"AB 1315 MULLIN Concurrence in Senate Amendments",78,0,1,0,79
967524,632990,2017-04-25,Assembly,"Do pass as amended and be re-referred to the Committee on [Appropriations]",16,0,0,0,16
967524,651867,2017-05-26,Assembly,"Do pass",17,0,0,0,17
967524,654424,2017-05-30,Assembly,"AB 1190 OBERNOLTE Assembly Third Reading",77,0,3,0,80
967524,671899,2017-07-10,Senate,"Do pass, but first be re-referred to the Committee on [Appropriations]",9,0,0,0,9
967524,675230,2017-09-07,Senate,"Assembly 3rd Reading AB1190 Obernolte By Dodd",40,0,0,0,40
967524,675375,2017-09-11,Assembly,"AB 1190 OBERNOLTE Concurrence in Senate Amendments",78,0,1,0,79
967525,627118,2017-04-18,Senate,"Do pass as amended, but first amend, and re-refer to the Committee on [Appropriations]",7,0,0,0,7
967525,655781,2017-05-31,Senate,"Senate 3rd Reading SB684 Bates",40,0,0,0,40
967525,672196,2017-07-11,Assembly,"Do pass as amended. To Consent Calendar",7,0,0,0,7
967525,672974,2017-07-20,Assembly,"SB 684 Bates Consent Calendar Second Day Regular Session",67,0,12,0,79
967525,674100,2017-08-24,Senate,"Special Consent Calendar # SB684",38,0,2,0,40
967527,627113,2017-04-18,Assembly,"Do pass as amended, and be re-referred to the Committee on [Appropriations] with recommendation: To Consent Calendar",15,0,0,0,15
967527,637313,2017-05-03,Assembly,"Do pass. To Consent Calendar",16,0,1,0,17
967527,643674,2017-05-11,Assembly,"AB 1225 PATTERSON Consent Calendar Second Day Regular Session",77,0,3,0,80
967527,671549,2017-07-05,Senate,"Do pass, but first be re-referred to the Committee on [Appropriations]",2,2,5,0,9
967527,671550,2017-07-05,Senate,"[First] hearing set for [07-06-2017]: Failed passage in Committee. Reconsideration granted",9,0,0,0,9
967527,769021,2018-06-27,Senate,"Do pass, but first be re-referred to the Committee on [Appropriations]",9,0,0,0,9
967528,641468,2017-05-08,Assembly,"Do pass as amended and be re-referred to the Committee on [Appropriations]",9,0,1,0,10
967530,618470,2017-04-04,Assembly,"Do pass and be re-referred to the Committee on [Appropriations] with recommendation: To Consent Calendar",7,0,0,0,7
967532,627973,2017-04-18,Assembly,"Do pass and be re-referred to the Committee on [Human Services]",12,0,1,0,13
967532,633613,2017-04-25,Assembly,"Do pass as amended and be re-referred to the Committee on [Appropriations]",7,0,0,0,7
967532,651749,2017-05-26,Assembly,"Do pass",17,0,0,0,17
967532,654362,2017-05-30,Assembly,"AB 1567 HOLDEN Assembly Third Reading",77,0,3,0,80
967532,667480,2017-06-21,Senate,"Do pass, but first be re-referred to the Committee on [Human Services] with the recommendation: To Consent Calendar",6,0,1,0,7
967532,672399,2017-07-11,Senate,"Do pass, but first be re-referred to the Committee on [Appropriations]",7,0,0,0,7
967532,673963,2017-08-21,Senate,"Placed on suspense file",7,0,0,0,7
967532,674760,2017-09-01,Senate,"Do pass as amended",7,0,0,0,7
967532,675517,2017-09-11,Senate,"Assembly 3rd Reading AB1567 Holden By Beall",40,0,0,0,40
967532,675932,2017-09-13,Assembly,"AB 1567 HOLDEN Concurrence in Senate Amendments",78,0,1,0,79
967534,631789,2017-04-25,Assembly,"Do pass and be re-referred to the Committee on [Appropriations] with recommendation: To Consent Calendar",15,0,1,0,16
967534,637390,2017-05-03,Assembly,"Do pass. To Consent Calendar",16,0,1,0,17
967534,643642,2017-05-11,Assembly,"AB 1627 COOLEY Consent Calendar Second Day Regular Session",77,0,3,0,80
967534,767936,2018-06-25,Senate,"Do pass as amended, but first amend, and re-refer to the Committee on [Appropriations]",7,0,2,0,9
967534,770502,2018-08-06,Senate,"Placed on suspense file",7,0,0,0,7
967536,631750,2017-04-24,Assembly,"Do pass and be re-referred to the Committee on [Appropriations]",10,0,0,0,10
967536,649268,2017-05-24,Assembly,"Do pass",17,0,0,0,17
967536,654514,2017-05-30,Assembly,"AB 1594 BLOOM Assembly Third Reading",74,0,6,0,80
967536,762811,2018-06-13,Senate,"Do pass, but first be re-referred to the Committee on [Transportation and Housing]",7,0,0,0,7
967536,768292,2018-06-26,Senate,"Do pass",12,0,1,0,13
967536,774580,2017-05-24,Assembly,,10,0,0,0,10
967538,627701,2017-04-17,Assembly,"Do pass as amended and be re-referred to the Committee on [Appropriations]",10,0,0,0,10
967538,649473,2017-05-24,Assembly,"Do pass. To Consent Calendar",17,0,0,0,17
967538,654569,2017-05-30,Assembly,"AB 1572 AGUIAR-CURRY Consent Calendar Second Day Regular Session",77,0,3,0,80
967538,667305,2017-06-21,Senate,"Do pass, but first be re-referred to the Committee on [Appropriations] with the recommendation: To Consent Calendar",6,0,1,0,7
967538,672568,2017-07-13,Senate,"Consent Calendar 2nd AB1572",39,0,1,0,40
967539,684764,2018-01-09,Assembly,"Do pass as amended and be re-referred to the Committee on [Appropriations]",6,0,0,0,6
967539,686220,2018-01-18,Assembly,"Do pass",17,0,0,0,17
967539,686221,2018-01-18,Assembly,"Set, [First] hearing. Referred to suspense file",17,0,0,0,17
967539,690128,2018-01-29,Assembly,"AB 1547 QUIRK-SILVA Assembly Third Reading",77,0,0,0,77
967539,767870,2018-06-25,Senate,"Do pass, but first be re-referred to the Committee on [Appropriations]",9,0,0,0,9
967539,770800,2018-08-06,Senate,"Placed on suspense file",7,0,0,0,7
967539,771972,2018-08-16,Senate,"Do pass as amended",7,0,0,0,7
967539,773426,2018-08-29,Senate,"Assembly 3rd Reading AB1547 Quirk-Silva et al. By Roth Urgency Clause",26,1,13,0,40
967539,773427,2018-08-29,Senate,"Assembly 3rd Reading AB1547 Quirk-Silva et al. By Roth Reconsider",38,0,2,0,40
967539,774170,2018-08-31,Senate,"Assembly 3rd Reading AB1547 Quirk-Silva et al. By Roth Urgency Clause",38,0,2,0,40
967539,774171,2018-08-31,Assembly,"AB 1547 Quirk-Silva Concurrence - Urgency Added",79,0,1,0,80
967541,631610,2017-04-24,Assembly,"Do pass and be re-referred to the Committee on [Appropriations] with recommendation: To Consent Calendar",10,0,0,0,10
967541,637468,2017-05-03,Assembly,"Set, [First] hearing. Referred to suspense file",16,0,1,0,17
967541,651587,2017-05-26,Assembly,"Do pass",17,0,0,0,17
967541,657006,2017-06-01,Assembly,"AB 1683 BURKE Assembly Third Reading",79,0,1,0,80
967543,641457,2017-05-09,Assembly,"Do pass as amended. To Consent Calendar",7,0,0,0,7
967543,647901,2017-05-22,Assembly,"AB 1604 NAZARIAN Consent Calendar Second Day Regular Session",77,0,3,0,80
967543,662758,2017-06-13,Senate,"Do pass, but first be re-referred to the Committee on [Appropriations]",4,0,1,0,5
967543,675592,2017-09-12,Senate,"Assembly 3rd Reading AB1604 Nazarian By Nguyen",39,0,1,0,40
967543,675794,2017-09-13,Assembly,"AB 1604 Nazarian Concurrence in Senate Amendments",75,0,4,0,79
967544,683968,2018-01-04,Assembly,"Be re-referred to the Committee on [Public Safety]",9,0,2,0,11
967544,684712,2018-01-09,Assembly,"Do pass",7,0,0,0,7
967544,686189,2018-01-18,Assembly,"AB 1584 GONZALEZ FLETCHER Assembly Third Reading",73,0,4,0,77
967544,762136,2018-06-12,Senate,"Do pass",7,0,0,0,7
967544,771393,2018-08-13,Senate,"Special Consent AB1584",37,0,3,0,40
967544,773240,2018-08-28,Senate,"Assembly 3rd Reading AB1584 Gonzalez Fletcher By Lara",38,0,2,0,40
967544,773732,2018-08-30,Assembly,"AB 1584 GONZALEZ FLETCHER Concurrence in Senate Amendments",77,0,3,0,80
967545,631624,2017-04-25,Assembly,"Do pass as amended and be re-referred to the Committee on [Appropriations]",7,0,0,0,7
967545,645920,2017-05-17,Assembly,"Do pass. To Consent Calendar",17,0,0,0,17
967545,651470,2017-05-26,Assembly,"AB 1595 GALLAGHER Consent Calendar Second Day Regular Session",76,0,4,0,80
967545,669159,2017-06-27,Senate,"Do pass, but first be re-referred to the Committee on [Appropriations]",7,0,0,0,7
967545,671870,2017-07-10,Senate,"Placed on suspense file",7,0,0,0,7
967546,683935,2018-01-03,Assembly,"Be re-referred to the Committees on [Jobs, Economic Development, and the Economy] and [Utilities and Energy]",10,0,1,0,11
967546,684763,2018-01-09,Assembly,"Do pass and be re-referred to the Committee on [Utilities and Energy]",6,0,0,0,6
967546,685061,2018-01-11,Assembly,"Do pass and be re-referred to the Committee on [Appropriations]",12,0,3,0,15
967546,686250,2018-01-18,Assembly,"Do pass as amended",16,0,1,0,17
967546,689927,2018-01-29,Assembly,"AB 1552 QUIRK-SILVA Assembly Third Reading",73,0,4,0,77
967547,632416,2017-04-25,Assembly,"Do pass and be re-referred to the Committee on [Appropriations] with recommendation: To Consent Calendar",10,0,0,0,10
967547,651741,2017-05-26,Assembly,"Do pass",17,0,0,0,17
967547,656948,2017-06-01,Assembly,"AB 1681 BURKE Assembly Third Reading",79,0,1,0,80
967551,614948,2017-03-29,Assembly,"Do pass",19,0,2,0,21
967551,621387,2017-04-06,Assembly,"AB 1540 BLOOM Assembly Third Reading",57,0,23,0,80
967551,672204,2017-07-11,Senate,"Do pass",13,0,0,0,13
967551,674359,2017-08-31,Senate,"Assembly 3rd Reading AB1540 Bloom et al. By Stern",40,0,0,0,40
967552,637551,2017-05-03,Assembly,"Do pass",6,3,0,0,9
967552,648011,2017-05-22,Assembly,"AB 1613 MULLIN Assembly Third Reading",45,29,6,0,80
967552,669260,2017-06-27,Senate,"Do pass, but first be re-referred to the Committee on [Governance and Finance]",9,3,1,0,13
967552,672356,2017-07-12,Senate,"Do pass",5,2,0,0,7
967552,674431,2017-08-31,Senate,"Assembly 3rd Reading AB1613 Mullin By Hill",26,11,3,0,40
967552,674680,2017-09-01,Assembly,"AB 1613 MULLIN Concurrence in Senate Amendments",47,29,3,0,79
967554,641778,2017-05-09,Assembly,"Do pass as amended",6,3,2,0,11
967554,657050,2017-06-01,Assembly,"AB 1541 KALRA Assembly Third Reading",62,12,6,0,80
967554,672219,2017-07-11,Senate,"Do pass",7,0,0,0,7
967554,674312,2017-08-31,Senate,"Assembly 3rd Reading AB1541 Kalra et al. By Wiener",38,0,2,0,40
967554,674898,2017-09-05,Assembly,"AB 1541 KALRA Concurrence in Senate Amendments",65,8,6,0,79
967555,631444,2017-04-25,Assembly,"Do pass and be re-referred to the Committee on [Appropriations] with recommendation: To Consent Calendar",15,0,0,0,15
967555,651840,2017-05-26,Assembly,"Do pass",17,0,0,0,17
967555,654582,2017-05-30,Assembly,"AB 1534 NAZARIAN Assembly Third Reading",76,0,4,0,80
967555,667147,2017-06-21,Senate,"Do pass as amended, but first amend, and re-refer to the Committee on [Appropriations]",9,0,0,0,9
967555,673908,2017-08-21,Senate,"Do pass",7,0,0,0,7
967555,772971,2018-08-27,Senate,"Assembly 3rd Reading AB1534 Nazarian By Mitchell",38,0,2,0,40
967555,773369,2018-08-29,Assembly,"AB 1534 NAZARIAN Concurrence in Senate Amendments",79,0,1,0,80
967556,631708,2017-04-24,Assembly,"Do pass and be re-referred to the Committee on [Appropriations] with recommendation: To Consent Calendar",14,0,0,0,14
967560,632530,2017-04-25,Assembly,"Do pass and be re-referred to the Committee on [Judiciary]",6,1,0,0,7
967562,618270,2017-04-04,Assembly,"Do pass as amended and be re-referred to the Committee on [Appropriations]",6,1,0,0,7
967566,684179,2018-01-08,Assembly,"Do pass and be re-referred to the Committee on [Appropriations]",10,0,0,0,10
967566,686174,2018-01-18,Assembly,"Do pass. To Consent Calendar",17,0,0,0,17
967566,690068,2018-01-29,Assembly,"AB 1596 GLORIA Consent Calendar Second Day Regular Session",75,0,2,0,77
967566,737312,2018-04-11,Senate,"Do pass as amended, but first amend, and re-refer to the Committee on [Appropriations]",6,0,1,0,7
967567,618780,2017-04-03,Assembly,"Do pass as amended and be re-referred to the Committee on [Appropriations]",10,0,0,0,10
967568,632001,2017-04-25,Assembly,"Do pass as amended and be re-referred to the Committee on [Appropriations]",9,4,3,0,16
967568,649442,2017-05-24,Assembly,"Do pass",13,4,0,0,17
967568,654100,2017-05-30,Assembly,"AB 1660 KALRA Assembly Third Reading",46,27,7,0,80
967568,671065,2017-07-03,Senate,"Do pass as amended, but first amend, and re-refer to the Committee on [Appropriations]",5,1,3,0,9
967568,675123,2017-09-07,Senate,"Assembly 3rd Reading AB1660 Kalra By Hill",28,12,0,0,40
967568,675368,2017-09-11,Assembly,"AB 1660 KALRA Concurrence in Senate Amendments",53,24,2,0,79
967569,600665,2017-03-09,Assembly,"Be adopted. To third reading",11,0,0,0,11
967569,616166,2017-03-30,Senate,"Special Consent Calendar # ACR25",37,0,3,0,40
967569,621418,2017-04-06,Assembly,"ACR 25 MAIENSCHEIN Concurrence in Senate Amendments",79,0,1,0,80
967572,628787,2017-04-18,Assembly,"Do pass as amended and be re-referred to the Committee on [Appropriations]",13,0,0,0,13
967572,637599,2017-05-03,Assembly,"Do pass. To Consent Calendar",16,0,1,0,17
967572,643437,2017-05-11,Assembly,"AB 1533 O'DONNELL Consent Calendar Second Day Regular Session",77,0,3,0,80
967572,663102,2017-06-14,Senate,"Do pass as amended, but first amend, and re-refer to the Committee on [Appropriations]",7,0,0,0,7
967572,671972,2017-07-10,Senate,"Do pass as amended",7,0,0,0,7
967572,674357,2017-08-31,Senate,"Special Consent Calendar # AB1533 O'Donnell et al. Urgency Clause",37,0,3,0,40
967572,674902,2017-09-05,Assembly,"AB 1533 O'DONNELL Concurrence in Senate Amendments",77,0,2,0,79
967573,621046,2017-04-06,Senate,"Assembly 3rd Reading (Supplemental File 1) ACA5 Frazier et al. By Newman",28,10,2,0,40
967573,621228,2017-04-06,Assembly,"ACA 5 FRAZIER Assembly Third Reading Amend By HARPER Set #1 Motion to Lay on the Table By CALDERON",54,25,1,0,80
967573,621229,2017-04-06,Assembly,"ACA 5 FRAZIER Assembly Third Reading",56,24,0,0,80
967574,634605,2017-04-26,Assembly,"Do pass as amended and be re-referred to the Committee on [Appropriations]",12,0,1,0,13
967574,651919,2017-05-26,Assembly,"Do pass",15,1,1,0,17
967574,656812,2017-06-01,Assembly,"AB 1665 GARCIA, E. Assembly Third Reading",67,5,8,0,80
967574,674231,2017-08-29,Senate,"Do pass, but first be re-referred to the Committee on [Appropriations]",8,0,3,0,11
967574,674712,2017-09-01,Senate,"Placed on suspense file",7,0,0,0,7
967574,674713,2017-09-01,Senate,"Do pass",7,0,0,0,7
967574,675845,2017-09-13,Senate,"Assembly 3rd Reading AB1665 Eduardo Garcia By Hueso Urgency Clause",34,2,4,0,40
967574,676062,2017-09-14,Assembly,"With recommendation: That Senate amendments be concurred in",12,0,1,0,13
967574,676472,2017-09-15,Assembly,"AB 1665 GARCIA, E. Concurrence - Urgency Added",68,8,3,0,79
967577,632314,2017-04-25,Assembly,"Do pass as amended and be re-referred to the Committee on [Appropriations]",4,0,3,0,7
967577,649454,2017-05-24,Assembly,"Do pass as amended",12,4,1,0,17
967577,655951,2017-05-31,Assembly,"AB 1646 MURATSUCHI Assembly Third Reading",69,2,9,0,80
967577,667207,2017-06-21,Senate,"Do pass, but first be re-referred to the Committee on [Appropriations]",5,1,1,0,7
967577,674442,2017-09-01,Senate,"Placed on suspense file",7,0,0,0,7
967577,674443,2017-09-01,Senate,"Do pass as amended",5,2,0,0,7
967577,675028,2017-09-06,Senate,"Assembly 3rd Reading AB1646 Muratsuchi et al. By Skinner",29,10,1,0,40
967577,675501,2017-09-11,Assembly,"AB 1646 MURATSUCHI Concurrence in Senate Amendments",55,18,6,0,79
967578,593785,2017-02-27,Assembly,"Be adopted. To Consent Calendar",10,0,1,0,11
967578,596754,2017-03-02,Assembly,"ACR 26 HARPER Consent Calendar Second Day",73,0,7,0,80
967578,616084,2017-03-30,Senate,"Special Consent Calendar # ACR26",37,0,3,0,40
967580,627680,2017-04-18,Assembly,"Do pass and be re-referred to the Committee on [Appropriations] with recommendation: To Consent Calendar",15,0,0,0,15
967580,651505,2017-05-26,Assembly,"Do pass",17,0,0,0,17
967580,654496,2017-05-30,Assembly,"AB 1591 BERMAN Assembly Third Reading",76,0,4,0,80
967580,663017,2017-06-14,Senate,"Do pass, but first be re-referred to the Committee on [Appropriations] with the recommendation: To Consent Calendar",9,0,0,0,9
967580,671955,2017-07-10,Senate,"Placed on suspense file",7,0,0,0,7
967580,674836,2017-09-01,Senate,"Do pass as amended",7,0,0,0,7
967580,676076,2017-09-14,Senate,"Special Consent Calendar # AB1591",40,0,0,0,40
967580,676349,2017-09-14,Assembly,"AB 1591 Berman Special Consent Calendar 1st Day Regular Session",79,0,0,0,79
967583,619128,2017-04-04,Assembly,"Do pass as amended and be re-referred to the Committee on [Appropriations]",8,0,3,0,11
967583,643311,2017-05-10,Assembly,"Do pass. To Consent Calendar",17,0,0,0,17
967583,646479,2017-05-18,Assembly,"AB 1615 GARCIA, E. Consent Calendar Second Day Regular Session",69,0,11,0,80
967583,666280,2017-06-20,Senate,"Do pass as amended, but first amend, and re-refer to the Committee on [Appropriations] with the recommendation: To Consent Calendar",7,0,0,0,7
967583,672621,2017-07-13,Senate,"Consent Calendar 2nd AB1615",39,0,1,0,40
967583,672744,2017-07-17,Assembly,"AB 1615 GARCIA, E. Concurrence in Senate Amendments",77,0,2,0,79
967585,632032,2017-04-25,Assembly,"Do pass and be re-referred to the Committee on [Appropriations] with recommendation: To Consent Calendar",10,0,0,0,10
967585,651966,2017-05-26,Assembly,"Do pass",17,0,0,0,17
967585,656847,2017-06-01,Assembly,"AB 1680 BURKE Assembly Third Reading",78,0,2,0,80
967585,672075,2017-07-11,Senate,"Do pass, but first be re-referred to the Committee on [Appropriations] with the recommendation: To Consent Calendar",13,0,0,0,13
967585,673985,2017-08-21,Senate,"Placed on suspense file",7,0,0,0,7
967585,674711,2017-09-01,Senate,"Do pass as amended",7,0,0,0,7
967588,632147,2017-04-25,Assembly,"Do pass and be re-referred to the Committee on [Appropriations]",10,5,0,0,15
967588,651888,2017-05-26,Assembly,"Do pass",12,5,0,0,17
967588,655760,2017-05-31,Assembly,"AB 1558 GARCIA, C. Assembly Third Reading",57,17,6,0,80
967588,669213,2017-06-27,Senate,"Do pass, but first be re-referred to the Committee on [Appropriations]",6,2,1,0,9
967588,671990,2017-07-10,Senate,"Placed on suspense file",7,0,0,0,7
967588,674584,2017-09-01,Senate,"Do pass",5,2,0,0,7
967588,675420,2017-09-11,Senate,"Assembly 3rd Reading AB1558 Cristina Garcia By Allen",28,12,0,0,40
967590,633356,2017-04-26,Assembly,"Do pass as amended and be re-referred to the Committee on [Appropriations]",14,0,1,0,15
967590,651792,2017-05-26,Assembly,"Do pass",17,0,0,0,17
967590,654051,2017-05-30,Assembly,"AB 1573 BLOOM Assembly Third Reading",76,0,4,0,80
967590,768128,2018-06-26,Senate,"Do pass as amended, but first amend, and re-refer to the Committee on [Appropriations] with the recommendation: To Consent Calendar",9,0,0,0,9
967590,770405,2018-08-06,Senate,"Placed on suspense file",7,0,0,0,7
967590,771706,2018-08-16,Senate,"Do pass as amended",7,0,0,0,7
967590,772372,2018-08-21,Senate,"Assembly 3rd Reading AB1573 Bloom By McGuire",39,0,1,0,40
967590,773103,2018-08-28,Assembly,"With recommendation: That Senate amendments be concurred in",14,0,1,0,15
967590,773632,2018-08-29,Assembly,"AB 1573 BLOOM Concurrence in Senate Amendments",75,0,5,0,80
967595,631435,2017-04-25,Assembly,"Do pass and be re-referred to the Committee on [Appropriations]",15,0,0,0,15
967595,651882,2017-05-26,Assembly,"Do pass",16,0,1,0,17
967595,655943,2017-05-31,Assembly,"AB 1654 RUBIO Assembly Third Reading",72,1,7,0,80
967595,672157,2017-07-11,Senate,"Do pass as amended, but first amend, and re-refer to the Committee on [Appropriations]",9,0,0,0,9
967595,768855,2018-06-26,Senate,"Do pass, but first be re-referred to the Committee on [Labor and Industrial Relations]",5,2,0,0,7
967595,768856,2018-06-27,Senate,"Do pass, but first be re-referred to the Committee on [Appropriations]",4,1,0,0,5
967595,770256,2018-08-06,Senate,"Placed on suspense file",7,0,0,0,7
967595,771682,2018-08-16,Senate,"Do pass as amended",5,2,0,0,7
967595,773147,2018-08-28,Senate,"Assembly 3rd Reading AB1654 Rubio et al. By Hertzberg",25,11,4,0,40
967595,774062,2018-08-31,Assembly,"With recommendation: That Senate amendments be concurred in",7,0,0,0,7
967595,774063,2018-08-31,Assembly,"AB 1654 Rubio Concurrence in Senate Amendments",60,16,4,0,80
967598,632485,2017-04-25,Assembly,"Do pass and be re-referred to the Committee on [Appropriations]",5,0,2,0,7
967598,649352,2017-05-24,Assembly,"Do pass",16,0,1,0,17
967598,654260,2017-05-30,Assembly,"AB 1671 CABALLERO Assembly Third Reading",72,1,7,0,80
967598,667111,2017-06-21,Senate,"Do pass, but first be re-referred to the Committee on [Appropriations]",6,0,1,0,7
967598,673793,2017-08-21,Senate,"Placed on suspense file",7,0,0,0,7
967598,676131,2017-09-14,Senate,"Assembly 3rd Reading AB1671 Caballero By Wieckowski",40,0,0,0,40
967598,676463,2017-09-15,Assembly,"AB 1671 Caballero Concurrence in Senate Amendments",74,0,5,0,79
967601,631886,2017-04-25,Assembly,"Do pass and be re-referred to the Committee on [Appropriations]",9,6,0,0,15
967601,651546,2017-05-26,Assembly,"Do pass as amended",11,6,0,0,17
967601,656134,2017-05-31,Assembly,"AB 1667 FRIEDMAN Assembly Third Reading",52,10,18,0,80
967603,618588,2017-04-04,Assembly,"Do pass and be re-referred to the Committee on [Governmental Organization]",10,0,5,0,15
967603,628003,2017-04-19,Assembly,"Do pass and be re-referred to the Committee on [Appropriations]",15,2,4,0,21
967604,633346,2017-04-25,Assembly,"Do pass and be re-referred to the Committee on [Appropriations]",9,1,0,0,10
967604,651703,2017-05-26,Assembly,"Do pass as amended",13,0,4,0,17
967604,656187,2017-05-31,Assembly,"AB 1618 CERVANTES Assembly Third Reading",73,0,7,0,80
967604,672253,2017-07-11,Senate,"Do pass as amended, but first amend, and re-refer to the Committee on [Appropriations]",6,0,1,0,7
967604,673867,2017-08-21,Senate,"Placed on suspense file",7,0,0,0,7
967604,674757,2017-09-01,Senate,"Do pass as amended",7,0,0,0,7
967604,675074,2017-09-06,Senate,"Assembly 3rd Reading AB1618 Cervantes By Hueso",40,0,0,0,40
967604,675369,2017-09-11,Assembly,"AB 1618 CERVANTES Concurrence in Senate Amendments",78,1,0,0,79
967605,631598,2017-04-25,Assembly,"Do pass as amended, and be re-referred to the Committee on [Appropriations] with recommendation: To Consent Calendar",10,0,0,0,10
967605,651866,2017-05-26,Assembly,"Do pass",17,0,0,0,17
967605,656842,2017-06-01,Assembly,"AB 1546 BURKE Assembly Third Reading",78,0,2,0,80
967605,672181,2017-07-11,Senate,"Do pass, but first be re-referred to the Committee on [Appropriations]",13,0,0,0,13
967605,673795,2017-08-21,Senate,"Placed on suspense file",7,0,0,0,7
967607,633073,2017-04-25,Assembly,"Do pass and be re-referred to the Committee on [Appropriations]",10,2,1,0,13
967609,631554,2017-04-25,Assembly,"Do pass and be re-referred to the Committee on [Appropriations]",10,5,0,0,15
967609,651903,2017-05-26,Assembly,"Do pass",11,6,0,0,17
967609,655752,2017-05-31,Assembly,"AB 1668 FRIEDMAN Assembly Third Reading",44,25,11,0,80
967609,672108,2017-07-11,Senate,"Do pass as amended, but first amend, and re-refer to the Committee on [Appropriations]",7,0,2,0,9
967609,674297,2017-08-31,Senate,"Do pass, but first be re-referred to the Committee on [Appropriations]",5,2,2,0,9
967609,676397,2017-09-15,Senate,"Do pass, but first be re-referred to the Committee on [Rules]",5,0,2,0,7
967609,752771,2018-05-14,Senate,"Assembly 3rd Reading AB1668 Friedman et al. By Hertzberg",24,14,1,0,39
967609,754239,2018-05-17,Assembly,"AB 1668 FRIEDMAN Concurrence in Senate Amendments",45,26,7,0,78
967612,618304,2017-04-04,Assembly,"Do pass as amended",7,0,0,0,7
967612,629097,2017-04-20,Assembly,"AB 1639 GARCIA, E. Assembly Third Reading",66,0,14,0,80
967612,662118,2017-06-13,Senate,"Do pass",6,0,1,0,7
967612,769621,2018-07-02,Senate,"Assembly 3rd Reading AB1639 Eduardo Garcia By Mitchell",35,0,4,0,39
967612,770543,2018-08-06,Assembly,"AB 1639 GARCIA, E. Concurrence in Senate Amendments",74,0,6,0,80
967613,632002,2017-04-25,Assembly,"Do pass and be re-referred to the Committee on [Appropriations]",9,4,3,0,16
967615,632252,2017-04-25,Assembly,"Do pass and be re-referred to the Committee on [Appropriations]",16,0,0,0,16
967616,683958,2018-01-04,Assembly,"Be re-referred to the Committee on [Jobs, Economic Development, and the Economy]",9,0,2,0,11
967616,684728,2018-01-09,Assembly,"Do pass as amended, and be re-referred to the Committee on [Appropriations] with recommendation: To Consent Calendar",6,0,0,0,6
967616,686164,2018-01-18,Assembly,"Do pass. To Consent Calendar",17,0,0,0,17
967616,689910,2018-01-29,Assembly,"AB 1561 QUIRK-SILVA Consent Calendar Second Day Regular Session",75,0,2,0,77
967616,749966,2018-05-07,Senate,"Do pass, but first be re-referred to the Committee on [Appropriations]",8,0,1,0,9
967616,772383,2018-08-21,Senate,"Assembly 3rd Reading AB1561 Quirk-Silva By Hueso",39,0,1,0,40
967616,772809,2018-08-27,Assembly,"AB 1561 QUIRK-SILVA Concurrence in Senate Amendments",80,0,0,0,80
967617,627357,2017-04-18,Assembly,"Do pass and be re-referred to the Committee on [Appropriations]",10,1,0,0,11
967617,637875,2017-05-03,Assembly,"Do pass",13,1,3,0,17
967617,656876,2017-06-01,Assembly,"AB 1682 BURKE Assembly Third Reading",66,12,2,0,80
967617,672323,2017-07-11,Senate,"Do pass, but first be re-referred to the Committee on [Appropriations]",5,2,0,0,7
967617,673962,2017-08-21,Senate,"Placed on suspense file",7,0,0,0,7
967618,627897,2017-04-19,Assembly,"Do pass and be re-referred to the Committee on [Appropriations] with recommendation: To Consent Calendar",13,0,0,0,13
967618,651681,2017-05-26,Assembly,"Do pass",17,0,0,0,17
967618,656102,2017-05-31,Assembly,"AB 1641 DALY Assembly Third Reading",76,0,4,0,80
967618,672337,2017-07-12,Senate,"Do pass, but first be re-referred to the Committee on [Appropriations] with the recommendation: To Consent Calendar",10,0,3,0,13
967618,673939,2017-08-21,Senate,"Placed on suspense file",7,0,0,0,7
967618,674759,2017-09-01,Senate,"Do pass",7,0,0,0,7
967618,676051,2017-09-14,Senate,"Special Consent Calendar # AB1641",40,0,0,0,40
967618,676332,2017-09-14,Assembly,"AB 1641 Daly Special Consent Calendar 1st Day Regular Session",79,0,0,0,79
967619,618362,2017-04-04,Assembly,"Do pass and be re-referred to the Committee on [Appropriations]",8,3,4,0,15
967619,651977,2017-05-26,Assembly,"Do pass as amended",11,5,1,0,17
967619,656094,2017-05-31,Assembly,"AB 1587 LEVINE Assembly Third Reading",53,21,6,0,80
967619,669125,2017-06-27,Senate,"Do pass as amended, but first amend, and re-refer to the Committee on [Judiciary]",7,1,1,0,9
967619,673973,2017-08-21,Senate,"Placed on suspense file",7,0,0,0,7
967621,628220,2017-04-18,Assembly,"Do pass and be re-referred to the Committee on [Appropriations]",13,0,0,0,13
967621,633609,2017-04-26,Assembly,"Do pass. To Consent Calendar",16,0,1,0,17
967621,638722,2017-05-04,Assembly,"AB 1655 GRAYSON Consent Calendar Second Day Regular Session",76,0,4,0,80
967621,671357,2017-07-05,Senate,"Do pass as amended, but first amend, and re-refer to the Committee on [Appropriations]",6,0,1,0,7
967621,674275,2017-08-31,Senate,"Assembly 3rd Reading AB1655 Grayson By Galgiani",37,0,3,0,40
967621,675184,2017-09-07,Assembly,"AB 1655 GRAYSON Concurrence in Senate Amendments",79,0,0,0,79
967621,774492,2017-08-31,Senate,,6,0,3,0,9
967622,632079,2017-04-24,Senate,"Do pass, but first be re-referred to the Committee on [Appropriations] with the recommendation: To Consent Calendar",9,0,0,0,9
967622,647888,2017-05-22,Senate,"Consent Calendar 2nd SB800 B.P.&E.D",37,0,3,0,40
967622,672127,2017-07-11,Assembly,"Do pass and be re-referred to the Committee on [Appropriations]",16,0,0,0,16
967622,674020,2017-08-23,Assembly,"Do pass. To Consent Calendar",15,0,2,0,17
967622,676608,2017-09-15,Assembly,"SB 800 B., P. & E.D. Senate Third Reading By LOW",79,0,0,0,79
967622,676609,2017-09-15,Senate,"Unfinished Business SB800 B.P.&E.D. (Hill) Concurrence",38,0,2,0,40
967625,621127,2017-04-06,Assembly,"Be re-referred to the Committee on [Environmental Safety and Toxic Materials]",9,0,2,0,11
967625,632356,2017-04-25,Assembly,"Do pass and be re-referred to the Committee on [Appropriations]",5,0,2,0,7
967625,686207,2018-01-18,Assembly,"Do pass as amended",13,0,4,0,17
967625,689896,2018-01-29,Assembly,"AB 1663 GARCIA, C. Assembly Third Reading",67,0,10,0,77
967626,620096,2017-04-05,Assembly,"Do pass and be re-referred to the Committee on [Local Government] with recommendation: To Consent Calendar",9,0,1,0,10
967626,629099,2017-04-19,Assembly,"Do pass and be re-referred to the Committee on [Appropriations] with recommendation: To Consent Calendar",9,0,0,0,9
967626,642945,2017-05-10,Assembly,"Do pass. To Consent Calendar",17,0,0,0,17
967626,654367,2017-05-30,Assembly,"AB 1564 ARAMBULA Assembly Third Reading",77,0,3,0,80
967626,672478,2017-07-12,Senate,"Do pass, but first be re-referred to the Committee on [Appropriations]",7,0,0,0,7
967627,633321,2017-04-25,Assembly,"Do pass as amended",8,2,3,0,13
967627,654267,2017-05-30,Assembly,"AB 1651 REYES Assembly Third Reading",50,25,5,0,80
967627,667300,2017-06-21,Senate,"Do pass as amended",5,1,1,0,7
967627,675612,2017-09-12,Senate,"Assembly 3rd Reading AB1651 Reyes By Pan",26,14,0,0,40
967627,675912,2017-09-13,Assembly,"AB 1651 Reyes Concurrence in Senate Amendments",54,24,1,0,79
967630,627159,2017-04-18,Assembly,"Do pass and be re-referred to the Committee on [Appropriations]",14,0,1,0,15
967630,633342,2017-04-26,Assembly,"Do pass. To Consent Calendar",16,0,1,0,17
967630,638641,2017-05-04,Assembly,"AB 1532 BLOOM Consent Calendar Second Day Regular Session",76,0,4,0,80
967631,626108,2017-04-17,Assembly,"Be re-referred to the Committee on [Business and Professions]",9,0,2,0,11
967631,632039,2017-04-25,Assembly,"Do pass and be re-referred to the Committee on [Appropriations] with recommendation: To Consent Calendar",15,0,1,0,16
967631,642563,2017-05-10,Assembly,"Do pass. To Consent Calendar",17,0,0,0,17
967631,646553,2017-05-18,Assembly,"AB 1686 GLORIA Consent Calendar Second Day Regular Session",69,0,11,0,80
967631,669189,2017-06-26,Senate,"Do pass, but first be re-referred to the Committee on [Appropriations]",8,1,0,0,9
967631,673884,2017-08-21,Senate,"Placed on suspense file",7,0,0,0,7
967633,633665,2017-04-26,Assembly,"Do pass and be re-referred to the Committee on [Revenue and Taxation]",7,0,0,0,7
967634,633615,2017-04-26,Assembly,"Do pass as amended and be re-referred to the Committee on [Appropriations]",5,2,0,0,7
967634,642477,2017-05-10,Assembly,"Do pass",12,5,0,0,17
967634,654016,2017-05-30,Assembly,"AB 1678 BERMAN Assembly Third Reading",53,23,4,0,80
967634,672592,2017-07-12,Senate,"Do pass, but first be re-referred to the Committee on [Appropriations]",4,1,0,0,5
967634,739626,2018-04-17,Senate,"Do pass, but first be re-referred to the Committee on [Appropriations]",5,0,0,0,5
967634,750249,2018-05-07,Senate,"Placed on suspense file",6,0,1,0,7
967634,756295,2018-05-25,Senate,"Do pass",7,0,0,0,7
967634,763684,2018-06-14,Senate,"Assembly 3rd Reading AB1678 Berman et al. By Stern Urgency Clause",37,0,2,0,39
967634,768940,2018-06-27,Assembly,"With recommendation: That Senate amendments be concurred in",6,1,0,0,7
967634,769605,2018-07-02,Assembly,"AB 1678 BERMAN Concurrence - Urgency Added",71,1,8,0,80
967635,629100,2017-04-19,Assembly,"Do pass and be re-referred to the Committee on [Housing and Community Development]",7,2,0,0,9
967635,633587,2017-04-26,Assembly,"Do pass as amended and be re-referred to the Committee on [Appropriations]",5,2,0,0,7
967635,649395,2017-05-24,Assembly,"Do pass",12,5,0,0,17
967635,655738,2017-05-31,Assembly,"AB 1598 MULLIN Assembly Third Reading",52,23,5,0,80
967635,669837,2017-06-28,Senate,"Do pass as amended, but first amend, and re-refer to the Committee on [Transportation and Housing]",4,1,2,0,7
967635,672172,2017-07-11,Senate,"Do pass as amended, but first amend, and re-refer to the Committee on [Appropriations]",10,2,1,0,13
967635,675413,2017-09-11,Senate,"Assembly 3rd Reading AB1598 Mullin et al. By Dodd",28,11,1,0,40
967635,675880,2017-09-13,Assembly,"AB 1598 MULLIN Concurrence in Senate Amendments",51,28,0,0,79
967636,627093,2017-04-18,Assembly,"Do pass",5,2,0,0,7
967636,656853,2017-06-01,Assembly,"AB 1578 JONES-SAWYER Assembly Third Reading",41,33,6,0,80
967636,669166,2017-06-27,Senate,"Do pass",5,2,0,0,7
967637,626829,2017-04-18,Assembly,"Do pass as amended and be re-referred to the Committee on [Appropriations]",8,1,6,0,15
967638,626870,2017-04-18,Assembly,"Do pass and be re-referred to the Committee on [Appropriations]",14,0,2,0,16
967638,637550,2017-05-03,Assembly,"Do pass. To Consent Calendar",16,0,1,0,17
967638,643422,2017-05-11,Assembly,"AB 1590 CHEN Consent Calendar Second Day Regular Session",77,0,3,0,80
967638,661607,2017-06-12,Senate,"Do pass as amended, but first amend, and re-refer to the Committee on [Appropriations]",9,0,0,0,9
967638,674353,2017-08-31,Senate,"Assembly 3rd Reading AB1590 Chen By Wilk",40,0,0,0,40
967638,674964,2017-09-05,Assembly,"AB 1590 CHEN Concurrence in Senate Amendments",77,0,2,0,79
967639,626806,2017-04-18,Assembly,"Do pass and be re-referred to the Committee on [Environmental Safety and Toxic Materials]",10,3,2,0,15
967639,632106,2017-04-25,Assembly,"Do pass as amended and be re-referred to the Committee on [Appropriations]",4,2,1,0,7
967639,651737,2017-05-26,Assembly,"Do pass",11,5,1,0,17
967639,656894,2017-06-01,Assembly,"AB 1575 KALRA Assembly Third Reading",51,21,8,0,80
967639,671358,2017-07-05,Senate,"Do pass as amended, but first amend, and re-refer to the Committee on [Health]",6,0,1,0,7
967639,672530,2017-07-12,Senate,"Do pass, but first be re-referred to the Committee on [Appropriations]",8,0,1,0,9
967639,673750,2017-08-21,Senate,"Placed on suspense file",7,0,0,0,7
967644,635718,2017-05-01,Assembly,"Do pass",10,0,1,0,11
967644,638574,2017-05-04,Assembly,"AB 1535 MAIENSCHEIN Assembly Third Reading",76,0,4,0,80
967644,660259,2017-06-07,Senate,"Do pass as amended, but first amend, and re-refer to the Committee on [Judiciary]",11,0,2,0,13
967644,672918,2017-07-18,Senate,"Do pass",7,0,0,0,7
967644,674433,2017-08-31,Senate,"Assembly 3rd Reading AB1535 Maienschein By Hertzberg",39,0,1,0,40
967644,674932,2017-09-05,Assembly,"AB 1535 MAIENSCHEIN Concurrence in Senate Amendments",76,0,3,0,79
967645,633580,2017-04-25,Assembly,"Do pass and be re-referred to the Committee on [Appropriations]",10,2,1,0,13
967647,631794,2017-04-25,Assembly,"Do pass and be re-referred to the Committee on [Appropriations]",14,0,1,0,15
967650,628118,2017-04-19,Assembly,"Do pass and be re-referred to the Committee on [Appropriations]",5,2,0,0,7
967650,646047,2017-05-17,Assembly,"Do pass",12,5,0,0,17
967650,656287,2017-05-31,Assembly,"AB 1603 RIDLEY-THOMAS Assembly Third Reading",54,21,5,0,80
967650,671969,2017-07-10,Senate,"Do pass, but first be re-referred to the Committee on [Appropriations]",3,2,0,0,5
967653,627923,2017-04-19,Assembly,"Do pass and be re-referred to the Committee on [Appropriations]",5,0,2,0,7
967653,651657,2017-05-26,Assembly,"Do pass",12,0,5,0,17
967653,656827,2017-06-01,Assembly,"AB 1597 NAZARIAN Assembly Third Reading",67,0,13,0,80
967653,767867,2018-06-25,Senate,"Do pass, but first be re-referred to the Committee on [Judiciary]",4,0,1,0,5
967653,768785,2018-06-26,Senate,"Do pass as amended, but first amend, and re-refer to the Committee on [Appropriations]",5,0,2,0,7
967653,770377,2018-08-06,Senate,"Placed on suspense file",7,0,0,0,7
967653,771882,2018-08-16,Senate,"Do pass",5,0,2,0,7
967653,773643,2018-08-29,Senate,"Assembly 3rd Reading AB1597 Nazarian et al. By Portantino",36,0,4,0,40
967653,774038,2018-08-31,Assembly,"AB 1597 NAZARIAN Concurrence in Senate Amendments",69,0,11,0,80
967653,777954,2018-08-29,Senate,,5,0,4,0,9
967655,627246,2017-04-18,Assembly,"Do pass as amended and be re-referred to the Committee on [Business and Professions]",13,1,1,0,15
967655,631888,2017-04-25,Assembly,"Do pass and be re-referred to the Committee on [Appropriations]",15,0,1,0,16
967655,649291,2017-05-24,Assembly,"Do pass",17,0,0,0,17
967655,654252,2017-05-30,Assembly,"AB 1606 COOPER Assembly Third Reading",75,0,5,0,80
967655,674083,2017-08-24,Senate,"Assembly 3rd Reading AB1606 Cooper et al. By Galgiani Urgency Clause",38,0,2,0,40
967655,674375,2017-08-31,Assembly,"AB 1606 COOPER Concurrence - Urgency Added",67,0,12,0,79
967659,633572,2017-04-25,Assembly,"Do pass and be re-referred to the Committee on [Appropriations]",7,3,3,0,13
967660,636374,2017-05-02,Assembly,"Do pass as amended",13,0,3,0,16
967660,644306,2017-05-15,Assembly,"AB 1560 FRIEDMAN Assembly Third Reading",73,0,7,0,80
967660,671872,2017-07-10,Senate,"Do pass",5,1,3,0,9
967662,619747,2017-04-04,Assembly,"Do pass and be re-referred to the Committee on [Judiciary]",7,0,0,0,7
967662,627127,2017-04-18,Assembly,"Do pass as amended and be re-referred to the Committee on [Appropriations]",11,0,0,0,11
967662,649435,2017-05-24,Assembly,"Do pass. To Consent Calendar",17,0,0,0,17
967662,654238,2017-05-30,Assembly,"AB 1583 CHAU Consent Calendar Second Day Regular Session",77,0,3,0,80
967662,667336,2017-06-21,Senate,"Do pass, but first be re-referred to the Committee on [Judiciary] with the recommendation: To Consent Calendar",6,0,1,0,7
967662,672349,2017-07-11,Senate,"Do pass, but first be re-referred to the Committee on [Appropriations] with the recommendation: To Consent Calendar",7,0,0,0,7
967662,673781,2017-08-21,Senate,"Placed on suspense file",7,0,0,0,7
967662,674567,2017-09-01,Senate,"Do pass",7,0,0,0,7
967662,676118,2017-09-14,Senate,"Special Consent Calendar # AB1583",40,0,0,0,40
967662,676348,2017-09-14,Assembly,"AB 1583 Chau Special Consent Calendar 1st Day Regular Session",79,0,0,0,79
967664,628242,2017-04-19,Assembly,"Do pass and be re-referred to the Committee on [Appropriations]",7,0,0,0,7
967664,651969,2017-05-26,Assembly,"Do pass",17,0,0,0,17
967664,654474,2017-05-30,Assembly,"AB 1577 GIPSON Assembly Third Reading",77,0,3,0,80
967664,767082,2018-06-20,Senate,"Do pass as amended, but first amend, and re-refer to the Committee on [Appropriations]",7,0,0,0,7
967664,771374,2018-08-13,Senate,"Placed on suspense file",7,0,0,0,7
967664,771770,2018-08-16,Senate,"Do pass",7,0,0,0,7
967664,773431,2018-08-29,Senate,"Assembly 3rd Reading AB1577 Gipson By Bradford Urgency Clause",24,0,16,0,40
967664,773432,2018-08-29,Senate,"Assembly 3rd Reading AB1577 Gipson By Bradford Reconsider",38,0,2,0,40
967664,774133,2018-08-31,Assembly,"With recommendation: That Senate amendments be concurred in",9,0,0,0,9
967664,774134,2018-08-31,Senate,"Assembly 3rd Reading AB1577 Gipson By Bradford Urgency Clause",38,0,2,0,40
967664,774135,2018-08-31,Assembly,"AB 1577 Gipson Concurrence - Urgency Added",79,0,1,0,80
967669,631603,2017-04-25,Assembly,"Do pass as amended and be re-referred to the Committee on [Appropriations]",6,1,0,0,7
967669,651984,2017-05-26,Assembly,"Do pass",16,1,0,0,17
967669,655928,2017-05-31,Assembly,"AB 1542 DABABNEH Assembly Third Reading",76,1,3,0,80
967669,672054,2017-07-11,Senate,"Do pass, but first be re-referred to the Committee on [Appropriations]",5,0,2,0,7
967669,673894,2017-08-21,Senate,"Placed on suspense file",7,0,0,0,7
967669,674608,2017-09-01,Senate,"Do pass as amended",7,0,0,0,7
967669,675297,2017-09-11,Senate,"Assembly 3rd Reading AB1542 Dababneh et al. By Wiener",39,0,1,0,40
967669,675879,2017-09-13,Assembly,"AB 1542 DABABNEH Concurrence in Senate Amendments",78,0,1,0,79
967670,634664,2017-04-26,Assembly,"Do pass and be re-referred to the Committee on [Appropriations]",4,2,1,0,7
967670,645805,2017-05-17,Assembly,"Do pass",11,5,1,0,17
967670,685423,2018-01-16,Assembly,"AB 1661 LIMÓN Assembly Third Reading Amend By LIMÓN Set #1",62,1,14,0,77
967670,686939,2018-01-22,Assembly,"AB 1661 LIMÓN Assembly Third Reading",70,0,7,0,77
967670,768868,2018-06-27,Senate,"Do pass as amended, but first amend, and re-refer to the Committee on [Appropriations]",7,0,0,0,7
967670,772821,2018-08-27,Senate,"Assembly 3rd Reading AB1661 Limón By Allen",39,0,1,0,40
967670,773616,2018-08-29,Assembly,"AB 1661 LIMÓN Concurrence in Senate Amendments",80,0,0,0,80
967670,777920,2018-01-22,Assembly,,62,0,7,0,69
967671,618354,2017-04-04,Assembly,"Do pass and be re-referred to the Committee on [Appropriations]",10,4,1,0,15
967671,651718,2017-05-26,Assembly,"Do pass",13,4,0,0,17
967671,655878,2017-05-31,Assembly,"AB 1617 BLOOM Assembly Third Reading",56,20,4,0,80
967671,766353,2018-06-19,Senate,"Do pass, but first be re-referred to the Committee on [Public Safety] with the recommendation: To Consent Calendar",7,0,0,0,7
967671,768232,2018-06-26,Senate,"Do pass as amended, but first amend, and re-refer to the Committee on [Appropriations] with the recommendation: To Consent Calendar",7,0,0,0,7
967671,771413,2018-08-13,Senate,"Consent Calendar AB1617",37,0,3,0,40
967671,772592,2018-08-23,Assembly,"With recommendation: That Senate amendments be concurred in",9,0,0,0,9
967671,772842,2018-08-27,Assembly,"AB 1617 BLOOM Concurrence in Senate Amendments",77,0,3,0,80
967672,643199,2017-05-10,Assembly,"Do pass. To Consent Calendar",6,0,1,0,7
967672,646651,2017-05-18,Assembly,"AB 1550 LIMÓN Consent Calendar Second Day Regular Session",69,0,11,0,80
967672,662993,2017-06-14,Senate,"Do pass, but first be re-referred to the Committee on [Governance and Finance] with the recommendation: To Consent Calendar",7,0,0,0,7
967672,672504,2017-07-12,Senate,"Do pass as amended",7,0,0,0,7
967672,674306,2017-08-31,Senate,"Special Consent Calendar # AB1550",37,0,3,0,40
967672,675227,2017-09-07,Assembly,"AB 1550 LIMÓN Concurrence in Senate Amendments",78,0,1,0,79
967677,642711,2017-05-10,Assembly,"Do pass as amended",5,3,1,0,9
967677,651726,2017-05-26,Assembly,"Do pass as amended",17,0,0,0,17
967677,656985,2017-06-01,Assembly,"AB 1568 BLOOM Assembly Third Reading",53,23,4,0,80
967677,672294,2017-07-12,Senate,"Do pass, but first be re-referred to the Committee on [Transportation and Housing]",5,1,1,0,7
967677,672812,2017-07-18,Senate,"Do pass as amended",9,3,1,0,13
967677,675929,2017-09-13,Senate,"Assembly 3rd Reading AB1568 Bloom By McGuire",29,11,0,0,40
967677,676562,2017-09-15,Assembly,"AB 1568 BLOOM Concurrence in Senate Amendments",54,24,1,0,79
967680,629240,2017-04-19,Assembly,"Do pass and be re-referred to the Committee on [Appropriations]",5,2,0,0,7
967680,642778,2017-05-10,Assembly,"Do pass",11,6,0,0,17
967680,654516,2017-05-30,Assembly,"AB 1565 THURMOND Assembly Third Reading",43,27,10,0,80
967680,669632,2017-06-28,Senate,"Do pass, but first be re-referred to the Committee on [Appropriations]",3,1,1,0,5
967680,762813,2018-06-13,Senate,"Do pass, but first be re-referred to the Committee on [Judiciary] with the recommendation: To Consent Calendar",5,0,0,0,5
967680,769696,2018-07-03,Senate,"Do pass and be ordered to the Consent Calendar",7,0,0,0,7
967680,771310,2018-08-13,Senate,"Consent Calendar AB1565 Thurmond Urgency Clause",37,0,3,0,40
967680,772425,2018-08-22,Assembly,"With recommendation: That Senate amendments be concurred in",7,0,0,0,7
967680,772891,2018-08-27,Assembly,"AB 1565 THURMOND Concurrence - Urgency Added",79,0,1,0,80
967683,628984,2017-04-19,Assembly,"Do pass and be re-referred to the Committee on [Appropriations]",7,0,0,0,7
967684,620139,2017-04-04,Assembly,"Do pass as amended and be re-referred to the Committee on [Appropriations]",7,0,0,0,7
967684,651975,2017-05-26,Assembly,"Do pass",15,0,2,0,17
967684,655996,2017-05-31,Assembly,"AB 1607 FRAZIER Assembly Third Reading",75,0,5,0,80
967684,672394,2017-07-11,Senate,"Do pass, but first be re-referred to the Committee on [Appropriations] with the recommendation: To Consent Calendar",7,0,0,0,7
967684,673933,2017-08-21,Senate,"Placed on suspense file",7,0,0,0,7
967684,674766,2017-09-01,Senate,"Do pass",7,0,0,0,7
967684,676041,2017-09-14,Senate,"Special Consent Calendar # AB1607",40,0,0,0,40
967684,676491,2017-09-15,Assembly,"AB 1607 FRAZIER Concurrence in Senate Amendments",78,0,1,0,79
967685,683938,2018-01-03,Assembly,"Be re-referred to the Committee on [Judiciary]",10,0,1,0,11
967685,684754,2018-01-09,Assembly,"Do pass as amended, and be re-referred to the Committee on [Appropriations] with recommendation: To Consent Calendar",10,0,0,0,10
967685,686272,2018-01-18,Assembly,"Do pass. To Consent Calendar",17,0,0,0,17
967685,690100,2018-01-29,Assembly,"AB 1531 BERMAN Consent Calendar Second Day Regular Session",75,0,2,0,77
967685,768826,2018-06-26,Senate,"Do pass as amended, but first amend, and re-refer to the Committee on [Appropriations] with the recommendation: To Consent Calendar",7,0,0,0,7
967685,771303,2018-08-13,Senate,"Consent Calendar AB1531",37,0,3,0,40
967685,772204,2018-08-20,Assembly,"AB 1531 BERMAN Concurrence in Senate Amendments",80,0,0,0,80
967687,633329,2017-04-26,Assembly,"Do pass and be re-referred to the Committee on [Appropriations] with recommendation: To Consent Calendar",7,0,0,0,7
967691,629162,2017-04-19,Assembly,"Do pass and be re-referred to the Committee on [Appropriations]",6,1,0,0,7
967691,638437,2017-05-04,Assembly,"AB 1556 STONE Assembly Third Reading",62,5,13,0,80
967691,662287,2017-06-13,Senate,"Do pass as amended",7,0,0,0,7
967691,674273,2017-08-31,Senate,"Assembly 3rd Reading AB1556 Mark Stone By Atkins",37,1,2,0,40
967691,674949,2017-09-05,Assembly,"AB 1556 STONE Concurrence in Senate Amendments",63,7,9,0,79
967692,627978,2017-04-19,Assembly,"Do pass and be re-referred to the Committee on [Appropriations]",13,0,0,0,13
967693,631445,2017-04-25,Assembly,"Do pass and be re-referred to the Committee on [Appropriations]",9,6,0,0,15
967694,621225,2017-04-05,Assembly,"Do pass",9,0,0,0,9
967694,629141,2017-04-20,Assembly,"AB 1625 RUBIO Assembly Third Reading",76,0,4,0,80
967694,672023,2017-07-11,Senate,"Do pass",10,0,3,0,13
967694,674354,2017-08-31,Senate,"Special Consent Calendar # AB1625",37,0,3,0,40
967694,674852,2017-09-05,Assembly,"AB 1625 RUBIO Concurrence in Senate Amendments",77,0,2,0,79
967694,777578,2017-08-31,Senate,"Special Consent Calendar # A",10,0,3,0,13
967697,631939,2017-04-25,Assembly,"Do pass and be re-referred to the Committee on [Appropriations]",2,5,0,0,7
967698,627072,2017-04-17,Assembly,"Do pass and be re-referred to the Committee on [Appropriations]",7,3,0,0,10
967698,652166,2017-05-26,Assembly,"Do pass",12,5,0,0,17
967698,655944,2017-05-31,Assembly,"AB 1593 RIDLEY-THOMAS Assembly Third Reading",53,23,4,0,80
967698,670120,2017-06-28,Senate,"Do pass, but first be re-referred to the Committee on [Appropriations]",6,1,0,0,7
967698,675105,2017-09-06,Senate,"Assembly 3rd Reading AB1593 Ridley-Thomas By Allen",28,12,0,0,40
967699,620778,2017-04-04,Assembly,"Do pass and be re-referred to the Committee on [Appropriations]",6,0,1,0,7
967699,651976,2017-05-26,Assembly,"Do pass as amended",16,0,1,0,17
967699,656868,2017-06-01,Assembly,"AB 1649 MURATSUCHI Assembly Third Reading",76,0,4,0,80
967699,667215,2017-06-21,Senate,"Do pass, but first be re-referred to the Committee on [Appropriations]",6,0,1,0,7
967699,671927,2017-07-10,Senate,"Placed on suspense file",7,0,0,0,7
967699,674805,2017-09-01,Senate,"Do pass as amended",7,0,0,0,7
967699,675035,2017-09-06,Senate,"Assembly 3rd Reading AB1649 Muratsuchi et al. By Skinner",39,0,1,0,40
967699,675331,2017-09-11,Assembly,"AB 1649 MURATSUCHI Concurrence in Senate Amendments",79,0,0,0,79
967701,631921,2017-04-24,Assembly,"Do pass as amended and be re-referred to the Committee on [Appropriations]",9,1,0,0,10
967703,634678,2017-04-26,Assembly,"Do pass as amended and be re-referred to the Committee on [Appropriations]",7,0,0,0,7
967704,636441,2017-05-02,Assembly,"Do pass as amended",7,2,2,0,11
967704,685051,2018-01-11,Assembly,"Do pass and be re-referred to the Committee on [Appropriations]",7,0,0,0,7
967705,633248,2017-04-25,Assembly,"Do pass and be re-referred to the Committee on [Appropriations]",9,1,3,0,13
967705,651844,2017-05-26,Assembly,"Do pass as amended",12,4,1,0,17
967705,656839,2017-06-01,Assembly,"AB 1619 BERMAN Assembly Third Reading",57,15,8,0,80
967705,669713,2017-06-28,Senate,"Do pass, but first be re-referred to the Committee on [Business, Professions and Economic Development]",3,2,2,0,7
967705,669714,2017-06-28,Senate,"[First] hearing set for [06-28-2017]: Failed passage in Committee. Reconsideration granted",7,0,0,0,7
967705,768725,2018-06-26,Senate,"Do pass, but first be re-referred to the Committee on [Appropriations]",7,0,0,0,7
967705,770347,2018-08-06,Senate,"Placed on suspense file",7,0,0,0,7
967705,771784,2018-08-16,Senate,"Do pass as amended",6,0,1,0,7
967705,772455,2018-08-22,Senate,"Assembly 3rd Reading AB1619 Berman et al. By Leyva",39,0,1,0,40
967705,773056,2018-08-28,Assembly,"With recommendation: That Senate amendments be concurred in",9,0,0,0,9
967705,773297,2018-08-29,Assembly,"AB 1619 BERMAN Concurrence in Senate Amendments",78,0,2,0,80
967706,619976,2017-04-04,Assembly,"Do pass as amended and be re-referred to the Committee on [Appropriations]",6,0,1,0,7
967708,627817,2017-04-18,Assembly,"Do pass as amended and be re-referred to the Committee on [Appropriations]",12,0,1,0,13
967708,651734,2017-05-26,Assembly,"Do pass",17,0,0,0,17
967708,655978,2017-05-31,Assembly,"AB 1674 GRAYSON Assembly Third Reading",77,0,3,0,80
967708,671376,2017-07-05,Senate,"Do pass, but first be re-referred to the Committee on [Appropriations]",6,0,1,0,7
967708,674425,2017-08-31,Senate,"Assembly 3rd Reading AB1674 Grayson et al. By Galgiani",39,0,1,0,40
967711,637583,2017-05-03,Assembly,"Do pass",8,0,1,0,9
967711,651795,2017-05-26,Assembly,"AB 1538 BONTA Assembly Third Reading",65,5,10,0,80
967711,672892,2017-07-19,Senate,"Do pass",5,1,1,0,7
967711,674432,2017-08-31,Senate,"Assembly 3rd Reading AB1538 Bonta By Skinner Urgency Clause",33,5,2,0,40
967711,674895,2017-09-05,Assembly,"AB 1538 BONTA Concurrence - Urgency Added",62,10,7,0,79
967713,684747,2018-01-09,Assembly,"Do pass and be re-referred to the Committee on [Appropriations]",15,0,1,0,16
967713,686182,2018-01-18,Assembly,"Do pass. To Consent Calendar",17,0,0,0,17
967713,689895,2018-01-29,Assembly,"AB 1659 LOW Consent Calendar Second Day Regular Session",75,0,2,0,77
967713,761756,2018-06-11,Senate,"Do pass, but first be re-referred to the Committee on [Appropriations] with the recommendation: To Consent Calendar",8,0,1,0,9
967713,772452,2018-08-22,Senate,"Assembly 3rd Reading AB1659 Low By Nguyen",38,0,2,0,40
967714,633600,2017-04-26,Assembly,"Do pass as amended, and be re-referred to the Committee on [Appropriations] with recommendation: To Consent Calendar",7,0,0,0,7
967714,642787,2017-05-10,Assembly,"Do pass. To Consent Calendar",17,0,0,0,17
967714,646434,2017-05-18,Assembly,"AB 1620 DABABNEH Consent Calendar Second Day Regular Session",69,0,11,0,80
967714,666417,2017-06-20,Senate,"Do pass, but first be re-referred to the Committee on [Appropriations]",5,0,0,0,5
967714,675115,2017-09-07,Senate,"Assembly 3rd Reading AB1620 Dababneh et al. By Morrell",40,0,0,0,40
967714,675479,2017-09-11,Assembly,"AB 1620 DABABNEH Concurrence in Senate Amendments",78,0,1,0,79
967715,633571,2017-04-26,Assembly,"Do pass and be re-referred to the Committee on [Appropriations]",7,0,0,0,7
967715,651704,2017-05-26,Assembly,"Do pass",17,0,0,0,17
967715,654188,2017-05-30,Assembly,"AB 1664 BOCANEGRA Assembly Third Reading",73,0,7,0,80
967715,777944,2017-05-26,Assembly,,7,0,0,0,7
967716,630537,2017-04-24,Assembly,"Do pass and be re-referred to the Committee on [Appropriations]",10,0,1,0,11
967716,651940,2017-05-26,Assembly,"Do pass as amended",16,0,1,0,17
967716,655822,2017-05-31,Assembly,"AB 1553 GOMEZ Assembly Third Reading",76,0,4,0,80
967716,670987,2017-07-03,Senate,"Do pass, but first be re-referred to the Committee on [Appropriations] with the recommendation: To Consent Calendar",6,0,3,0,9
967716,672799,2017-07-17,Senate,"Placed on suspense file",7,0,0,0,7
967716,674723,2017-09-01,Senate,"Do pass",7,0,0,0,7
967716,675379,2017-09-11,Senate,"Assembly 3rd Reading AB1553 Cervantes et al. By Mitchell",40,0,0,0,40
967716,675861,2017-09-13,Assembly,"AB 1553 CERVANTES Concurrence in Senate Amendments",79,0,0,0,79
967718,627852,2017-04-19,Assembly,"Do pass and be re-referred to the Committee on [Local Government]",4,2,1,0,7
967719,636643,2017-05-02,Assembly,"Do pass as amended",14,0,2,0,16
967719,646488,2017-05-18,Assembly,"AB 1616 NAZARIAN Assembly Third Reading",71,0,9,0,80
967719,671342,2017-07-05,Senate,"Do pass and be ordered to the Consent Calendar",7,0,0,0,7
967719,672630,2017-07-13,Senate,"Consent Calendar 2nd AB1616 Nazarian",39,0,1,0,40
967719,672786,2017-07-17,Assembly,"AB 1616 NAZARIAN Concurrence in Senate Amendments",78,0,1,0,79
967721,626816,2017-04-17,Assembly,"Do pass and be re-referred to the Committee on [Appropriations]",8,2,0,0,10
967721,637580,2017-05-03,Assembly,"Do pass",11,5,1,0,17
967721,654207,2017-05-30,Assembly,"AB 1647 MURATSUCHI Assembly Third Reading",56,18,6,0,80
967721,667216,2017-06-21,Senate,"Do pass as amended, but first amend, and re-refer to the Committee on [Appropriations]",5,1,1,0,7
967721,675423,2017-09-11,Senate,"Assembly 3rd Reading AB1647 Muratsuchi et al. By Wieckowski",28,11,1,0,40
967721,675820,2017-09-13,Assembly,"AB 1647 MURATSUCHI Concurrence in Senate Amendments",57,19,3,0,79
969646,608348,2017-03-21,Senate,"Be adopted. Ordered to third reading",7,0,0,0,7
969646,621077,2017-04-06,Senate,"Senate 3rd Reading SJR5 Stone et al",34,2,4,0,40
969646,672095,2017-07-11,Assembly,"Be adopted. To third reading",7,0,0,0,7
969646,676351,2017-09-14,Assembly,"SJR 5 Stone Senate Third Reading By CUNNINGHAM",60,10,9,0,79
969656,591823,2017-02-23,Assembly,"HR 20 MEDINA Assembly Third Reading",58,7,15,0,80
969667,596775,2017-03-02,Assembly,"Be adopted. To third reading",11,0,0,0,11
969667,607038,2017-03-20,Senate,"Assembly 3rd Reading ACR27 McCarty et al. By Hernandez",39,0,1,0,40
972955,597997,2017-03-06,Senate,"Senate 3rd Reading SR20 Glazer et al",38,0,2,0,40
972962,627761,2017-04-18,Assembly,"Do pass as amended, and be re-referred to the Committee on [Appropriations] with recommendation: To Consent Calendar",15,0,0,0,15
972962,633608,2017-04-18,Assembly,"Do pass and be re-referred to the Committee on [Appropriations] with recommendation: To Consent Calendar",15,0,0,0,15
972962,637566,2017-05-03,Assembly,"Do pass. To Consent Calendar",16,0,1,0,17
972962,643689,2017-05-11,Assembly,"AB 1688 HEALTH Consent Calendar Second Day Regular Session",77,0,3,0,80
972962,672660,2017-07-12,Senate,"Do pass as amended, but first amend, and re-refer to the Committee on [Appropriations]",8,0,1,0,9
972962,675708,2017-09-12,Senate,"Assembly 3rd Reading AB1688 HEALTH (Wood) By Hernandez",39,0,1,0,40
972962,675959,2017-09-13,Assembly,"AB 1688 Health Concurrence in Senate Amendments",79,0,0,0,79
975314,596721,2017-03-02,Senate,"Senate 3rd Reading SCR27 Gaines",36,0,4,0,40
975314,674063,2017-08-24,Assembly,"Be adopted. To Consent Calendar",9,0,2,0,11
975314,674335,2017-08-31,Assembly,"SCR 27 Gaines Consent Calendar Second Day Regular Session",73,0,6,0,79
975318,672015,2017-07-10,Assembly,"Be adopted. To Consent Calendar",7,0,4,0,11
975318,672756,2017-07-17,Assembly,"AJR 5 MEDINA Assembly Third Reading",69,0,10,0,79
975318,674253,2017-08-30,Senate,"Be adopted. Ordered to third reading",9,0,4,0,13
975318,675659,2017-09-12,Senate,"Assembly 3rd Reading AJR5 Medina et al. By Mendoza",40,0,0,0,40
975318,676336,2017-09-14,Assembly,"AJR 5 MEDINA Concurrence in Senate Amendments",74,0,5,0,79
975318,774561,2017-09-12,Senate,,9,0,0,0,9
975321,619723,2017-04-04,Assembly,"Do pass and be re-referred to the Committee on [Appropriations] with recommendation: To Consent Calendar",7,0,0,0,7
975321,637400,2017-05-03,Assembly,"Do pass. To Consent Calendar",16,0,1,0,17
975321,643502,2017-05-11,Assembly,"AB 1689 E.S. & T.M. Consent Calendar Second Day Regular Session",77,0,3,0,80
975321,667140,2017-06-21,Senate,"Do pass, but first be re-referred to the Committee on [Appropriations] with the recommendation: To Consent Calendar",6,0,1,0,7
975321,672550,2017-07-13,Senate,"Consent Calendar 2nd AB1689 E.S. & T.M",39,0,1,0,40
975321,672721,2017-07-17,Assembly,"AB 1689 E.S. & T.M. Concurrence in Senate Amendments By QUIRK",77,0,2,0,79
975324,598096,2017-03-06,Senate,"Senate 3rd Reading SCR28 Stone",38,0,2,0,40
975324,607158,2017-03-20,Assembly,"Be adopted. To Consent Calendar",11,0,0,0,11
975324,611050,2017-03-23,Assembly,"SCR 28 Stone Consent Calendar Second Day Regular Session",76,0,4,0,80
975327,612668,2017-03-27,Assembly,"Be adopted. To third reading",11,0,0,0,11
977643,600640,2017-03-09,Assembly,"Be adopted. To third reading",11,0,0,0,11
977643,615893,2017-03-30,Senate,"Special Consent Calendar # ACR28",37,0,3,0,40
977645,615521,2017-03-29,Assembly,"Do pass. To Consent Calendar",12,0,1,0,13
977645,637578,2017-05-03,Assembly,"Do pass. To Consent Calendar",13,0,0,0,13
977645,643572,2017-05-11,Assembly,"AB 1698 INS. Consent Calendar Second Day Regular Session",77,0,3,0,80
977645,672433,2017-07-12,Senate,"Do pass and be ordered to the Consent Calendar",10,0,3,0,13
977645,769547,2018-07-02,Senate,"Do pass",7,0,0,0,7
977645,770534,2018-08-06,Senate,"Assembly 3rd Reading AB1698 Daly By Glazer",37,0,2,0,39
977646,614870,2017-03-29,Assembly,"Do pass and be re-referred to the Committee on [Appropriations]",10,0,3,0,13
977646,627840,2017-04-19,Assembly,"Do pass and be re-referred to the Committee on [Appropriations]",11,0,2,0,13
977646,649344,2017-05-24,Assembly,"Do pass as amended",17,0,0,0,17
977646,656871,2017-06-01,Assembly,"AB 1699 INS. Assembly Third Reading By DALY",75,1,4,0,80
977646,672389,2017-07-12,Senate,"Do pass, but first be re-referred to the Committee on [Appropriations]",9,0,4,0,13
977646,675681,2017-09-12,Senate,"Assembly 3rd Reading AB1699 INS. (Daly) By Mendoza",38,2,0,0,40
977646,675812,2017-09-13,Assembly,"AB 1699 Insurance Concurrence in Senate Amendments",75,1,3,0,79
977649,618929,2017-04-04,Assembly,"Do pass. To Consent Calendar",11,0,0,0,11
977649,626335,2017-04-17,Assembly,"AB 1691 JUD. Consent Calendar Second Day Regular Session",76,0,4,0,80
977649,662417,2017-06-13,Senate,"Do pass and be ordered to the Consent Calendar",7,0,0,0,7
977649,665386,2017-06-19,Senate,"Consent Calendar 2nd AB1691 JUD",33,0,7,0,40
977650,614771,2017-03-29,Assembly,"Do pass and be re-referred to the Committee on [Appropriations] with recommendation: To Consent Calendar",12,0,1,0,13
977650,620124,2017-04-05,Assembly,"Do pass. To Consent Calendar",17,0,0,0,17
977650,627982,2017-04-19,Assembly,"Do pass",13,0,0,0,13
977650,630511,2017-04-24,Assembly,"AB 1695 INS. Assembly Third Reading By DALY",77,0,3,0,80
977650,663798,2017-06-14,Senate,"Do pass, but first be re-referred to the Committee on [Appropriations] with the recommendation: To Consent Calendar",5,0,0,0,5
977650,670993,2017-07-03,Senate,"Consent Calendar 2nd AB1695 INS",33,0,7,0,40
977652,618546,2017-04-04,Assembly,"Do pass as amended",10,0,1,0,11
977652,629118,2017-04-20,Assembly,"AB 1690 JUD. Assembly Third Reading By STONE",65,0,15,0,80
977652,662391,2017-06-13,Senate,"Do pass",7,0,0,0,7
977652,671975,2017-07-10,Senate,"Assembly 3rd Reading AB1690 JUD. (Stone) By Leyva",39,0,1,0,40
977652,672736,2017-07-17,Assembly,"AB 1690 JUD. Concurrence in Senate Amendments By STONE",64,0,15,0,79
977654,618576,2017-04-04,Assembly,"Do pass as amended, and be re-referred to the Committee on [Appropriations] with recommendation: To Consent Calendar",11,0,0,0,11
977654,651721,2017-05-26,Assembly,"Do pass",17,0,0,0,17
977654,654519,2017-05-30,Assembly,"AB 1692 JUD. Assembly Third Reading By STONE",77,0,3,0,80
977654,666197,2017-06-20,Senate,"Do pass as amended, but first amend, and re-refer to the Committee on [Appropriations] with the recommendation: To Consent Calendar",7,0,0,0,7
977654,672712,2017-07-17,Senate,"Placed on suspense file",7,0,0,0,7
977654,674450,2017-09-01,Senate,"Do pass as amended",7,0,0,0,7
977654,675033,2017-09-06,Senate,"Assembly 3rd Reading AB1692 JUD. (Stone) By Wieckowski",40,0,0,0,40
977654,675294,2017-09-11,Assembly,"AB 1692 JUD. Concurrence in Senate Amendments By STONE",79,0,0,0,79
977656,614782,2017-03-29,Assembly,"Do pass",12,0,1,0,13
977656,637607,2017-05-03,Assembly,"Do pass. To Consent Calendar",13,0,0,0,13
977656,643664,2017-05-11,Assembly,"AB 1696 INS. Consent Calendar Second Day Regular Session",77,0,3,0,80
977656,672450,2017-07-12,Senate,"Do pass as amended, and be ordered to the Consent Calendar",10,0,3,0,13
977656,675709,2017-09-12,Senate,"Assembly 3rd Reading AB1696 INS. (Daly) By Mendoza",40,0,0,0,40
977656,675853,2017-09-13,Assembly,"AB 1696 Insurance Concurrence in Senate Amendments",78,0,1,0,79
977657,618596,2017-04-04,Assembly,"Do pass",11,0,0,0,11
977657,621195,2017-04-06,Assembly,"AB 1694 JUD. Assembly Third Reading By STONE",68,0,12,0,80
977657,662413,2017-06-13,Senate,"Do pass and be ordered to the Consent Calendar",7,0,0,0,7
977657,665038,2017-06-19,Senate,"Consent Calendar 2nd AB1694 JUD",33,0,7,0,40
977657,700781,2018-02-13,Senate,"Do pass, but first be re-referred to the Committee on [Appropriations]",6,0,1,0,7
977657,719924,2018-03-08,Senate,"Assembly 3rd Reading AB1694 Mark Stone By Mitchell Urgency Clause",34,0,5,0,39
977657,725618,2018-03-20,Assembly,"With recommendation: That Senate amendments be concurred in",7,0,0,0,7
977657,727668,2018-03-22,Assembly,"AB 1694 STONE Concurrence - Urgency Added",68,0,9,0,77
977660,607280,2017-03-20,Assembly,"Be adopted. To Consent Calendar",14,0,0,0,14
977660,611036,2017-03-23,Assembly,"ACR 29 DAHLE Consent Calendar Second Day Regular Session",76,0,4,0,80
977660,672226,2017-07-11,Senate,"Be adopted, but first be re-referred to the Committee on [Appropriations] with recommendation: To Consent Calendar",11,0,2,0,13
977660,674127,2017-08-24,Senate,"Consent Calendar 2nd ACR29",38,0,2,0,40
977664,618608,2017-04-04,Assembly,"Do pass. To Consent Calendar",11,0,0,0,11
977664,626443,2017-04-17,Assembly,"AB 1693 JUD. Consent Calendar Second Day Regular Session",76,0,4,0,80
977664,666306,2017-06-20,Senate,"Do pass and be ordered to the Consent Calendar",7,0,0,0,7
977664,671009,2017-07-03,Senate,"Consent Calendar 2nd AB1693 JUD",33,0,7,0,40
977664,671959,2017-07-10,Assembly,"AB 1693 JUD. Concurrence in Senate Amendments By STONE",77,0,3,0,80
977666,628057,2017-04-19,Assembly,"Do pass and be re-referred to the Committee on [Appropriations] with recommendation: To Consent Calendar",13,0,0,0,13
977666,649670,2017-05-24,Assembly,"Do pass. To Consent Calendar",17,0,0,0,17
977666,654112,2017-05-30,Assembly,"AB 1697 INS. Consent Calendar Second Day Regular Session",77,0,3,0,80
977666,768756,2018-06-27,Senate,"Do pass, but first be re-referred to the Committee on [Appropriations] with the recommendation: To Consent Calendar",5,0,0,0,5
977666,771264,2018-08-13,Senate,"Consent Calendar AB1697 INS",37,0,3,0,40
977666,773021,2018-08-27,Senate,"Assembly 3rd Reading AB1697 INS. (Daly) By Pan",39,0,1,0,40
977666,773528,2018-08-29,Assembly,"AB 1697 INS. Concurrence in Senate Amendments By DALY",80,0,0,0,80
978885,596766,2017-03-02,Senate,"Senate 3rd Reading SCR29 Beall",36,0,4,0,40
978885,605274,2017-03-16,Assembly,"Be adopted. To third reading",9,0,2,0,11
978889,637451,2017-05-03,Assembly,"Do pass",6,1,0,0,7
978889,643386,2017-05-11,Assembly,"AB 1701 THURMOND Assembly Third Reading",52,19,9,0,80
978889,669931,2017-06-28,Senate,"Do pass, but first be re-referred to the Committee on [Judiciary]",3,1,1,0,5
978889,672841,2017-07-18,Senate,"Do pass as amended, but first amend, and re-refer to the Committee on [Rules]",4,2,1,0,7
978889,675095,2017-09-06,Senate,"Assembly 3rd Reading AB1701 Thurmond et al. By Bradford",25,12,3,0,40
978889,675909,2017-09-13,Assembly,"AB 1701 THURMOND Concurrence in Senate Amendments",62,15,2,0,79
978890,598225,2017-03-06,Assembly,"Be adopted. To third reading",11,0,0,0,11
978890,605286,2017-03-16,Senate,"Assembly 3rd Reading ACR30 Limón et al. By Atkins",39,0,1,0,40
978893,629104,2017-04-20,Assembly,"Be re-referred to the Committees on [Business and Professions] and [Labor and Employment]",9,0,2,0,11
978893,631566,2017-04-25,Assembly,"Do pass and be re-referred to the Committee on [Labor and Employment]",12,4,0,0,16
978893,634712,2017-04-27,Assembly,"Do pass and be re-referred to the Committee on [Appropriations]",6,1,0,0,7
978893,643200,2017-05-10,Assembly,"Do pass",12,5,0,0,17
978893,647975,2017-05-22,Assembly,"AB 1700 COOPER Assembly Third Reading",56,21,3,0,80
978893,669171,2017-06-26,Senate,"Do pass, but first be re-referred to the Committee on [Appropriations]",8,1,0,0,9
978893,673959,2017-08-21,Senate,"Placed on suspense file",7,0,0,0,7
978893,777738,2017-04-27,Assembly,,12,4,0,0,16
982040,631890,2017-04-25,Assembly,"Do pass as amended, and be re-referred to the Committee on [Appropriations] with recommendation: To Consent Calendar",15,0,1,0,16
982040,651952,2017-05-26,Assembly,"Do pass",17,0,0,0,17
982040,654418,2017-05-30,Assembly,"AB 1706 B. & P. Assembly Third Reading By LOW",75,0,5,0,80
982040,671906,2017-07-10,Senate,"Do pass, but first be re-referred to the Committee on [Appropriations]",9,0,0,0,9
982040,673968,2017-08-21,Senate,"Placed on suspense file",7,0,0,0,7
982040,674773,2017-09-01,Senate,"Do pass as amended",7,0,0,0,7
982040,675387,2017-09-11,Senate,"Assembly 3rd Reading AB1706 B. & P. (Low) By Hill",39,0,1,0,40
982040,676102,2017-09-14,Assembly,"Do pass",15,0,1,0,16
982040,676422,2017-09-14,Assembly,"With recommendation: That Senate amendments be concurred in",15,0,1,0,16
982040,676599,2017-09-15,Assembly,"AB 1706 Business and Professions Concurrence in Senate Amendments",77,0,2,0,79
982043,665396,2017-06-19,Assembly,"Be adopted. To third reading",9,0,2,0,11
982048,632630,2017-04-25,Assembly,"Do pass as amended and be re-referred to the Committee on [Appropriations]",14,0,2,0,16
982048,651923,2017-05-26,Assembly,"Do pass as amended",13,0,4,0,17
982048,656897,2017-06-01,Assembly,"AB 1705 B. & P. Assembly Third Reading By LOW",77,1,2,0,80
982048,671919,2017-07-10,Senate,"Do pass as amended, but first amend, and re-refer to the Committee on [Appropriations]",9,0,0,0,9
982048,675897,2017-09-13,Senate,"Assembly 3rd Reading AB1705 Low By Hill",40,0,0,0,40
982048,676135,2017-09-14,Assembly,"Do pass",15,0,1,0,16
982048,676423,2017-09-14,Assembly,"With recommendation: That Senate amendments be concurred in",15,0,1,0,16
982048,676610,2017-09-15,Assembly,"AB 1705 Low Concurrence in Senate Amendments",77,0,2,0,79
982053,613603,2017-03-28,Assembly,"Be adopted as amended, and re-refer to the Committee on [Appropriations]",9,1,1,0,11
982053,652000,2017-05-26,Assembly,"Be adopted. To third reading",12,0,5,0,17
982053,654515,2017-05-30,Assembly,"AJR 6 GLORIA Assembly Third Reading",56,8,16,0,80
982053,672070,2017-07-11,Senate,"Be adopted, but first be re-referred to the Committee on [Appropriations]",9,3,1,0,13
982053,673846,2017-08-21,Senate,"Placed on suspense file",7,0,0,0,7
982053,674811,2017-09-01,Senate,"Be adopted. Ordered to third reading",5,2,0,0,7
982053,674888,2017-09-05,Senate,"Assembly 3rd Reading AJR6 Gloria et al. By Leyva",28,12,0,0,40
982062,600691,2017-03-09,Assembly,"Be adopted. To third reading",11,0,0,0,11
982067,605208,2017-03-16,Senate,"Senate 3rd Reading SCR30 Pan",38,0,2,0,40
982067,667643,2017-06-21,Assembly,"Be adopted. To Consent Calendar",6,0,1,0,7
982067,670299,2017-06-29,Assembly,"SCR 30 Pan Consent Calendar Second Day Regular Session",74,0,6,0,80
982072,632500,2017-04-25,Assembly,"Do pass and be re-referred to the Committee on [Appropriations] with recommendation: To Consent Calendar",15,0,1,0,16
982072,652180,2017-05-26,Assembly,"Do pass",17,0,0,0,17
982072,654422,2017-05-30,Assembly,"AB 1708 B. & P. Assembly Third Reading By LOW",77,0,3,0,80
982072,671930,2017-07-10,Senate,"Do pass, but first be re-referred to the Committee on [Appropriations]",9,0,0,0,9
982072,673990,2017-08-21,Senate,"Placed on suspense file",7,0,0,0,7
982072,674776,2017-09-01,Senate,"Do pass as amended",7,0,0,0,7
982072,675868,2017-09-13,Senate,"Assembly 3rd Reading AB1708 Low By Hill",38,2,0,0,40
982072,676097,2017-09-14,Assembly,"Do pass",15,0,1,0,16
982072,676419,2017-09-14,Assembly,"With recommendation: That Senate amendments be concurred in",15,0,1,0,16
982072,676595,2017-09-15,Assembly,"AB 1708 Low Concurrence in Senate Amendments",75,1,3,0,79
982077,631665,2017-04-25,Assembly,"Do pass and be re-referred to the Committee on [Appropriations] with recommendation: To Consent Calendar",15,0,1,0,16
982077,652128,2017-05-26,Assembly,"Do pass",17,0,0,0,17
982077,654131,2017-05-30,Assembly,"AB 1707 B. & P. Assembly Third Reading By LOW",76,0,4,0,80
982077,672005,2017-07-10,Senate,"Do pass, but first be re-referred to the Committee on [Appropriations]",9,0,0,0,9
982077,672991,2017-07-20,Senate,"Assembly 3rd Reading AB1707 Low By Pan Urgency Clause",38,0,2,0,40
982077,672992,2017-07-20,Assembly,"AB 1707 LOW Concurrence - Urgency Added By BROUGH",68,0,11,0,79
984772,598651,2017-03-06,Senate,"W/O REF. TO FILE SR22 De León",29,9,2,0,40
984775,658099,2017-06-05,Senate,"Senate 3rd Reading SCR31 Pan",39,0,1,0,40
984775,664228,2017-06-15,Assembly,"Be adopted. To Consent Calendar",10,0,1,0,11
984775,667873,2017-06-22,Assembly,"SCR 31 Pan Consent Calendar Second Day Regular Session",74,0,6,0,80
984789,642438,2017-05-10,Assembly,"Be adopted and re-referred to the Committee on [Appropriations]",4,2,1,0,7
984789,651802,2017-05-26,Assembly,"Be adopted",12,5,0,0,17
984789,675623,2017-09-12,Assembly,"ACA 10 LOW Assembly Third Reading",46,24,9,0,79
984802,607431,2017-03-20,Assembly,"Be adopted. To third reading",11,0,0,0,11
984815,603265,2017-03-14,Senate,"Be adopted. Ordered to third reading",4,1,2,0,7
984815,611120,2017-03-23,Senate,"Senate 3rd Reading SR23 Wiener et al",24,10,6,0,40
984829,634191,2017-04-25,Assembly,"Do pass and be re-referred to the Committee on [Appropriations]",9,0,1,0,10
984829,649287,2017-05-24,Assembly,"Do pass. To Consent Calendar",17,0,0,0,17
984829,654466,2017-05-30,Assembly,"AB 1709 V. A. Consent Calendar Second Day Regular Session",77,0,3,0,80
984829,669276,2017-06-27,Senate,"Do pass, but first be re-referred to the Committee on [Veterans Affairs] with the recommendation: To Consent Calendar",13,0,0,0,13
984829,672265,2017-07-11,Senate,"Do pass as amended, but first amend, and re-refer to the Committee on [Appropriations] with the recommendation: To Consent Calendar",6,0,1,0,7
984829,672512,2017-07-11,Senate,"Do pass, but first be re-referred to the Committee on [Appropriations]",6,0,1,0,7
984829,675099,2017-09-06,Senate,"Assembly 3rd Reading AB1709 V.A. (Irwin) By Newman",40,0,0,0,40
984844,626894,2017-04-18,Assembly,"Do pass and be re-referred to the Committee on [Veterans Affairs]",11,0,0,0,11
984844,633637,2017-04-25,Assembly,"Do pass and be re-referred to the Committee on [Appropriations]",9,0,1,0,10
984844,642501,2017-05-10,Assembly,"Do pass. To Consent Calendar",17,0,0,0,17
984844,646582,2017-05-18,Assembly,"AB 1710 V. A. Consent Calendar Second Day Regular Session",69,0,11,0,80
984844,662455,2017-06-13,Senate,"Do pass, but first be re-referred to the Committee on [Judiciary]",7,0,0,0,7
984844,672329,2017-07-11,Senate,"Do pass, but first be re-referred to the Committee on [Appropriations] with the recommendation: To Consent Calendar",7,0,0,0,7
984844,674065,2017-08-24,Senate,"Consent Calendar 2nd AB1710 V.A",38,0,2,0,40
984844,675725,2017-09-12,Senate,"Assembly 3rd Reading AB1710 V.A. (Irwin) By Newman",40,0,0,0,40
984844,676308,2017-09-14,Assembly,"AB 1710 V. A. Concurrence in Senate Amendments",79,0,0,0,79
984857,633854,2017-04-25,Assembly,"Do pass and be re-referred to the Committee on [Appropriations]",9,0,1,0,10
984857,642705,2017-05-10,Assembly,"Do pass. To Consent Calendar",17,0,0,0,17
984857,646590,2017-05-18,Assembly,"AB 1711 V. A. Consent Calendar Second Day Regular Session",69,0,11,0,80
984857,662503,2017-06-13,Senate,"Do pass, but first be re-referred to the Committee on [Appropriations] with the recommendation: To Consent Calendar",7,0,0,0,7
984857,671010,2017-07-03,Senate,"Consent Calendar 2nd AB1711 V.A",33,0,7,0,40
984872,612745,2017-03-27,Senate,"Be adopted, but first be re-referred to the Committee on [Appropriations]",4,1,0,0,5
984872,630447,2017-04-24,Senate,"Senate 3rd Reading SCR32 Pan",37,0,3,0,40
984872,671664,2017-07-06,Assembly,"Be adopted, and re-refer to the Committee on [Appropriations] with recommendation: To Consent Calendar",7,0,0,0,7
984872,672936,2017-07-19,Assembly,"Be adopted. To Consent Calendar",16,0,1,0,17
984872,673852,2017-08-21,Assembly,"SCR 32 Pan Consent Calendar Second Day",77,0,2,0,79
986030,602490,2017-03-13,Senate,"Be adopted. Ordered to third reading",7,1,1,0,9
986030,602491,2017-03-13,Senate,"Senate 3rd Reading SR26 Hernandez et al",25,9,6,0,40
986040,613014,2017-03-27,Senate,"Senate 3rd Reading SCR34 Allen et al",39,0,1,0,40
986040,671045,2017-07-03,Assembly,"Be adopted. To Consent Calendar",11,0,0,0,11
986040,671558,2017-07-06,Assembly,"SCR 34 Allen Consent Calendar Second Day Regular Session",74,0,6,0,80
986050,605344,2017-03-16,Senate,"Senate 3rd Reading SR25 Galgiani et al",39,0,1,0,40
986059,611183,2017-03-23,Senate,"Senate 3rd Reading SCR33 Pan",38,0,2,0,40
986059,671981,2017-07-10,Assembly,"Be adopted. To Consent Calendar",11,0,0,0,11
986059,672577,2017-07-13,Assembly,"SCR 33 Pan Consent Calendar Second Day Regular Session",75,0,4,0,79
986064,611068,2017-03-23,Senate,"Senate 3rd Reading SR24 Hill et al",38,0,2,0,40
988011,607192,2017-03-20,Assembly,"Be adopted. To Consent Calendar",14,0,0,0,14
988011,611172,2017-03-23,Assembly,"ACR 31 LACKEY Consent Calendar Second Day Regular Session",76,0,4,0,80
988011,672238,2017-07-11,Senate,"Be adopted, but first be re-referred to the Committee on [Appropriations] with recommendation: To Consent Calendar",11,0,2,0,13
988011,674133,2017-08-24,Senate,"Consent Calendar 2nd ACR31",38,0,2,0,40
988011,674185,2017-08-28,Assembly,"ACR 31 LACKEY Concurrence in Senate Amendments",74,0,5,0,79
988016,631759,2017-04-25,Senate,"Do pass, but first be re-referred to the Committee on [Appropriations] with the recommendation: To Consent Calendar",9,0,0,0,9
988016,648004,2017-05-22,Senate,"Consent Calendar 2nd SB809 N.R. & W",37,0,3,0,40
988016,662296,2017-06-13,Assembly,"Do pass and be re-referred to the Committee on [Natural Resources]",14,0,1,0,15
988016,672112,2017-07-10,Assembly,"Do pass and be re-referred to the Committee on [Appropriations]",9,0,1,0,10
988016,672865,2017-07-19,Assembly,"Do pass",16,0,1,0,17
988016,674089,2017-08-24,Assembly,"SB 809 N.R. & W. Senate Third Reading By GARCIA, E",75,0,4,0,79
988016,674274,2017-08-31,Senate,"Special Consent Calendar # SB809 N.R. & W",37,0,3,0,40
988019,605059,2017-03-16,Assembly,"Be adopted. To third reading",9,0,2,0,11
988025,611175,2017-03-23,Senate,"Senate 3rd Reading SCR35 Beall",38,0,2,0,40
988025,634697,2017-04-27,Assembly,"Be adopted. To Consent Calendar",9,0,2,0,11
988025,638348,2017-05-04,Assembly,"SCR 35 Beall Consent Calendar Second Day Regular Session",76,0,4,0,80
988028,627849,2017-04-17,Assembly,"Do pass and be re-referred to the Committee on [Appropriations] with recommendation: To Consent Calendar",10,0,0,0,10
988028,633625,2017-04-26,Assembly,"Do pass. To Consent Calendar",16,0,1,0,17
988028,638691,2017-05-04,Assembly,"AB 1712 NAT. RES. Consent Calendar Second Day Regular Session",76,0,4,0,80
988028,662975,2017-06-13,Senate,"Do pass, but first be re-referred to the Committee on [Appropriations] with the recommendation: To Consent Calendar",9,0,0,0,9
988028,670982,2017-07-03,Senate,"Consent Calendar 2nd AB1712 NAT. RES",33,0,7,0,40
988032,631505,2017-04-25,Senate,"Do pass as amended, but first amend, and re-refer to the Committee on [Appropriations] with the recommendation: To Consent Calendar",13,0,0,0,13
988032,633324,2017-04-25,Senate,"Do pass, but first be re-referred to the Committee on [Appropriations] with the recommendation: To Consent Calendar",13,0,0,0,13
988032,644254,2017-05-15,Senate,"Consent Calendar 2nd SB810 T.&H",39,0,1,0,40
988032,671865,2017-07-10,Assembly,"Do pass as amended, and be re-referred to the Committee on [Appropriations] with recommendation: To Consent Calendar",14,0,0,0,14
988032,674015,2017-08-23,Assembly,"Do pass. To Consent Calendar",15,0,2,0,17
988032,674940,2017-09-05,Assembly,"SB 810 T. & H. Senate Third Reading By FRAZIER",75,0,4,0,79
988032,675193,2017-09-07,Senate,"Special Consent Calendar # SB810 T.&H",40,0,0,0,40
989540,633302,2017-04-26,Assembly,"Do pass and be re-referred to the Committee on [Revenue and Taxation]",7,0,0,0,7
989540,645128,2017-05-15,Assembly,"Do pass and be re-referred to the Committee on [Appropriations]",8,0,2,0,10
989540,649380,2017-05-24,Assembly,"Do pass",17,0,0,0,17
989540,651474,2017-05-26,Assembly,"AB 1714 H. & C.D. Assembly Third Reading By CHIU",75,0,5,0,80
989540,669108,2017-06-27,Senate,"Do pass, but first be re-referred to the Committee on [Governance and Finance] with the recommendation: To Consent Calendar",12,0,1,0,13
989540,671354,2017-07-05,Senate,"Do pass, but first be re-referred to the Committee on [Appropriations] with the recommendation: To Consent Calendar",7,0,0,0,7
989540,674337,2017-08-31,Senate,"Consent Calendar 2nd AB1714 H. & C.D",37,0,3,0,40
989540,674941,2017-09-05,Assembly,"AB 1714 H. & C.D. Concurrence in Senate Amendments By CHIU",76,0,3,0,79
989544,614867,2017-03-29,Senate,"Be adopted. Ordered to third reading",5,0,2,0,7
989544,617416,2017-04-03,Senate,"Senate 3rd Reading SR27 Wieckowski",27,4,9,0,40
989553,633341,2017-04-26,Assembly,"Do pass and be re-referred to the Committee on [Appropriations]",10,0,0,0,10
991780,633359,2017-04-25,Assembly,"Be adopted and re-referred to the Committee on [Appropriations]",10,2,1,0,13
991780,651533,2017-05-26,Assembly,"Be adopted. To third reading",12,1,4,0,17
991780,654270,2017-05-30,Assembly,"ACR 32 MEDINA Assembly Third Reading",63,7,10,0,80
991780,669905,2017-06-28,Senate,"Be adopted, but first be re-referred to the Committee on [Appropriations]",6,0,1,0,7
991780,671839,2017-07-10,Senate,"Placed on suspense file",7,0,0,0,7
991780,674815,2017-09-01,Senate,"Be adopted. Ordered to third reading",6,1,0,0,7
991780,675573,2017-09-11,Senate,"Assembly 3rd Reading ACR32 Medina et al. By Leyva",40,0,0,0,40
991803,607182,2017-03-20,Assembly,"Be adopted. To third reading",11,0,0,0,11
991803,630532,2017-04-24,Senate,"Special Consent Calendar # ACR33",37,0,3,0,40
992517,616458,2017-03-30,Assembly,"Be adopted. To third reading",10,0,1,0,11
992517,644325,2017-05-15,Senate,"Special Consent ACR34",39,0,1,0,40
992535,607202,2017-03-20,Senate,"Senate 3rd Reading SR28 Galgiani et al",39,0,1,0,40
993134,631885,2017-04-25,Assembly,"Do pass and be re-referred to the Committee on [Appropriations]",7,0,0,0,7
993134,645170,2017-05-15,Assembly,"Do pass and be re-referred to the Committee on [Appropriations]",10,0,0,0,10
993136,618067,2017-04-03,Assembly,"Be adopted. To third reading",10,0,1,0,11
993136,644513,2017-05-15,Senate,"Special Consent Calendar # ACR37",39,0,1,0,40
993141,631638,2017-04-25,Senate,"Do pass, but first be re-referred to the Committee on [Appropriations] with the recommendation: To Consent Calendar",7,0,0,0,7
993141,644490,2017-05-15,Senate,"Consent Calendar 2nd SB811 PUB. S",39,0,1,0,40
993141,668988,2017-06-27,Assembly,"Do pass and be re-referred to the Committee on [Appropriations] with recommendation: To Consent Calendar",6,0,1,0,7
993141,672897,2017-07-19,Assembly,"Do pass. To Consent Calendar",16,0,1,0,17
993141,674078,2017-08-24,Assembly,"SB 811 PUB. S. Consent Calendar Second Day Regular Session",76,0,3,0,79
993141,674345,2017-08-31,Senate,"Special Consent Calendar # SB811 PUB. S",37,0,3,0,40
993145,616274,2017-03-30,Assembly,"Be adopted. To third reading",10,0,1,0,11
993145,644527,2017-05-15,Senate,"Special Consent Calendar # ACR35",39,0,1,0,40
993150,612676,2017-03-27,Assembly,"Be adopted. To third reading",11,0,0,0,11
993150,630414,2017-04-24,Senate,"Special Consent Calendar # ACR36",37,0,3,0,40
993154,684755,2018-01-09,Assembly,"Do pass as amended, and be re-referred to the Committee on [Appropriations] with recommendation: To Consent Calendar",6,0,0,0,6
993154,686244,2018-01-18,Assembly,"Do pass",17,0,0,0,17
993154,689983,2018-01-29,Assembly,"AB 1715 QUIRK-SILVA Assembly Third Reading",76,0,1,0,77
993154,750041,2018-05-07,Senate,"Do pass, but first be re-referred to the Committee on [Appropriations]",8,0,1,0,9
993154,767932,2018-06-25,Senate,"Placed on suspense file",7,0,0,0,7
993154,771699,2018-08-16,Senate,"Do pass as amended",7,0,0,0,7
993154,772338,2018-08-21,Senate,"Assembly 3rd Reading AB1715 Quirk-Silva et al. By Portantino",39,0,1,0,40
993154,772828,2018-08-27,Assembly,"AB 1715 QUIRK-SILVA Concurrence in Senate Amendments",80,0,0,0,80
993801,627915,2017-04-19,Assembly,"Do pass and be re-referred to the Committee on [Appropriations] with recommendation: To Consent Calendar",20,0,1,0,21
993801,633313,2017-04-26,Assembly,"Do pass. To Consent Calendar",16,0,1,0,17
993801,638374,2017-05-04,Assembly,"AB 1724 G.O. Consent Calendar Second Day Regular Session",76,0,4,0,80
993801,672043,2017-07-11,Senate,"Do pass as amended, but first amend, and re-refer to the Committee on [Appropriations]",13,0,0,0,13
993801,674958,2017-09-05,Senate,"Assembly 3rd Reading AB1724 Jones-Sawyer et al. By Dodd",38,0,2,0,40
993801,675796,2017-09-13,Assembly,"With recommendation: That Senate amendments be concurred in",16,0,5,0,21
993801,676257,2017-09-14,Assembly,"AB 1724 JONES-SAWYER Concurrence in Senate Amendments",79,0,0,0,79
993814,631882,2017-04-24,Assembly,"Do pass and be re-referred to the Committee on [Appropriations] with recommendation: To Consent Calendar",10,0,0,0,10
993814,637485,2017-05-03,Assembly,"Do pass. To Consent Calendar",16,0,1,0,17
993814,643406,2017-05-11,Assembly,"AB 1717 REV. & TAX. Consent Calendar Second Day Regular Session",77,0,3,0,80
993814,671364,2017-07-05,Senate,"Do pass, but first be re-referred to the Committee on [Appropriations] with the recommendation: To Consent Calendar",7,0,0,0,7
993814,672970,2017-07-20,Senate,"Consent Calendar 2nd AB1717 REV. & TAX",38,0,2,0,40
993826,628042,2017-04-19,Assembly,"Do pass and be re-referred to the Committee on [Appropriations] with recommendation: To Consent Calendar",20,0,1,0,21
993826,633323,2017-04-26,Assembly,"Do pass. To Consent Calendar",16,0,1,0,17
993826,638308,2017-05-04,Assembly,"AB 1722 G.O. Consent Calendar Second Day Regular Session",76,0,4,0,80
993826,672037,2017-07-11,Senate,"Do pass, but first be re-referred to the Committee on [Appropriations]",13,0,0,0,13
993826,675881,2017-09-13,Senate,"That the measure be returned to Senate Floor for consideration. Ordered to third reading",12,0,1,0,13
993826,676056,2017-09-14,Senate,"Assembly 3rd Reading AB1722 G.O. (Gray) By Dodd",40,0,0,0,40
993826,676396,2017-09-15,Assembly,"With recommendation: That Senate amendments be concurred in",17,0,4,0,21
993826,676446,2017-09-16,Assembly,"AB 1722 G.O. Concurrence in Senate Amendments By GRAY",74,0,5,0,79
993837,628687,2017-04-19,Assembly,"Do pass and be re-referred to the Committee on [Appropriations] with recommendation: To Consent Calendar",20,0,1,0,21
993837,633553,2017-04-26,Assembly,"Do pass. To Consent Calendar",16,0,1,0,17
993837,638649,2017-05-04,Assembly,"AB 1723 G.O. Consent Calendar Second Day Regular Session",76,0,4,0,80
993837,672077,2017-07-11,Senate,"Do pass, but first be re-referred to the Committee on [Appropriations] with the recommendation: To Consent Calendar",13,0,0,0,13
993837,675550,2017-09-11,Senate,"Assembly 3rd Reading AB1723 G.O. (Gray) By Portantino",40,0,0,0,40
993837,676438,2017-09-15,Assembly,"With recommendation: That Senate amendments be concurred in",17,0,4,0,21
993837,676439,2017-09-16,Assembly,"AB 1723 G.O. Concurrence in Senate Amendments By GRAY",74,0,5,0,79
993849,643949,2017-05-08,Assembly,"Do pass. To Consent Calendar",9,0,1,0,10
993849,646387,2017-05-18,Assembly,"AB 1721 REV. & TAX. Consent Calendar Second Day Regular Session",69,0,11,0,80
993860,632027,2017-04-24,Assembly,"Do pass and be re-referred to the Committee on [Appropriations] with recommendation: To Consent Calendar",10,0,0,0,10
993860,637610,2017-05-03,Assembly,"Do pass. To Consent Calendar",16,0,1,0,17
993860,643571,2017-05-11,Assembly,"AB 1719 REV. & TAX. Consent Calendar Second Day Regular Session",77,0,3,0,80
993860,671433,2017-07-05,Senate,"Do pass, but first be re-referred to the Committee on [Appropriations] with the recommendation: To Consent Calendar",7,0,0,0,7
993860,672988,2017-07-20,Senate,"Consent Calendar 2nd AB1719 REV. & TAX",38,0,2,0,40
993871,632043,2017-04-24,Assembly,"Do pass and be re-referred to the Committee on [Appropriations] with recommendation: To Consent Calendar",10,0,0,0,10
993871,637558,2017-05-03,Assembly,"Do pass. To Consent Calendar",16,0,1,0,17
993871,643680,2017-05-11,Assembly,"AB 1720 REV. & TAX. Consent Calendar Second Day Regular Session",77,0,3,0,80
993871,671384,2017-07-05,Senate,"Do pass, but first be re-referred to the Committee on [Appropriations] with the recommendation: To Consent Calendar",7,0,0,0,7
993871,673006,2017-07-20,Senate,"Consent Calendar 2nd AB1720 REV. & TAX",38,0,2,0,40
993883,641461,2017-05-08,Assembly,"Do pass. To Consent Calendar",9,0,1,0,10
993883,646562,2017-05-18,Assembly,"AB 1718 REV. & TAX. Consent Calendar Second Day Regular Session",69,0,11,0,80
993883,671405,2017-07-05,Senate,"Do pass and be ordered to the Consent Calendar",7,0,0,0,7
993883,672548,2017-07-13,Senate,"Consent Calendar 2nd AB1718 REV. & TAX",39,0,1,0,40
995631,642610,2017-05-10,Assembly,"Be adopted. To third reading",9,1,3,0,13
995631,647950,2017-05-22,Assembly,"AJR 7 MULLIN Assembly Third Reading",55,18,7,0,80
995631,672809,2017-07-18,Senate,"Be adopted as amended",8,1,2,0,11
995631,674272,2017-08-31,Senate,"Assembly 3rd Reading AJR7 Mullin et al. By Skinner",28,8,4,0,40
995631,674889,2017-09-05,Assembly,"AJR 7 MULLIN Concurrence in Senate Amendments",54,16,9,0,79
995645,642700,2017-05-10,Assembly,"Do pass. To Consent Calendar",8,0,1,0,9
995645,646568,2017-05-18,Assembly,"AB 1725 L. GOV. Consent Calendar Second Day Regular Session",69,0,11,0,80
995645,669850,2017-06-28,Senate,"Do pass, but first be re-referred to the Committee on [Appropriations] with the recommendation: To Consent Calendar",7,0,0,0,7
995645,674429,2017-08-31,Senate,"Assembly 3rd Reading AB1725 L. GOV. (Aguiar-Curry) By McGuire",38,0,2,0,40
995645,674956,2017-09-05,Assembly,"AB 1725 L. GOV. Concurrence in Senate Amendments By AGUIAR-CURRY",77,0,2,0,79
995673,626029,2017-04-17,Senate,"Senate 3rd Reading SR29 Portantino et al",39,0,1,0,40
995686,615932,2017-03-30,Assembly,"Be adopted. To third reading",10,0,1,0,11
995686,630488,2017-04-24,Senate,"Special Consent Calendar # ACR39",37,0,3,0,40
995701,612567,2017-03-27,Assembly,"Be adopted. To third reading",11,0,0,0,11
995701,630573,2017-04-24,Senate,"Special Consent Calendar # ACR38",37,0,3,0,40
995715,611188,2017-03-23,Assembly,"Be adopted. To third reading",7,2,2,0,11
995715,616117,2017-03-30,Assembly,"HR 28 GIPSON Assembly Third Reading",51,17,12,0,80
995728,632970,2017-04-25,Assembly,"Do pass and be re-referred to the Committee on [Appropriations] with recommendation: To Consent Calendar",15,0,0,0,15
995728,637535,2017-05-03,Assembly,"Do pass. To Consent Calendar",16,0,1,0,17
995728,643569,2017-05-11,Assembly,"AB 1726 HEALTH Consent Calendar Second Day Regular Session",77,0,3,0,80
995728,660737,2017-06-07,Senate,"Do pass as amended, but first amend, and re-refer to the Committee on [Appropriations]",9,0,0,0,9
995728,673934,2017-08-21,Senate,"Assembly 3rd Reading AB1726 HEALTH (Wood) By Hernandez",39,0,1,0,40
995728,674131,2017-08-24,Assembly,"AB 1726 HEALTH Concurrence in Senate Amendments By WOOD",77,0,2,0,79
996312,630502,2017-04-24,Assembly,"Be adopted. To third reading",26,0,3,0,29
996312,646603,2017-05-18,Assembly,"ACR 40 TING Assembly Third Reading",70,0,10,0,80
996314,626478,2017-04-17,Senate,"Senate 3rd Reading SCR36 Lara et al",39,0,1,0,40
996314,630536,2017-04-24,Assembly,"Be adopted. To third reading",11,0,0,0,11
996317,632080,2017-04-25,Assembly,"Do pass. To Consent Calendar",7,0,0,0,7
996317,635710,2017-05-01,Assembly,"AB 1727 J., E.D. & E. Consent Calendar Second Day By QUIRK-SILVA",74,0,6,0,80
996317,658200,2017-06-05,Senate,"Do pass and be ordered to the Consent Calendar",9,0,0,0,9
996317,660837,2017-06-08,Senate,"Consent Calendar 2nd AB1727 J.,E.D.,& E. (Quirk-Silva)",40,0,0,0,40
996902,616129,2017-03-30,Assembly,"Be adopted. To third reading",10,0,1,0,11
996902,635974,2017-05-01,Senate,"Assembly 3rd Reading ACR41 Bonta et al. By Pan",36,0,4,0,40
996903,634583,2017-04-26,Senate,"Do pass, but first be re-referred to the Committee on [Appropriations] with the recommendation: To Consent Calendar",7,0,0,0,7
996903,644324,2017-05-15,Senate,"Consent Calendar 2nd SB812 GOV. & F",39,0,1,0,40
996903,669160,2017-06-26,Assembly,"Do pass and be re-referred to the Committee on [Appropriations] with recommendation: To Consent Calendar",9,0,1,0,10
996903,672893,2017-07-19,Assembly,"Do pass as amended. To Consent Calendar",16,0,1,0,17
996903,674116,2017-08-24,Assembly,"SB 812 GOV.& F. Consent Calendar Second Day Regular Session",76,0,3,0,79
996903,674408,2017-08-31,Senate,"Special Consent Calendar # SB812 GOV. & F",37,0,3,0,40
996905,620107,2017-04-05,Assembly,"Be adopted. To third reading",6,0,1,0,7
996905,635947,2017-05-01,Senate,"Assembly 3rd Reading ACR42 Holden et al. By Bradford",36,0,4,0,40
996908,634399,2017-04-26,Senate,"Do pass, but first be re-referred to the Committee on [Appropriations] with the recommendation: To Consent Calendar",7,0,0,0,7
996908,644489,2017-05-15,Senate,"Placed on suspense file",7,0,0,0,7
996908,650843,2017-05-25,Senate,"Do pass",7,0,0,0,7
996908,655860,2017-05-31,Senate,"Special Consent Calendar # SB813 GOV. & F",40,0,0,0,40
996908,672177,2017-07-10,Assembly,"Do pass as amended, and be re-referred to the Committee on [Appropriations] with recommendation: To Consent Calendar",10,0,0,0,10
996908,674004,2017-08-23,Assembly,"Do pass. To Consent Calendar",15,0,2,0,17
996908,674338,2017-08-31,Assembly,"SB 813 GOV.& F. Consent Calendar Second Day Regular Session",73,0,6,0,79
996908,674903,2017-09-05,Senate,"Special Consent SB813 GOV. & F",40,0,0,0,40
996909,638661,2017-05-04,Senate,"Senate 3rd Reading SJR6 Pan et al",36,0,4,0,40
996909,672286,2017-07-12,Assembly,"Be adopted. To third reading",7,0,0,0,7
996909,674115,2017-08-24,Assembly,"SJR 6 Pan Senate Third Reading By MCCARTY",69,0,10,0,79
996911,632004,2017-04-25,Senate,"Do pass, but first be re-referred to the Committee on [Appropriations] with the recommendation: To Consent Calendar",13,0,0,0,13
996911,644835,2017-05-15,Senate,"Do pass",7,0,0,0,7
996911,647942,2017-05-22,Senate,"Senate 3rd Reading SB814 G.O. (Dodd)",37,0,3,0,40
996911,669863,2017-06-28,Assembly,"Do pass and be re-referred to the Committee on [Appropriations] with recommendation: To Consent Calendar",7,0,0,0,7
996911,672852,2017-07-19,Assembly,"Do pass. To Consent Calendar",16,0,1,0,17
996911,674088,2017-08-24,Assembly,"SB 814 G.O. Consent Calendar Second Day Regular Session",76,0,3,0,79
996911,674352,2017-08-31,Senate,"Special Consent Calendar # SB814 G.O",37,0,3,0,40
996912,634613,2017-04-26,Assembly,"Do pass and be re-referred to the Committee on [Appropriations] with recommendation: To Consent Calendar",9,0,0,0,9
996912,642973,2017-05-10,Assembly,"Do pass. To Consent Calendar",17,0,0,0,17
996912,646629,2017-05-18,Assembly,"AB 1728 L. GOV. Consent Calendar Second Day Regular Session",69,0,11,0,80
996912,672503,2017-07-12,Senate,"Do pass, but first be re-referred to the Committee on [Appropriations] with the recommendation: To Consent Calendar",7,0,0,0,7
996912,673902,2017-08-21,Senate,"Do pass",7,0,0,0,7
996912,674304,2017-08-31,Senate,"Special Consent Calendar # AB1728 L. GOV",37,0,3,0,40
997362,630504,2017-04-24,Senate,"Senate 3rd Reading SR31 Mitchell",39,0,1,0,40
997369,617578,2017-04-03,Senate,"Senate 3rd Reading SR30 Mitchell et al",38,0,2,0,40
997378,642914,2017-05-10,Assembly,"Do pass as amended. To Consent Calendar",7,0,0,0,7
997378,647929,2017-05-22,Assembly,"AB 1730 E. & R. Consent Calendar Second Day By BERMAN",77,0,3,0,80
997378,666695,2017-06-20,Senate,"Do pass and be ordered to the Consent Calendar",5,0,0,0,5
997378,671055,2017-07-03,Senate,"Consent Calendar 2nd AB1730 E. & R",33,0,7,0,40
997391,637494,2017-05-03,Assembly,"Be adopted and re-referred to the Committee on [Health]",5,0,2,0,7
997391,641830,2017-05-09,Assembly,"Be adopted. To third reading",12,0,3,0,15
997391,647928,2017-05-22,Assembly,"AJR 8 KALRA Assembly Third Reading",56,0,24,0,80
997391,662438,2017-06-13,Senate,"Be adopted. Ordered to third reading",3,0,2,0,5
997391,670369,2017-06-29,Senate,"Assembly 3rd Reading AJR8 Kalra et al. By Wiener",25,3,12,0,40
997405,633690,2017-04-26,Assembly,"Do pass as amended and be re-referred to the Committee on [Appropriations]",7,0,0,0,7
997405,635859,2017-04-26,Assembly,"Do pass and be re-referred to the Committee on [Appropriations]",7,0,0,0,7
997405,642808,2017-05-10,Assembly,"Do pass. To Consent Calendar",17,0,0,0,17
997405,646587,2017-05-18,Assembly,"AB 1729 E. & R. Consent Calendar Second Day Regular Session",69,0,11,0,80
997405,666389,2017-06-20,Senate,"Do pass, but first be re-referred to the Committee on [Appropriations] with the recommendation: To Consent Calendar",5,0,0,0,5
997405,674438,2017-08-31,Senate,"Assembly 3rd Reading AB1729 E. & R. (Berman) By Stern",39,0,1,0,40
997405,674872,2017-09-05,Assembly,"AB 1729 E. & R. Concurrence in Senate Amendments By BERMAN",77,0,2,0,79
997417,631868,2017-04-25,Assembly,"Do pass and be re-referred to the Committee on [Higher Education]",7,0,0,0,7
997417,633417,2017-04-25,Assembly,"Do pass and be re-referred to the Committee on [Appropriations]",12,0,1,0,13
997417,642456,2017-05-10,Assembly,"Do pass",17,0,0,0,17
997417,644487,2017-05-15,Assembly,"AB 1731 J., E.D. & E. Assembly Third Reading By QUIRK-SILVA",76,0,4,0,80
997417,663246,2017-06-14,Senate,"Do pass, but first be re-referred to the Committee on [Appropriations] with the recommendation: To Consent Calendar",7,0,0,0,7
997417,671015,2017-07-03,Senate,"Consent Calendar 2nd AB1731 J., E.D., & E",33,0,7,0,40
997429,640671,2017-05-08,Assembly,"Be adopted. To Consent Calendar",14,0,0,0,14
997429,643399,2017-05-11,Assembly,"ACR 43 WOOD Consent Calendar Second Day Regular Session",77,0,3,0,80
997429,672134,2017-07-11,Senate,"Be adopted, but first be re-referred to the Committee on [Appropriations] with recommendation: To Consent Calendar",11,0,2,0,13
997429,674099,2017-08-24,Senate,"Consent Calendar 2nd ACR43",38,0,2,0,40
1000324,641208,2017-05-08,Assembly,"Be adopted. To Consent Calendar",14,0,0,0,14
1000324,643662,2017-05-11,Assembly,"ACR 47 GRAY Consent Calendar Second Day Regular Session",77,0,3,0,80
1000324,672139,2017-07-11,Senate,"Be adopted, but first be re-referred to the Committee on [Appropriations] with recommendation: To Consent Calendar",11,0,2,0,13
1000324,674129,2017-08-24,Senate,"Consent Calendar 2nd ACR47",38,0,2,0,40
1000345,640548,2017-05-08,Assembly,"Be adopted. To Consent Calendar",14,0,0,0,14
1000345,643404,2017-05-11,Assembly,"ACR 46 GRAY Consent Calendar Second Day Regular Session",77,0,3,0,80
1000345,672171,2017-07-11,Senate,"Be adopted, but first be re-referred to the Committee on [Appropriations] with recommendation: To Consent Calendar",11,0,2,0,13
1000345,674098,2017-08-24,Senate,"Consent Calendar 2nd ACR46",38,0,2,0,40
1000345,674210,2017-08-28,Assembly,"ACR 46 GRAY Concurrence in Senate Amendments",74,0,5,0,79
1000973,621263,2017-04-06,Assembly,"Be adopted. To third reading",9,0,2,0,11
1000973,644498,2017-05-15,Senate,"Special Consent Calendar # ACR48",39,0,1,0,40
1001075,640562,2017-05-08,Assembly,"Be adopted. To Consent Calendar",14,0,0,0,14
1001075,643557,2017-05-11,Assembly,"ACR 49 FRAZIER Consent Calendar Second Day Regular Session",77,0,3,0,80
1001075,672069,2017-07-11,Senate,"Be adopted, but first be re-referred to the Committee on [Appropriations] with recommendation: To Consent Calendar",11,0,2,0,13
1001075,674072,2017-08-24,Senate,"Consent Calendar 2nd ACR49",38,0,2,0,40
1001777,640555,2017-05-08,Assembly,"Be re-referred to the Committee on [Revenue and Taxation]",9,0,2,0,11
1001777,669196,2017-06-26,Assembly,"Be adopted as amended, and re-refer to the Committee on [Appropriations]",9,0,1,0,10
1001777,672907,2017-07-19,Assembly,"Be adopted. To Consent Calendar",16,0,1,0,17
1001777,674154,2017-08-24,Assembly,"ACA 12 GLORIA Consent Calendar Second Day",76,0,3,0,79
1001777,737527,2018-04-11,Senate,"Be adopted as amended, but first amend, and re-refer to the Committee on [Elections and Constitutional Amendments]",6,0,1,0,7
1001777,747499,2018-05-01,Senate,"Be adopted, but first be re-referred to the Committee on [Appropriations] with recommendation: To Consent Calendar",5,0,0,0,5
1001777,767880,2018-06-25,Senate,"Placed on suspense file",7,0,0,0,7
1001799,626873,2017-04-17,Assembly,"Be adopted. To third reading",7,1,2,0,10
1001799,629169,2017-04-20,Assembly,"AJR 9 STONE Assembly Third Reading",66,1,13,0,80
1001799,660112,2017-06-07,Senate,"Be adopted. Ordered to third reading",5,1,1,0,7
1001799,675026,2017-09-05,Senate,"Assembly 3rd Reading AJR9 Mark Stone et al. By Stern",34,1,5,0,40
1001799,675134,2017-09-07,Assembly,"AJR 9 STONE Concurrence in Senate Amendments",74,1,4,0,79
1001821,621227,2017-04-06,Senate,"Senate 3rd Reading SCR37 Jackson et al",39,0,1,0,40
1001821,629185,2017-04-20,Assembly,"Be adopted. To Consent Calendar",8,0,3,0,11
1001821,635847,2017-05-01,Assembly,"SCR 37 Jackson Senate Third Reading By CERVANTES",69,0,11,0,80
1001821,638601,2017-05-04,Senate,"Unfinished Business SCR37 Jackson et al. Concurrence",39,0,1,0,40
1001841,676538,2017-09-15,Senate,"Senate 3rd Reading SCR38 De León",27,10,3,0,40
1001841,771385,2018-08-13,Assembly,"Be adopted. To third reading",10,0,1,0,11
1001841,771911,2018-08-16,Assembly,"SCR 38 Atkins Senate Third Reading By COOLEY",78,0,2,0,80
1001841,772282,2018-08-20,Senate,"Unfinished Business SCR38 Atkins Concurrence",39,0,1,0,40
1003519,628852,2017-04-19,Assembly,"Be adopted. To third reading",5,2,0,0,7
1003942,633642,2017-04-26,Assembly,"Be adopted. To third reading",7,0,0,0,7
1003942,676356,2017-09-14,Senate,"Assembly 3rd Reading ACR50 Chu et al. By Pan",38,1,1,0,40
1003943,626715,2017-04-17,Assembly,"Be adopted. To third reading",9,0,2,0,11
1003943,644351,2017-05-15,Senate,"Special Consent Calendar # ACR51",39,0,1,0,40
1003944,651661,2017-05-26,Assembly,"Be adopted. To third reading",9,0,2,0,11
1003944,668695,2017-06-26,Senate,"Special Consent Calendar # ACR52",39,0,1,0,40
1003945,634527,2017-04-27,Senate,"Senate 3rd Reading SCR39 Atkins et al",37,0,3,0,40
1003945,640506,2017-05-08,Assembly,"Be adopted. To Consent Calendar",9,0,2,0,11
1003945,643654,2017-05-11,Assembly,"SCR 39 Atkins Consent Calendar Second Day Regular Session",77,0,3,0,80
1004252,645324,2017-05-16,Assembly,"Be adopted as amended",9,0,2,0,11
1004252,651592,2017-05-26,Assembly,"AJR 10 SANTIAGO Assembly Third Reading",62,2,16,0,80
1004252,666305,2017-06-20,Senate,"Be adopted. Ordered to third reading",5,1,1,0,7
1004252,674392,2017-08-31,Senate,"Assembly 3rd Reading AJR10 Santiago et al. By Hueso",30,8,2,0,40
1004254,629189,2017-04-20,Assembly,"Be adopted. To third reading",9,0,2,0,11
1004254,644508,2017-05-15,Senate,"Special Consent Calendar # ACR53",39,0,1,0,40
1004446,667934,2017-06-22,Assembly,"Be adopted. To third reading",9,0,2,0,11
1004446,672785,2017-07-17,Senate,"Special Consent Calendar # ACR54",38,0,2,0,40
1006526,646628,2017-05-18,Senate,"Senate 3rd Reading SCR40 Glazer et al",38,0,2,0,40
1006526,670960,2017-07-03,Assembly,"Be adopted. To Consent Calendar",11,0,0,0,11
1006526,671602,2017-07-06,Assembly,"SCR 40 Glazer Consent Calendar Second Day Regular Session",74,0,6,0,80
1006527,634669,2017-04-27,Assembly,"Be adopted. To third reading",9,0,2,0,11
1006527,654529,2017-05-30,Senate,"Special Consent Calendar # ACR55 Baker et al",40,0,0,0,40
1006530,643519,2017-05-11,Assembly,"Be adopted. To third reading",11,0,0,0,11
1006530,658041,2017-06-05,Senate,"Assembly 3rd Reading ACR57 McCarty et al. By Allen",38,0,2,0,40
1006531,634423,2017-04-27,Senate,"Senate 3rd Reading SR32 Fuller",37,0,3,0,40
1006532,634635,2017-04-26,Assembly,"Be adopted, and re-refer to the Committee on [Appropriations] with recommendation: To Consent Calendar",7,0,0,0,7
1006532,651686,2017-05-26,Assembly,"Be adopted. To third reading",17,0,0,0,17
1006532,654254,2017-05-30,Assembly,"ACR 58 CHU Assembly Third Reading",76,0,4,0,80
1006532,667679,2017-06-21,Senate,"Be adopted, but first be re-referred to the Committee on [Appropriations] with recommendation: To Consent Calendar",6,0,1,0,7
1006532,672646,2017-07-13,Senate,"Consent Calendar 2nd ACR58",39,0,1,0,40
1006533,630359,2017-04-24,Assembly,"Be adopted. To third reading",11,0,0,0,11
1006533,651373,2017-05-26,Senate,"Special Consent Calendar # ACR60",37,0,3,0,40
1006534,674125,2017-08-24,Assembly,"Be adopted. To third reading",9,0,2,0,11
1006534,676236,2017-09-14,Senate,"Assembly 3rd Reading ACR59 Rubio et al. By Jackson",40,0,0,0,40
1006535,628873,2017-04-20,Assembly,"Be adopted. To third reading",9,0,2,0,11
1006535,644345,2017-05-15,Senate,"Special Consent Calendar # ACR56",39,0,1,0,40
1006537,762869,2018-06-13,Assembly,"Be adopted. To Consent Calendar",5,0,2,0,7
1006537,767136,2018-06-21,Assembly,"HR 30 Consent Calendar Second Day",75,0,5,0,80
1006880,643306,2017-05-10,Assembly,"Be adopted. To third reading",12,0,1,0,13
1006880,659323,2017-06-06,Senate,"Be adopted. Ordered to third reading",9,0,2,0,11
1006880,668724,2017-06-26,Senate,"Special Consent ACR62 Quirk et al. By Hueso",39,0,1,0,40
1006881,635752,2017-05-01,Assembly,"Be adopted. To third reading",10,0,1,0,11
1006881,654547,2017-05-30,Senate,"Special Consent Calendar # ACR61 Nazarian et al",40,0,0,0,40
1006883,637402,2017-05-03,Assembly,"Be adopted. To Consent Calendar",20,0,1,0,21
1006883,643528,2017-05-11,Assembly,"ACR 63 GRAY Consent Calendar Second Day Regular Session",77,0,3,0,80
1006883,654075,2017-05-30,Senate,"Special Consent Calendar # ACR63 Gray",40,0,0,0,40
1007129,633293,2017-04-26,Assembly,"Be adopted. To third reading",7,0,0,0,7
1007129,660903,2017-06-08,Senate,"Special Consent ACR64",40,0,0,0,40
1007130,634512,2017-04-27,Senate,"Senate 3rd Reading SCR42 Newman et al",36,0,4,0,40
1007130,651601,2017-05-26,Assembly,"Be adopted. To Consent Calendar",9,0,2,0,11
1007130,656009,2017-05-31,Assembly,"SCR 42 Newman Consent Calendar Second Day Regular Session",76,0,4,0,80
1007132,630308,2017-04-24,Assembly,"Be adopted. To third reading",11,0,0,0,11
1007132,651445,2017-05-26,Senate,"Special Consent Calendar # ACR65",37,0,3,0,40
1007134,631643,2017-04-25,Assembly,"Be adopted as amended",7,0,0,0,7
1007136,635839,2017-05-01,Assembly,"Be adopted. To third reading",10,0,1,0,11
1007522,634370,2017-04-27,Assembly,"Be adopted. To third reading",9,0,2,0,11
1007522,651605,2017-05-26,Senate,"Special Consent Calendar # ACR71",37,0,3,0,40
1007526,676026,2017-09-13,Assembly,"Be adopted. To Consent Calendar",13,0,1,0,14
1007526,676452,2017-09-16,Assembly,"ACR 67 AGUIAR-CURRY Consent Calendar First Day",78,0,1,0,79
1007526,769699,2018-07-03,Senate,"Be adopted, but first be re-referred to the Committee on [Appropriations] with recommendation: To Consent Calendar",12,0,1,0,13
1007526,771395,2018-08-13,Senate,"Consent Calendar ACR67",37,0,3,0,40
1007528,634565,2017-04-27,Assembly,"Be adopted. To third reading",9,0,2,0,11
1007528,651386,2017-05-26,Senate,"Special Consent Calendar # ACR66",37,0,3,0,40
1007531,641165,2017-05-08,Assembly,"Be adopted. To Consent Calendar",14,0,0,0,14
1007531,643655,2017-05-11,Assembly,"ACR 70 SALAS Consent Calendar Second Day Regular Session",77,0,3,0,80
1007531,672083,2017-07-11,Senate,"Be adopted, but first be re-referred to the Committee on [Appropriations] with recommendation: To Consent Calendar",11,0,2,0,13
1007531,674130,2017-08-24,Senate,"Consent Calendar 2nd ACR70",38,0,2,0,40
1007535,670052,2017-06-28,Assembly,"Be adopted. To Consent Calendar",9,0,1,0,10
1007535,671011,2017-07-03,Assembly,"AJR 11 FLORA Consent Calendar Second Day",66,0,14,0,80
1007535,675742,2017-09-12,Senate,"Assembly 3rd Reading AJR11 Flora et al. By Galgiani",36,1,3,0,40
1007537,635759,2017-05-01,Assembly,"Be adopted. To third reading",10,0,1,0,11
1007537,651604,2017-05-26,Senate,"Special Consent Calendar # ACR69",37,0,3,0,40
1007540,638749,2017-05-04,Assembly,"Be adopted. To third reading",8,0,3,0,11
1007540,654403,2017-05-30,Senate,"Special Consent Calendar # ACR68 Arambula et al",40,0,0,0,40
1007541,643757,2017-05-11,Senate,"Senate 3rd Reading SR33 Leyva et al",37,0,3,0,40
1008033,640698,2017-05-08,Assembly,"Be adopted. To Consent Calendar",9,0,2,0,11
1008033,643663,2017-05-11,Assembly,"HR 33 COOPER Consent Calendar Second Day Regular Session",77,0,3,0,80
1008051,635802,2017-05-01,Assembly,"Be adopted. To third reading",10,0,1,0,11
1008051,651381,2017-05-26,Senate,"Special Consent Calendar # ACR73",37,0,3,0,40
1008061,667932,2017-06-22,Assembly,"Be adopted. To third reading",9,0,2,0,11
1008061,672704,2017-07-17,Senate,"Special Consent Calendar # ACR72",38,0,2,0,40
1008072,634692,2017-04-27,Assembly,"Be adopted. To third reading",9,0,2,0,11
1008072,651437,2017-05-26,Senate,"Special Consent Calendar # ACR74",37,0,3,0,40
1008538,638456,2017-05-04,Senate,"Senate 3rd Reading SCR45 Galgiani et al",38,0,2,0,40
1008538,640714,2017-05-08,Assembly,"Be adopted. To third reading",9,0,2,0,11
1008547,641111,2017-05-08,Assembly,"Be adopted as amended. To Consent Calendar",14,0,0,0,14
1008547,644551,2017-05-15,Assembly,"ACR 76 CALDERON Consent Calendar Second Day",79,0,1,0,80
1008547,672030,2017-07-11,Senate,"Be adopted, but first be re-referred to the Committee on [Appropriations] with recommendation: To Consent Calendar",11,0,2,0,13
1008547,674124,2017-08-24,Senate,"Consent Calendar 2nd ACR76",38,0,2,0,40
1008547,674218,2017-08-28,Assembly,"ACR 76 CALDERON Concurrence in Senate Amendments",74,0,5,0,79
1008564,641823,2017-05-09,Senate,"Be adopted as amended, but first amend, and re-refer to the Committee on [Appropriations] with the recommendation: To Consent Calendar",13,0,0,0,13
1008564,651399,2017-05-26,Senate,"Consent Calendar 2nd SCR46",37,0,3,0,40
1008564,671861,2017-07-10,Assembly,"Be adopted. To Consent Calendar",14,0,0,0,14
1008564,672567,2017-07-13,Assembly,"SCR 46 Gaines Consent Calendar Second Day Regular Session",75,0,4,0,79
1008571,640644,2017-05-08,Senate,"Senate 3rd Reading SR34 Monning",38,0,2,0,40
1008579,640991,2017-05-08,Assembly,"Be adopted. To third reading",9,0,2,0,11
1008579,651532,2017-05-26,Senate,"Special Consent Calendar # ACR75",37,0,3,0,40
1008590,667331,2017-06-20,Assembly,"Be adopted as amended",6,0,1,0,7
1008590,670232,2017-06-29,Assembly,"AJR 13 LACKEY Assembly Third Reading",74,0,6,0,80
1008590,674319,2017-08-31,Senate,"Special Consent Calendar # AJR13",37,0,3,0,40
1008597,654571,2017-05-30,Senate,"Senate 3rd Reading SCR44 Pan",36,0,4,0,40
1008597,664051,2017-06-15,Assembly,"Be adopted. To Consent Calendar",10,0,1,0,11
1008597,667860,2017-06-22,Assembly,"SCR 44 Pan Consent Calendar Second Day Regular Session",74,0,6,0,80
1008929,638674,2017-05-04,Assembly,"Be adopted. To third reading",8,0,3,0,11
1008929,651380,2017-05-26,Senate,"Assembly 3rd Reading ACR78 Baker et al. By Wilk",36,0,4,0,40
1008944,634431,2017-04-27,Assembly,"Be adopted. To Consent Calendar",9,0,2,0,11
1008944,638702,2017-05-04,Assembly,"HR 34 MCCARTY Consent Calendar Second Day Regular Session",76,0,4,0,80
1008960,643779,2017-05-11,Assembly,"Be adopted. To third reading",11,0,0,0,11
1008960,654526,2017-05-30,Senate,"Special Consent Calendar # ACR79 Salas et al",40,0,0,0,40
1008980,672463,2017-07-11,Assembly,"Be adopted as amended, and re-refer to the Committee on [Appropriations]",7,0,0,0,7
1009348,658143,2017-06-05,Senate,"Senate 3rd Reading SCR47 Mendoza et al",39,0,1,0,40
1009348,664189,2017-06-15,Assembly,"Be adopted. To Consent Calendar",10,0,1,0,11
1009348,667867,2017-06-22,Assembly,"SCR 47 Mendoza Consent Calendar Second Day Regular Session",74,0,6,0,80
1009359,662394,2017-06-13,Senate,"Be adopted. Ordered to third reading",6,1,0,0,7
1009359,670372,2017-06-29,Senate,"Senate 3rd Reading SCR48 Skinner et al",30,5,5,0,40
1009359,672038,2017-07-11,Assembly,"Be adopted. To third reading",6,0,1,0,7
1009359,676201,2017-09-14,Assembly,"SCR 48 Skinner Senate Third Reading By LOW",45,23,11,0,79
1009376,667281,2017-06-21,Senate,"Be adopted as amended, but first amend, and re-refer to the Committee on [Elections and Constitutional Amendments]",5,1,1,0,7
1009376,672564,2017-07-12,Senate,"Be adopted, but first be re-referred to the Committee on [Appropriations]",4,1,0,0,5
1009376,673849,2017-08-21,Senate,"Placed on suspense file",7,0,0,0,7
1009376,674465,2017-09-01,Senate,"Be adopted",5,2,0,0,7
1009376,675702,2017-09-12,Senate,"Senate 3rd Reading SCA12 Mendoza et al",21,7,12,0,40
1009376,675703,2017-09-12,Senate,"Senate 3rd Reading SCA12 Mendoza et al. Reconsider",40,0,0,0,40
1009376,676140,2017-09-14,Senate,"Senate 3rd Reading SCA12 Mendoza et al",27,7,6,0,40
1009385,640688,2017-05-08,Assembly,"Be adopted. To third reading",9,0,2,0,11
1009385,654389,2017-05-30,Senate,"Special Consent Calendar # ACR81 Chau et al",40,0,0,0,40
1009936,666455,2017-06-20,Assembly,"Be adopted. To third reading",10,1,2,0,13
1009945,638701,2017-05-04,Senate,"Senate 3rd Reading SCR50 Skinner et al",39,0,1,0,40
1009945,660899,2017-06-08,Assembly,"Be adopted. To Consent Calendar",6,0,5,0,11
1009945,664025,2017-06-15,Assembly,"SCR 50 Skinner Consent Calendar Second Day",77,0,3,0,80
1009949,645197,2017-05-16,Assembly,"Be adopted as amended",7,0,4,0,11
1009949,648000,2017-05-22,Assembly,"AJR 14 TING Assembly Third Reading",59,0,21,0,80
1009949,666299,2017-06-20,Senate,"Be adopted. Ordered to third reading",5,1,1,0,7
1009949,672765,2017-07-17,Senate,"Assembly 3rd Reading AJR14 Ting et al. By Pan",30,10,0,0,40
1009949,673981,2017-08-21,Assembly,"AJR 14 TING Concurrence in Senate Amendments",60,0,19,0,79
1009958,638717,2017-05-04,Assembly,"Be adopted. To third reading",8,0,3,0,11
1009961,638402,2017-05-04,Senate,"Senate 3rd Reading SR35 Jackson et al",29,5,6,0,40
1010379,648460,2017-05-22,Senate,"Senate 3rd Reading SR36 Cannella et al",37,0,3,0,40
1010380,643460,2017-05-11,Assembly,"Be adopted. To third reading",11,0,0,0,11
1010380,660854,2017-06-08,Senate,"Special Consent ACR82",40,0,0,0,40
1010381,643671,2017-05-11,Assembly,"Be adopted. To third reading",11,0,0,0,11
1010381,654283,2017-05-30,Senate,"Special Consent Calendar # ACR83 Cooley et al",40,0,0,0,40
1010709,643567,2017-05-11,Senate,"Senate 3rd Reading SCR51 Mendoza et al",37,0,3,0,40
1010712,667922,2017-06-22,Assembly,"Be adopted. To third reading",9,0,2,0,11
1010712,670961,2017-07-03,Assembly,"ACR 85 GARCIA, E. Assembly Third Reading",66,0,14,0,80
1010712,672743,2017-07-17,Senate,"Assembly 3rd Reading ACR85 Eduardo Garcia et al. By Monning",39,0,1,0,40
1010714,640732,2017-05-08,Assembly,"Be adopted. To third reading",9,0,2,0,11
1010714,654331,2017-05-30,Senate,"Special Consent Calendar # ACR86 Chau et al",40,0,0,0,40
1010717,644297,2017-05-15,Assembly,"Be adopted. To third reading",11,0,0,0,11
1010717,660919,2017-06-08,Senate,"Special Consent Calendar # ACR87",40,0,0,0,40
1010718,644425,2017-05-15,Assembly,"Be adopted. To third reading",11,0,0,0,11
1010718,654461,2017-05-30,Senate,"Special Consent Calendar # ACR84 Gipson et al",40,0,0,0,40
1011075,668793,2017-06-26,Assembly,"Be adopted. To Consent Calendar",14,0,0,0,14
1011075,670368,2017-06-29,Assembly,"ACR 88 CUNNINGHAM Consent Calendar Second Day",74,0,6,0,80
1011075,672080,2017-07-11,Senate,"Be adopted as amended, but first amend, and re-refer to the Committee on [Appropriations] with the recommendation: To Consent Calendar",11,0,2,0,13
1011075,674117,2017-08-24,Senate,"Consent Calendar 2nd ACR88",38,0,2,0,40
1011075,674390,2017-08-31,Assembly,"ACR 88 CUNNINGHAM Concurrence in Senate Amendments",76,0,3,0,79
1011079,674075,2017-08-24,Senate,"Senate 3rd Reading SR37 Hertzberg et al",39,0,1,0,40
1011084,643532,2017-05-11,Assembly,"Be adopted. To third reading",11,0,0,0,11
1011084,654457,2017-05-30,Senate,"Special Consent Calendar # ACR89 Aguiar-Curry et al",40,0,0,0,40
1011088,655030,2017-05-30,Senate,"Senate 3rd Reading SCR52 Jackson",40,0,0,0,40
1011088,665153,2017-06-19,Assembly,"Be adopted. To Consent Calendar",9,0,2,0,11
1011088,667910,2017-06-22,Assembly,"SCR 52 Jackson Consent Calendar Second Day Regular Session",74,0,6,0,80
1011093,643400,2017-05-11,Assembly,"Be adopted. To third reading",11,0,0,0,11
1012080,659959,2017-06-07,Senate,"Be adopted. Ordered to third reading",2,5,0,0,7
1012080,659960,2017-06-07,Senate,"[06-07-2017] hearing: Motion to Reconsider. [Reconsideration Granted.]",7,0,0,0,7
1012082,644509,2017-05-15,Senate,"Senate 3rd Reading SR38 Atkins et al",39,0,1,0,40
1012083,684891,2018-01-10,Senate,"Do pass as amended, but first amend, and re-refer to the Committee on [Appropriations] with the recommendation: To Consent Calendar",6,0,1,0,7
1012083,690059,2018-01-29,Senate,"Consent Calendar SB816 ED",39,0,1,0,40
1012083,762701,2018-06-13,Assembly,"Do pass and be re-referred to the Committee on [Appropriations] with recommendation: To Consent Calendar",5,0,2,0,7
1012083,768718,2018-06-27,Assembly,"Do pass. To Consent Calendar",16,0,1,0,17
1012083,773085,2018-08-28,Assembly,"SB 816 ED. Senate Third Reading By O'DONNELL",79,0,1,0,80
1012516,645055,2017-05-16,Assembly,"Be adopted. To Consent Calendar",10,0,1,0,11
1012516,646431,2017-05-18,Assembly,"HR 39 MCCARTY Consent Calendar Second Day Regular Session",69,0,11,0,80
1012518,672972,2017-07-20,Senate,"Senate 3rd Reading SR40 Morrell et al",38,0,2,0,40
1012520,654654,2017-05-30,Senate,"Senate 3rd Reading SCR53 Fuller et al",39,0,1,0,40
1012520,661627,2017-06-07,Senate,"Senate 3rd Reading SCR53 Fuller et al",40,0,0,0,40
1012520,674565,2017-09-01,Assembly,"Be adopted. To Consent Calendar",9,0,2,0,11
1012520,675185,2017-09-07,Assembly,"SCR 53 Fuller Consent Calendar Second Day",77,0,2,0,79
1013489,654190,2017-05-30,Senate,"Senate 3rd Reading SCR54 Beall et al",39,0,1,0,40
1013489,661644,2017-06-07,Senate,"Senate 3rd Reading SCR54 Beall et al",40,0,0,0,40
1013489,664202,2017-06-15,Assembly,"Be adopted. To Consent Calendar",10,0,1,0,11
1013489,667870,2017-06-22,Assembly,"SCR 54 Beall Consent Calendar Second Day Regular Session",74,0,6,0,80
1013524,646586,2017-05-18,Assembly,"Be adopted. To third reading",9,0,2,0,11
1013524,660918,2017-06-08,Senate,"Special Consent Calendar # ACR91",40,0,0,0,40
1013985,673007,2017-07-20,Senate,"Senate 3rd Reading SCR55 Newman et al",38,0,2,0,40
1013986,648640,2017-05-23,Assembly,"Be adopted. To third reading",9,4,2,0,15
1013986,651457,2017-05-26,Assembly,"AJR 15 AGUIAR-CURRY Assembly Third Reading",56,16,8,0,80
1013986,657893,2017-06-05,Senate,"Be adopted. Ordered to third reading",6,2,1,0,9
1013986,660924,2017-06-08,Senate,"Assembly 3rd Reading AJR15 Aguiar-Curry et al. By Dodd",28,8,4,0,40
1013988,651542,2017-05-26,Assembly,"Be adopted. To third reading",9,0,2,0,11
1013988,668645,2017-06-26,Senate,"Special Consent Calendar # ACR92",39,0,1,0,40
1013989,665125,2017-06-19,Senate,"Senate 3rd Reading SR41 De León et al",28,7,5,0,40
1014311,666724,2017-06-20,Assembly,"Be adopted as amended",11,0,0,0,11
1014311,668591,2017-06-26,Assembly,"AJR 16 LOW Assembly Third Reading",71,0,9,0,80
1014311,674227,2017-08-29,Senate,"Be adopted as amended",6,0,1,0,7
1014311,674998,2017-09-05,Senate,"Assembly 3rd Reading AJR16 Low et al. By Lara",40,0,0,0,40
1014311,675534,2017-09-11,Assembly,"AJR 16 LOW Concurrence in Senate Amendments",76,0,3,0,79
1014356,647989,2017-05-22,Assembly,"Be adopted. To third reading",8,0,3,0,11
1014972,651463,2017-05-26,Senate,"Senate 3rd Reading SR42 De León",26,10,4,0,40
1014991,651377,2017-05-26,Assembly,"Be adopted. To third reading",9,0,2,0,11
1014991,668689,2017-06-26,Senate,"Special Consent Calendar # ACR93",39,0,1,0,40
1015008,669186,2017-06-27,Senate,"Be adopted, but first be re-referred to the Committee on [Appropriations] with recommendation: To Consent Calendar",12,0,1,0,13
1015008,672628,2017-07-13,Senate,"Consent Calendar 2nd SCR57",39,0,1,0,40
1015008,675779,2017-09-13,Assembly,"Be adopted. To Consent Calendar",13,0,1,0,14
1015008,716810,2018-03-05,Senate,"Unfinished Business SCR57 Cannella et al. Concurrence",36,0,3,0,39
1015024,660933,2017-06-08,Assembly,"Be adopted. To third reading",6,0,5,0,11
1015024,674905,2017-09-05,Senate,"Assembly 3rd Reading ACR94 Cooley et al. By McGuire",40,0,0,0,40
1015037,662389,2017-06-13,Senate,"Be adopted, but first be re-referred to the Committee on [Appropriations] with recommendation: To Consent Calendar",13,0,0,0,13
1015037,670979,2017-07-03,Senate,"Consent Calendar 2nd SCR56",33,0,7,0,40
1015037,675954,2017-09-13,Assembly,"Be adopted. To Consent Calendar",13,0,1,0,14
1015037,676615,2017-09-16,Assembly,"SCR 56 Anderson Consent Calendar First Day Regular Session",78,0,1,0,79
1015516,657884,2017-06-05,Assembly,"Be adopted. To third reading",9,0,2,0,11
1015516,672694,2017-07-17,Senate,"Special Consent Calendar # ACR95",38,0,2,0,40
1015833,660931,2017-06-08,Senate,"Senate 3rd Reading SCR58 McGuire",40,0,0,0,40
1015833,668697,2017-06-26,Assembly,"Be adopted. To Consent Calendar",9,0,2,0,11
1015833,670405,2017-06-29,Assembly,"SCR 58 McGuire Consent Calendar Second Day Regular Session",74,0,6,0,80
1015833,671017,2017-07-03,Senate,"Unfinished Business SCR58 McGuire Concurrence",33,0,7,0,40
1016173,660891,2017-06-08,Senate,"Senate 3rd Reading SCR59 Bates",39,0,1,0,40
1016173,749015,2018-05-03,Assembly,"Be adopted. To Consent Calendar",6,0,5,0,11
1016173,752081,2018-05-10,Assembly,"SCR 59 Bates Consent Calendar Second Day Regular Session",73,0,5,0,78
1016173,754233,2018-05-17,Senate,"Unfinished Business SCR59 Bates Concurrence",38,0,1,0,39
1016651,662566,2017-06-13,Senate,"Be adopted as amended, but first amend, and re-refer to the Committee on [Appropriations]",7,0,2,0,9
1016651,674155,2017-08-24,Senate,"Senate 3rd Reading SJR7 McGuire et al",34,0,6,0,40
1016651,674423,2017-08-31,Assembly,"Be adopted and re-referred to the Committee on [Appropriations]",11,4,0,0,15
1016651,675548,2017-09-11,Assembly,"Be adopted. To third reading",12,4,1,0,17
1016651,676577,2017-09-15,Assembly,"SJR 7 McGuire Senate Third Reading By WOOD",57,18,4,0,79
1016791,661672,2017-06-12,Assembly,"Be adopted. To third reading",9,0,2,0,11
1016791,672761,2017-07-17,Senate,"Special Consent Calendar # ACR97",38,0,2,0,40
1017391,661689,2017-06-12,Assembly,"Be adopted. To third reading",9,0,2,0,11
1017391,672693,2017-07-17,Senate,"Special Consent Calendar # ACR98",38,0,2,0,40
1017578,661647,2017-06-12,Assembly,"Be adopted. To third reading",8,0,3,0,11
1017579,665311,2017-06-19,Assembly,"Be adopted as amended",9,0,2,0,11
1017579,667912,2017-06-22,Assembly,"AJR 18 CHOI Assembly Third Reading",69,0,11,0,80
1017579,672691,2017-07-17,Senate,"Special Consent Calendar # AJR18",38,0,2,0,40
1017580,667945,2017-06-22,Assembly,"Be adopted. To third reading",9,0,2,0,11
1018059,664227,2017-06-15,Senate,"Senate 3rd Reading SCR61 Nguyen",34,0,6,0,40
1018059,668709,2017-06-26,Assembly,"Be adopted. To Consent Calendar",9,0,2,0,11
1018059,670421,2017-06-29,Assembly,"SCR 61 Nguyen Consent Calendar Second Day Regular Session",74,0,6,0,80
1018061,669221,2017-06-27,Senate,"Be adopted, but first be re-referred to the Committee on [Appropriations] with recommendation: To Consent Calendar",12,0,1,0,13
1018061,673975,2017-08-21,Senate,"Senate 3rd Reading SCR60 Nguyen",38,0,2,0,40
1018061,676016,2017-09-13,Assembly,"Be adopted. To Consent Calendar",13,0,1,0,14
1018061,676598,2017-09-16,Assembly,"SCR 60 Nguyen Consent Calendar First Day Regular Session",78,0,1,0,79
1018062,669074,2017-06-27,Assembly,"Be adopted. To third reading",15,0,0,0,15
1018063,672104,2017-07-11,Assembly,"Be adopted as amended. To Consent Calendar",15,0,0,0,15
1018063,674101,2017-08-24,Assembly,"AJR 19 ARAMBULA Consent Calendar Second Day Regular Session",76,0,3,0,79
1018063,675609,2017-09-12,Senate,"Assembly 3rd Reading AJR19 Arambula By Leyva",39,0,1,0,40
1018063,676197,2017-09-14,Assembly,"AJR 19 ARAMBULA Concurrence in Senate Amendments",79,0,0,0,79
1018065,665201,2017-06-19,Senate,"Senate 3rd Reading SR43 Bradford",39,0,1,0,40
1018278,667946,2017-06-22,Assembly,"Be adopted. To third reading",9,0,2,0,11
1018288,667933,2017-06-22,Senate,"Senate 3rd Reading SR44 Jackson et al",30,4,6,0,40
1018299,665319,2017-06-19,Senate,"Senate 3rd Reading SCR62 Pan",29,3,8,0,40
1018299,674141,2017-08-24,Assembly,"Be adopted. To Consent Calendar",7,1,3,0,11
1018299,674212,2017-08-24,Assembly,"Be adopted. To third reading",7,1,3,0,11
1018299,674358,2017-08-31,Assembly,"SCR 62 Pan Senate Third Reading By MCCARTY",53,19,7,0,79
1018310,672591,2017-07-13,Assembly,"Be adopted. To third reading",8,0,3,0,11
1018482,661526,2017-06-12,Assembly,"Be adopted. To third reading",9,0,2,0,11
1018483,664220,2017-06-15,Assembly,"Be adopted. To third reading",10,0,1,0,11
1018483,672763,2017-07-17,Senate,"Special Consent Calendar # ACR100",38,0,2,0,40
1018484,667949,2017-06-22,Assembly,"Be adopted. To third reading",9,0,2,0,11
1018485,664225,2017-06-15,Assembly,"Be adopted. To third reading",10,0,1,0,11
1018486,768736,2018-06-27,Assembly,"Be adopted and re-referred to the Committee on [Appropriations]",1,5,1,0,7
1018906,672096,2017-07-10,Assembly,"Be adopted. To third reading",7,1,2,0,10
1018906,673983,2017-08-21,Assembly,"AJR 20 GONZALEZ FLETCHER Assembly Third Reading",57,14,8,0,79
1018906,674261,2017-08-30,Senate,"Be adopted. Ordered to third reading",5,1,1,0,7
1018906,675197,2017-09-07,Senate,"Assembly 3rd Reading AJR20 Gonzalez Fletcher By Lara",27,10,3,0,40
1019148,672014,2017-07-11,Senate,"Be adopted, but first be re-referred to the Committee on [Appropriations] with recommendation: To Consent Calendar",7,0,0,0,7
1019148,674298,2017-08-31,Senate,"Senate 3rd Reading SCR64 Galgiani",40,0,0,0,40
1019148,675448,2017-09-11,Assembly,"Be adopted. To Consent Calendar",7,0,0,0,7
1019148,676381,2017-09-14,Assembly,"SCR 64 Galgiani Consent Calendar Second Day Regular Session",79,0,0,0,79
1019366,672612,2017-07-12,Assembly,"Be adopted. To third reading",7,0,0,0,7
1019366,674398,2017-08-31,Senate,"Assembly 3rd Reading ACR102 Eduardo Garcia et al. By Hueso",38,0,2,0,40
1019660,665056,2017-06-19,Senate,"Senate 3rd Reading SR46 Lara et al",33,1,6,0,40
1020261,672138,2017-07-11,Senate,"Be adopted. Ordered to third reading",9,0,0,0,9
1020261,672716,2017-07-17,Senate,"Senate 3rd Reading SJR8 Allen et al",36,1,3,0,40
1020261,674002,2017-08-22,Assembly,"Be adopted. To third reading",8,4,3,0,15
1020261,674391,2017-08-31,Assembly,"SJR 8 Allen Senate Third Reading By GLORIA",53,14,12,0,79
1020262,668552,2017-06-26,Senate,"Senate 3rd Reading SR47 Bradford",39,0,1,0,40
1020263,674999,2017-09-05,Senate,"Senate 3rd Reading SCR65 Newman et al",40,0,0,0,40
1020263,675529,2017-09-11,Assembly,"Be adopted. To third reading",7,0,4,0,11
1020442,671877,2017-07-10,Assembly,"Be adopted. To Consent Calendar",14,0,0,0,14
1020442,672584,2017-07-13,Assembly,"ACR 103 CUNNINGHAM Consent Calendar Second Day",75,0,4,0,79
1020442,769754,2018-07-03,Senate,"Be adopted, but first be re-referred to the Committee on [Appropriations] with recommendation: To Consent Calendar",12,0,1,0,13
1020442,771318,2018-08-13,Senate,"Consent Calendar ACR103",37,0,3,0,40
1020442,772593,2018-08-23,Assembly,"ACR 103 CUNNINGHAM Concurrence in Senate Amendments",79,0,1,0,80
1020582,670991,2017-07-03,Senate,"Senate 3rd Reading SCR66 Mitchell et al",33,0,7,0,40
1020582,672644,2017-07-13,Assembly,"Be adopted. To Consent Calendar",8,0,3,0,11
1020582,672982,2017-07-20,Assembly,"SCR 66 Mitchell Consent Calendar Second Day Regular Session",67,0,12,0,79
1020603,674146,2017-08-24,Assembly,"Be adopted. To third reading",9,0,2,0,11
1020603,675299,2017-09-11,Senate,"Assembly 3rd Reading ACR104 Gloria et al. By Pan",40,0,0,0,40
1021074,674220,2017-08-28,Assembly,"Be adopted. To third reading",9,0,2,0,11
1021074,676134,2017-09-14,Senate,"Assembly 3rd Reading ACR105 Kiley et al. By Nielsen",40,0,0,0,40
1021090,670193,2017-06-29,Assembly,"Be adopted. To third reading",8,0,3,0,11
1021090,674283,2017-08-31,Senate,"Special Consent Calendar # ACR107",37,0,3,0,40
1021232,671914,2017-07-10,Senate,"Senate 3rd Reading SCR67 Anderson et al",39,0,1,0,40
1021232,674810,2017-09-01,Assembly,"Be adopted. To Consent Calendar",9,0,2,0,11
1021232,675157,2017-09-07,Assembly,"SCR 67 Anderson Consent Calendar Second Day Regular Session",77,0,2,0,79
1021477,674234,2017-08-29,Assembly,"Be adopted. To Consent Calendar",12,0,3,0,15
1021477,674369,2017-08-31,Assembly,"ACR 108 BONTA Consent Calendar Second Day",73,0,6,0,79
1021477,675622,2017-09-12,Senate,"Assembly 3rd Reading ACR108 Bonta By Hernandez",40,0,0,0,40
1021580,676000,2017-09-13,Assembly,"Be adopted. To Consent Calendar",13,0,1,0,14
1021580,676527,2017-09-16,Assembly,"ACR 110 GLORIA Consent Calendar First Day Regular Session",78,0,1,0,79
1021580,769738,2018-07-03,Senate,"Be adopted, but first be re-referred to the Committee on [Appropriations] with recommendation: To Consent Calendar",12,0,1,0,13
1021580,771309,2018-08-13,Senate,"Consent Calendar ACR110",37,0,3,0,40
1021674,672638,2017-07-13,Assembly,"Be adopted. To third reading",8,0,3,0,11
1021674,672949,2017-07-20,Senate,"Assembly 3rd Reading ACR111 Kalra et al. By Wieckowski",38,0,2,0,40
1021679,672542,2017-07-13,Assembly,"Be adopted. To third reading",8,0,3,0,11
1021789,673994,2017-08-21,Senate,"Senate 3rd Reading SR48 Nguyen",39,0,1,0,40
1021998,672777,2017-07-17,Senate,"Senate 3rd Reading SR49 Bradford",40,0,0,0,40
1022014,673986,2017-08-21,Senate,"Senate 3rd Reading SR50 Leyva",39,0,1,0,40
1022145,674008,2017-08-22,Assembly,"Be adopted as amended",8,0,2,0,10
1022145,676119,2017-09-14,Senate,"Assembly 3rd Reading ACR112 Choi et al. By Nguyen",40,0,0,0,40
1022304,672981,2017-07-20,Senate,"Senate 3rd Reading SR51 McGuire et al",26,7,7,0,40
1022344,674236,2017-08-29,Assembly,"Be adopted. To Consent Calendar",12,0,3,0,15
1022344,674276,2017-08-31,Assembly,"ACR 113 RUBIO Consent Calendar Second Day Regular Session",73,0,6,0,79
1022344,675719,2017-09-12,Senate,"Assembly 3rd Reading ACR113 Rubio By Mitchell",40,0,0,0,40
1022564,674014,2017-08-22,Assembly,"Be adopted. To third reading",8,0,2,0,10
1022564,675199,2017-09-07,Senate,"Assembly 3rd Reading ACR114 Bloom et al. By Beall",40,0,0,0,40
1022674,674290,2017-08-31,Senate,"Senate 3rd Reading SCR68 Bates et al",36,0,4,0,40
1022674,675266,2017-09-08,Assembly,"Be adopted. To Consent Calendar",9,0,2,0,11
1022674,675618,2017-09-12,Assembly,"SCR 68 Bates Consent Calendar Second Day Regular Session",79,0,0,0,79
1022679,674202,2017-08-28,Senate,"Senate 3rd Reading SCR69 Cannella",39,0,1,0,40
1022679,675272,2017-09-08,Assembly,"Be adopted. To third reading",9,0,2,0,11
1022684,672948,2017-07-20,Senate,"Senate 3rd Reading SR53 De León",25,12,3,0,40
1022695,674383,2017-08-31,Assembly,"Be adopted. To Consent Calendar",9,0,2,0,11
1022695,676251,2017-09-14,Senate,"Special Consent Calendar # ACR115",40,0,0,0,40
1022806,674350,2017-08-31,Senate,"Senate 3rd Reading SCR70 Vidak et al",37,0,3,0,40
1022806,675303,2017-09-11,Assembly,"Be adopted. To Consent Calendar",7,0,4,0,11
1022806,676337,2017-09-14,Assembly,"SCR 70 Vidak Consent Calendar Second Day",79,0,0,0,79
1022835,674109,2017-08-24,Assembly,"ACA 17 MULLIN Assembly Third Reading",78,0,1,0,79
1022835,674657,2017-09-01,Senate,"Placed on suspense file",7,0,0,0,7
1022835,674658,2017-09-01,Senate,"Be adopted",7,0,0,0,7
1022835,676074,2017-09-14,Senate,"Special Consent Calendar # ACA17",40,0,0,0,40
1022927,674180,2017-08-28,Assembly,"Be adopted. To third reading",9,0,2,0,11
1022927,676162,2017-09-14,Senate,"Assembly 3rd Reading ACR116 Limón et al. By Skinner",40,0,0,0,40
1022938,674378,2017-08-31,Senate,"Senate 3rd Reading SCR71 Bates et al",37,0,3,0,40
1022938,675270,2017-09-08,Assembly,"Be adopted. To Consent Calendar",9,0,2,0,11
1022938,675642,2017-09-12,Assembly,"SCR 71 Bates Consent Calendar Second Day Regular Session",79,0,0,0,79
1022960,674190,2017-08-28,Senate,"Senate 3rd Reading SCR72 Fuller et al",39,0,1,0,40
1022960,674935,2017-09-05,Assembly,"Be adopted. To Consent Calendar",9,0,2,0,11
1022960,675113,2017-09-07,Assembly,"SCR 72 Fuller Consent Calendar Second Day Regular Session",77,0,2,0,79
1022972,676576,2017-09-15,Senate,"Senate 3rd Reading SCR74 Wiener et al",38,0,2,0,40
1022972,726327,2018-03-20,Assembly,"Be adopted, and re-refer to the Committee on [Appropriations] with recommendation: To Consent Calendar",15,0,0,0,15
1022972,734337,2018-04-05,Assembly,"SCR 74 Wiener Senate Third Reading By WALDRON",70,0,7,0,77
1022983,675753,2017-09-12,Senate,"Senate 3rd Reading SCR73 Nielsen et al",40,0,0,0,40
1022994,674228,2017-08-29,Senate,"Be adopted as amended",5,0,2,0,7
1024954,673783,2017-08-21,Assembly,"HR 51 LEVINE Assembly Third Reading",78,0,1,0,79
1024982,674211,2017-08-28,Assembly,"Be adopted. To third reading",9,0,2,0,11
1024982,676303,2017-09-14,Senate,"Assembly 3rd Reading ACR118 Waldron et al. By Atkins",40,0,0,0,40
1024983,676175,2017-09-14,Assembly,"Be adopted. To third reading",4,0,3,0,7
1024983,676433,2017-09-15,Assembly,"AJR 21 RUBIO Assembly Third Reading",65,0,14,0,79
1024984,674233,2017-08-29,Senate,"Be adopted. Ordered to third reading",7,0,0,0,7
1024984,676132,2017-09-14,Senate,"Senate 3rd Reading SR55 Skinner et al",40,0,0,0,40
1024985,674123,2017-08-24,Senate,"Senate 3rd Reading SCR76 Wiener",39,0,1,0,40
1024985,674988,2017-09-05,Assembly,"Be adopted. To Consent Calendar",9,0,2,0,11
1024985,675220,2017-09-07,Assembly,"SCR 76 Wiener Consent Calendar Second Day Regular Session",77,0,2,0,79
1024986,674097,2017-08-24,Assembly,"Be adopted. To third reading",9,0,2,0,11
1024987,674196,2017-08-28,Senate,"Senate 3rd Reading SJR12 Wiener",37,0,3,0,40
1024987,765147,2018-06-19,Assembly,"Be adopted. To third reading",12,0,1,0,13
1024987,771354,2018-08-13,Assembly,"SJR 12 Wiener Senate Third Reading",67,0,13,0,80
1024987,772283,2018-08-20,Senate,"Unfinished Business SJR12 Wiener et al. Concurrence",36,0,4,0,40
1024988,674235,2017-08-29,Senate,"Be adopted. Ordered to third reading",4,1,0,0,5
1024988,674744,2017-09-01,Senate,"Senate 3rd Reading SJR11 Stern",24,11,5,0,40
1024988,676053,2017-09-14,Assembly,"Be adopted. To third reading",4,2,1,0,7
1024988,676572,2017-09-15,Assembly,"SJR 11 Stern Senate Third Reading By BERMAN",53,20,6,0,79
1024989,674197,2017-08-28,Assembly,"Be adopted. To third reading",9,0,2,0,11
1024989,675650,2017-09-12,Senate,"Assembly 3rd Reading ACR121 Kalra et al. By Wieckowski",40,0,0,0,40
1024990,674404,2017-08-31,Senate,"Senate 3rd Reading SR54 Mitchell",37,0,3,0,40
1024991,674213,2017-08-28,Assembly,"Be adopted. To third reading",9,0,2,0,11
1024992,674330,2017-08-31,Senate,"Senate 3rd Reading SCR77 Dodd et al",37,0,3,0,40
1024992,675357,2017-09-11,Assembly,"Be adopted. To Consent Calendar",7,0,4,0,11
1024992,676353,2017-09-14,Assembly,"SCR 77 Dodd Consent Calendar Second Day Regular Session",79,0,0,0,79
1024993,674191,2017-08-28,Assembly,"Be adopted. To third reading",9,0,2,0,11
1024994,674229,2017-08-29,Senate,"Be adopted as amended",4,1,2,0,7
1024994,675097,2017-09-06,Senate,"Senate 3rd Reading SCR79 Pan",30,7,3,0,40
1024995,674238,2017-08-29,Senate,"Be adopted. Ordered to third reading",7,0,0,0,7
1024995,674532,2017-09-01,Senate,"Senate 3rd Reading SJR13 Skinner et al",37,0,3,0,40
1024995,675307,2017-09-11,Assembly,"Be adopted. To third reading",7,0,0,0,7
1024996,674182,2017-08-28,Assembly,"Be adopted. To third reading",9,0,2,0,11
1024996,675717,2017-09-12,Senate,"Assembly 3rd Reading ACR119 Rubio et al. By Pan",40,0,0,0,40
1024997,674232,2017-08-29,Senate,"Be adopted. Ordered to third reading",6,0,1,0,7
1024997,674507,2017-09-01,Senate,"Senate 3rd Reading SCR78 Jackson et al",37,0,3,0,40
1024997,701019,2018-02-13,Assembly,"Be adopted. To third reading",9,0,1,0,10
1024998,674533,2017-09-01,Assembly,"Be adopted. To third reading",9,0,2,0,11
1024998,675698,2017-09-12,Senate,"Assembly 3rd Reading ACR120 Salas et al. By Roth",39,0,1,0,40
1024999,725972,2018-03-20,Assembly,"Be adopted. To Consent Calendar",7,0,0,0,7
1024999,732755,2018-04-02,Assembly,"ACR 117 THURMOND Consent Calendar Second Day Regular Session",73,0,4,0,77
1024999,763009,2018-06-12,Senate,"Be adopted and be ordered to the Consent Calendar",7,0,0,0,7
1024999,768014,2018-06-25,Senate,"Consent Calendar ACR117",36,0,3,0,39
1025000,674990,2017-09-05,Senate,"Special Consent SCR75",40,0,0,0,40
1025000,675532,2017-09-11,Assembly,"Be adopted. To Consent Calendar",7,0,4,0,11
1025000,676320,2017-09-14,Assembly,"SCR 75 Allen Consent Calendar Second Day Regular Session",79,0,0,0,79
1025001,674325,2017-08-31,Assembly,"Be adopted. To third reading",8,0,3,0,11
1025001,675156,2017-09-07,Assembly,"AJR 22 LOW Assembly Third Reading",61,1,17,0,79
1025001,676224,2017-09-14,Senate,"Assembly 3rd Reading AJR22 Low et al. By Lara",27,3,10,0,40
1025002,674203,2017-08-28,Assembly,"Be adopted. To third reading",9,0,2,0,11
1025002,675720,2017-09-12,Senate,"Assembly 3rd Reading ACR122 Kalra et al. By Pan",40,0,0,0,40
1025003,674619,2017-09-01,Assembly,"Be adopted. To third reading",9,0,2,0,11
1025003,676138,2017-09-14,Senate,"Special Consent Calendar # ACR123",40,0,0,0,40
1025047,674749,2017-09-01,Assembly,"Be adopted. To third reading",9,0,2,0,11
1025047,676146,2017-09-14,Senate,"Assembly 3rd Reading ACR126 Gonzalez Fletcher By Lara",40,0,0,0,40
1025049,674544,2017-09-01,Assembly,"Be adopted. To third reading",9,0,2,0,11
1025049,676153,2017-09-14,Senate,"Special Consent Calendar # ACR125",40,0,0,0,40
1025050,674745,2017-09-01,Assembly,"Be adopted. To third reading",9,0,2,0,11
1025051,674219,2017-08-28,Assembly,"Be adopted. To third reading",9,0,2,0,11
1025051,676221,2017-09-14,Senate,"Special Consent Calendar # ACR124",40,0,0,0,40
1025069,674216,2017-08-28,Assembly,"Be adopted. To third reading",7,0,4,0,11
1025069,676600,2017-09-15,Assembly,"HR 57 THURMOND Assembly Third Reading",53,4,22,0,79
1025070,675004,2017-09-05,Assembly,"Be adopted. To third reading",9,0,2,0,11
1025070,676155,2017-09-14,Senate,"Assembly 3rd Reading ACR128 Quirk-Silva et al. By Newman",40,0,0,0,40
1025071,674639,2017-09-01,Assembly,"Be adopted. To third reading",9,0,2,0,11
1025071,676289,2017-09-14,Senate,"Special Consent Calendar # ACR127",40,0,0,0,40
1025072,674627,2017-09-01,Senate,"Senate 3rd Reading SCR80 Dodd",37,0,3,0,40
1025072,675283,2017-09-08,Assembly,"Be adopted. To Consent Calendar",9,0,2,0,11
1025072,675724,2017-09-12,Assembly,"SCR 80 Dodd Consent Calendar Second Day Regular Session",79,0,0,0,79
1025072,676008,2017-09-13,Senate,"Unfinished Business SCR80 Dodd Concurrence",40,0,0,0,40
1025094,674993,2017-09-05,Senate,"Senate 3rd Reading SR56 De León",40,0,0,0,40
1025097,674500,2017-09-01,Senate,"Senate 3rd Reading SCR82 Newman",37,0,3,0,40
1025097,675274,2017-09-08,Assembly,"Be adopted. To Consent Calendar",9,0,2,0,11
1025097,675603,2017-09-12,Assembly,"SCR 82 Newman Consent Calendar Second Day Regular Session",79,0,0,0,79
1025100,674370,2017-08-31,Assembly,"Be adopted. To Consent Calendar",15,0,0,0,15
1025100,674972,2017-09-05,Assembly,"AJR 23 BIGELOW Consent Calendar Second Day",74,0,5,0,79
1025100,676220,2017-09-14,Senate,"Assembly 3rd Reading AJR23 Bigelow et al. By Berryhill",40,0,0,0,40
1025103,674379,2017-08-31,Assembly,"Be adopted as amended",5,2,0,0,7
1025103,675653,2017-09-12,Assembly,"AJR 24 SANTIAGO Assembly Third Reading",47,28,4,0,79
1025103,676471,2017-09-15,Senate,"W/O REF. TO FILE AJR24 Santiago By Skinner",25,12,3,0,40
1025106,674991,2017-09-05,Senate,"Senate 3rd Reading SCR81 Lara et al",40,0,0,0,40
1025106,676568,2017-09-15,Senate,"Unfinished Business SCR81 Lara et al. Concurrence",38,0,2,0,40
1025106,698553,2017-09-14,Assembly,"Be adopted. To third reading",5,0,2,0,7
1025109,771209,2018-08-09,Senate,"Senate 3rd Reading SCR83 Jackson",37,0,2,0,39
1025109,772277,2018-08-20,Assembly,"Be adopted. To Consent Calendar",9,0,2,0,11
1025109,772599,2018-08-23,Assembly,"SCR 83 Jackson Consent Calendar Second Day Regular Session",75,0,5,0,80
1025195,674904,2017-09-05,Senate,"Senate 3rd Reading SCR84 Skinner et al",40,0,0,0,40
1025195,675410,2017-09-11,Assembly,"Be adopted. To Consent Calendar",7,0,4,0,11
1025195,676230,2017-09-14,Assembly,"SCR 84 Skinner Consent Calendar Second Day Regular Session",79,0,0,0,79
1025196,674891,2017-09-05,Assembly,"Be adopted. To third reading",9,0,2,0,11
1025196,676291,2017-09-14,Senate,"Assembly 3rd Reading ACR130 Chau et al. By Dodd",40,0,0,0,40
1025197,676312,2017-09-14,Senate,"Senate 3rd Reading SR58 Wiener et al",40,0,0,0,40
1025198,675418,2017-09-11,Assembly,"Be adopted. To third reading",7,0,4,0,11
1025198,676565,2017-09-15,Senate,"W/O REF. TO FILE ACR129 Cristina Garcia By Allen",38,0,2,0,40
1025199,674341,2017-08-31,Senate,"Senate 3rd Reading SR57 Nielsen",40,0,0,0,40
1025273,674929,2017-09-05,Senate,"Special Consent SR59",40,0,0,0,40
1025274,675047,2017-09-06,Senate,"Senate 3rd Reading SR60 Fuller et al",40,0,0,0,40
1025275,675436,2017-09-11,Assembly,"AJR 25 REYES Assembly Third Reading",72,0,7,0,79
1025275,676089,2017-09-14,Senate,"Assembly 3rd Reading AJR25 Reyes et al. By Hueso",40,0,0,0,40
1025277,675275,2017-09-08,Assembly,"Be adopted. To third reading",9,0,2,0,11
1025277,675850,2017-09-13,Senate,"Assembly 3rd Reading ACR133 Harper By Moorlach",40,0,0,0,40
1025278,675046,2017-09-06,Senate,"Senate 3rd Reading SR61 Fuller et al",40,0,0,0,40
1025279,674927,2017-09-05,Assembly,"Be adopted. To third reading",9,0,2,0,11
1025279,676235,2017-09-14,Senate,"Special Consent Calendar # ACR131",40,0,0,0,40
1025389,683943,2018-01-03,Assembly,"Be adopted. To third reading",10,0,1,0,11
1025389,694828,2018-02-05,Senate,"Special Consent ACR134 Eduardo Garcia et al",37,0,3,0,40
1025391,675267,2017-09-08,Assembly,"Be adopted. To third reading",9,0,2,0,11
1025393,675158,2017-09-07,Senate,"Senate 3rd Reading SJR14 Glazer et al",34,1,5,0,40
1025393,675159,2017-09-07,Senate,"Senate 3rd Reading SJR14 Glazer et al. Reconsider",39,0,1,0,40
1025393,675160,2017-09-07,Senate,"Senate 3rd Reading SJR14 Glazer et al",37,0,3,0,40
1025393,771459,2018-08-14,Assembly,"Be adopted as amended",8,0,1,0,9
1025393,772607,2018-08-23,Assembly,"SJR 14 Glazer Senate Third Reading By GONZALEZ FLETCHER",64,2,14,0,80
1025393,773215,2018-08-28,Senate,"Unfinished Business SJR14 Glazer et al. Concurrence",33,2,5,0,40
1025394,675154,2017-09-07,Senate,"Senate 3rd Reading SR62 Wilk",37,0,3,0,40
1025451,675145,2017-09-07,Senate,"Senate 3rd Reading SR64 Atkins et al",40,0,0,0,40
1025458,675142,2017-09-07,Senate,"Senate 3rd Reading SR63 Atkins et al",40,0,0,0,40
1025467,725761,2018-03-20,Assembly,"Be adopted as amended. To Consent Calendar",10,0,0,0,10
1025467,732815,2018-04-02,Assembly,"HR 63 GALLAGHER Consent Calendar Second Day Regular Session",67,4,6,0,77
1025468,675437,2017-09-11,Assembly,"Be adopted. To third reading",7,0,4,0,11
1025470,675526,2017-09-11,Assembly,"Be adopted. To third reading",7,0,4,0,11
1025471,754438,2018-05-17,Assembly,"Be adopted. To third reading",9,0,2,0,11
1025542,676007,2017-09-13,Assembly,"HR 66 GIPSON Assembly Third Reading",60,1,18,0,79
1025553,724828,2018-03-19,Assembly,"Be adopted. To Consent Calendar",13,0,1,0,14
1025553,727790,2018-03-22,Assembly,"ACR 135 LIMÓN Consent Calendar Second Day Regular Session",69,0,8,0,77
1025553,769750,2018-07-03,Senate,"Be adopted, but first be re-referred to the Committee on [Appropriations] with recommendation: To Consent Calendar",12,0,1,0,13
1025553,771312,2018-08-13,Senate,"Consent Calendar ACR135",37,0,3,0,40
1025674,675277,2017-09-08,Assembly,"Be adopted. To third reading",9,0,2,0,11
1025674,676465,2017-09-15,Senate,"W/O REF. TO FILE ACR136 Melendez By Morrell",38,0,2,0,40
1025675,684183,2018-01-08,Assembly,"Be adopted. To third reading",10,0,0,0,10
1025675,684752,2018-01-08,Assembly,"Be adopted. To Consent Calendar",10,0,0,0,10
1025675,685129,2018-01-12,Assembly,"ACR 137 GARCIA, E. Consent Calendar Second Day",65,0,12,0,77
1025675,694823,2018-02-05,Senate,"Special Consent ACR137",37,0,3,0,40
1025792,676142,2017-09-14,Senate,"Senate 3rd Reading SR67 Jackson",40,0,0,0,40
1025798,676049,2017-09-14,Senate,"Senate 3rd Reading SR65 Mitchell",40,0,0,0,40
1025805,676276,2017-09-14,Senate,"Senate 3rd Reading SR66 Bradford",39,0,1,0,40
1025812,676107,2017-09-14,Senate,"Senate 3rd Reading SR68 Moorlach",37,1,2,0,40
1045711,743235,2018-04-24,Senate,"Do pass",12,0,0,0,12
1045711,744947,2018-04-26,Senate,"Senate 3rd Reading SB821 Jackson et al",35,0,4,0,39
1045711,766439,2018-06-20,Assembly,"Do pass as amended",19,0,2,0,21
1045711,773987,2018-08-31,Senate,"Unfinished Business SB821 Jackson et al. Concurrence",39,0,1,0,40
1045711,773988,2018-08-31,Assembly,"SB 821 Jackson Senate Third Reading By LIMÓN",80,0,0,0,80
1045760,739688,2018-04-17,Senate,"Do pass, but first be re-referred to the Committee on [Judiciary]",10,0,1,0,11
1045760,743948,2018-04-24,Senate,"Do pass, but first be re-referred to the Committee on [Appropriations]",6,0,1,0,7
1045760,743949,2018-04-24,Senate,"[04-25-2018] set for [First] hearing: Reconsideration of favorable vote granted",7,0,0,0,7
1045760,743950,2018-04-24,Senate,"Do pass, but first be re-referred to the Committee on [Appropriations]",7,0,0,0,7
1045760,754954,2018-05-21,Senate,"Senate 3rd Reading SB819 Hill et al",39,0,0,0,39
1045760,766317,2018-06-20,Assembly,"Do pass and be re-referred to the Committee on [Judiciary]",15,0,0,0,15
1045760,768144,2018-06-26,Assembly,"Do pass as amended and be re-referred to the Committee on [Appropriations]",9,0,1,0,10
1045760,771086,2018-08-08,Assembly,"Do pass. To Consent Calendar",17,0,0,0,17
1045760,772996,2018-08-27,Assembly,"SB 819 Hill Senate Third Reading By EGGMAN",79,0,1,0,80
1045760,773184,2018-08-28,Senate,"Unfinished Business SB819 Hill et al. Concurrence",39,0,1,0,40
1045811,733795,2018-04-04,Senate,"Do pass, but first be re-referred to the Committee on [Judiciary]",5,2,0,0,7
1045811,743942,2018-04-24,Senate,"Do pass, but first be re-referred to the Committee on [Appropriations]",5,1,1,0,7
1045811,743943,2018-04-24,Senate,"[04-25-2018] set for [First] hearing: Reconsideration of favorable vote granted",7,0,0,0,7
1045811,743944,2018-04-24,Senate,"Do pass, but first be re-referred to the Committee on [Appropriations]",5,2,0,0,7
1045811,752074,2018-05-10,Senate,"Senate 3rd Reading SB818 Beall et al",24,12,3,0,39
1045811,764297,2018-06-18,Assembly,"Do pass and be re-referred to the Committee on [Judiciary]",11,0,0,0,11
1045811,768224,2018-06-26,Assembly,"Do pass and be re-referred to the Committee on [Appropriations]",10,0,0,0,10
1045811,771063,2018-08-08,Assembly,"Do pass. To Consent Calendar",17,0,0,0,17
1045811,771783,2018-08-16,Assembly,"SB 818 Beall Consent Calendar Second Day Regular Session",76,0,4,0,80
1045811,772134,2018-08-20,Senate,"Unfinished Business SB818 Beall et al. Concurrence",34,0,6,0,40
1045861,747655,2018-05-01,Senate,"Do pass as amended",5,1,1,0,7
1045861,754890,2018-05-21,Senate,"Senate 3rd Reading SB820 Leyva et al",29,7,3,0,39
1045861,769708,2018-07-03,Assembly,"Do pass",8,2,0,0,10
1045861,772497,2018-08-23,Assembly,"SB 820 Leyva Senate Third Reading By GONZALEZ FLETCHER",56,19,5,0,80
1045861,772676,2018-08-24,Senate,"Unfinished Business SB820 Leyva et al. Concurrence",30,8,2,0,40
1045914,683961,2018-01-04,Assembly,"Be adopted. To third reading",9,0,2,0,11
1045914,694836,2018-02-05,Senate,"Special Consent ACR141",37,0,3,0,40
1045915,725767,2018-03-20,Assembly,"Do pass",10,0,0,0,10
1045915,734740,2018-04-05,Assembly,"AB 1739 CHAU Third Reading Urgency",70,0,7,0,77
1045915,762938,2018-06-12,Senate,"Do pass and be ordered to the Consent Calendar",7,0,0,0,7
1045915,767967,2018-06-25,Senate,"Consent Calendar AB1739 Chau Urgency Clause",36,0,3,0,39
1045917,737401,2018-04-10,Assembly,"Do pass and be re-referred to the Committee on [Public Safety]",16,0,0,0,16
1045917,743112,2018-04-24,Assembly,"Do pass and be re-referred to the Committee on [Appropriations]",6,1,0,0,7
1045917,756417,2018-05-25,Assembly,"Do pass",15,1,1,0,17
1045917,757146,2018-05-29,Assembly,"AB 1752 LOW Assembly Third Reading",76,0,2,0,78
1045917,765018,2018-06-18,Senate,"Do pass, but first be re-referred to the Committee on [Public Safety]",9,0,0,0,9
1045917,768116,2018-06-26,Senate,"Do pass, but first be re-referred to the Committee on [Appropriations]",6,1,0,0,7
1045917,770434,2018-08-06,Senate,"Placed on suspense file",7,0,0,0,7
1045918,753281,2018-05-14,Assembly,"Do pass and be re-referred to the Committee on [Appropriations]",2,4,4,0,10
1045919,737475,2018-04-10,Assembly,"Do pass and be re-referred to the Committee on [Public Safety]",16,0,0,0,16
1045919,742869,2018-04-24,Assembly,"Do pass and be re-referred to the Committee on [Appropriations]",6,0,1,0,7
1045919,756579,2018-05-25,Assembly,"Do pass",16,0,1,0,17
1045919,756949,2018-05-29,Assembly,"AB 1751 LOW Assembly Third Reading",75,0,3,0,78
1045919,764894,2018-06-18,Senate,"Do pass, but first be re-referred to the Committee on [Public Safety]",8,0,1,0,9
1045919,768233,2018-06-26,Senate,"Do pass as amended, but first amend, and re-refer to the Committee on [Appropriations]",7,0,0,0,7
1045919,770568,2018-08-06,Senate,"Placed on suspense file",7,0,0,0,7
1045919,771607,2018-08-16,Senate,"Do pass as amended",7,0,0,0,7
1045919,773589,2018-08-29,Senate,"Assembly 3rd Reading AB1751 Low By Bates",38,0,2,0,40
1045919,773751,2018-08-30,Assembly,"AB 1751 LOW Concurrence in Senate Amendments",79,0,1,0,80
1045920,742871,2018-04-24,Assembly,"Do pass and be re-referred to the Committee on [Appropriations]",2,5,0,0,7
1045920,742872,2018-04-24,Assembly,Reconsideration,2,5,0,0,7
1045921,706135,2018-02-20,Senate,"Senate 3rd Reading SR70 Bradford",37,0,3,0,40
1045922,737349,2018-04-10,Assembly,"Do pass and be re-referred to the Committee on [Public Safety]",15,1,0,0,16
1045922,743122,2018-04-24,Assembly,"Do pass and be re-referred to the Committee on [Appropriations]",7,0,0,0,7
1045922,756397,2018-05-25,Assembly,"Do pass",16,0,1,0,17
1045922,757139,2018-05-29,Assembly,"AB 1753 LOW Assembly Third Reading",76,0,2,0,78
1045922,764820,2018-06-18,Senate,"Do pass, but first be re-referred to the Committee on [Public Safety]",9,0,0,0,9
1045922,768121,2018-06-26,Senate,"Do pass, but first be re-referred to the Committee on [Appropriations] with the recommendation: To Consent Calendar",7,0,0,0,7
1045922,770396,2018-08-06,Senate,"Placed on suspense file",7,0,0,0,7
1045922,771650,2018-08-16,Senate,"Do pass",7,0,0,0,7
1045922,773637,2018-08-29,Senate,"Assembly 3rd Reading AB1753 Low By Bates",39,0,1,0,40
1045922,773711,2018-08-30,Assembly,"AB 1753 LOW Concurrence in Senate Amendments",80,0,0,0,80
1045923,739570,2018-04-17,Senate,"Do pass as amended, but first amend, and re-refer to the Committee on [Judiciary]",8,3,0,0,11
1045923,743742,2018-04-24,Senate,"Do pass as amended, but first amend, and re-refer to the Committee on [Appropriations]",5,2,0,0,7
1045923,752751,2018-05-14,Senate,"Placed on suspense file",7,0,0,0,7
1045923,756672,2018-05-25,Senate,"Do pass",5,2,0,0,7
1045923,757749,2018-05-30,Senate,"Senate 3rd Reading SB822 Wiener et al",23,12,4,0,39
1045923,766086,2018-06-20,Assembly,"Do pass as amended and be re-referred to the Committee on [Privacy and Consumer Protection]",8,2,3,0,13
1045923,768267,2018-06-26,Assembly,"Do pass and be re-referred to the Committee on [Appropriations]",8,2,0,0,10
1045923,772444,2018-08-22,Assembly,"Do pass as amended",9,3,1,0,13
1045923,773760,2018-08-30,Assembly,"SB 822 Wiener Senate Third Reading By SANTIAGO",61,18,1,0,80
1045923,774050,2018-08-31,Senate,"Unfinished Business SB822 Wiener et al. Concurrence",27,12,1,0,40
1045924,734480,2018-04-05,Senate,"Senate 3rd Reading SCR88 Nguyen",37,0,2,0,39
1045924,738875,2018-04-16,Assembly,"Be adopted. To third reading",9,0,2,0,11
1045926,763581,2018-06-14,Senate,"Senate 3rd Reading SCR86 Nguyen",36,0,3,0,39
1045926,769323,2018-06-28,Assembly,"Be adopted. To Consent Calendar",9,0,2,0,11
1045926,769797,2018-07-05,Assembly,"SCR 86 Nguyen Consent Calendar Second Day Regular Session",69,0,11,0,80
1045927,725559,2018-03-20,Senate,"Do pass, but first be re-referred to the Committee on [Labor and Industrial Relations]",5,2,0,0,7
1045927,737192,2018-04-11,Senate,"Do pass, but first be re-referred to the Committee on [Appropriations]",4,1,0,0,5
1045927,742426,2018-04-23,Senate,"Placed on suspense file",7,0,0,0,7
1045927,756230,2018-05-25,Senate,"Do pass",5,2,0,0,7
1045927,757174,2018-05-29,Senate,"Senate 3rd Reading SB825 Beall et al",26,11,2,0,39
1045928,727646,2018-03-21,Assembly,"Do pass as amended and be re-referred to the Committee on [Appropriations]",6,0,1,0,7
1045928,756778,2018-05-25,Assembly,"Do pass",16,0,1,0,17
1045928,756964,2018-05-29,Assembly,"AB 1747 RODRIGUEZ Assembly Third Reading",77,0,1,0,78
1045928,766150,2018-06-20,Senate,"Do pass as amended, but first amend, and re-refer to the Committee on [Appropriations]",7,0,0,0,7
1045928,770823,2018-08-06,Senate,"Placed on suspense file",7,0,0,0,7
1045928,771888,2018-08-16,Senate,"Do pass as amended",7,0,0,0,7
1045928,772619,2018-08-23,Senate,"Assembly 3rd Reading AB1747 Rodriguez et al. By Allen",39,0,1,0,40
1045928,772979,2018-08-27,Assembly,"AB 1747 RODRIGUEZ Concurrence in Senate Amendments",79,0,1,0,80
1045929,701219,2018-02-13,Assembly,"Do pass as amended. To Consent Calendar",9,0,1,0,10
1045929,706039,2018-02-20,Assembly,"AB 1736 CUNNINGHAM Consent Calendar Second Day",67,0,10,0,77
1045929,753412,2018-05-15,Senate,"Do pass",7,0,0,0,7
1045929,767243,2018-06-21,Senate,"Assembly 3rd Reading AB1736 Cunningham By Wiener",36,0,3,0,39
1045930,752966,2018-05-14,Senate,"Senate 3rd Reading SR71 Nguyen",38,0,1,0,39
1045931,717920,2018-03-06,Assembly,"Do pass and be re-referred to the Committee on [Appropriations]",6,0,1,0,7
1045931,756619,2018-05-25,Assembly,"Do pass",15,0,2,0,17
1045931,757123,2018-05-29,Assembly,"AB 1735 CUNNINGHAM Assembly Third Reading",76,2,0,0,78
1045931,765680,2018-06-19,Senate,"Do pass, but first be re-referred to the Committee on [Appropriations]",4,0,3,0,7
1045931,770802,2018-08-06,Senate,"Placed on suspense file",7,0,0,0,7
1045931,772043,2018-08-16,Senate,"Do pass",7,0,0,0,7
1045931,772708,2018-08-24,Senate,"Special Consent AB1735",39,0,1,0,40
1045932,686243,2018-01-18,Senate,"Senate 3rd Reading SJR15 Dodd et al",38,0,2,0,40
1045933,717898,2018-03-06,Assembly,"Do pass as amended",7,0,0,0,7
1045933,734498,2018-04-05,Assembly,"AB 1746 CERVANTES Assembly Third Reading",69,0,8,0,77
1045933,753505,2018-05-15,Senate,"Do pass, but first be re-referred to the Committee on [Appropriations]",7,0,0,0,7
1045933,767893,2018-06-25,Senate,"Placed on suspense file",7,0,0,0,7
1045933,771679,2018-08-16,Senate,"Do pass as amended",7,0,0,0,7
1045933,772424,2018-08-22,Senate,"Assembly 3rd Reading AB1746 Cervantes et al. By Stern",39,0,1,0,40
1045933,772915,2018-08-27,Assembly,"AB 1746 CERVANTES Concurrence in Senate Amendments",80,0,0,0,80
1045935,744892,2018-04-26,Assembly,"Be re-referred to the Committee on [Budget]",8,0,3,0,11
1045936,727739,2018-03-21,Assembly,"Do pass and be re-referred to the Committee on [Appropriations]",6,0,1,0,7
1045936,756306,2018-05-25,Assembly,"Do pass as amended",14,0,3,0,17
1045936,757547,2018-05-30,Assembly,"AB 1743 O'DONNELL Assembly Third Reading",78,0,0,0,78
1045936,775353,2018-05-25,Assembly,,6,0,3,0,9
1045937,685115,2018-01-12,Senate,"Senate 3rd Reading SCR85 Bradford",30,0,10,0,40
1045938,740656,2018-04-17,Senate,"Do pass, but first be re-referred to the Committee on [Judiciary]",13,0,0,0,13
1045938,751280,2018-05-09,Senate,"Do pass and be ordered to the Consent Calendar",6,0,0,0,6
1045938,754339,2018-05-17,Senate,"Consent Calendar SB829",38,0,1,0,39
1045938,760917,2018-06-07,Assembly,"Be re-referred to the Committees on [Business and Professions] and [Revenue and Taxation]",6,0,5,0,11
1045938,765167,2018-06-19,Assembly,"Do pass and be re-referred to the Committee on [Revenue and Taxation]",13,1,5,0,19
1045938,768285,2018-06-25,Assembly,"Do pass as amended and be re-referred to the Committee on [Appropriations]",8,1,1,0,10
1045938,771792,2018-08-16,Assembly,"Do pass as amended",12,0,5,0,17
1045938,773490,2018-08-29,Assembly,"SB 829 Wiener Third Reading Urgency By WOOD",73,3,4,0,80
1045938,773784,2018-08-30,Senate,"That the Assembly amendments be concurred in",6,0,1,0,7
1045938,774116,2018-08-31,Senate,"Unfinished Business SB829 Wiener et al. Urgency Clause Concurrence",35,2,3,0,40
1045939,736105,2018-04-10,Senate,"Do pass as amended",5,1,1,0,7
1045939,742229,2018-04-23,Senate,"Senate 3rd Reading SB823 Hill et al",28,7,4,0,39
1045939,766955,2018-06-21,Assembly,"Be re-referred to the Committee on [Health]",9,0,2,0,11
1045939,768257,2018-06-26,Assembly,"Do pass as amended and be re-referred to the Committee on [Appropriations]",15,0,0,0,15
1045939,771566,2018-08-16,Assembly,"Do pass",17,0,0,0,17
1045939,773758,2018-08-30,Assembly,"SB 823 Hill Senate Third Reading By WOOD",80,0,0,0,80
1045939,773957,2018-08-31,Senate,"That the Assembly amendments be concurred in",9,0,0,0,9
1045939,774143,2018-08-31,Senate,"Unfinished Business SB823 Hill Concurrence",39,0,1,0,40
1045941,744852,2018-04-25,Assembly,"Do pass and be re-referred to the Committee on [Appropriations]",6,0,1,0,7
1045941,756581,2018-05-25,Assembly,"Do pass",12,3,2,0,17
1045941,757633,2018-05-30,Assembly,"AB 1754 MCCARTY Assembly Third Reading",61,11,6,0,78
1045941,768949,2018-06-27,Senate,"Do pass, but first be re-referred to the Committee on [Appropriations]",7,0,0,0,7
1045941,770385,2018-08-06,Senate,"Placed on suspense file",7,0,0,0,7
1045942,740562,2018-04-17,Senate,"Do pass, but first be re-referred to the Committee on [Governance and Finance]",4,6,3,0,13
1045942,740563,2018-04-17,Senate,"[First] hearing set for [04-18-2018]: Failed passage in Committee. Reconsideration granted",13,0,0,0,13
1045943,685439,2018-01-16,Assembly,"Be adopted. To third reading",10,0,1,0,11
1045943,705711,2018-02-20,Senate,"Special Consent ACR140 Bonta et al",37,0,3,0,40
1045944,745268,2018-04-25,Senate,"Do pass as amended, but first amend, and re-refer to the Committee on [Appropriations]",9,0,4,0,13
1045944,755277,2018-05-22,Senate,"Placed on suspense file",7,0,0,0,7
1045944,756321,2018-05-25,Senate,"Do pass",5,1,1,0,7
1045944,757087,2018-05-29,Senate,"Senate 3rd Reading SB824 Lara et al",27,5,7,0,39
1045944,766165,2018-06-20,Assembly,"Do pass and be re-referred to the Committee on [Judiciary]",8,0,5,0,13
1045944,768159,2018-06-26,Assembly,"Do pass as amended and be re-referred to the Committee on [Appropriations]",8,0,2,0,10
1045944,771483,2018-08-15,Assembly,"Do pass",17,0,0,0,17
1045944,773095,2018-08-28,Assembly,"SB 824 Lara Senate Third Reading By AGUIAR-CURRY",79,0,1,0,80
1045944,773416,2018-08-29,Senate,"Unfinished Business SB824 Lara et al. Concurrence",39,0,1,0,40
1045945,739863,2018-04-16,Assembly,"Do pass as amended and be re-referred to the Committee on [Appropriations]",6,2,2,0,10
1045945,751099,2018-05-09,Assembly,"Do pass",12,4,1,0,17
1045945,754934,2018-05-21,Assembly,"AB 1741 BONTA Assembly Third Reading",61,12,5,0,78
1045945,762981,2018-06-13,Senate,"Do pass as amended, but first amend, and re-refer to the Committee on [Appropriations]",6,1,0,0,7
1045945,771184,2018-08-09,Senate,"Assembly 3rd Reading AB1741 Bonta By Hertzberg Urgency Clause",29,6,4,0,39
1045945,771301,2018-08-13,Assembly,"AB 1741 BONTA Concurrence - Urgency Added",66,11,3,0,80
1045946,741118,2018-04-18,Senate,"Do pass, but first be re-referred to the Committee on [Judiciary]",5,1,1,0,7
1045946,743825,2018-04-24,Senate,"Do pass, but first be re-referred to the Committee on [Appropriations]",5,1,1,0,7
1045946,743826,2018-04-24,Senate,"[04-25-2018] set for [First] hearing: Reconsideration of favorable vote granted",7,0,0,0,7
1045946,743827,2018-04-24,Senate,"Do pass, but first be re-referred to the Committee on [Appropriations]",5,2,0,0,7
1045946,750335,2018-05-07,Senate,"Placed on suspense file",6,0,1,0,7
1045946,756394,2018-05-25,Senate,"Do pass as amended",5,2,0,0,7
1045946,758509,2018-05-31,Senate,"Senate 3rd Reading SB826 Jackson et al",22,11,6,0,39
1045946,767853,2018-06-25,Assembly,"Do pass and be re-referred to the Committee on [Judiciary]",8,0,3,0,11
1045946,768280,2018-06-26,Assembly,"Do pass and be re-referred to the Committee on [Appropriations]",7,1,2,0,10
1045946,771789,2018-08-16,Assembly,"Do pass as amended",12,0,5,0,17
1045946,773460,2018-08-29,Assembly,"SB 826 Jackson Senate Third Reading By GONZALEZ FLETCHER",41,26,13,0,80
1045946,773768,2018-08-30,Senate,"Unfinished Business SB826 Jackson et al. Concurrence",23,9,8,0,40
1045947,743939,2018-04-24,Senate,"Do pass as amended, but first amend, and re-refer to the Committee on [Appropriations]",10,0,3,0,13
1045947,752581,2018-05-14,Senate,"Placed on suspense file",7,0,0,0,7
1045947,756351,2018-05-25,Senate,"Do pass as amended",5,0,2,0,7
1045947,757678,2018-05-30,Senate,"Senate 3rd Reading SB828 Wiener",23,10,6,0,39
1045947,766159,2018-06-20,Assembly,"Do pass and be re-referred to the Committee on [Local Government]",4,2,1,0,7
1045947,768699,2018-06-27,Assembly,"Do pass as amended and be re-referred to the Committee on [Appropriations]",6,2,1,0,9
1045947,771541,2018-08-16,Assembly,"Do pass as amended",12,5,0,0,17
1045947,772698,2018-08-24,Assembly,"SB 828 Wiener Senate Third Reading Amend By BLOOM Set #1",46,23,11,0,80
1045947,773605,2018-08-29,Assembly,"SB 828 Wiener Senate Third Reading By BLOOM",53,21,6,0,80
1045947,773759,2018-08-30,Senate,"Unfinished Business SB828 Wiener Concurrence",22,13,5,0,40
1045948,739529,2018-04-17,Assembly,"Do pass and be re-referred to the Committee on [Revenue and Taxation]",7,0,0,0,7
1045948,753305,2018-05-14,Assembly,"Do pass and be re-referred to the Committee on [Appropriations]",9,0,1,0,10
1045948,756350,2018-05-25,Assembly,"Do pass as amended",15,1,1,0,17
1045948,757751,2018-05-30,Assembly,"AB 1734 CALDERON Assembly Third Reading",74,2,2,0,78
1045948,775151,2018-05-25,Assembly,"Do pass as amendedlass=""columnField"" style=""text-align:left"">",9,1,1,0,11
1045949,722775,2018-03-14,Senate,"Do pass as amended, but first amend, and re-refer to the Committee on [Appropriations]",4,2,0,0,6
1045949,738819,2018-04-16,Senate,"Placed on suspense file",7,0,0,0,7
1045949,756235,2018-05-25,Senate,"Do pass as amended",5,2,0,0,7
1045949,757725,2018-05-30,Senate,"Senate 3rd Reading SB830 Dodd et al",25,13,1,0,39
1045949,768765,2018-06-27,Assembly,"Do pass and be re-referred to the Committee on [Appropriations]",5,0,2,0,7
1045949,771552,2018-08-16,Assembly,"Do pass as amended",12,1,4,0,17
1045949,772992,2018-08-27,Assembly,"SB 830 Dodd Senate Third Reading By MULLIN",72,2,6,0,80
1045949,773138,2018-08-28,Senate,"Unfinished Business SB830 Dodd et al. Concurrence",28,11,1,0,40
1045950,738412,2018-04-11,Assembly,"Do pass and be re-referred to the Committee on [Health] with recommendation: To Consent Calendar",7,0,0,0,7
1045950,743460,2018-04-24,Assembly,"Do pass as amended and be re-referred to the Committee on [Appropriations]",15,0,0,0,15
1045950,751164,2018-05-09,Assembly,"Do pass. To Consent Calendar",16,0,1,0,17
1045950,754333,2018-05-17,Assembly,"AB 1744 MCCARTY Consent Calendar Second Day Regular Session",73,0,5,0,78
1045950,762965,2018-06-13,Senate,"Do pass, but first be re-referred to the Committee on [Health]",7,0,0,0,7
1045950,765992,2018-06-20,Senate,"Do pass, but first be re-referred to the Committee on [Appropriations]",8,0,1,0,9
1045950,770442,2018-08-06,Senate,"Placed on suspense file",7,0,0,0,7
1045951,684189,2018-01-08,Assembly,"Be adopted. To third reading",10,0,1,0,11
1045951,694849,2018-02-05,Senate,"Special Consent ACR139",37,0,3,0,40
1045952,739564,2018-04-16,Assembly,"Do pass and be re-referred to the Committee on [Privacy and Consumer Protection]",8,1,2,0,11
1045952,747843,2018-05-01,Assembly,"Do pass as amended",10,0,0,0,10
1045952,752073,2018-05-10,Assembly,"AB 1742 QUIRK Assembly Third Reading",73,0,5,0,78
1045953,717733,2018-03-06,Assembly,"Do pass and be re-referred to the Committee on [Appropriations]",2,4,1,0,7
1045953,717734,2018-03-06,Assembly,Reconsideration,7,0,0,0,7
1045953,743536,2018-04-24,Assembly,"Do pass and be re-referred to the Committee on [Appropriations]",2,5,0,0,7
1045954,733796,2018-04-04,Assembly,"Do pass",13,0,0,0,13
1045954,738354,2018-04-12,Assembly,"AB 1749 DALY Assembly Third Reading",69,0,8,0,77
1045954,768688,2018-06-27,Senate,"Do pass",4,0,1,0,5
1045954,772853,2018-08-27,Senate,"Assembly 3rd Reading AB1749 Daly et al. By Bates",39,0,1,0,40
1045954,773387,2018-08-29,Assembly,"AB 1749 DALY Concurrence in Senate Amendments",80,0,0,0,80
1045954,777400,2018-08-27,Senate,"Assembly 3rd Reading A",4,0,1,0,5
1045955,735524,2018-04-09,Assembly,"Be adopted. To Consent Calendar",12,0,2,0,14
1045955,738246,2018-04-12,Assembly,"ACR 142 MATHIS Consent Calendar Second Day Regular Session",68,0,9,0,77
1045955,769746,2018-07-03,Senate,"Be adopted, but first be re-referred to the Committee on [Appropriations] with recommendation: To Consent Calendar",12,0,1,0,13
1045955,771307,2018-08-13,Senate,"Consent Calendar ACR142",37,0,3,0,40
1045956,771210,2018-08-09,Senate,"Senate 3rd Reading SCR87 Nguyen",35,0,4,0,39
1045956,771803,2018-08-16,Assembly,"Be adopted. To Consent Calendar",9,0,2,0,11
1045956,772595,2018-08-23,Assembly,"SCR 87 Nguyen Consent Calendar Second Day Regular Session",75,0,5,0,80
1045957,735620,2018-04-09,Assembly,"Do pass and be re-referred to the Committee on [Appropriations] with recommendation: To Consent Calendar",12,0,2,0,14
1045957,740686,2018-04-18,Assembly,"Do pass. To Consent Calendar",15,0,2,0,17
1045957,744798,2018-04-26,Assembly,"AB 1755 STEINORTH Consent Calendar Second Day Regular Session",74,0,4,0,78
1045957,762149,2018-06-12,Senate,"Do pass, but first be re-referred to the Committee on [Appropriations] with the recommendation: To Consent Calendar",12,0,1,0,13
1045957,769573,2018-07-02,Senate,"Consent Calendar AB1755",37,0,2,0,39
1046792,736106,2018-04-09,Assembly,"Do pass and be re-referred to the Committee on [Appropriations]",7,3,0,0,10
1046792,756240,2018-05-25,Assembly,"Do pass",12,4,1,0,17
1046792,757517,2018-05-30,Assembly,"AB 1775 MURATSUCHI Assembly Third Reading",45,24,9,0,78
1046792,768120,2018-06-26,Senate,"Do pass, but first be re-referred to the Committee on [Appropriations]",7,2,0,0,9
1046792,770398,2018-08-06,Senate,"Placed on suspense file",7,0,0,0,7
1046792,771695,2018-08-16,Senate,"Do pass",5,1,1,0,7
1046792,773218,2018-08-28,Senate,"Assembly 3rd Reading AB1775 Muratsuchi et al. By Jackson",26,9,5,0,40
1046792,773358,2018-08-29,Assembly,"AB 1775 MURATSUCHI Concurrence in Senate Amendments",45,25,10,0,80
1046794,684180,2018-01-08,Assembly,"Be adopted. To third reading",10,0,1,0,11
1046794,694875,2018-02-05,Senate,"Special Consent ACR144",37,0,3,0,40
1046795,736179,2018-04-10,Assembly,"Do pass and be re-referred to the Committee on [Appropriations]",6,1,0,0,7
1046798,685456,2018-01-16,Senate,"Be adopted. Ordered to third reading",4,2,1,0,7
1046798,686994,2018-01-22,Senate,"Senate 3rd Reading SR72 Leyva et al",25,11,4,0,40
1046799,736074,2018-04-10,Assembly,"Do pass as amended and be re-referred to the Committee on [Judiciary]",12,0,3,0,15
1046799,744791,2018-04-26,Assembly,"AB 1776 STEINORTH Assembly Third Reading",72,0,6,0,78
1046799,765956,2018-06-20,Senate,"Do pass as amended, and be ordered to the Consent Calendar",8,0,1,0,9
1046799,771266,2018-08-13,Senate,"Assembly 3rd Reading AB1776 Steinorth et al. By Glazer",36,0,4,0,40
1046799,772156,2018-08-20,Assembly,"AB 1776 STEINORTH Concurrence in Senate Amendments",79,0,1,0,80
1046800,722306,2018-03-13,Senate,"Do pass as amended, but first amend, and re-refer to the Committee on [Appropriations]",6,2,1,0,9
1046800,738905,2018-04-16,Senate,"Placed on suspense file",7,0,0,0,7
1046800,756289,2018-05-25,Senate,"Do pass",5,2,0,0,7
1046800,757147,2018-05-29,Senate,"Senate 3rd Reading SB836 Glazer et al",27,11,1,0,39
1046800,762281,2018-06-12,Assembly,"Do pass and be re-referred to the Committee on [Appropriations]",10,5,0,0,15
1046800,771833,2018-08-16,Assembly,"Do pass as amended",12,5,0,0,17
1046800,773340,2018-08-29,Assembly,"SB 836 Glazer Senate Third Reading By LEVINE",54,25,1,0,80
1046800,773790,2018-08-30,Senate,"Unfinished Business SB836 Glazer et al. Concurrence",26,11,3,0,40
1046802,755712,2018-05-23,Assembly,"Do pass",16,0,1,0,17
1046802,756694,2018-05-25,Assembly,"AB 1773 APPR. Third Reading Urgency By GONZALEZ FLETCHER",70,0,8,0,78
1046802,767997,2018-06-25,Senate,"Do pass",7,0,0,0,7
1046802,769632,2018-07-02,Senate,"Assembly 3rd Reading AB1773 APPR. (Gonzalez Fletcher) Urgency Clause",37,0,2,0,39
1046803,738207,2018-04-12,Assembly,"Be re-referred to the Committee on [Natural Resources]",7,0,4,0,11
1046803,743002,2018-04-23,Assembly,"Amend, and re-refer to the Committee on [Natural Resources]",10,0,0,0,10
1046803,749967,2018-05-07,Assembly,"Do pass as amended and be re-referred to the Committee on [Appropriations]",9,0,0,0,9
1046803,755710,2018-05-23,Assembly,"Do pass. To Consent Calendar",16,0,1,0,17
1046803,757027,2018-05-29,Assembly,"AB 1759 MCCARTY Consent Calendar Second Day",78,0,0,0,78
1046803,768148,2018-06-26,Senate,"Do pass, but first be re-referred to the Committee on [Appropriations] with the recommendation: To Consent Calendar",9,0,0,0,9
1046803,771265,2018-08-13,Senate,"Consent Calendar AB1759 McCarty et al. Urgency Clause",37,0,3,0,40
1046805,740566,2018-04-18,Assembly,"Do pass. To Consent Calendar",13,0,0,0,13
1046805,744867,2018-04-26,Assembly,"AB 1772 AGUIAR-CURRY Consent Calendar Second Day",74,0,4,0,78
1046805,763060,2018-06-13,Senate,"Do pass as amended",11,0,2,0,13
1046805,773556,2018-08-29,Senate,"Assembly 3rd Reading AB1772 Aguiar-Curry et al. By McGuire Urgency Clause",26,4,10,0,40
1046805,773557,2018-08-29,Senate,"Assembly 3rd Reading AB1772 Aguiar-Curry et al. By McGuire Reconsider",38,0,2,0,40
1046805,774001,2018-08-31,Senate,"Assembly 3rd Reading AB1772 Aguiar-Curry et al. By McGuire Urgency Clause",38,0,2,0,40
1046805,774002,2018-08-31,Assembly,"AB 1772 Aguiar-Curry Concurrence - Urgency Added",80,0,0,0,80
1046806,725466,2018-03-20,Assembly,"Do pass and be re-referred to the Committee on [Appropriations]",15,0,0,0,15
1046806,733971,2018-04-04,Assembly,"Do pass. To Consent Calendar",15,0,2,0,17
1046806,738224,2018-04-12,Assembly,"AB 1766 MAIENSCHEIN Consent Calendar Second Day Regular Session",68,0,9,0,77
1046806,762956,2018-06-13,Senate,"Do pass, but first be re-referred to the Committee on [Judiciary] with the recommendation: To Consent Calendar",8,0,1,0,9
1046806,766015,2018-06-19,Senate,"Do pass, but first be re-referred to the Committee on [Appropriations] with the recommendation: To Consent Calendar",7,0,0,0,7
1046806,770899,2018-08-06,Senate,"Placed on suspense file",7,0,0,0,7
1046806,772055,2018-08-16,Senate,"Do pass",7,0,0,0,7
1046806,772704,2018-08-24,Senate,"Special Consent AB1766",39,0,1,0,40
1046807,747806,2018-05-02,Assembly,"Do pass and be re-referred to the Committee on [Judiciary]",5,1,1,0,7
1046807,750663,2018-05-08,Assembly,"Do pass as amended",8,1,1,0,10
1046807,758647,2018-05-31,Assembly,"AB 1761 MURATSUCHI Assembly Third Reading",48,18,12,0,78
1046807,766170,2018-06-19,Senate,"Do pass, but first be re-referred to the Committee on [Labor and Industrial Relations]",4,1,2,0,7
1046807,768686,2018-06-27,Senate,"Do pass as amended, but first amend, and re-refer to the Committee on [Appropriations]",4,1,0,0,5
1046807,770292,2018-08-06,Senate,"Placed on suspense file",7,0,0,0,7
1046808,739617,2018-04-16,Senate,"Do pass as amended, but first amend, and re-refer to the Committee on [Appropriations]",6,2,1,0,9
1046808,746125,2018-04-30,Senate,"Placed on suspense file",6,0,1,0,7
1046808,756328,2018-05-25,Senate,"Do pass as amended",5,1,1,0,7
1046808,757643,2018-05-30,Senate,"Senate 3rd Reading SB834 Jackson et al",24,8,7,0,39
1046808,768220,2018-06-25,Assembly,"Do pass and be re-referred to the Committee on [Appropriations]",7,3,0,0,10
1046808,771562,2018-08-16,Assembly,"Do pass",12,5,0,0,17
1046808,772918,2018-08-27,Assembly,"SB 834 Jackson Senate Third Reading By MURATSUCHI",45,25,10,0,80
1046808,773314,2018-08-29,Senate,"Unfinished Business SB834 Jackson et al. Concurrence",28,7,5,0,40
1046809,751468,2018-05-09,Assembly,"Do pass as amended and be re-referred to the Committee on [Appropriations]",7,0,0,0,7
1046810,703987,2018-02-16,Assembly,"Be adopted. To third reading",7,0,4,0,11
1046810,716378,2018-03-05,Senate,"Assembly 3rd Reading ACR143 Muratsuchi et al. By Pan",36,0,3,0,39
1046811,725731,2018-03-20,Assembly,"Do pass and be re-referred to the Committee on [Appropriations] with recommendation: To Consent Calendar",15,0,0,0,15
1046811,756662,2018-05-25,Assembly,"Do pass as amended",16,0,1,0,17
1046811,757842,2018-05-30,Assembly,"AB 1780 MAIENSCHEIN Assembly Third Reading",77,0,1,0,78
1046811,766702,2018-06-20,Senate,"Do pass, but first be re-referred to the Committee on [Judiciary]",8,0,1,0,9
1046811,768715,2018-06-26,Senate,"Do pass, but first be re-referred to the Committee on [Appropriations] with the recommendation: To Consent Calendar",7,0,0,0,7
1046811,770911,2018-08-06,Senate,"Placed on suspense file",7,0,0,0,7
1046814,722220,2018-03-13,Senate,"Do pass as amended, but first amend, and re-refer to the Committee on [Appropriations]",6,2,1,0,9
1046814,738870,2018-04-16,Senate,"Placed on suspense file",7,0,0,0,7
1046814,756279,2018-05-25,Senate,"Do pass",5,2,0,0,7
1046814,757182,2018-05-29,Senate,"Senate 3rd Reading SB835 Glazer et al",26,11,2,0,39
1046814,762276,2018-06-12,Assembly,"Do pass and be re-referred to the Committee on [Appropriations]",10,5,0,0,15
1046814,771866,2018-08-16,Assembly,"Do pass as amended",12,5,0,0,17
1046814,773566,2018-08-29,Assembly,"SB 835 Glazer Senate Third Reading By LEVINE",55,25,0,0,80
1046814,773686,2018-08-30,Senate,"Unfinished Business SB835 Glazer et al. Concurrence",26,11,3,0,40
1046815,724662,2018-03-19,Assembly,"Do pass and be re-referred to the Committee on [Appropriations] with recommendation: To Consent Calendar",13,0,1,0,14
1046816,733260,2018-04-03,Senate,"Be adopted as amended",6,0,1,0,7
1046816,752113,2018-05-10,Senate,"Senate 3rd Reading SJR16 Wilk et al",38,0,1,0,39
1046816,762122,2018-06-12,Assembly,"Be adopted. To third reading",8,0,2,0,10
1046816,767934,2018-06-25,Assembly,"SJR 16 Wilk Senate Third Reading By LACKEY",60,0,20,0,80
1046817,736656,2018-04-10,Senate,"Do pass, but first be re-referred to the Committee on [Appropriations]",12,0,0,0,12
1046817,742468,2018-04-23,Senate,"Placed on suspense file",7,0,0,0,7
1046817,756305,2018-05-25,Senate,"Do pass",7,0,0,0,7
1046817,758478,2018-05-31,Senate,"Special Consent SB833 McGuire et al",39,0,0,0,39
1046817,769207,2018-06-28,Assembly,"Do pass as amended and be re-referred to the Committee on [Appropriations]",16,0,5,0,21
1046817,771121,2018-08-08,Assembly,"Do pass",17,0,0,0,17
1046817,772771,2018-08-27,Assembly,"SB 833 McGuire Senate Third Reading By AGUIAR-CURRY",79,0,1,0,80
1046817,773232,2018-08-28,Senate,"Unfinished Business SB833 McGuire et al. Concurrence",39,0,1,0,40
1046818,722321,2018-03-13,Assembly,"Do pass and be re-referred to the Committee on [Appropriations]",9,3,1,0,13
1046818,756593,2018-05-25,Assembly,"Do pass",12,4,1,0,17
1046818,756985,2018-05-29,Assembly,"AB 1767 CERVANTES Assembly Third Reading",54,24,0,0,78
1046818,766668,2018-06-20,Senate,"Do pass, but first be re-referred to the Committee on [Appropriations]",5,2,0,0,7
1046818,769533,2018-07-02,Senate,"Placed on suspense file",7,0,0,0,7
1046819,737363,2018-04-11,Assembly,"Do pass as amended and be re-referred to the Committee on [Local Government]",6,1,0,0,7
1046819,744817,2018-04-25,Assembly,"Do pass and be re-referred to the Committee on [Appropriations]",6,2,1,0,9
1046819,756372,2018-05-25,Assembly,"Do pass as amended",12,4,1,0,17
1046819,758617,2018-05-31,Assembly,"AB 1771 BLOOM Assembly Third Reading",48,27,3,0,78
1046819,768189,2018-06-26,Senate,"Do pass, but first be re-referred to the Committee on [Appropriations]",8,4,1,0,13
1046819,770364,2018-08-06,Senate,"Placed on suspense file",7,0,0,0,7
1046819,771663,2018-08-16,Senate,"Do pass",5,2,0,0,7
1046819,773577,2018-08-29,Senate,"Assembly 3rd Reading AB1771 Bloom By Wiener",24,14,2,0,40
1046819,773788,2018-08-30,Assembly,"AB 1771 BLOOM Concurrence in Senate Amendments",49,27,4,0,80
1046821,744856,2018-04-25,Assembly,"Do pass and be re-referred to the Committee on [Appropriations]",6,1,0,0,7
1046823,751051,2018-05-08,Assembly,"Do pass",1,1,8,0,10
1046824,736176,2018-04-10,Assembly,"Do pass and be re-referred to the Committee on [Appropriations]",13,0,2,0,15
1046824,756620,2018-05-25,Assembly,"Do pass as amended",15,0,2,0,17
1046824,757819,2018-05-30,Assembly,"AB 1762 STEINORTH Assembly Third Reading",78,0,0,0,78
1046824,768334,2018-06-26,Senate,"Do pass as amended, but first amend, and re-refer to the Committee on [Appropriations] with the recommendation: To Consent Calendar",9,0,0,0,9
1046824,770946,2018-08-06,Senate,"Placed on suspense file",7,0,0,0,7
1046824,772023,2018-08-16,Senate,"Do pass as amended",7,0,0,0,7
1046824,772428,2018-08-22,Senate,"Assembly 3rd Reading AB1762 Steinorth et al. By Nguyen",39,0,1,0,40
1046824,772429,2018-08-22,Senate,"Assembly 3rd Reading AB1762 Steinorth et al. By Nguyen Reconsider",39,0,1,0,40
1046824,773020,2018-08-27,Senate,"Assembly 3rd Reading AB1762 Steinorth et al. By Nguyen",39,0,1,0,40
1046824,773308,2018-08-29,Assembly,"AB 1762 STEINORTH Concurrence in Senate Amendments",79,0,1,0,80
1046826,740756,2018-04-17,Senate,"Do pass, but first be re-referred to the Committee on [Governance and Finance]",11,0,2,0,13
1046826,743704,2018-04-25,Senate,"Do pass as amended, but first amend, and re-refer to the Committee on [Appropriations]",6,0,1,0,7
1046826,755325,2018-05-22,Senate,"Placed on suspense file",7,0,0,0,7
1046826,756265,2018-05-25,Senate,"Do pass as amended",7,0,0,0,7
1046826,757746,2018-05-30,Senate,"Senate 3rd Reading SB831 Wieckowski et al",33,1,5,0,39
1046826,766030,2018-06-20,Assembly,"Do pass and be re-referred to the Committee on [Local Government]",6,1,0,0,7
1046827,751426,2018-05-09,Assembly,"Do pass",7,0,0,0,7
1046827,752641,2018-05-14,Assembly,"AB 1768 STEINORTH Assembly Third Reading",77,0,1,0,78
1046827,762240,2018-06-12,Senate,"Do pass and be ordered to the Consent Calendar",12,0,1,0,13
1046827,767512,2018-06-18,Senate,"Consent Calendar AB1768 Steinorth",37,0,1,0,38
1046828,740575,2018-04-18,Senate,"Do pass as amended, but first amend, and re-refer to the Committee on [Appropriations]",5,1,1,0,7
1046828,749806,2018-05-07,Senate,"Placed on suspense file",6,0,1,0,7
1046829,738172,2018-04-11,Assembly,"Do pass. To Consent Calendar",9,0,0,0,9
1046829,741416,2018-04-19,Assembly,"AB 1770 STEINORTH Consent Calendar Second Day Regular Session",71,0,7,0,78
1046829,766522,2018-06-20,Senate,"Do pass",7,0,0,0,7
1046829,772600,2018-08-23,Senate,"Assembly 3rd Reading AB1770 Steinorth By Leyva",38,0,2,0,40
1046830,722229,2018-03-13,Assembly,"Be adopted. To third reading",13,0,0,0,13
1046830,735650,2018-04-09,Senate,"Special Consent ACR145",39,0,0,0,39
1048658,725420,2018-03-20,Assembly,"Do pass as amended and be re-referred to the Committee on [Appropriations]",13,0,3,0,16
1048658,737455,2018-04-11,Assembly,"Do pass. To Consent Calendar",15,0,2,0,17
1048658,741412,2018-04-19,Assembly,"AB 1791 WALDRON Consent Calendar Second Day Regular Session",71,0,7,0,78
1048658,762052,2018-06-11,Senate,"Do pass, but first be re-referred to the Committee on [Appropriations] with the recommendation: To Consent Calendar",8,0,1,0,9
1048658,769532,2018-07-02,Senate,"Consent Calendar AB1791",37,0,2,0,39
1048662,726062,2018-03-20,Assembly,"Do pass as amended and be re-referred to the Committee on [Appropriations]",15,0,0,0,15
1048662,737450,2018-04-11,Assembly,"Do pass. To Consent Calendar",15,0,2,0,17
1048662,741399,2018-04-19,Assembly,"AB 1787 SALAS Consent Calendar Second Day Regular Session",71,0,7,0,78
1048662,763100,2018-06-13,Senate,"Do pass, but first be re-referred to the Committee on [Appropriations]",8,0,1,0,9
1048662,770822,2018-08-06,Senate,"Assembly 3rd Reading AB1787 Salas et al. By Galgiani",36,0,3,0,39
1048662,771427,2018-08-13,Assembly,"AB 1787 SALAS Concurrence in Senate Amendments",77,0,3,0,80
1048667,686929,2018-01-22,Assembly,"Be adopted. To third reading",8,0,3,0,11
1048667,705915,2018-02-20,Senate,"Special Consent ACR146",37,0,3,0,40
1048672,733302,2018-04-03,Assembly,"Do pass as amended and be re-referred to the Committee on [Appropriations]",15,0,0,0,15
1048672,744395,2018-04-25,Assembly,"Do pass. To Consent Calendar",17,0,0,0,17
1048672,748863,2018-05-03,Assembly,"AB 1785 NAZARIAN Consent Calendar Second Day Regular Session",71,0,7,0,78
1048672,760498,2018-06-06,Senate,"Do pass, but first be re-referred to the Committee on [Appropriations] with the recommendation: To Consent Calendar",8,0,1,0,9
1048672,769642,2018-07-02,Senate,"Consent Calendar AB1785",37,0,2,0,39
1048677,717865,2018-03-06,Assembly,"Do pass as amended and be re-referred to the Committee on [Appropriations]",7,0,0,0,7
1048677,756406,2018-05-25,Assembly,"Do pass as amended",16,0,1,0,17
1048677,757700,2018-05-30,Assembly,"AB 1784 MAIENSCHEIN Assembly Third Reading",78,0,0,0,78
1048677,768910,2018-06-26,Senate,"Do pass as amended, but first amend, and re-refer to the Committee on [Appropriations] with the recommendation: To Consent Calendar",6,0,1,0,7
1048677,770419,2018-08-06,Senate,"Placed on suspense file",7,0,0,0,7
1048681,733172,2018-04-02,Assembly,"Do pass and be re-referred to the Committee on [Appropriations]",9,1,1,0,11
1048681,740941,2018-04-17,Assembly,"Do pass and be re-referred to the Committee on [Appropriations]",10,0,0,0,10
1048686,687006,2018-01-22,Assembly,"Be adopted. To third reading",8,0,3,0,11
1048686,706141,2018-02-20,Senate,"Special Consent ACR147",37,0,3,0,40
1048691,742976,2018-04-24,Assembly,"Do pass as amended and be re-referred to the Committee on [Appropriations]",15,0,1,0,16
1048691,751396,2018-05-09,Assembly,"Do pass. To Consent Calendar",16,0,1,0,17
1048691,754297,2018-05-17,Assembly,"AB 1790 SALAS Consent Calendar Second Day Regular Session",73,0,5,0,78
1048691,763156,2018-06-13,Senate,"Do pass as amended, but first amend, and re-refer to the Committee on [Appropriations]",8,0,1,0,9
1048691,769761,2018-07-05,Senate,"Assembly 3rd Reading AB1790 Salas et al. By Galgiani",35,0,4,0,39
1048691,772469,2018-08-22,Senate,"That the measure be returned to Senate Floor for consideration. Ordered to third reading",9,0,0,0,9
1048691,772964,2018-08-27,Senate,"Assembly 3rd Reading AB1790 Salas et al. By Galgiani",39,0,1,0,40
1048691,773338,2018-08-29,Assembly,"AB 1790 SALAS Concurrence in Senate Amendments",80,0,0,0,80
1048700,737313,2018-04-11,Senate,"Do pass, but first be re-referred to the Committee on [Appropriations]",4,1,1,0,6
1048700,742215,2018-04-23,Senate,"Placed on suspense file",7,0,0,0,7
1048704,723248,2018-03-14,Assembly,"Do pass and be re-referred to the Committee on [Appropriations]",6,0,1,0,7
1048709,747899,2018-05-02,Assembly,"Do pass",18,0,3,0,21
1048709,752789,2018-05-14,Assembly,"AB 1782 MURATSUCHI Assembly Third Reading",62,4,12,0,78
1048709,762363,2018-06-12,Senate,"Do pass",10,0,2,0,12
1048709,769569,2018-07-02,Senate,"Assembly 3rd Reading AB1782 Muratsuchi et al. By Stern",36,0,3,0,39
1048709,770529,2018-08-06,Assembly,"AB 1782 MURATSUCHI Concurrence in Senate Amendments",66,4,10,0,80
1048714,726363,2018-03-20,Assembly,"Do pass as amended and be re-referred to the Committee on [Appropriations]",15,0,0,0,15
1048714,737316,2018-04-11,Assembly,"Do pass. To Consent Calendar",15,0,2,0,17
1048714,741428,2018-04-19,Assembly,"AB 1788 SALAS Consent Calendar Second Day Regular Session",71,0,7,0,78
1048714,762785,2018-06-13,Senate,"Do pass as amended, but first amend, and re-refer to the Committee on [Appropriations]",8,0,1,0,9
1048714,769798,2018-07-05,Senate,"Assembly 3rd Reading AB1788 Salas et al. By Galgiani",35,0,4,0,39
1048714,771357,2018-08-13,Assembly,"AB 1788 SALAS Concurrence in Senate Amendments",78,0,2,0,80
1048719,743952,2018-04-24,Assembly,"Do pass as amended and be re-referred to the Committee on [Appropriations]",13,0,0,0,13
1048719,751354,2018-05-09,Assembly,"Do pass. To Consent Calendar",16,0,1,0,17
1048719,754206,2018-05-17,Assembly,"AB 1786 CERVANTES Consent Calendar Second Day Regular Session",73,0,5,0,78
1048719,762894,2018-06-13,Senate,"Do pass, but first be re-referred to the Committee on [Appropriations] with the recommendation: To Consent Calendar",7,0,0,0,7
1048719,767901,2018-06-25,Senate,"Placed on suspense file",7,0,0,0,7
1048719,771887,2018-08-16,Senate,"Do pass",7,0,0,0,7
1048719,772803,2018-08-27,Senate,"Assembly 3rd Reading AB1786 Cervantes et al. By Roth",39,0,1,0,40
1048727,719809,2018-03-08,Assembly,"Be adopted. To third reading",8,0,3,0,11
1048727,735581,2018-04-09,Senate,"Special Consent ACR148",39,0,0,0,39
1050218,739691,2018-04-17,Assembly,"Do pass and be re-referred to the Committee on [Appropriations]",6,0,1,0,7
1050218,756535,2018-05-25,Assembly,"Do pass as amended",11,4,2,0,17
1050218,758767,2018-05-31,Assembly,"AB 1793 BONTA Assembly Third Reading",43,28,7,0,78
1050218,768139,2018-06-26,Senate,"Do pass, but first be re-referred to the Committee on [Appropriations]",5,1,1,0,7
1050218,770504,2018-08-06,Senate,"Placed on suspense file",7,0,0,0,7
1050218,771649,2018-08-16,Senate,"Do pass",5,2,0,0,7
1050218,772464,2018-08-22,Senate,"Assembly 3rd Reading AB1793 Bonta et al. By Wiener",28,10,2,0,40
1050225,751656,2018-05-09,Assembly,"Do pass",7,0,0,0,7
1050225,752627,2018-05-14,Assembly,"AB 1796 MURATSUCHI Assembly Third Reading",53,18,7,0,78
1050225,762994,2018-06-12,Senate,"Do pass as amended",5,1,1,0,7
1050225,769660,2018-07-02,Senate,"Assembly 3rd Reading AB1796 Muratsuchi By Allen",26,11,2,0,39
1050225,770290,2018-08-06,Assembly,"AB 1796 MURATSUCHI Concurrence in Senate Amendments",55,20,5,0,80
1050229,751772,2018-05-09,Assembly,"Do pass as amended",6,1,0,0,7
1050229,757269,2018-05-29,Assembly,"AB 1792 FRAZIER Assembly Third Reading",55,23,0,0,78
1050229,766541,2018-06-20,Senate,"Do pass as amended, but first amend, and re-refer to the Committee on [Transportation and Housing]",7,0,0,0,7
1050229,769743,2018-07-03,Senate,"Do pass",11,2,0,0,13
1050236,740781,2018-04-18,Senate,"Do pass, but first be re-referred to the Committee on [Judiciary]",6,0,1,0,7
1050236,751159,2018-05-08,Senate,"Do pass as amended",7,0,0,0,7
1050236,754258,2018-05-17,Senate,"Senate 3rd Reading SB838 Hertzberg",38,0,1,0,39
1050236,764211,2018-06-18,Assembly,"Do pass and be re-referred to the Committee on [Privacy and Consumer Protection]",11,0,0,0,11
1050236,769691,2018-07-03,Assembly,"Do pass as amended",10,0,0,0,10
1050236,773706,2018-08-30,Assembly,"SB 838 Hertzberg Senate Third Reading By CALDERON",80,0,0,0,80
1050236,774003,2018-08-31,Senate,"Unfinished Business SB838 Hertzberg Concurrence",39,0,1,0,40
1050243,740799,2018-04-18,Assembly,"Do pass. To Consent Calendar",13,0,0,0,13
1050243,744739,2018-04-26,Assembly,"AB 1799 LEVINE Consent Calendar Second Day Regular Session",74,0,4,0,78
1050243,762794,2018-06-13,Senate,"Do pass and be ordered to the Consent Calendar",11,0,2,0,13
1050243,767969,2018-06-25,Senate,"Consent Calendar AB1799",36,0,3,0,39
1050246,740814,2018-04-18,Assembly,"Do pass. To Consent Calendar",13,0,0,0,13
1050246,744866,2018-04-26,Assembly,"AB 1800 LEVINE Consent Calendar Second Day Regular Session",74,0,4,0,78
1050246,762892,2018-06-13,Senate,"Do pass as amended",11,0,2,0,13
1050246,774211,2018-08-31,Senate,"Assembly 3rd Reading AB1800 Levine et al. By Glazer Urgency Clause",37,0,3,0,40
1050246,774212,2018-08-31,Assembly,"AB 1800 Levine Concurrence - Urgency Added",79,0,1,0,80
1050252,743346,2018-04-24,Assembly,"Do pass and be re-referred to the Committee on [Appropriations] with recommendation: To Consent Calendar",16,0,0,0,16
1050252,748611,2018-05-03,Assembly,"AB 1802 SALAS Assembly Third Reading",72,0,6,0,78
1050259,748616,2018-05-02,Assembly,"Do pass as amended",13,0,0,0,13
1050259,752698,2018-05-14,Assembly,"AB 1797 LEVINE Assembly Third Reading",77,0,1,0,78
1050259,762835,2018-06-13,Senate,"Do pass as amended",11,0,2,0,13
1050259,769789,2018-07-05,Senate,"Assembly 3rd Reading AB1797 Levine et al. By Gaines",35,0,4,0,39
1050259,771169,2018-08-09,Assembly,"AB 1797 LEVINE Concurrence in Senate Amendments",77,0,3,0,80
1050262,724862,2018-03-19,Assembly,"Do pass and be re-referred to the Committee on [Education]",13,0,1,0,14
1050262,738265,2018-04-11,Assembly,"Do pass and be re-referred to the Committee on [Appropriations]",6,0,1,0,7
1050262,756773,2018-05-25,Assembly,"Do pass",15,0,2,0,17
1050262,757172,2018-05-29,Assembly,"AB 1798 CHU Assembly Third Reading",76,0,2,0,78
1050262,765816,2018-06-19,Senate,"Do pass, but first be re-referred to the Committee on [Appropriations]",13,0,0,0,13
1050262,771176,2018-08-09,Senate,"Assembly 3rd Reading AB1798 Chu By Cannella",36,0,3,0,39
1050269,722240,2018-03-13,Assembly,"Be adopted as amended",13,0,0,0,13
1050269,742226,2018-04-23,Senate,"Special Consent ACR150",38,0,1,0,39
1050272,725592,2018-03-20,Assembly,"Be adopted. To third reading",12,0,4,0,16
1050272,751058,2018-05-08,Assembly,"Be adopted. To third reading",5,0,2,0,7
1050272,754321,2018-05-17,Assembly,"AJR 27 LOW Assembly Third Reading",56,2,20,0,78
1050272,767958,2018-06-25,Senate,"Be adopted. Ordered to third reading",8,0,1,0,9
1050272,772316,2018-08-20,Senate,"Assembly 3rd Reading AJR27 Low et al. By McGuire",29,3,8,0,40
1050279,724856,2018-03-19,Assembly,"Be adopted. To Consent Calendar",13,0,1,0,14
1050279,727842,2018-03-22,Assembly,"ACR 149 CHOI Consent Calendar Second Day Regular Session",69,0,8,0,77
1050279,769752,2018-07-03,Senate,"Be adopted, but first be re-referred to the Committee on [Appropriations] with recommendation: To Consent Calendar",12,0,1,0,13
1050279,771394,2018-08-13,Senate,"Consent Calendar ACR149",37,0,3,0,40
1050288,740706,2018-04-17,Assembly,"Do pass as amended and be re-referred to the Committee on [Appropriations]",12,0,3,0,15
1050294,740594,2018-04-17,Assembly,"Do pass as amended and be re-referred to the Committee on [Appropriations]",14,0,1,0,15
1050294,756386,2018-05-25,Assembly,"Do pass as amended",14,0,3,0,17
1050294,757672,2018-05-30,Assembly,"AB 1801 NAZARIAN Assembly Third Reading",71,0,7,0,78
1050294,766110,2018-06-20,Senate,"Do pass as amended, but first amend, and re-refer to the Committee on [Appropriations]",8,0,1,0,9
1050294,770924,2018-08-06,Senate,"Placed on suspense file",7,0,0,0,7
1050294,771919,2018-08-16,Senate,"Do pass",7,0,0,0,7
1050294,772388,2018-08-21,Senate,"Assembly 3rd Reading AB1801 Nazarian By Pan",39,0,1,0,40
1050294,772769,2018-08-27,Assembly,"AB 1801 NAZARIAN Concurrence in Senate Amendments",80,0,0,0,80
1050298,751562,2018-05-09,Assembly,"Do pass. To Consent Calendar",9,0,0,0,9
1050298,754345,2018-05-17,Assembly,"AB 1794 LIMÓN Consent Calendar Second Day Regular Session",73,0,5,0,78
1050298,763326,2018-06-13,Senate,"Do pass and be ordered to the Consent Calendar",7,0,0,0,7
1050298,767968,2018-06-25,Senate,"Consent Calendar AB1794",36,0,3,0,39
1052828,752184,2018-05-10,Assembly,"AB 1818 BUDGET Assembly Third Reading By TING",50,22,6,0,78
1052828,762797,2018-06-13,Senate,"Do pass",14,2,1,0,17
1052829,752028,2018-05-10,Assembly,"AB 1826 BUDGET Assembly Third Reading By TING",50,22,6,0,78
1052829,762799,2018-06-13,Senate,"Do pass",13,3,1,0,17
1052829,763378,2018-06-14,Senate,"Assembly 3rd Reading AB1826 BUDGET (Ting) By Mitchell",28,9,2,0,39
1052829,763379,2018-06-14,Assembly,"AB 1826 BUDGET Concurrence in Senate Amendments By TING",55,24,1,0,80
1052830,685472,2018-01-16,Assembly,"Be adopted. To third reading",10,0,1,0,11
1052830,694908,2018-02-05,Senate,"Special Consent ACR152",37,0,3,0,40
1052832,752176,2018-05-10,Assembly,"AB 1846 BUDGET Assembly Third Reading By TING",50,22,6,0,78
1052832,771933,2018-08-16,Senate,"Do pass",12,5,0,0,17
1052833,748744,2018-05-03,Senate,"Senate 3rd Reading SB840 B. & F.R. (Mitchell)",24,11,4,0,39
1052833,751947,2018-05-10,Assembly,"SB 840 B. & F. R. Senate Third Reading By TING",50,22,6,0,78
1052833,756772,2018-05-25,Senate,"Unfinished Business SB840 B. & F.R. (Mitchell) Concurrence",0,35,4,0,39
1052833,763384,2018-06-14,Senate,"Conference Report SB840 Mitchell",27,10,2,0,39
1052833,763385,2018-06-14,Assembly,"SB 840 Mitchell Conference Report By TING",57,23,0,0,80
1052834,751949,2018-05-10,Assembly,"AB 1831 BUDGET Assembly Third Reading By TING",50,22,6,0,78
1052834,763106,2018-06-13,Senate,"Do pass",9,6,2,0,17
1052834,763632,2018-06-14,Senate,"Assembly 3rd Reading AB1831 BUDGET (Ting) By Mitchell",24,12,3,0,39
1052834,763633,2018-06-14,Assembly,"AB 1831 BUDGET Concurrence in Senate Amendments By TING",55,25,0,0,80
1052834,774572,2018-06-14,Senate,,9,12,3,0,24
1052835,751963,2018-05-10,Assembly,"AB 1816 BUDGET Assembly Third Reading By TING",50,22,6,0,78
1052835,762930,2018-06-13,Senate,"Do pass",13,4,0,0,17
1052837,748930,2018-05-03,Senate,"Senate 3rd Reading SB868 B. & F.R",24,11,4,0,39
1052838,748979,2018-05-03,Senate,"Senate 3rd Reading SB862 B. & F.R",24,11,4,0,39
1052838,773665,2018-08-29,Assembly,"SB 862 B. & F. R. Senate Third Reading By TING",62,18,0,0,80
1052838,773868,2018-08-30,Senate,"Unfinished Business SB862 B. & F.R. (Mitchell) Concurrence",28,9,3,0,40
1052838,773869,2018-08-30,Senate,"Unfinished Business SB862 B. & F.R. (Mitchell) Concurrence Reconsider",39,0,1,0,40
1052838,773870,2018-08-30,Senate,"Unfinished Business SB862 B. & F.R. (Mitchell) Concurrence",30,7,3,0,40
1052840,727809,2018-03-21,Assembly,"Do pass and be re-referred to the Committee on [Appropriations]",6,0,1,0,7
1052840,737413,2018-04-11,Assembly,"Do pass. To Consent Calendar",15,0,2,0,17
1052840,741450,2018-04-19,Assembly,"AB 1861 RODRIGUEZ Consent Calendar Second Day Regular Session",71,0,7,0,78
1052840,760584,2018-06-06,Senate,"Do pass, but first be re-referred to the Committee on [Appropriations]",6,0,0,0,6
1052840,771426,2018-08-13,Senate,"Assembly 3rd Reading AB1861 Rodriguez By Mitchell",36,0,4,0,40
1052840,772173,2018-08-20,Assembly,"AB 1861 RODRIGUEZ Concurrence in Senate Amendments",80,0,0,0,80
1052843,748813,2018-05-03,Senate,"Senate 3rd Reading SB869 B. & F.R",24,11,4,0,39
1052843,773413,2018-08-29,Assembly,"SB 869 B. & F. R. Senate Third Reading By TING",55,25,0,0,80
1052843,773919,2018-08-30,Senate,"Unfinished Business SB869 B. & F.R. (Mitchell) Concurrence",26,13,1,0,40
1052844,751987,2018-05-10,Assembly,"AB 1845 BUDGET Assembly Third Reading By TING",50,22,6,0,78
1052844,771935,2018-08-16,Senate,"Do pass",16,0,1,0,17
1052845,748786,2018-05-03,Senate,"Senate 3rd Reading SB871 B. & F.R",24,11,4,0,39
1052845,764097,2018-06-18,Senate,"W/O REF. TO FILE SB871 B. & F.R. (Mitchell) Concurrence",34,0,5,0,39
1052845,764098,2018-06-18,Assembly,"SB 871 B. & F. R. Senate Third Reading",79,1,0,0,80
1052847,737378,2018-04-11,Assembly,"Do pass as amended and be re-referred to the Committee on [Appropriations]",5,2,0,0,7
1052847,756691,2018-05-25,Assembly,"Do pass",12,4,1,0,17
1052847,757101,2018-05-29,Assembly,"AB 1857 NAZARIAN Assembly Third Reading",41,29,8,0,78
1052847,768371,2018-06-26,Senate,"Do pass, but first be re-referred to the Committee on [Appropriations]",12,0,1,0,13
1052847,770908,2018-08-06,Senate,"Placed on suspense file",7,0,0,0,7
1052847,772081,2018-08-16,Senate,"Do pass as amended",7,0,0,0,7
1052847,772382,2018-08-21,Senate,"Assembly 3rd Reading AB1857 Nazarian et al. By Dodd",38,0,2,0,40
1052847,772781,2018-08-27,Assembly,"AB 1857 NAZARIAN Concurrence in Senate Amendments",77,0,3,0,80
1052848,748521,2018-05-03,Senate,"Senate 3rd Reading SB878 B. & F.R",24,11,4,0,39
1052848,773408,2018-08-29,Assembly,"SB 878 B. & F. R. Senate Third Reading By TING",80,0,0,0,80
1052848,773887,2018-08-30,Senate,"Unfinished Business SB878 B. & F.R. (Mitchell) Concurrence",38,0,2,0,40
1052849,752131,2018-05-10,Assembly,"AB 1821 BUDGET Assembly Third Reading By TING",50,22,6,0,78
1052849,764315,2018-06-18,Senate,"Do pass",16,1,0,0,17
1052850,752095,2018-05-10,Assembly,"AB 1812 BUDGET Assembly Third Reading By TING",50,22,6,0,78
1052850,764123,2018-06-18,Senate,"Do pass",12,5,0,0,17
1052850,764124,2018-06-18,Senate,"Assembly 3rd Reading AB1812 BUDGET (Ting) By Mitchell",27,8,4,0,39
1052850,764125,2018-06-18,Assembly,"AB 1812 BUDGET Concurrence in Senate Amendments By TING",53,25,2,0,80
1052851,752035,2018-05-10,Assembly,"AB 1843 BUDGET Assembly Third Reading By TING",50,22,6,0,78
1052851,771913,2018-08-16,Senate,"Do pass",12,4,1,0,17
1052851,773108,2018-08-28,Senate,"Do pass",12,5,0,0,17
1052852,748902,2018-05-03,Senate,"Senate 3rd Reading SB845 B. & F.R",24,11,4,0,39
1052853,751380,2018-05-08,Assembly,"Be adopted as amended. To Consent Calendar",8,0,2,0,10
1052853,754387,2018-05-17,Assembly,"ACR 151 VOEPEL Consent Calendar Second Day Regular Session",73,0,5,0,78
1052853,768273,2018-06-26,Senate,"Be adopted and be ordered to the Consent Calendar",6,0,0,0,6
1052853,769548,2018-07-02,Senate,"Consent Calendar ACR151",37,0,2,0,39
1052854,748879,2018-05-03,Senate,"Senate 3rd Reading SB855 B. & F.R",24,11,4,0,39
1052854,764309,2018-06-18,Senate,"W/O REF. TO FILE SB855 B. & F.R. (Mitchell) Concurrence",36,0,3,0,39
1052854,764310,2018-06-18,Assembly,"SB 855 B. & F. R. Senate Third Reading",69,9,2,0,80
1052858,748662,2018-05-03,Senate,"Senate 3rd Reading SB872 B. & F.R",24,11,4,0,39
1052858,769593,2018-07-02,Senate,"Unfinished Business SB872 B. & F.R. (Mitchell) Concurrence",29,5,5,0,39
1052858,769594,2018-07-02,Assembly,"SB 872 B. & F. R. Senate Third Reading",72,0,8,0,80
1052859,748708,2018-05-03,Senate,"Senate 3rd Reading SB856 B. & F.R",24,11,4,0,39
1052859,767986,2018-06-25,Senate,"W/O REF. TO FILE SB856 B. & F.R. (Mitchell) Concurrence",29,4,6,0,39
1052859,767987,2018-06-25,Assembly,"SB 856 B. & F. R. Senate Third Reading By TING",60,16,4,0,80
1052860,752015,2018-05-10,Assembly,"AB 1837 BUDGET Assembly Third Reading By TING",50,22,6,0,78
1052860,764298,2018-06-18,Senate,"Do pass",16,0,1,0,17
1052861,751946,2018-05-10,Assembly,"AB 1840 BUDGET Assembly Third Reading By TING",50,22,6,0,78
1052861,771868,2018-08-16,Senate,"Do pass",14,2,1,0,17
1052861,773097,2018-08-28,Senate,"Do pass",14,3,0,0,17
1052861,773735,2018-08-30,Senate,"Assembly 3rd Reading AB1840 BUDGET (Ting) By Mitchell",35,4,1,0,40
1052861,774149,2018-08-31,Assembly,"AB 1840 BUDGET Concurrence in Senate Amendments By TING",71,3,6,0,80
1052862,748959,2018-05-03,Senate,"Senate 3rd Reading SB850 B. & F.R",24,11,4,0,39
1052862,763559,2018-06-14,Senate,"W/O REF. TO FILE SB850 B. & F.R. (Mitchell) Concurrence",31,6,2,0,39
1052862,763560,2018-06-14,Assembly,"SB 850 B. & F. R. Senate Third Reading Amend By DAHLE Set #1 Motion to Lay on the Table By CALDERON",54,22,4,0,80
1052862,763561,2018-06-14,Assembly,"SB 850 B. & F. R. Senate Third Reading",64,16,0,0,80
1052864,751994,2018-05-10,Assembly,"AB 1835 BUDGET Assembly Third Reading By TING",50,22,6,0,78
1052864,771938,2018-08-16,Senate,"Do pass",16,1,0,0,17
1052866,722227,2018-03-13,Assembly,"Do pass and be re-referred to the Committee on [Appropriations]",13,0,0,0,13
1052866,756450,2018-05-25,Assembly,"Do pass as amended",12,0,5,0,17
1052866,757695,2018-05-30,Assembly,"AB 1858 CALDERON Assembly Third Reading",75,0,3,0,78
1052866,765194,2018-06-18,Senate,"Do pass, but first be re-referred to the Committee on [Education]",8,0,1,0,9
1052866,768905,2018-06-27,Senate,"Do pass as amended, but first amend, and re-refer to the Committee on [Appropriations]",7,0,0,0,7
1052866,773125,2018-08-28,Senate,"Assembly 3rd Reading AB1858 Calderon et al. By Allen",38,0,2,0,40
1052866,773362,2018-08-29,Assembly,"AB 1858 CALDERON Concurrence in Senate Amendments",79,0,1,0,80
1052867,752153,2018-05-10,Assembly,"AB 1841 BUDGET Assembly Third Reading By TING",50,22,6,0,78
1052867,771936,2018-08-16,Senate,"Do pass",14,3,0,0,17
1052868,748904,2018-05-03,Senate,"Senate 3rd Reading SB863 B. & F.R",24,11,4,0,39
1052869,748711,2018-05-03,Senate,"Senate 3rd Reading SB860 B. & F.R",24,11,4,0,39
1052870,751999,2018-05-10,Assembly,"AB 1810 BUDGET Assembly Third Reading By TING",50,22,6,0,78
1052870,764261,2018-06-18,Senate,"Do pass",12,5,0,0,17
1052870,764262,2018-06-18,Senate,"Assembly 3rd Reading AB1810 BUDGET (Ting) By Mitchell",24,12,3,0,39
1052870,764263,2018-06-18,Assembly,"AB 1810 BUDGET Concurrence in Senate Amendments By TING",50,25,5,0,80
1052872,748752,2018-05-03,Senate,"Senate 3rd Reading SB875 B. & F.R",24,11,4,0,39
1052872,773648,2018-08-29,Assembly,"SB 875 B. & F. R. Senate Third Reading By TING",73,7,0,0,80
1052872,773831,2018-08-30,Senate,"Unfinished Business SB875 B. & F.R. (Mitchell) Concurrence",38,1,1,0,40
1052874,748792,2018-05-03,Senate,"Senate 3rd Reading SB867 B. & F.R",24,11,4,0,39
1052874,773614,2018-08-29,Assembly,"SB 867 B. & F. R. Senate Third Reading By TING",80,0,0,0,80
1052874,773749,2018-08-30,Senate,"Unfinished Business SB867 B. & F.R. (Mitchell) Concurrence",38,0,2,0,40
1052877,752136,2018-05-10,Assembly,"AB 1839 BUDGET Assembly Third Reading By TING",50,22,6,0,78
1052878,748634,2018-05-03,Senate,"Senate 3rd Reading SB846 B. & F.R",24,11,4,0,39
1052878,773301,2018-08-29,Assembly,"SB 846 B. & F. R. Senate Third Reading By TING",56,24,0,0,80
1052878,773780,2018-08-30,Senate,"Unfinished Business SB846 B. & F.R. (Mitchell) Concurrence",27,10,3,0,40
1052879,751941,2018-05-10,Assembly,"AB 1823 BUDGET Assembly Third Reading By TING",50,22,6,0,78
1052879,768290,2018-06-26,Senate,"Do pass",11,5,1,0,17
1052880,752065,2018-05-10,Assembly,"AB 1814 BUDGET Assembly Third Reading By TING",50,22,6,0,78
1052880,762824,2018-06-13,Senate,"Do pass",12,5,0,0,17
1052881,752032,2018-05-10,Assembly,"AB 1828 BUDGET Assembly Third Reading By TING",50,22,6,0,78
1052881,771723,2018-08-16,Senate,"Do pass",12,2,3,0,17
1052881,773109,2018-08-28,Senate,"Do pass",12,4,1,0,17
1052882,752036,2018-05-10,Assembly,"AB 1829 BUDGET Assembly Third Reading By TING",50,22,6,0,78
1052882,771942,2018-08-16,Senate,"Do pass",12,5,0,0,17
1052885,740809,2018-04-17,Assembly,"Do pass as amended and be re-referred to the Committee on [Judiciary]",9,1,0,0,10
1052885,746917,2018-05-01,Assembly,"Do pass as amended",8,2,0,0,10
1052885,758612,2018-05-31,Assembly,"AB 1859 CHAU Assembly Third Reading",57,15,6,0,78
1052885,768697,2018-06-26,Senate,"Do pass, but first be re-referred to the Committee on [Appropriations]",5,2,0,0,7
1052885,770415,2018-08-06,Senate,"Placed on suspense file",7,0,0,0,7
1052885,771659,2018-08-16,Senate,"Do pass as amended",5,2,0,0,7
1052885,772790,2018-08-27,Senate,"Assembly 3rd Reading AB1859 Chau By Hertzberg",39,0,1,0,40
1052885,773457,2018-08-29,Assembly,"AB 1859 CHAU Concurrence in Senate Amendments",80,0,0,0,80
1052885,777580,2018-05-31,Assembly,Noes:,8,15,6,0,29
1052888,752116,2018-05-10,Assembly,"AB 1844 BUDGET Assembly Third Reading By TING",50,22,6,0,78
1052888,771941,2018-08-16,Senate,"Do pass",16,0,1,0,17
1052889,752150,2018-05-10,Assembly,"AB 1838 BUDGET Assembly Third Reading By TING",50,22,6,0,78
1052889,768234,2018-06-26,Senate,"Do pass",9,5,3,0,17
1052889,769274,2018-06-28,Senate,"Assembly 3rd Reading AB1838 BUDGET (Ting) By Mitchell",21,7,11,0,39
1052889,769275,2018-06-28,Assembly,"AB 1838 BUDGET Concurrence in Senate Amendments By TING",70,2,8,0,80
1052890,751967,2018-05-10,Assembly,"AB 1820 BUDGET Assembly Third Reading By TING",50,22,6,0,78
1052890,763000,2018-06-13,Senate,"Do pass",11,5,1,0,17
1052891,722241,2018-03-13,Assembly,"Do pass and be re-referred to the Committee on [Appropriations]",13,0,0,0,13
1052892,752109,2018-05-10,Assembly,"AB 1832 BUDGET Assembly Third Reading By TING",50,22,6,0,78
1052892,764231,2018-06-18,Senate,"Do pass",11,6,0,0,17
1052892,773060,2018-08-28,Senate,"Do pass",11,5,1,0,17
1052893,751992,2018-05-10,Assembly,"AB 1819 BUDGET Assembly Third Reading By TING",50,22,6,0,78
1052893,763112,2018-06-13,Senate,"Do pass",16,0,1,0,17
1052894,752140,2018-05-10,Assembly,"AB 1807 BUDGET Assembly Third Reading By TING",50,22,6,0,78
1052894,763110,2018-06-13,Senate,"Do pass",14,3,0,0,17
1052896,751984,2018-05-10,Assembly,"AB 1825 BUDGET Assembly Third Reading By TING",50,22,6,0,78
1052896,762814,2018-06-13,Senate,"Do pass",14,2,1,0,17
1052896,763472,2018-06-14,Senate,"Assembly 3rd Reading AB1825 BUDGET (Ting) By Mitchell",35,2,2,0,39
1052896,763473,2018-06-14,Assembly,"AB 1825 BUDGET Concurrence in Senate Amendments By TING",79,0,1,0,80
1052897,752082,2018-05-10,Assembly,"AB 1833 BUDGET Assembly Third Reading By TING",50,22,6,0,78
1052897,771937,2018-08-16,Senate,"Do pass",13,4,0,0,17
1052897,773110,2018-08-28,Senate,"Do pass",12,5,0,0,17
1052898,752089,2018-05-10,Assembly,"AB 1809 BUDGET Assembly Third Reading By TING",50,22,6,0,78
1052898,764330,2018-06-18,Senate,"Do pass",10,4,3,0,17
1052898,764331,2018-06-18,Senate,"Assembly 3rd Reading AB1809 BUDGET (Ting) By Mitchell",28,5,6,0,39
1052898,764332,2018-06-18,Assembly,"AB 1809 BUDGET Concurrence in Senate Amendments By TING",64,10,6,0,80
1052899,743317,2018-04-24,Assembly,"Do pass and be re-referred to the Committee on [Appropriations]",13,0,2,0,15
1052899,756468,2018-05-25,Assembly,"Do pass as amended",12,2,3,0,17
1052899,757545,2018-05-30,Assembly,"AB 1860 LIMÓN Assembly Third Reading",67,7,4,0,78
1052899,768936,2018-06-27,Senate,"Do pass, but first be re-referred to the Committee on [Appropriations]",9,0,0,0,9
1052899,772833,2018-08-27,Senate,"Assembly 3rd Reading AB1860 Limón et al. By Mitchell",34,3,3,0,40
1052899,773327,2018-08-29,Assembly,"AB 1860 LIMÓN Concurrence in Senate Amendments",74,3,3,0,80
1052899,777202,2018-08-27,Senate,"Assembly 3rd Reading AB1",9,3,3,0,15
1052900,748623,2018-05-03,Senate,"Senate 3rd Reading SB877 B. & F.R",24,11,4,0,39
1052900,773598,2018-08-29,Assembly,"SB 877 B. & F. R. Senate Third Reading By TING",80,0,0,0,80
1052900,773719,2018-08-30,Senate,"Unfinished Business SB877 B. & F.R. (Mitchell) Concurrence",27,11,2,0,40
1052903,752117,2018-05-10,Assembly,"AB 1808 BUDGET Assembly Third Reading By TING",50,22,6,0,78
1052903,764119,2018-06-18,Senate,"Do pass",15,2,0,0,17
1052903,764120,2018-06-18,Senate,"Assembly 3rd Reading AB1808 BUDGET (Ting) By Mitchell",32,3,4,0,39
1052903,764121,2018-06-18,Assembly,"AB 1808 BUDGET Concurrence in Senate Amendments By TING",80,0,0,0,80
1052904,748707,2018-05-03,Senate,"Senate 3rd Reading SB853 B. & F.R",24,11,4,0,39
1052904,763750,2018-06-14,Senate,"W/O REF. TO FILE SB853 B. & F.R. (Mitchell) Concurrence",36,0,3,0,39
1052904,763751,2018-06-14,Assembly,"SB 853 B. & F. R. Senate Third Reading",80,0,0,0,80
1052906,736350,2018-04-09,Assembly,"Do pass and be re-referred to the Committee on [Appropriations] with recommendation: To Consent Calendar",7,0,3,0,10
1052906,756629,2018-05-25,Assembly,"Do pass",15,0,2,0,17
1052906,757109,2018-05-29,Assembly,"AB 1804 BERMAN Assembly Third Reading",77,0,1,0,78
1052906,767276,2018-06-20,Senate,"Do pass, but first be re-referred to the Committee on [Appropriations]",5,0,2,0,7
1052906,771421,2018-08-13,Senate,"Placed on suspense file",7,0,0,0,7
1052906,771943,2018-08-16,Senate,"Do pass as amended",7,0,0,0,7
1052906,773392,2018-08-29,Senate,"Assembly 3rd Reading AB1804 Berman et al. By Skinner",39,0,1,0,40
1052906,773814,2018-08-30,Assembly,"AB 1804 BERMAN Concurrence in Senate Amendments",78,0,2,0,80
1052908,748651,2018-05-03,Senate,"Senate 3rd Reading SB861 B. & F.R",24,11,4,0,39
1052908,773466,2018-08-29,Assembly,"SB 861 B. & F. R. Senate Third Reading By TING",51,25,4,0,80
1052908,773837,2018-08-30,Senate,"Unfinished Business SB861 B. & F.R. (Mitchell) Concurrence",27,12,1,0,40
1052909,748712,2018-05-03,Senate,"Senate 3rd Reading SB847 B. & F.R",24,11,4,0,39
1052909,764281,2018-06-18,Senate,"W/O REF. TO FILE SB847 B. & F.R. (Mitchell) Concurrence",31,6,2,0,39
1052909,764282,2018-06-18,Assembly,"SB 847 B. & F. R. Senate Third Reading",72,3,5,0,80
1052910,748658,2018-05-03,Senate,"Senate 3rd Reading SB848 B. & F.R",24,11,4,0,39
1052910,763773,2018-06-14,Senate,"W/O REF. TO FILE SB848 B. & F.R. (Mitchell) Concurrence",25,11,3,0,39
1052910,763774,2018-06-14,Assembly,"SB 848 B. & F. R. Senate Third Reading",55,25,0,0,80
1052911,748538,2018-05-03,Senate,"Senate 3rd Reading SB859 B. & F.R",24,11,4,0,39
1052912,748683,2018-05-03,Senate,"Senate 3rd Reading SB873 B. & F.R",24,11,4,0,39
1052912,773613,2018-08-29,Assembly,"SB 873 B. & F. R. Senate Third Reading By TING",60,20,0,0,80
1052912,773765,2018-08-30,Senate,"Unfinished Business SB873 B. & F.R. (Mitchell) Concurrence",27,11,2,0,40
1052915,751918,2018-05-10,Assembly,"AB 1813 BUDGET Assembly Third Reading By TING",50,22,6,0,78
1052915,764279,2018-06-18,Senate,"Do pass",15,2,0,0,17
1052920,748647,2018-05-03,Senate,"Senate 3rd Reading SB849 B. & F.R",24,11,4,0,39
1052920,767837,2018-06-25,Assembly,"SB 849 B. & F. R. Senate Third Reading By TING",76,0,4,0,80
1052920,767976,2018-06-25,Senate,"W/O REF. TO FILE SB849 B. & F.R. (Mitchell) Concurrence",36,0,3,0,39
1052921,748932,2018-05-03,Senate,"Senate 3rd Reading SB842 B. & F.R",24,11,4,0,39
1052922,748850,2018-05-03,Senate,"Senate 3rd Reading SB866 B. & F.R",24,11,4,0,39
1052922,764302,2018-06-18,Senate,"W/O REF. TO FILE SB866 B. & F.R. (Mitchell) Concurrence",23,12,4,0,39
1052922,764303,2018-06-18,Assembly,"SB 866 B. & F. R. Senate Third Reading",55,25,0,0,80
1052926,748894,2018-05-03,Senate,"Senate 3rd Reading SB843 B. & F.R",24,11,4,0,39
1052927,748975,2018-05-03,Senate,"Senate 3rd Reading SB864 B. & F.R",24,11,4,0,39
1052928,752196,2018-05-10,Assembly,"AB 1815 BUDGET Assembly Third Reading By TING",50,22,6,0,78
1052928,767864,2018-06-25,Senate,"Do pass",16,0,1,0,17
1052930,748915,2018-05-03,Senate,"Senate 3rd Reading SB852 B. & F.R",24,11,4,0,39
1052930,763431,2018-06-14,Senate,"W/O REF. TO FILE SB852 B. & F.R. (Mitchell) Concurrence",30,3,6,0,39
1052930,763432,2018-06-14,Assembly,"SB 852 B. & F. R. Senate Third Reading",73,5,2,0,80
1052932,748784,2018-05-03,Senate,"Senate 3rd Reading SB865 B. & F.R",24,11,4,0,39
1052934,748921,2018-05-03,Senate,"Senate 3rd Reading SB841 B. & F.R. (Mitchell)",24,11,4,0,39
1052934,763660,2018-06-14,Senate,"W/O REF. TO FILE SB 841 B.F.& R. (Mitchell)",29,8,2,0,39
1052934,763661,2018-06-14,Assembly,"SB 841 B. & F. R. Senate Third Reading By TING",79,0,1,0,80
1052935,748841,2018-05-03,Senate,"Senate 3rd Reading SB876 B. & F.R",24,11,4,0,39
1052935,773526,2018-08-29,Assembly,"SB 876 B. & F. R. Senate Third Reading By TING",79,0,1,0,80
1052935,773828,2018-08-30,Senate,"Unfinished Business SB876 B. & F.R. (Mitchell) Concurrence",38,1,1,0,40
1052936,748854,2018-05-03,Senate,"Senate 3rd Reading SB879 B. & F.R",24,11,4,0,39
1052936,773669,2018-08-29,Assembly,"SB 879 B. & F. R. Senate Third Reading By TING",79,0,1,0,80
1052936,773761,2018-08-30,Senate,"Unfinished Business SB879 B. & F.R. (Mitchell) Concurrence",39,0,1,0,40
1052938,748842,2018-05-03,Senate,"Senate 3rd Reading SB870 B. & F.R",24,11,4,0,39
1052939,733813,2018-04-03,Assembly,"Do pass as amended and be re-referred to the Committee on [Appropriations]",13,0,0,0,13
1052939,740745,2018-04-18,Assembly,"Do pass. To Consent Calendar",15,0,2,0,17
1052939,744761,2018-04-26,Assembly,"AB 1805 IRWIN Consent Calendar Second Day Regular Session",74,0,4,0,78
1052939,760338,2018-06-06,Senate,"Do pass, but first be re-referred to the Committee on [Appropriations] with the recommendation: To Consent Calendar",6,0,0,0,6
1052939,767885,2018-06-25,Senate,"Placed on suspense file",7,0,0,0,7
1052939,771626,2018-08-16,Senate,"Do pass as amended",7,0,0,0,7
1052939,773225,2018-08-28,Senate,"Assembly 3rd Reading AB1805 Irwin By Allen",39,0,1,0,40
1052939,773326,2018-08-29,Assembly,"AB 1805 IRWIN Concurrence in Senate Amendments",78,0,2,0,80
1052940,748918,2018-05-03,Senate,"Senate 3rd Reading SB874 B. & F.R",24,11,4,0,39
1052941,751942,2018-05-10,Assembly,"AB 1817 BUDGET Assembly Third Reading By TING",50,22,6,0,78
1052941,763036,2018-06-13,Senate,"Do pass",13,4,0,0,17
1052941,763376,2018-06-14,Senate,"Assembly 3rd Reading AB1817 BUDGET (Ting) By Mitchell",29,8,2,0,39
1052941,763377,2018-06-14,Assembly,"AB 1817 BUDGET Concurrence in Senate Amendments By TING",78,1,1,0,80
1052942,743731,2018-04-25,Senate,"Do pass, but first be re-referred to the Committee on [Appropriations]",5,0,0,0,5
1052942,750484,2018-05-07,Senate,"Placed on suspense file",6,0,1,0,7
1052942,756343,2018-05-25,Senate,"Do pass",7,0,0,0,7
1052942,758592,2018-05-31,Senate,"Special Consent SB880",39,0,0,0,39
1052942,769002,2018-06-27,Assembly,"Do pass and be re-referred to the Committee on [Appropriations]",13,0,0,0,13
1052942,771093,2018-08-08,Assembly,"Do pass. To Consent Calendar",17,0,0,0,17
1052942,771629,2018-08-16,Assembly,"SB 880 Pan Consent Calendar Second Day Regular Session",76,0,4,0,80
1052942,772213,2018-08-20,Senate,"Unfinished Business SB880 Pan Concurrence",35,0,5,0,40
1052944,752191,2018-05-10,Assembly,"AB 1811 BUDGET Assembly Third Reading By TING",50,22,6,0,78
1052944,764212,2018-06-18,Senate,"Do pass",12,5,0,0,17
1052944,764213,2018-06-18,Senate,"Assembly 3rd Reading AB1811 BUDGET (Ting) By Mitchell",28,6,5,0,39
1052944,764214,2018-06-18,Assembly,"AB 1811 BUDGET Concurrence in Senate Amendments By TING",61,14,5,0,80
1052945,752017,2018-05-10,Assembly,"AB 1824 BUDGET Assembly Third Reading By TING",50,22,6,0,78
1052945,762746,2018-06-13,Senate,"Do pass",13,3,1,0,17
1052945,763366,2018-06-14,Senate,"Assembly 3rd Reading AB1824 BUDGET (Ting) By Mitchell",31,6,2,0,39
1052945,763367,2018-06-14,Assembly,"AB 1824 BUDGET Concurrence in Senate Amendments By TING",78,0,2,0,80
1052947,748855,2018-05-03,Senate,"Senate 3rd Reading SB851 B. & F.R",24,11,4,0,39
1052948,752018,2018-05-10,Assembly,"AB 1834 BUDGET Assembly Third Reading By TING",50,22,6,0,78
1052948,762995,2018-06-13,Senate,"Do pass",16,0,1,0,17
1052948,763567,2018-06-14,Senate,"Assembly 3rd Reading AB1834 BUDGET (Ting) By Mitchell",37,0,2,0,39
1052948,763568,2018-06-14,Assembly,"AB 1834 BUDGET Concurrence in Senate Amendments By TING",56,24,0,0,80
1052950,752007,2018-05-10,Assembly,"AB 1842 BUDGET Assembly Third Reading By TING",50,22,6,0,78
1052950,771940,2018-08-16,Senate,"Do pass",17,0,0,0,17
1052951,748820,2018-05-03,Senate,"Senate 3rd Reading SB857 B. & F.R",24,11,4,0,39
1052951,769597,2018-07-02,Senate,"Unfinished Business SB857 B. & F.R. (Mitchell) Concurrence",24,11,4,0,39
1052951,769598,2018-07-02,Assembly,"SB 857 B. & F. R. Senate Third Reading",55,20,5,0,80
1052952,752012,2018-05-10,Assembly,"AB 1827 BUDGET Assembly Third Reading By TING",50,22,6,0,78
1052952,764170,2018-06-18,Senate,"[06-18-2018] set for [First] hearing: Reconsideration of favorable vote granted",17,0,0,0,17
1052952,767961,2018-06-25,Senate,"Do pass",15,0,2,0,17
1052952,767962,2018-06-25,Assembly,"AB 1827 BUDGET Concurrence - Urgency Added By TING",72,1,7,0,80
1052952,767970,2018-06-25,Senate,"Assembly 3rd Reading AB1827 BUDGET (Ting) By Mitchell Urgency Clause",35,0,4,0,39
1052954,748849,2018-05-03,Senate,"Senate 3rd Reading SB844 B. & F.R",24,11,4,0,39
1052956,748824,2018-05-03,Senate,"Senate 3rd Reading SB858 B. & F.R",24,11,4,0,39
1052957,748912,2018-05-03,Senate,"Senate 3rd Reading SB854 B. & F.R",24,11,4,0,39
1052957,763655,2018-06-14,Senate,"W/O REF. TO FILE SB854 B. & F.R. (Mitchell) Concurrence",25,12,2,0,39
1052957,763656,2018-06-14,Assembly,"SB 854 B. & F. R. Senate Third Reading",56,23,1,0,80
1052958,752016,2018-05-10,Assembly,"AB 1836 BUDGET Assembly Third Reading By TING",50,22,6,0,78
1052958,762809,2018-06-13,Senate,"Do pass",12,4,1,0,17
1052958,774262,2018-08-31,Senate,"Assembly 3rd Reading AB1836 BUDGET (Ting) By Mitchell",26,13,1,0,40
1052959,752083,2018-05-10,Assembly,"AB 1822 BUDGET Assembly Third Reading By TING",50,22,6,0,78
1052959,767935,2018-06-25,Senate,"Do pass",13,3,1,0,17
1052960,752097,2018-05-10,Assembly,"AB 1830 BUDGET Assembly Third Reading By TING",50,22,6,0,78
1052960,762830,2018-06-13,Senate,"Do pass",12,4,1,0,17
1052960,763368,2018-06-14,Senate,"Assembly 3rd Reading AB1830 BUDGET (Ting) By Mitchell",28,9,2,0,39
1052960,763369,2018-06-14,Assembly,"AB 1830 BUDGET Concurrence in Senate Amendments By TING",55,23,2,0,80
1057938,724616,2018-03-19,Assembly,"Be adopted. To Consent Calendar",13,0,1,0,14
1057938,727745,2018-03-22,Assembly,"ACR 154 VOEPEL Consent Calendar Second Day Regular Session",69,0,8,0,77
1057938,769741,2018-07-03,Senate,"Be adopted, but first be re-referred to the Committee on [Appropriations] with recommendation: To Consent Calendar",12,0,1,0,13
1057938,771328,2018-08-13,Senate,"Consent Calendar ACR154",37,0,3,0,40
1057949,733149,2018-04-03,Assembly,"Be adopted. To third reading",16,0,0,0,16
1057949,738259,2018-04-12,Assembly,"ACR 153 SANTIAGO Consent Calendar Second Day Regular Session",68,0,9,0,77
1057949,754865,2018-05-21,Senate,"Special Consent ACR153",39,0,0,0,39
1057959,722401,2018-03-13,Senate,"Do pass, but first be re-referred to the Committee on [Judiciary] with the recommendation: To Consent Calendar",8,0,1,0,9
1057959,740716,2018-04-17,Senate,"Do pass, but first be re-referred to the Committee on [Appropriations] with the recommendation: To Consent Calendar",7,0,0,0,7
1057959,750476,2018-05-07,Senate,"Placed on suspense file",6,0,1,0,7
1057959,756451,2018-05-25,Senate,"Do pass",7,0,0,0,7
1057959,758640,2018-05-31,Senate,"Special Consent SB881",39,0,0,0,39
1057959,768353,2018-06-26,Assembly,"Do pass and be re-referred to the Committee on [Judiciary]",15,0,0,0,15
1057959,769204,2018-06-28,Assembly,"Do pass and be re-referred to the Committee on [Appropriations] with recommendation: To Consent Calendar",10,0,0,0,10
1057959,771890,2018-08-16,Assembly,"Do pass",17,0,0,0,17
1057959,773072,2018-08-28,Assembly,"SB 881 Wieckowski Senate Third Reading By CHU",78,0,2,0,80
1057983,725929,2018-03-20,Assembly,"Do pass as amended and be re-referred to the Committee on [Human Services]",8,1,1,0,10
1057983,737580,2018-04-10,Assembly,"Do pass as amended and be re-referred to the Committee on [Appropriations]",6,0,1,0,7
1057983,756676,2018-05-25,Assembly,"Do pass",12,3,2,0,17
1057983,757800,2018-05-30,Assembly,"AB 1862 SANTIAGO Third Reading Urgency",58,16,4,0,78
1057983,762955,2018-06-12,Senate,"Do pass, but first be re-referred to the Committee on [Judiciary]",6,0,1,0,7
1057983,769045,2018-06-26,Senate,"Do pass, but first be re-referred to the Committee on [Appropriations]",5,2,0,0,7
1057988,701513,2018-02-13,Assembly,"Be adopted as amended",7,0,3,0,10
1057998,747261,2018-04-30,Assembly,"Do pass as amended and be re-referred to the Committee on [Appropriations]",9,1,0,0,10
1057998,756738,2018-05-25,Assembly,"Do pass",15,1,1,0,17
1057998,757026,2018-05-29,Assembly,"AB 1863 JONES-SAWYER Assembly Third Reading",64,11,3,0,78
1057998,771076,2018-08-08,Senate,"Do pass, but first be re-referred to the Committee on [Appropriations]",6,0,1,0,7
1057998,771381,2018-08-13,Senate,"Placed on suspense file",7,0,0,0,7
1057998,771930,2018-08-16,Senate,"Do pass",5,2,0,0,7
1057998,772350,2018-08-21,Senate,"Assembly 3rd Reading AB1863 Jones-Sawyer et al. By McGuire",29,6,5,0,40
1058003,722515,2018-03-13,Senate,"Do pass, but first be re-referred to the Committee on [Education] with the recommendation: To Consent Calendar",10,0,2,0,12
1058003,737357,2018-04-11,Senate,"Do pass and be ordered to the Consent Calendar",6,0,0,0,6
1058003,742486,2018-04-23,Senate,"Consent Calendar SB892",38,0,1,0,39
1058003,765970,2018-06-20,Assembly,"Do pass and be re-referred to the Committee on [Education] with recommendation: To Consent Calendar",19,0,2,0,21
1058003,768969,2018-06-27,Assembly,"Do pass as amended. To Consent Calendar",7,0,0,0,7
1058003,770341,2018-08-06,Assembly,"SB 892 Pan Consent Calendar Second Day",75,0,5,0,80
1058003,771199,2018-08-09,Senate,"Unfinished Business SB892 Pan et al. Concurrence",37,0,2,0,39
1058008,740813,2018-04-17,Senate,"Do pass, but first be re-referred to the Committee on [Governance and Finance]",5,7,1,0,13
1058019,746650,2018-04-30,Assembly,"Be adopted. To third reading",11,0,0,0,11
1058019,748874,2018-05-03,Assembly,"AJR 28 JONES-SAWYER Assembly Third Reading",58,3,17,0,78
1058019,763681,2018-06-14,Senate,"Assembly 3rd Reading AJR28 Jones-Sawyer et al. By McGuire",30,6,3,0,39
1058867,741438,2018-04-18,Assembly,"Do pass and be re-referred to the Committee on [Appropriations]",6,0,1,0,7
1058867,756476,2018-05-25,Assembly,"Do pass",12,1,4,0,17
1058867,757032,2018-05-29,Assembly,"AB 1870 REYES Assembly Third Reading",57,4,17,0,78
1058867,766250,2018-06-19,Senate,"Do pass, but first be re-referred to the Committee on [Appropriations]",5,2,0,0,7
1058867,769578,2018-07-02,Senate,"Placed on suspense file",7,0,0,0,7
1058867,771690,2018-08-16,Senate,"Do pass as amended",5,1,1,0,7
1058867,772936,2018-08-27,Senate,"Assembly 3rd Reading AB1870 Reyes et al. By Leyva",25,10,5,0,40
1058867,773383,2018-08-29,Assembly,"AB 1870 REYES Concurrence in Senate Amendments",61,9,10,0,80
1058873,685851,2018-01-17,Assembly,"Be adopted. To third reading",8,1,1,0,10
1058873,686982,2018-01-22,Assembly,"HR 71 CABALLERO Assembly Third Reading",50,21,6,0,77
1058879,741432,2018-04-18,Assembly,"Do pass and be re-referred to the Committee on [Appropriations]",6,0,1,0,7
1058879,747802,2018-05-02,Assembly,"Do pass",12,3,2,0,17
1058879,752754,2018-05-14,Assembly,"AB 1867 REYES Assembly Third Reading",53,10,15,0,78
1058879,762903,2018-06-13,Senate,"Do pass as amended, but first amend, and re-refer to the Committee on [Judiciary]",4,1,0,0,5
1058879,766132,2018-06-19,Senate,"Do pass as amended, but first amend, and re-refer to the Committee on [Appropriations]",5,1,1,0,7
1058879,771267,2018-08-13,Senate,"Assembly 3rd Reading AB1867 Reyes By Wiener",31,4,5,0,40
1058879,772241,2018-08-20,Assembly,"AB 1867 REYES Concurrence in Senate Amendments",74,0,6,0,80
1058879,777229,2018-08-13,Senate,"Assembly 3rd Reading AB1867 Reyes By Wienertd colspan=""2""> ?",5,4,5,0,14
1058885,694837,2018-02-05,Senate,"Senate 3rd Reading SR73 McGuire et al",30,4,6,0,40
1058903,722120,2018-03-13,Senate,"Do pass, but first be re-referred to the Committee on [Appropriations]",7,0,0,0,7
1058903,738770,2018-04-16,Senate,"Placed on suspense file",7,0,0,0,7
1058903,756298,2018-05-25,Senate,"Do pass as amended",7,0,0,0,7
1058903,757650,2018-05-30,Senate,"Senate 3rd Reading SB896 McGuire et al",38,0,1,0,39
1058903,762176,2018-06-12,Assembly,"Do pass and be re-referred to the Committee on [Appropriations] with recommendation: To Consent Calendar",7,0,0,0,7
1058903,771539,2018-08-16,Assembly,"Do pass",17,0,0,0,17
1058903,772798,2018-08-27,Assembly,"SB 896 McGuire Senate Third Reading By AGUIAR-CURRY",80,0,0,0,80
1058903,777261,2018-08-16,Assembly,,7,0,0,0,7
1058910,751316,2018-05-09,Assembly,"Do pass",6,0,1,0,7
1058910,754929,2018-05-21,Assembly,"AB 1868 CUNNINGHAM Assembly Third Reading",74,0,4,0,78
1058910,762889,2018-06-13,Senate,"Do pass",7,0,0,0,7
1058910,772631,2018-08-23,Senate,"Assembly 3rd Reading AB1868 Cunningham By Galgiani",39,0,1,0,40
1058910,773472,2018-08-29,Assembly,"AB 1868 CUNNINGHAM Concurrence in Senate Amendments",79,0,1,0,80
1058915,692970,2018-02-01,Assembly,"Be adopted. To third reading",9,0,2,0,11
1058915,727708,2018-03-22,Senate,"Special Consent ACR155 Baker et al",37,0,2,0,39
1058921,744164,2018-04-25,Senate,"Do pass as amended, but first amend, and re-refer to the Committee on [Appropriations]",6,0,0,0,6
1058921,753049,2018-05-14,Senate,"Placed on suspense file",7,0,0,0,7
1058921,756217,2018-05-25,Senate,"Do pass as amended",7,0,0,0,7
1058921,758526,2018-05-31,Senate,"Senate 3rd Reading SB895 Nguyen et al",39,0,0,0,39
1058921,768706,2018-06-27,Assembly,"Do pass and be re-referred to the Committee on [Appropriations]",7,0,0,0,7
1058921,771926,2018-08-16,Assembly,"Do pass as amended",12,0,5,0,17
1058921,773587,2018-08-29,Assembly,"SB 895 Nguyen Senate Third Reading By KALRA",80,0,0,0,80
1058921,774188,2018-08-31,Senate,"Unfinished Business SB895 Nguyen et al. Concurrence",39,0,1,0,40
1058927,745269,2018-04-25,Senate,"Do pass as amended",8,0,5,0,13
1058933,737270,2018-04-09,Assembly,"Do pass and be re-referred to the Committee on [Appropriations]",3,5,2,0,10
1058945,718059,2018-03-06,Assembly,"Do pass and be re-referred to the Committee on [Appropriations]",7,0,0,0,7
1058945,733949,2018-04-04,Assembly,"Do pass. To Consent Calendar",15,0,2,0,17
1058945,738295,2018-04-12,Assembly,"AB 1865 LACKEY Consent Calendar Second Day Regular Session",68,0,9,0,77
1058945,753222,2018-05-15,Senate,"Do pass as amended, but first amend, and re-refer to the Committee on [Appropriations]",7,0,0,0,7
1058945,767896,2018-06-25,Senate,"Placed on suspense file",7,0,0,0,7
1058945,771692,2018-08-16,Senate,"Do pass",7,0,0,0,7
1058945,772881,2018-08-27,Senate,"Assembly 3rd Reading AB1865 Lackey et al. By Wiener",39,0,1,0,40
1058945,773513,2018-08-29,Assembly,"AB 1865 LACKEY Concurrence in Senate Amendments",79,0,1,0,80
1058951,745271,2018-04-25,Senate,"Do pass as amended",8,0,5,0,13
1058951,756951,2018-05-29,Senate,"Senate 3rd Reading SB894 Dodd et al",24,11,4,0,39
1058951,768786,2018-06-27,Assembly,"Do pass as amended",9,2,2,0,13
1058951,773812,2018-08-30,Assembly,"SB 894 Dodd Senate Third Reading By LEVINE",51,25,4,0,80
1058951,774120,2018-08-31,Senate,"Unfinished Business SB894 Dodd et al. Concurrence",26,12,2,0,40
1058951,777945,2018-04-25,Senate,,0,0,5,0,5
1058956,745267,2018-04-25,Senate,"Do pass as amended, but first amend, and re-refer to the Committee on [Appropriations]",8,0,5,0,13
1058956,755341,2018-05-22,Senate,"Placed on suspense file",7,0,0,0,7
1058956,756241,2018-05-25,Senate,"Do pass",5,2,0,0,7
1058956,757091,2018-05-29,Senate,"Senate 3rd Reading SB898 Hertzberg et al",27,11,1,0,39
1060865,694699,2018-02-05,Assembly,"Be adopted. To third reading",8,1,1,0,10
1060865,697706,2018-02-08,Assembly,"AJR 29 LIMÓN Assembly Third Reading",56,9,12,0,77
1060865,716476,2018-03-05,Senate,"Assembly 3rd Reading AJR29 Limón et al. By Jackson",27,5,7,0,39
1060875,748821,2018-05-02,Assembly,"Do pass and be re-referred to the Committee on [Appropriations]",13,0,0,0,13
1060875,756277,2018-05-25,Assembly,"Do pass",15,1,1,0,17
1060875,756950,2018-05-29,Assembly,"AB 1875 WOOD Assembly Third Reading",75,0,3,0,78
1060875,769269,2018-06-27,Senate,"Do pass as amended, but first amend, and re-refer to the Committee on [Appropriations]",12,0,1,0,13
1060875,770362,2018-08-06,Senate,"Placed on suspense file",7,0,0,0,7
1060875,771746,2018-08-16,Senate,"Do pass",7,0,0,0,7
1060875,773373,2018-08-29,Senate,"Assembly 3rd Reading AB1875 Wood et al. By Lara",39,0,1,0,40
1060875,773755,2018-08-30,Assembly,"AB 1875 WOOD Concurrence in Senate Amendments",78,0,2,0,80
1060886,724743,2018-03-19,Assembly,"Do pass and be re-referred to the Committee on [Veterans Affairs]",13,0,1,0,14
1060886,744380,2018-04-24,Assembly,"Do pass and be re-referred to the Committee on [Appropriations]",10,0,0,0,10
1060886,756505,2018-05-25,Assembly,"Do pass",16,0,1,0,17
1060886,757010,2018-05-29,Assembly,"AB 1873 OBERNOLTE Assembly Third Reading",76,0,2,0,78
1060886,762234,2018-06-12,Senate,"Do pass, but first be re-referred to the Committee on [Appropriations] with the recommendation: To Consent Calendar",12,0,1,0,13
1060886,768103,2018-06-25,Senate,"Placed on suspense file",7,0,0,0,7
1060886,771961,2018-08-16,Senate,"Do pass as amended",7,0,0,0,7
1060886,772939,2018-08-27,Senate,"Assembly 3rd Reading AB1873 Obernolte et al. By Roth",39,0,1,0,40
1060886,773580,2018-08-29,Assembly,"AB 1873 OBERNOLTE Concurrence in Senate Amendments",80,0,0,0,80
1060896,717862,2018-03-06,Assembly,"Do pass",6,0,1,0,7
1060896,723531,2018-03-15,Assembly,"AB 1872 VOEPEL Assembly Third Reading",63,0,14,0,77
1060896,753250,2018-05-15,Senate,"Do pass",7,0,0,0,7
1060896,763482,2018-06-14,Senate,"Assembly 3rd Reading AB1872 Voepel By Moorlach",32,0,7,0,39
1060907,736608,2018-04-10,Senate,"Do pass, but first be re-referred to the Committee on [Agriculture] with the recommendation: To Consent Calendar",6,0,1,0,7
1060907,739888,2018-04-17,Senate,"Do pass, but first be re-referred to the Committee on [Appropriations] with the recommendation: To Consent Calendar",4,0,1,0,5
1060907,746787,2018-04-30,Senate,"Placed on suspense file",6,0,1,0,7
1060907,756669,2018-05-25,Senate,"Do pass as amended",7,0,0,0,7
1060907,757834,2018-05-30,Senate,"Senate 3rd Reading SB900 Wiener et al",37,0,2,0,39
1060919,724769,2018-03-19,Assembly,"Do pass and be re-referred to the Committee on [Appropriations] with recommendation: To Consent Calendar",13,0,1,0,14
1060929,733356,2018-04-03,Senate,"Do pass and be ordered to the Consent Calendar",13,0,0,0,13
1060929,735551,2018-04-09,Senate,"Consent Calendar SB903 Cannella et al. Urgency Clause",39,0,0,0,39
1060929,761757,2018-06-11,Assembly,"Do pass. To Consent Calendar",14,0,0,0,14
1060929,763463,2018-06-14,Assembly,"SB 903 Cannella Consent Calendar Second Day Regular Session",78,0,2,0,80
1060929,769228,2018-06-28,Senate,"Unfinished Business SB903 Cannella et al. Urgency Clause Concurrence",37,0,2,0,39
1060940,738252,2018-04-11,Assembly,"Do pass as amended and be re-referred to the Committee on [Appropriations]",5,1,1,0,7
1060940,756504,2018-05-25,Assembly,"Do pass as amended",12,4,1,0,17
1060940,757508,2018-05-30,Assembly,"AB 1871 BONTA Assembly Third Reading",56,16,6,0,78
1060940,762762,2018-06-13,Senate,"Do pass, but first be re-referred to the Committee on [Appropriations]",7,0,0,0,7
1060940,767909,2018-06-25,Senate,"Placed on suspense file",7,0,0,0,7
1060940,771766,2018-08-16,Senate,"Do pass",5,2,0,0,7
1060940,772567,2018-08-23,Senate,"Assembly 3rd Reading AB1871 Bonta et al. By Leyva",31,6,3,0,40
1060950,744115,2018-04-25,Senate,"Do pass as amended, but first amend, and re-refer to the Committee on [Appropriations]",4,0,1,0,5
1060950,752937,2018-05-14,Senate,"Placed on suspense file",7,0,0,0,7
1060950,756714,2018-05-25,Senate,"Do pass",5,0,2,0,7
1060950,757159,2018-05-29,Senate,"Senate 3rd Reading SB899 Pan",32,3,4,0,39
1060950,768696,2018-06-27,Assembly,"Do pass as amended",13,0,0,0,13
1060950,772319,2018-08-20,Assembly,"SB 899 Pan Senate Third Reading By DALY",80,0,0,0,80
1060950,772394,2018-08-21,Senate,"Unfinished Business SB899 Pan Concurrence",37,0,3,0,40
1060961,743401,2018-04-24,Assembly,"Do pass and be re-referred to the Committee on [Appropriations]",0,6,9,0,15
1060971,740900,2018-04-18,Senate,"Do pass, but first be re-referred to the Committee on [Public Safety]",8,0,1,0,9
1060971,743064,2018-04-24,Senate,"Do pass as amended, but first amend, and re-refer to the Committee on [Appropriations]",6,1,0,0,7
1060971,752759,2018-05-14,Senate,"Placed on suspense file",7,0,0,0,7
1060980,739810,2018-04-17,Senate,"Do pass as amended, but first amend, and re-refer to the Committee on [Appropriations]",11,0,0,0,11
1060980,752760,2018-05-14,Senate,"Placed on suspense file",7,0,0,0,7
1060980,756285,2018-05-25,Senate,"Do pass",7,0,0,0,7
1060980,758561,2018-05-31,Senate,"Special Consent SB901",39,0,0,0,39
1060980,768804,2018-06-27,Assembly,"Do pass and be re-referred to the Committee on [Appropriations]",15,0,0,0,15
1060980,769766,2018-07-05,Senate,"Unfinished Business SB901 Dodd et al. Concurrence",0,35,4,0,39
1060980,769767,2018-07-05,Assembly,"SB 901 Dodd Senate Third Reading By HOLDEN",69,1,10,0,80
1060980,774056,2018-08-31,Senate,"Conference Report SB901 Dodd et al",29,4,7,0,40
1060980,774057,2018-08-31,Assembly,"SB 901 Dodd Conference Report By HOLDEN",49,14,17,0,80
1062395,722905,2018-03-14,Senate,"Do pass, but first be re-referred to the Committee on [Appropriations]",9,0,0,0,9
1062395,752717,2018-05-14,Senate,"Placed on suspense file",7,0,0,0,7
1062395,756323,2018-05-25,Senate,"Do pass as amended",7,0,0,0,7
1062395,757676,2018-05-30,Senate,"Senate 3rd Reading SB906 Beall et al",38,0,1,0,39
1062395,764936,2018-06-19,Assembly,"Do pass and be re-referred to the Committee on [Appropriations]",15,0,0,0,15
1062395,771597,2018-08-16,Assembly,"Do pass as amended",12,0,5,0,17
1062395,774227,2018-08-31,Senate,"Unfinished Business SB906 Beall et al. Concurrence",39,0,1,0,40
1062395,774228,2018-08-31,Assembly,"SB 906 Beall Senate Third Reading By WALDRON",80,0,0,0,80
1062398,733465,2018-04-03,Senate,"Be adopted as amended",5,1,1,0,7
1062401,734431,2018-04-04,Assembly,"Do pass and be re-referred to the Committee on [Appropriations]",20,0,1,0,21
1062401,756467,2018-05-25,Assembly,"Do pass as amended",13,2,2,0,17
1062401,757504,2018-05-30,Assembly,"AB 1877 LIMÓN Assembly Third Reading",69,6,3,0,78
1062401,768304,2018-06-26,Senate,"Do pass, but first be re-referred to the Committee on [Appropriations]",12,0,1,0,13
1062401,770421,2018-08-06,Senate,"Placed on suspense file",7,0,0,0,7
1062401,771686,2018-08-16,Senate,"Do pass",7,0,0,0,7
1062401,773522,2018-08-29,Senate,"Assembly 3rd Reading AB1877 Limón et al. By Jackson",39,0,1,0,40
1062401,773752,2018-08-30,Assembly,"AB 1877 LIMÓN Concurrence in Senate Amendments",80,0,0,0,80
1062409,725486,2018-03-20,Assembly,"Do pass as amended, and be re-referred to the Committee on [Veterans Affairs] with recommendation: To Consent Calendar",7,0,0,0,7
1062409,737437,2018-04-10,Assembly,"Do pass and be re-referred to the Committee on [Appropriations]",10,0,0,0,10
1062409,756526,2018-05-25,Assembly,"Do pass as amended",16,0,1,0,17
1062409,758636,2018-05-31,Assembly,"AB 1883 WEBER Assembly Third Reading",78,0,0,0,78
1062409,762772,2018-06-12,Senate,"Do pass, but first be re-referred to the Committee on [Veterans Affairs] with the recommendation: To Consent Calendar",6,0,1,0,7
1062409,768180,2018-06-26,Senate,"Do pass, but first be re-referred to the Committee on [Appropriations] with the recommendation: To Consent Calendar",6,0,0,0,6
1062409,770350,2018-08-06,Senate,"Placed on suspense file",7,0,0,0,7
1062415,686872,2018-01-22,Assembly,"Be adopted. To third reading",8,0,3,0,11
1062415,705976,2018-02-20,Senate,"Special Consent ACR156",37,0,3,0,40
1062420,735588,2018-04-09,Senate,"Do pass, but first be re-referred to the Committee on [Judiciary]",9,0,0,0,9
1062420,744305,2018-04-24,Senate,"Do pass as amended, but first amend, and re-refer to the Committee on [Appropriations] with the recommendation: To Consent Calendar",7,0,0,0,7
1062420,754953,2018-05-21,Senate,"Senate 3rd Reading SB904 Wieckowski",39,0,0,0,39
1062420,764935,2018-06-19,Assembly,"Do pass and be re-referred to the Committee on [Judiciary]",17,0,2,0,19
1062420,768338,2018-06-26,Assembly,"Do pass and be re-referred to the Committee on [Appropriations] with recommendation: To Consent Calendar",10,0,0,0,10
1062420,771103,2018-08-08,Assembly,"Do pass. To Consent Calendar",17,0,0,0,17
1062420,771955,2018-08-16,Assembly,"SB 904 Wieckowski Consent Calendar Second Day Regular Session",76,0,4,0,80
1062420,772138,2018-08-20,Senate,"Unfinished Business SB904 Wieckowski Concurrence",35,0,5,0,40
1062424,733893,2018-04-04,Senate,"Do pass, but first be re-referred to the Committee on [Transportation and Housing] with the recommendation: To Consent Calendar",6,0,1,0,7
1062424,744703,2018-04-24,Senate,"Do pass and be ordered to the Consent Calendar",11,0,2,0,13
1062424,748716,2018-05-03,Senate,"Consent Calendar SB907 Cannella",38,0,1,0,39
1062424,763121,2018-06-13,Assembly,"Do pass and be re-referred to the Committee on [Transportation] with recommendation: To Consent Calendar",7,0,2,0,9
1062424,768030,2018-06-25,Assembly,"Do pass. To Consent Calendar",13,0,1,0,14
1062424,769553,2018-07-02,Assembly,"SB 907 Cannella Consent Calendar Second Day",77,0,3,0,80
1062426,743975,2018-04-25,Assembly,"Do pass as amended",14,0,1,0,15
1062426,754104,2018-05-16,Assembly,"Do pass. To Consent Calendar",17,0,0,0,17
1062426,756243,2018-05-25,Assembly,"AB 1879 SANTIAGO Consent Calendar Second Day Regular Session",70,0,8,0,78
1062426,765826,2018-06-19,Senate,"Do pass, but first be re-referred to the Committee on [Appropriations]",10,1,0,0,11
1062426,773892,2018-08-29,Senate,"Assembly 3rd Reading AB1879 Santiago et al. By Bradford Urgency Clause",25,1,14,0,40
1062426,773893,2018-08-29,Senate,"Assembly 3rd Reading AB1879 Santiago et al. By Bradford Reconsider",38,0,2,0,40
1062426,774198,2018-08-31,Senate,"Assembly 3rd Reading AB1879 Santiago et al. By Bradford Urgency Clause",34,0,6,0,40
1062429,743095,2018-04-23,Assembly,"Do pass as amended and be re-referred to the Committee on [Appropriations]",7,3,0,0,10
1062429,755702,2018-05-23,Assembly,"Do pass",11,5,1,0,17
1062429,757754,2018-05-30,Assembly,"AB 1884 CALDERON Assembly Third Reading",49,25,4,0,78
1062429,767168,2018-06-20,Senate,"Do pass as amended, but first amend, and re-refer to the Committee on [Appropriations]",5,1,1,0,7
1062429,772175,2018-08-20,Senate,"Assembly 3rd Reading AB1884 Calderon et al. By Stern",27,12,1,0,40
1062429,772587,2018-08-23,Assembly,"AB 1884 CALDERON Concurrence in Senate Amendments",50,25,5,0,80
1062433,717812,2018-03-06,Assembly,"Do pass and be re-referred to the Committee on [Appropriations]",6,0,1,0,7
1062433,756479,2018-05-25,Assembly,"Do pass",16,0,1,0,17
1062433,757130,2018-05-29,Assembly,"AB 1882 CERVANTES Assembly Third Reading",76,0,2,0,78
1062433,764949,2018-06-19,Senate,"Do pass, but first be re-referred to the Committee on [Appropriations]",7,0,0,0,7
1062433,769673,2018-07-02,Senate,"Placed on suspense file",7,0,0,0,7
1062433,771962,2018-08-16,Senate,"Do pass",7,0,0,0,7
1062433,772684,2018-08-24,Senate,"Special Consent AB1882",39,0,1,0,40
1062433,773558,2018-08-29,Assembly,"AB 1882 CERVANTES Concurrence in Senate Amendments",79,0,1,0,80
1062436,722304,2018-03-13,Senate,"Do pass as amended, but first amend, and re-refer to the Committee on [Appropriations]",8,2,2,0,12
1062436,738807,2018-04-16,Senate,"Placed on suspense file",7,0,0,0,7
1062436,756180,2018-05-25,Senate,"Do pass as amended",5,2,0,0,7
1062436,757693,2018-05-30,Senate,"Senate 3rd Reading SB905 Wiener et al",27,9,3,0,39
1062436,769272,2018-06-28,Assembly,"Do pass as amended and be re-referred to the Committee on [Appropriations]",11,6,4,0,21
1062436,771564,2018-08-16,Assembly,"Do pass as amended",12,0,5,0,17
1062436,773321,2018-08-29,Assembly,"SB 905 Wiener Senate Third Reading By SANTIAGO",51,22,7,0,80
1062436,773718,2018-08-30,Senate,"Unfinished Business SB905 Wiener et al. Concurrence",28,8,4,0,40
1064544,727406,2018-03-21,Assembly,"Do pass and be re-referred to the Committee on [Appropriations]",6,0,1,0,7
1064564,717774,2018-03-06,Assembly,"Do pass and be re-referred to the Committee on [Appropriations]",5,1,1,0,7
1064564,740733,2018-04-18,Assembly,"Do pass",10,5,2,0,17
1064564,749986,2018-05-07,Assembly,"AB 1892 JONES-SAWYER Assembly Third Reading",63,2,13,0,78
1064564,762939,2018-06-12,Senate,"Do pass as amended, but first amend, and re-refer to the Committee on [Appropriations]",6,0,1,0,7
1064564,772139,2018-08-20,Senate,"Assembly 3rd Reading AB1892 Jones-Sawyer By Mitchell",34,3,3,0,40
1064564,772582,2018-08-23,Assembly,"AB 1892 JONES-SAWYER Concurrence in Senate Amendments",70,1,9,0,80
1064564,777396,2018-08-20,Senate,,6,3,3,0,12
1064584,736799,2018-04-10,Senate,"Do pass, but first be re-referred to the Committee on [Appropriations] with the recommendation: To Consent Calendar",7,0,0,0,7
1064584,746078,2018-04-30,Senate,"Consent Calendar SB909 Hertzberg",36,0,3,0,39
1064584,762352,2018-06-12,Assembly,"Do pass as amended, and be re-referred to the Committee on [Appropriations] with recommendation: To Consent Calendar",9,0,1,0,10
1064584,771079,2018-08-08,Assembly,"Do pass. To Consent Calendar",17,0,0,0,17
1064584,771620,2018-08-16,Assembly,"SB 909 Hertzberg Consent Calendar Second Day Regular Session",76,0,4,0,80
1064584,772326,2018-08-21,Senate,"Unfinished Business SB909 Hertzberg Concurrence",39,0,1,0,40
1064607,740774,2018-04-18,Assembly,"Do pass",9,0,0,0,9
1064607,744899,2018-04-26,Assembly,"AB 1889 CABALLERO Assembly Third Reading",71,1,6,0,78
1064607,769331,2018-06-27,Senate,"Do pass as amended",7,0,0,0,7
1064607,771397,2018-08-13,Senate,"Special Consent AB1889",37,0,3,0,40
1064607,772297,2018-08-20,Assembly,"AB 1889 CABALLERO Concurrence in Senate Amendments",80,0,0,0,80
1064648,717863,2018-03-06,Assembly,"Do pass. To Consent Calendar",7,0,0,0,7
1064648,723662,2018-03-15,Assembly,"AB 1888 SALAS Consent Calendar Second Day",66,0,11,0,77
1064648,753211,2018-05-15,Senate,"Do pass and be ordered to the Consent Calendar",7,0,0,0,7
1064648,754856,2018-05-21,Senate,"Consent Calendar AB1888",39,0,0,0,39
1064668,690067,2018-01-29,Assembly,"Be adopted. To third reading",9,0,2,0,11
1064712,733256,2018-04-03,Senate,"Do pass, but first be re-referred to the Committee on [Appropriations]",3,1,3,0,7
1064712,733257,2018-04-03,Senate,"[First] hearing set for [04-03-2018]: Failed passage in Committee. Reconsideration granted",6,0,1,0,7
1064712,743081,2018-04-24,Senate,"Do pass, but first be re-referred to the Committee on [Appropriations]",3,0,4,0,7
1064734,741086,2018-04-18,Assembly,"Do pass and be re-referred to the Committee on [Appropriations]",20,0,1,0,21
1064734,748344,2018-05-02,Assembly,"Do pass. To Consent Calendar",17,0,0,0,17
1064734,751896,2018-05-10,Assembly,"AB 1891 LEVINE Consent Calendar Second Day Regular Session",73,0,5,0,78
1064734,762163,2018-06-12,Senate,"Do pass, but first be re-referred to the Committee on [Appropriations]",10,0,2,0,12
1064734,772293,2018-08-20,Senate,"Assembly 3rd Reading AB1891 Levine By Skinner",39,0,1,0,40
1064734,772614,2018-08-23,Assembly,"AB 1891 LEVINE Concurrence in Senate Amendments",79,0,1,0,80
1064756,722860,2018-03-14,Senate,"Do pass, but first be re-referred to the Committee on [Appropriations]",7,0,2,0,9
1064756,754921,2018-05-21,Senate,"Senate 3rd Reading SB910 Hernandez et al",27,10,2,0,39
1064756,765101,2018-06-19,Assembly,"Do pass and be re-referred to the Committee on [Appropriations]",11,1,3,0,15
1064756,768776,2018-06-27,Assembly,"Do pass",12,0,5,0,17
1064756,771523,2018-08-16,Assembly,"SB 910 Hernandez Senate Third Reading By WOOD",51,21,8,0,80
1064756,772217,2018-08-20,Senate,"Unfinished Business SB910 Hernandez et al. Concurrence",27,9,4,0,40
1064797,722242,2018-03-13,Assembly,"Do pass as amended and be re-referred to the Committee on [Education]",13,0,0,0,13
1064797,738273,2018-04-11,Assembly,"Do pass and be re-referred to the Committee on [Appropriations] with recommendation: To Consent Calendar",7,0,0,0,7
1064797,743847,2018-04-25,Assembly,"Do pass",12,0,5,0,17
1064797,746026,2018-04-30,Assembly,"AB 1887 MEDINA Assembly Third Reading",69,2,7,0,78
1064797,760240,2018-06-06,Senate,"Do pass, but first be re-referred to the Committee on [Appropriations]",6,0,0,0,6
1064797,770380,2018-08-06,Senate,"Assembly 3rd Reading AB1887 Medina et al. By Lara Urgency Clause",29,5,5,0,39
1064797,771149,2018-08-09,Assembly,"AB 1887 MEDINA Concurrence - Urgency Added",69,5,6,0,80
1064819,725600,2018-03-20,Assembly,"Do pass and be re-referred to the Committee on [Appropriations] with recommendation: To Consent Calendar",15,0,0,0,15
1064819,733831,2018-04-04,Assembly,"Do pass as amended",15,0,2,0,17
1064819,741342,2018-04-19,Assembly,"AB 1893 MAIENSCHEIN Assembly Third Reading",73,0,5,0,78
1064819,760443,2018-06-06,Senate,"Do pass, but first be re-referred to the Committee on [Appropriations] with the recommendation: To Consent Calendar",8,0,1,0,9
1064819,769574,2018-07-02,Senate,"Consent Calendar AB1893",37,0,2,0,39
1064840,743958,2018-04-24,Senate,"Do pass, but first be re-referred to the Committee on [Appropriations]",10,0,3,0,13
1064840,750040,2018-05-07,Senate,"Placed on suspense file",6,0,1,0,7
1064840,756196,2018-05-25,Senate,"Do pass as amended",7,0,0,0,7
1064840,757717,2018-05-30,Senate,"Senate 3rd Reading SB912 Beall et al",35,0,4,0,39
1064840,768984,2018-06-27,Assembly,"Do pass and be re-referred to the Committee on [Appropriations]",6,0,1,0,7
1064840,771049,2018-08-08,Assembly,"Do pass. To Consent Calendar",17,0,0,0,17
1064840,771670,2018-08-16,Assembly,"SB 912 Beall Consent Calendar Second Day Regular Session",76,0,4,0,80
1064840,772370,2018-08-21,Senate,"That the Assembly amendments be concurred in",13,0,0,0,13
1064840,772427,2018-08-22,Senate,"Unfinished Business SB912 Beall et al. Concurrence",39,0,1,0,40
1064862,722186,2018-03-13,Assembly,"Do pass as amended and be re-referred to the Committee on [Appropriations]",11,0,2,0,13
1064862,756597,2018-05-25,Assembly,"Do pass",12,0,5,0,17
1064862,757154,2018-05-29,Assembly,"AB 1895 CALDERON Assembly Third Reading",60,0,18,0,78
1064862,762992,2018-06-13,Senate,"Do pass, but first be re-referred to the Committee on [Appropriations]",7,0,0,0,7
1064862,768027,2018-06-25,Senate,"Placed on suspense file",7,0,0,0,7
1064862,771966,2018-08-16,Senate,"Do pass as amended",5,1,1,0,7
1064862,772332,2018-08-21,Senate,"Assembly 3rd Reading AB1895 Calderon et al. By Lara",31,5,4,0,40
1064862,772885,2018-08-27,Assembly,"AB 1895 CALDERON Concurrence in Senate Amendments",63,4,13,0,80
1064883,722168,2018-03-13,Assembly,"Do pass and be re-referred to the Committee on [Human Services]",13,0,0,0,13
1064883,737613,2018-04-10,Assembly,"Do pass and be re-referred to the Committee on [Appropriations] with recommendation: To Consent Calendar",7,0,0,0,7
1064883,747888,2018-05-02,Assembly,"Do pass. To Consent Calendar",17,0,0,0,17
1064883,752114,2018-05-10,Assembly,"AB 1894 WEBER Consent Calendar Second Day Regular Session",73,0,5,0,78
1064883,760344,2018-06-06,Senate,"Do pass, but first be re-referred to the Committee on [Human Services] with the recommendation: To Consent Calendar",6,0,0,0,6
1064883,768814,2018-06-26,Senate,"Do pass, but first be re-referred to the Committee on [Appropriations] with the recommendation: To Consent Calendar",6,0,1,0,7
1064883,770403,2018-08-06,Senate,"Placed on suspense file",7,0,0,0,7
1064883,771696,2018-08-16,Senate,"Do pass",7,0,0,0,7
1064883,772233,2018-08-20,Senate,"Assembly 3rd Reading AB1894 Weber By Wilk",39,0,1,0,40
1064903,740896,2018-04-18,Assembly,"Do pass and be re-referred to the Committee on [Appropriations]",20,0,1,0,21
1064903,748326,2018-05-02,Assembly,"Do pass. To Consent Calendar",17,0,0,0,17
1064903,751895,2018-05-10,Assembly,"AB 1890 LEVINE Consent Calendar Second Day Regular Session",73,0,5,0,78
1064903,762108,2018-06-12,Senate,"Do pass, but first be re-referred to the Committee on [Appropriations]",10,0,2,0,12
1064903,772232,2018-08-20,Senate,"Assembly 3rd Reading AB1890 Levine By Dodd",39,0,1,0,40
1064903,772562,2018-08-23,Assembly,"AB 1890 LEVINE Concurrence in Senate Amendments",79,0,1,0,80
1064925,691018,2018-01-25,Assembly,"Be adopted as amended",7,0,0,0,7
1064925,705824,2018-02-20,Senate,"Special Consent ACR157",37,0,3,0,40
1067687,717896,2018-03-06,Assembly,"Do pass and be re-referred to the Committee on [Appropriations]",5,1,1,0,7
1067687,733861,2018-04-04,Assembly,"Do pass",11,4,2,0,17
1067687,735590,2018-04-09,Assembly,"AB 1903 GONZALEZ FLETCHER Assembly Third Reading",51,20,6,0,77
1067687,762140,2018-06-12,Senate,"Do pass, but first be re-referred to the Committee on [Appropriations]",5,2,0,0,7
1067687,771359,2018-08-13,Senate,"Assembly 3rd Reading AB1903 Gonzalez Fletcher By Bradford",26,10,4,0,40
1067701,745258,2018-04-25,Senate,"Do pass as amended",8,1,4,0,13
1067701,754304,2018-05-17,Senate,"Senate 3rd Reading SB917 Jackson",25,11,3,0,39
1067701,768775,2018-06-27,Assembly,"Do pass as amended",8,3,2,0,13
1067701,773068,2018-08-28,Assembly,"SB 917 Jackson Senate Third Reading By COOLEY",47,22,11,0,80
1067701,773296,2018-08-29,Senate,"Unfinished Business SB917 Jackson Concurrence",27,12,1,0,40
1067715,772314,2018-08-20,Assembly,"Be adopted. To third reading",9,0,2,0,11
1067715,774261,2018-08-31,Senate,"Assembly 3rd Reading ACR158 Baker By Leyva",39,0,1,0,40
1067729,737360,2018-04-11,Senate,"Do pass",6,0,1,0,7
1067729,742728,2018-04-23,Senate,"Senate 3rd Reading SB914 Dodd et al",38,0,1,0,39
1067729,762860,2018-06-13,Assembly,"Do pass",7,0,2,0,9
1067729,768099,2018-06-25,Assembly,"SB 914 Dodd Senate Third Reading By GRAYSON",57,6,17,0,80
1067729,769543,2018-07-02,Senate,"Unfinished Business SB914 Dodd et al. Concurrence",37,0,2,0,39
1067744,722590,2018-03-12,Assembly,"Do pass as amended and be re-referred to the Committee on [Appropriations]",6,0,4,0,10
1067758,738981,2018-04-16,Assembly,"Do pass and be re-referred to the Committee on [Appropriations]",3,9,2,0,14
1067758,738982,2018-04-16,Assembly,Reconsideration,14,0,0,0,14
1067758,742161,2018-04-23,Assembly,"Do pass and be re-referred to the Committee on [Appropriations]",13,0,1,0,14
1067787,740226,2018-04-17,Assembly,"Do pass and be re-referred to the Committee on [Judiciary]",13,0,0,0,13
1067787,750503,2018-05-08,Assembly,"Do pass as amended. To Consent Calendar",10,0,0,0,10
1067787,754249,2018-05-17,Assembly,"AB 1896 CERVANTES Consent Calendar Second Day Regular Session",73,0,5,0,78
1067787,765133,2018-06-19,Senate,"Do pass, but first be re-referred to the Committee on [Judiciary] with the recommendation: To Consent Calendar",7,0,0,0,7
1067787,768944,2018-06-26,Senate,"Do pass and be ordered to the Consent Calendar",7,0,0,0,7
1067787,769784,2018-07-05,Senate,"Consent Calendar AB1896",35,0,4,0,39
1067801,725461,2018-03-20,Senate,"Do pass as amended, but first amend, and re-refer to the Committee on [Appropriations]",5,0,2,0,7
1067801,738893,2018-04-16,Senate,"Placed on suspense file",7,0,0,0,7
1067815,699438,2018-02-12,Senate,"Senate 3rd Reading SR74 De León et al",25,8,7,0,40
1067830,690146,2018-01-29,Assembly,"Be adopted. To third reading",9,0,2,0,11
1067830,705998,2018-02-20,Senate,"Special Consent ACR159",37,0,3,0,40
1067844,743817,2018-04-25,Senate,"Do pass",5,0,0,0,5
1067844,746028,2018-04-30,Senate,"Senate 3rd Reading SB913 Hertzberg",32,3,4,0,39
1067844,767067,2018-06-20,Assembly,"Do pass",7,0,0,0,7
1067844,770305,2018-08-06,Assembly,"SB 913 Hertzberg Senate Third Reading By BLOOM",63,9,8,0,80
1067844,771146,2018-08-09,Senate,"Unfinished Business SB913 Hertzberg et al. Concurrence",32,1,6,0,39
1067858,753196,2018-05-15,Senate,"Be adopted, but first be re-referred to the Committee on [Appropriations]",11,0,2,0,13
1067858,769577,2018-07-02,Senate,"Senate 3rd Reading SCR90 Roth et al",35,0,4,0,39
1067873,736144,2018-04-10,Senate,"Do pass as amended, but first amend, and re-refer to the Committee on [Transportation and Housing]",4,0,3,0,7
1067873,743936,2018-04-24,Senate,"Do pass, but first be re-referred to the Committee on [Appropriations]",10,0,3,0,13
1067873,749879,2018-05-07,Senate,"Placed on suspense file",6,0,1,0,7
1067873,756218,2018-05-25,Senate,"Do pass as amended",6,1,0,0,7
1067873,757697,2018-05-30,Senate,"Senate 3rd Reading SB918 Wiener et al",37,0,2,0,39
1067873,768820,2018-06-26,Assembly,"Do pass and be re-referred to the Committee on [Appropriations]",7,0,0,0,7
1067873,771577,2018-08-16,Assembly,"Do pass as amended",12,0,5,0,17
1067873,773766,2018-08-30,Assembly,"SB 918 Wiener Senate Third Reading By RUBIO",80,0,0,0,80
1067873,774189,2018-08-31,Senate,"Unfinished Business SB918 Wiener et al. Concurrence",39,0,1,0,40
1067887,725554,2018-03-20,Assembly,"Do pass",8,0,2,0,10
1067887,732875,2018-04-02,Assembly,"AB 1908 CHÁVEZ Assembly Third Reading",72,0,5,0,77
1067887,762275,2018-06-12,Senate,"Do pass and be ordered to the Consent Calendar",5,0,2,0,7
1067887,768097,2018-06-25,Senate,"Consent Calendar AB1908",36,0,3,0,39
1067887,771166,2018-08-09,Assembly,"AB 1908 CHÁVEZ Concurrence in Senate Amendments",78,0,2,0,80
1067930,741411,2018-04-18,Assembly,"Do pass and be re-referred to the Committee on [Appropriations]",5,2,0,0,7
1067944,747841,2018-05-01,Assembly,"Do pass as amended",8,2,0,0,10
1067944,757001,2018-05-29,Assembly,"AB 1906 IRWIN Assembly Third Reading",56,16,6,0,78
1067944,764867,2018-06-18,Senate,"Do pass, but first be re-referred to the Committee on [Judiciary]",8,1,0,0,9
1067944,768913,2018-06-26,Senate,"Do pass as amended, but first amend, and re-refer to the Committee on [Appropriations]",5,1,1,0,7
1067944,770248,2018-08-06,Senate,"Placed on suspense file",7,0,0,0,7
1067944,771851,2018-08-16,Senate,"Do pass",5,2,0,0,7
1067944,773597,2018-08-29,Senate,"Assembly 3rd Reading AB1906 Irwin et al. By Jackson",29,8,3,0,40
1067944,773862,2018-08-30,Assembly,"AB 1906 IRWIN Concurrence in Senate Amendments",60,17,3,0,80
1067959,722225,2018-03-13,Senate,"Do pass as amended, but first amend, and re-refer to the Committee on [Appropriations]",6,0,3,0,9
1067959,738814,2018-04-16,Senate,"Placed on suspense file",7,0,0,0,7
1067959,756455,2018-05-25,Senate,"Do pass",5,2,0,0,7
1067959,756982,2018-05-29,Senate,"Senate 3rd Reading SB919 Dodd",29,8,2,0,39
1067959,768260,2018-06-26,Assembly,"Do pass as amended and be re-referred to the Committee on [Appropriations]",12,2,1,0,15
1067972,690050,2018-01-29,Assembly,"Be adopted. To third reading",9,0,2,0,11
1067972,705969,2018-02-20,Senate,"Special Consent ACR160",37,0,3,0,40
1067986,735605,2018-04-09,Assembly,"Do pass and be re-referred to the Committee on [Appropriations]",5,2,7,0,14
1067986,735606,2018-04-09,Assembly,Reconsideration,14,0,0,0,14
1068001,751125,2018-05-09,Assembly,"Do pass as amended",9,0,0,0,9
1068001,754943,2018-05-21,Assembly,"AB 1900 BROUGH Assembly Third Reading",73,1,4,0,78
1068001,762725,2018-06-13,Senate,"Do pass",7,0,0,0,7
1068001,771445,2018-08-13,Senate,"Special Consent AB1900",37,0,3,0,40
1068015,738829,2018-04-16,Assembly,"Do pass as amended and be re-referred to the Committee on [Transportation]",8,1,1,0,10
1068015,742240,2018-04-23,Assembly,"Do pass",14,0,0,0,14
1068015,744893,2018-04-26,Assembly,"AB 1901 OBERNOLTE Assembly Third Reading",63,6,9,0,78
1068029,768988,2018-06-27,Assembly,"Do pass",16,0,1,0,17
1068029,769634,2018-07-02,Assembly,"AB 1897 APPR. Third Reading Urgency By GONZALEZ FLETCHER",74,0,6,0,80
1068029,771429,2018-08-13,Senate,"Do pass",5,1,1,0,7
1068029,773236,2018-08-28,Senate,"Assembly 3rd Reading AB1897 APPR. (Gonzalez Fletcher) By Portantino Urgency Clause",27,12,1,0,40
1069542,736070,2018-04-10,Senate,"Do pass, but first be re-referred to the Committee on [Appropriations]",6,0,1,0,7
1069542,742227,2018-04-23,Senate,"Placed on suspense file",7,0,0,0,7
1069542,756221,2018-05-25,Senate,"Do pass as amended",5,1,1,0,7
1069542,757520,2018-05-30,Senate,"Senate 3rd Reading SB923 Wiener et al",27,8,4,0,39
1069542,762175,2018-06-12,Assembly,"Do pass and be re-referred to the Committee on [Appropriations]",5,1,1,0,7
1069542,771540,2018-08-16,Assembly,"Do pass as amended",12,1,4,0,17
1069542,774222,2018-08-31,Senate,"Unfinished Business SB923 Wiener et al. Concurrence",21,8,11,0,40
1069542,774223,2018-08-31,Assembly,"SB 923 Wiener Senate Third Reading By LEVINE",50,21,9,0,80
1069553,736042,2018-04-10,Senate,"Do pass, but first be re-referred to the Committee on [Judiciary] with the recommendation: To Consent Calendar",6,0,1,0,7
1069553,744019,2018-04-24,Senate,"Do pass and be ordered to the Consent Calendar",7,0,0,0,7
1069553,748970,2018-05-03,Senate,"Consent Calendar SB925",38,0,1,0,39
1069553,762424,2018-06-12,Assembly,"Do pass as amended, and be re-referred to the Committee on [Judiciary] with recommendation: To Consent Calendar",7,0,0,0,7
1069553,765190,2018-06-19,Assembly,"Do pass. To Consent Calendar",10,0,0,0,10
1069553,767981,2018-06-25,Assembly,"SB 925 Beall Consent Calendar Second Day Regular Session",75,0,5,0,80
1069553,769603,2018-07-02,Senate,"Unfinished Business SB925 Beall et al. Concurrence",37,0,2,0,39
1069563,717779,2018-03-06,Assembly,"Do pass and be re-referred to the Committee on [Appropriations]",7,0,0,0,7
1069563,733876,2018-04-04,Assembly,"Do pass. To Consent Calendar",15,0,2,0,17
1069563,738194,2018-04-12,Assembly,"AB 1909 NAZARIAN Consent Calendar Second Day Regular Session",68,0,9,0,77
1069563,762800,2018-06-12,Senate,"Do pass, but first be re-referred to the Committee on [Appropriations]",6,0,1,0,7
1069563,771779,2018-08-16,Senate,"Assembly 3rd Reading AB1909 Nazarian By Nguyen",39,0,1,0,40
1069563,772268,2018-08-20,Assembly,"AB 1909 NAZARIAN Concurrence in Senate Amendments",80,0,0,0,80
1069574,735651,2018-04-09,Senate,"Do pass, but first be re-referred to the Committee on [Judiciary]",9,0,0,0,9
1069574,744269,2018-04-24,Senate,"Do pass as amended, but first amend, and re-refer to the Committee on [Appropriations] with the recommendation: To Consent Calendar",7,0,0,0,7
1069574,754898,2018-05-21,Senate,"Senate 3rd Reading SB920 Cannella et al",39,0,0,0,39
1069574,765679,2018-06-19,Assembly,"Do pass and be re-referred to the Committee on [Appropriations] with recommendation: To Consent Calendar",17,0,2,0,19
1069574,768961,2018-06-27,Assembly,"Do pass. To Consent Calendar",16,0,1,0,17
1069574,769808,2018-07-05,Assembly,"SB 920 Cannella Consent Calendar Second Day Regular Session",69,0,11,0,80
1069584,751372,2018-05-09,Assembly,"Do pass and be re-referred to the Committee on [Appropriations]",1,5,1,0,7
1069584,751373,2018-05-09,Assembly,Reconsideration,7,0,0,0,7
1069595,742942,2018-04-24,Assembly,"Do pass and be re-referred to the Committee on [Appropriations]",2,5,0,0,7
1069595,742943,2018-04-24,Assembly,Reconsideration,2,5,0,0,7
1069615,740783,2018-04-18,Assembly,"Do pass as amended and be re-referred to the Committee on [Judiciary]",5,0,2,0,7
1069615,743126,2018-04-24,Assembly,"Do pass and be re-referred to the Committee on [Appropriations]",7,2,1,0,10
1069615,756448,2018-05-25,Assembly,"Do pass",12,4,1,0,17
1069615,757692,2018-05-30,Assembly,"AB 1912 RODRIGUEZ Assembly Third Reading",49,27,2,0,78
1069615,767876,2018-06-25,Senate,"Do pass, but first be re-referred to the Committee on [Judiciary]",3,1,1,0,5
1069615,768904,2018-06-26,Senate,"Do pass as amended, but first amend, and re-refer to the Committee on [Appropriations]",5,1,1,0,7
1069615,770537,2018-08-06,Senate,"Placed on suspense file",7,0,0,0,7
1069615,771664,2018-08-16,Senate,"Do pass as amended",5,2,0,0,7
1069615,773717,2018-08-30,Senate,"Assembly 3rd Reading AB1912 Rodriguez By Portantino",27,10,3,0,40
1069615,774061,2018-08-31,Assembly,"AB 1912 RODRIGUEZ Concurrence in Senate Amendments",59,13,8,0,80
1069625,723241,2018-03-14,Assembly,"Do pass and be re-referred to the Committee on [Judiciary]",5,1,1,0,7
1069625,736201,2018-04-10,Assembly,"Do pass and be re-referred to the Committee on [Appropriations]",8,1,1,0,10
1069625,756600,2018-05-25,Assembly,"Do pass",12,4,1,0,17
1069625,758693,2018-05-31,Assembly,"AB 1913 KALRA Assembly Third Reading",28,32,18,0,78
1069635,736010,2018-04-10,Senate,"Do pass, but first be re-referred to the Committee on [Appropriations]",4,3,5,0,12
1069635,736011,2018-04-10,Senate,"[First] hearing set for [04-10-2018]: Failed passage in Committee. Reconsideration granted",12,0,0,0,12
1069646,748702,2018-05-03,Assembly,"Be adopted. To third reading",6,0,5,0,11
1069646,761066,2018-06-07,Senate,"Special Consent ACR161 Limón et al",37,0,2,0,39
1069667,744711,2018-04-24,Senate,"Be adopted, but first be re-referred to the Committee on [Appropriations]",7,0,0,0,7
1069667,755125,2018-05-21,Senate,"Senate 3rd Reading SCR91 Roth et al",38,0,1,0,39
1069667,769716,2018-07-03,Assembly,"Be adopted and re-referred to the Committee on [Appropriations]",10,0,0,0,10
1069667,771092,2018-08-08,Assembly,"Be adopted. To Consent Calendar",17,0,0,0,17
1069667,771389,2018-08-13,Assembly,"SCR 91 Roth Consent Calendar Second Day Regular Session",77,0,3,0,80
1069678,740879,2018-04-18,Assembly,"Do pass and be re-referred to the Committee on [Appropriations]",6,0,1,0,7
1069678,756565,2018-05-25,Assembly,"Do pass as amended",13,2,2,0,17
1069678,757817,2018-05-30,Assembly,"AB 1916 COOPER Assembly Third Reading",67,0,11,0,78
1069678,768033,2018-06-25,Senate,"Do pass, but first be re-referred to the Committee on [Appropriations]",4,1,0,0,5
1069678,770912,2018-08-06,Senate,"Placed on suspense file",7,0,0,0,7
1069678,771977,2018-08-16,Senate,"Do pass",7,0,0,0,7
1069678,772386,2018-08-21,Senate,"Assembly 3rd Reading AB1916 Cooper et al. By Skinner",39,0,1,0,40
1069688,754497,2018-05-17,Senate,"Senate 3rd Reading SR75 Morrell et al",38,0,1,0,39
1069699,725628,2018-03-20,Assembly,"Do pass and be re-referred to the Committee on [Appropriations]",14,0,1,0,15
1069699,756637,2018-05-25,Assembly,"Do pass",15,0,2,0,17
1069699,757885,2018-05-30,Assembly,"AB 1918 GARCIA, E. Assembly Third Reading",75,0,3,0,78
1069699,768392,2018-06-26,Senate,"Do pass as amended, but first amend, and re-refer to the Committee on [Appropriations]",8,1,0,0,9
1069699,770947,2018-08-06,Senate,"Placed on suspense file",7,0,0,0,7
1069699,771984,2018-08-16,Senate,"Do pass",7,0,0,0,7
1069699,773208,2018-08-28,Senate,"Assembly 3rd Reading AB1918 Eduardo Garcia et al. By McGuire",33,3,4,0,40
1069699,773559,2018-08-29,Assembly,"AB 1918 GARCIA, E. Concurrence in Senate Amendments",75,0,5,0,80
1069709,725791,2018-03-20,Assembly,"Do pass as amended and be re-referred to the Committee on [Appropriations]",7,0,0,0,7
1069709,737403,2018-04-11,Assembly,"Do pass. To Consent Calendar",15,0,2,0,17
1069709,741404,2018-04-19,Assembly,"AB 1914 FLORA Consent Calendar Second Day Regular Session",71,0,7,0,78
1069709,763166,2018-06-12,Senate,"Do pass as amended, but first amend, and re-refer to the Committee on [Public Safety]",6,0,1,0,7
1069709,769610,2018-07-02,Senate,"Do pass as amended",8,0,1,0,9
1069709,771246,2018-08-13,Senate,"Do pass",6,0,1,0,7
1069709,773222,2018-08-28,Senate,"Assembly 3rd Reading AB1914 Flora By Hill",38,0,2,0,40
1069709,773709,2018-08-30,Assembly,"With recommendation: That Senate amendments be concurred in",11,0,3,0,14
1069709,774131,2018-08-31,Assembly,"AB 1914 FLORA Concurrence in Senate Amendments",80,0,0,0,80
1069720,736138,2018-04-10,Senate,"Do pass, but first be re-referred to the Committee on [Environmental Quality]",5,5,2,0,12
1069720,736139,2018-04-10,Senate,"[First] hearing set for [04-10-2018]: Failed passage in Committee. Reconsideration granted",12,0,0,0,12
1069730,737181,2018-04-11,Senate,"Do pass, but first be re-referred to the Committee on [Veterans Affairs]",6,0,1,0,7
1069730,743295,2018-04-24,Senate,"Do pass, but first be re-referred to the Committee on [Appropriations]",7,0,0,0,7
1069730,750132,2018-05-07,Senate,"Placed on suspense file",6,0,1,0,7
1069730,756519,2018-05-25,Senate,"Do pass",7,0,0,0,7
1069730,758653,2018-05-31,Senate,"Special Consent SB924",39,0,0,0,39
1069730,765817,2018-06-18,Assembly,"Do pass as amended and be re-referred to the Committee on [Veterans Affairs]",8,0,2,0,10
1069730,768760,2018-06-26,Assembly,"Do pass and be re-referred to the Committee on [Appropriations]",9,0,1,0,10
1070892,753292,2018-05-14,Assembly,"Do pass and be re-referred to the Committee on [Appropriations]",2,6,2,0,10
1070903,736002,2018-04-09,Assembly,"Do pass as amended and be re-referred to the Committee on [Appropriations]",9,0,1,0,10
1070903,756308,2018-05-25,Assembly,"Do pass as amended",16,0,1,0,17
1070903,757696,2018-05-30,Assembly,"AB 1933 MAIENSCHEIN Assembly Third Reading",78,0,0,0,78
1070903,767089,2018-06-20,Senate,"Do pass as amended, but first amend, and re-refer to the Committee on [Appropriations] with the recommendation: To Consent Calendar",7,0,0,0,7
1070903,771268,2018-08-13,Senate,"Consent Calendar AB1933",37,0,3,0,40
1070903,772210,2018-08-20,Assembly,"AB 1933 MAIENSCHEIN Concurrence in Senate Amendments",80,0,0,0,80
1070914,743940,2018-04-24,Assembly,"Do pass and be re-referred to the Committee on [Appropriations] with recommendation: To Consent Calendar",7,0,0,0,7
1070914,751229,2018-05-09,Assembly,"Do pass. To Consent Calendar",16,0,1,0,17
1070914,754354,2018-05-17,Assembly,"AB 1930 STONE Consent Calendar Second Day Regular Session",73,0,5,0,78
1070914,762928,2018-06-12,Senate,"Do pass as amended, but first amend, and re-refer to the Committee on [Judiciary]",6,0,1,0,7
1070914,768752,2018-06-26,Senate,"Do pass, but first be re-referred to the Committee on [Appropriations] with the recommendation: To Consent Calendar",7,0,0,0,7
1070914,773425,2018-08-29,Senate,"Assembly 3rd Reading AB1930 Mark Stone By Wiener",39,0,1,0,40
1070914,773699,2018-08-30,Assembly,"AB 1930 STONE Concurrence in Senate Amendments",79,0,1,0,80
1070914,777511,2018-08-29,Senate,,7,0,1,0,8
1070925,735777,2018-04-09,Assembly,"Do pass and be re-referred to the Committee on [Appropriations]",11,0,3,0,14
1070925,740851,2018-04-18,Assembly,"Do pass. To Consent Calendar",15,0,2,0,17
1070925,744882,2018-04-26,Assembly,"AB 1925 CHOI Consent Calendar Second Day Regular Session",74,0,4,0,78
1070925,762249,2018-06-12,Senate,"Do pass, but first be re-referred to the Committee on [Appropriations] with the recommendation: To Consent Calendar",12,0,1,0,13
1070925,769567,2018-07-02,Senate,"Consent Calendar AB1925",37,0,2,0,39
1070936,737059,2018-04-09,Assembly,"Do pass and be re-referred to the Committee on [Appropriations]",8,0,2,0,10
1070936,756557,2018-05-25,Assembly,"Do pass",15,0,2,0,17
1070936,757150,2018-05-29,Assembly,"AB 1928 MCCARTY Assembly Third Reading",76,0,2,0,78
1070936,768608,2018-06-26,Senate,"Do pass, but first be re-referred to the Committee on [Appropriations] with the recommendation: To Consent Calendar",9,0,0,0,9
1070936,772160,2018-08-20,Senate,"Assembly 3rd Reading AB1928 McCarty et al. By McGuire",39,0,1,0,40
1070936,772584,2018-08-23,Assembly,"AB 1928 MCCARTY Concurrence in Senate Amendments",79,0,1,0,80
1070947,725694,2018-03-20,Assembly,"Do pass and be re-referred to the Committee on [Appropriations]",6,0,1,0,7
1070947,756680,2018-05-25,Assembly,"Do pass as amended",12,4,1,0,17
1070947,757534,2018-05-30,Assembly,"AB 1927 BONTA Assembly Third Reading",66,0,12,0,78
1070947,765934,2018-06-19,Senate,"Do pass, but first be re-referred to the Committee on [Appropriations] with the recommendation: To Consent Calendar",7,0,0,0,7
1070947,770837,2018-08-06,Senate,"Placed on suspense file",7,0,0,0,7
1070947,772041,2018-08-16,Senate,"Do pass",7,0,0,0,7
1070947,772706,2018-08-24,Senate,"Special Consent AB1927",39,0,1,0,40
1070958,717749,2018-03-06,Assembly,"Do pass as amended and be re-referred to the Committee on [Appropriations]",7,0,0,0,7
1070958,733771,2018-04-04,Assembly,"Do pass. To Consent Calendar",15,0,2,0,17
1070958,738268,2018-04-12,Assembly,"AB 1920 GRAYSON Consent Calendar Second Day Regular Session",68,0,9,0,77
1070958,762131,2018-06-12,Senate,"Do pass, but first be re-referred to the Committee on [Appropriations]",7,0,0,0,7
1070958,767831,2018-06-25,Senate,"Placed on suspense file",7,0,0,0,7
1070958,771715,2018-08-16,Senate,"Do pass",7,0,0,0,7
1070958,772701,2018-08-24,Senate,"Special Consent AB1920",39,0,1,0,40
1070969,692939,2018-02-01,Senate,"Senate 3rd Reading SR78 Mitchell et al",39,0,1,0,40
1070979,736147,2018-04-10,Assembly,"Do pass as amended and be re-referred to the Committee on [Appropriations]",6,1,0,0,7
1070979,756405,2018-05-25,Assembly,"Do pass as amended",13,0,4,0,17
1070979,757535,2018-05-30,Assembly,"AB 1919 WOOD Assembly Third Reading",65,5,8,0,78
1070979,765098,2018-06-19,Senate,"Do pass, but first be re-referred to the Committee on [Governmental Organization]",6,1,0,0,7
1070979,768176,2018-06-26,Senate,"Do pass, but first be re-referred to the Committee on [Appropriations]",13,0,0,0,13
1070979,770278,2018-08-06,Senate,"Placed on suspense file",7,0,0,0,7
1070979,771758,2018-08-16,Senate,"Do pass as amended",7,0,0,0,7
1070979,774017,2018-08-31,Senate,"Assembly 3rd Reading AB1919 Wood et al. By Jackson",37,1,2,0,40
1070979,774018,2018-08-31,Assembly,"AB 1919 WOOD Concurrence in Senate Amendments",68,4,8,0,80
1070979,777399,2018-08-31,Senate,As,7,1,2,0,10
1070990,703969,2018-02-16,Assembly,"Be adopted. To third reading",7,0,4,0,11
1070990,727805,2018-03-22,Senate,"Special Consent ACR162",37,0,2,0,39
1071001,688970,2018-01-25,Senate,"Senate 3rd Reading SR79 De León",27,9,4,0,40
1071023,708531,2018-02-22,Senate,"Senate 3rd Reading SR77 Cannella",36,0,4,0,40
1071076,689905,2018-01-29,Senate,"Senate 3rd Reading SR76 Skinner et al",39,0,1,0,40
1071087,717722,2018-03-06,Assembly,"Do pass. To Consent Calendar",7,0,0,0,7
1071087,723666,2018-03-15,Assembly,"AB 1934 JONES-SAWYER Consent Calendar Second Day Regular Session",66,0,11,0,77
1071087,753314,2018-05-15,Senate,"Do pass, but first be re-referred to the Committee on [Judiciary] with the recommendation: To Consent Calendar",7,0,0,0,7
1071087,762935,2018-06-12,Senate,"Do pass and be ordered to the Consent Calendar",7,0,0,0,7
1071087,767971,2018-06-25,Senate,"Consent Calendar AB1934",36,0,3,0,39
1071098,733882,2018-04-03,Assembly,"Do pass as amended and be re-referred to the Committee on [Appropriations]",13,0,0,0,13
1071098,756517,2018-05-25,Assembly,"Do pass",16,0,1,0,17
1071098,757085,2018-05-29,Assembly,"AB 1935 IRWIN Assembly Third Reading",77,0,1,0,78
1071098,762883,2018-06-13,Senate,"Do pass as amended, but first amend, and re-refer to the Committee on [Appropriations]",7,0,0,0,7
1071098,769602,2018-07-02,Senate,"Placed on suspense file",7,0,0,0,7
1071109,733228,2018-04-03,Assembly,"Do pass",2,5,0,0,7
1071109,733229,2018-04-03,Assembly,Reconsideration,7,0,0,0,7
1071109,743088,2018-04-24,Assembly,"Do pass",2,5,0,0,7
1071119,717773,2018-03-06,Assembly,"Do pass and be re-referred to the Committee on [Appropriations]",6,0,1,0,7
1071119,756393,2018-05-25,Assembly,"Do pass as amended",16,0,1,0,17
1071119,757670,2018-05-30,Assembly,"AB 1921 MAIENSCHEIN Assembly Third Reading",77,0,1,0,78
1071119,768866,2018-06-26,Senate,"Do pass, but first be re-referred to the Committee on [Appropriations] with the recommendation: To Consent Calendar",6,0,1,0,7
1071119,770524,2018-08-06,Senate,"Placed on suspense file",7,0,0,0,7
1071119,772069,2018-08-16,Senate,"Do pass as amended",7,0,0,0,7
1071119,773214,2018-08-28,Senate,"Assembly 3rd Reading AB1921 Maienschein et al. By Mitchell",39,0,1,0,40
1071119,773570,2018-08-29,Assembly,"AB 1921 MAIENSCHEIN Concurrence in Senate Amendments",79,0,1,0,80
1071130,743124,2018-04-24,Assembly,"Do pass and be re-referred to the Committee on [Appropriations]",4,0,3,0,7
1071141,740754,2018-04-18,Assembly,"Do pass as amended and be re-referred to the Committee on [Appropriations]",13,0,0,0,13
1071151,736021,2018-04-10,Senate,"Do pass as amended, but first amend, and re-refer to the Committee on [Judiciary]",5,0,2,0,7
1071151,743792,2018-04-24,Senate,"Do pass as amended, but first amend, and re-refer to the Committee on [Appropriations]",5,1,1,0,7
1071151,743793,2018-04-24,Senate,"[04-25-2018] set for [First] hearing: Reconsideration of favorable vote granted",7,0,0,0,7
1071151,743794,2018-04-24,Senate,"Do pass as amended, but first amend, and re-refer to the Committee on [Appropriations]",5,2,0,0,7
1071151,752985,2018-05-14,Senate,"Placed on suspense file",7,0,0,0,7
1071151,756344,2018-05-25,Senate,"Do pass as amended",5,2,0,0,7
1071151,757706,2018-05-30,Senate,"Senate 3rd Reading SB926 Skinner",27,10,2,0,39
1071151,768737,2018-06-26,Assembly,"Do pass and be re-referred to the Committee on [Appropriations]",5,2,0,0,7
1071151,771045,2018-08-08,Assembly,"Do pass",12,5,0,0,17
1071151,772313,2018-08-20,Assembly,"SB 926 Skinner Senate Third Reading By REYES",55,25,0,0,80
1071151,772351,2018-08-21,Senate,"Unfinished Business SB926 Skinner Concurrence",28,9,3,0,40
1072216,690073,2018-01-29,Assembly,"Be adopted. To third reading",9,0,2,0,11
1072221,740016,2018-04-17,Senate,"Do pass as amended, but first amend, and re-refer to the Committee on [Appropriations]",4,0,1,0,5
1072221,746459,2018-04-30,Senate,"Placed on suspense file",6,0,1,0,7
1072224,740650,2018-04-18,Senate,"Do pass, but first be re-referred to the Committee on [Governance and Finance]",7,0,0,0,7
1072224,743726,2018-04-25,Senate,"Do pass as amended, but first amend, and re-refer to the Committee on [Appropriations]",6,1,0,0,7
1072224,755313,2018-05-22,Senate,"Placed on suspense file",7,0,0,0,7
1072224,756211,2018-05-25,Senate,"Do pass as amended",5,2,0,0,7
1072224,757621,2018-05-30,Senate,"Senate 3rd Reading SB930 Hertzberg et al",32,6,1,0,39
1072224,764277,2018-06-18,Assembly,"Do pass and be re-referred to the Committee on [Business and Professions]",10,0,1,0,11
1072224,768104,2018-06-26,Assembly,"Do pass and be re-referred to the Committee on [Appropriations]",17,2,0,0,19
1072234,737305,2018-04-11,Senate,"Do pass, but first be re-referred to the Committee on [Judiciary]",4,0,1,0,5
1072234,740687,2018-04-17,Senate,"Do pass, but first be re-referred to the Committee on [Transportation and Housing]",5,2,0,0,7
1072234,743810,2018-04-24,Senate,"Do pass as amended, but first amend, and re-refer to the Committee on [Appropriations]",8,1,4,0,13
1072234,752600,2018-05-14,Senate,"Placed on suspense file",7,0,0,0,7
1072234,756317,2018-05-25,Senate,"Do pass as amended",5,2,0,0,7
1072234,757712,2018-05-30,Senate,"Senate 3rd Reading SB937 Wiener et al",24,6,9,0,39
1072234,767021,2018-06-20,Assembly,"Do pass and be re-referred to the Committee on [Business and Professions]",5,2,0,0,7
1072234,768318,2018-06-26,Assembly,"Do pass and be re-referred to the Committee on [Appropriations]",12,4,3,0,19
1072234,771589,2018-08-16,Assembly,"Do pass",13,3,1,0,17
1072234,773073,2018-08-28,Assembly,"SB 937 Wiener Senate Third Reading By LIMÓN",57,18,5,0,80
1072234,773578,2018-08-29,Senate,"Unfinished Business SB937 Wiener et al. Concurrence",28,9,3,0,40
1072238,722139,2018-03-13,Assembly,"Do pass and be re-referred to the Committee on [Appropriations]",12,0,1,0,13
1072243,710267,2018-02-26,Assembly,"Be adopted. To third reading",8,0,3,0,11
1072243,735475,2018-04-09,Senate,"Special Consent ACR163",39,0,0,0,39
1072247,734161,2018-04-04,Senate,"Do pass, but first be re-referred to the Committee on [Appropriations]",6,0,1,0,7
1072247,738863,2018-04-16,Senate,"Do pass",7,0,0,0,7
1072247,742167,2018-04-23,Senate,"Senate 3rd Reading SB929 McGuire",38,0,1,0,39
1072247,762759,2018-06-13,Assembly,"Do pass and be re-referred to the Committee on [Appropriations]",7,0,2,0,9
1072247,768939,2018-06-27,Assembly,"Do pass. To Consent Calendar",16,0,1,0,17
1072247,772169,2018-08-20,Assembly,"SB 929 McGuire Senate Third Reading By BLOOM",80,0,0,0,80
1072247,772441,2018-08-22,Senate,"Unfinished Business SB929 McGuire Concurrence",39,0,1,0,40
1072252,743967,2018-04-24,Senate,"Do pass as amended, but first amend, and re-refer to the Committee on [Appropriations]",12,0,1,0,13
1072252,752714,2018-05-14,Senate,"Placed on suspense file",7,0,0,0,7
1072256,733165,2018-04-03,Senate,"Do pass",6,0,1,0,7
1072256,738185,2018-04-12,Senate,"Senate 3rd Reading SB931 Hertzberg",38,0,1,0,39
1072256,762209,2018-06-12,Assembly,"Do pass and be re-referred to the Committee on [Health] with recommendation: To Consent Calendar",9,0,1,0,10
1072256,768252,2018-06-26,Assembly,"Do pass and be re-referred to the Committee on [Appropriations] with recommendation: To Consent Calendar",15,0,0,0,15
1072256,772192,2018-08-20,Assembly,"SB 931 Hertzberg Senate Third Reading By JONES-SAWYER",80,0,0,0,80
1072261,740747,2018-04-18,Assembly,"Do pass and be re-referred to the Committee on [Appropriations]",5,1,1,0,7
1072261,756568,2018-05-25,Assembly,"Do pass",12,4,1,0,17
1072261,757567,2018-05-30,Assembly,"AB 1937 SANTIAGO Assembly Third Reading",53,25,0,0,78
1072261,767911,2018-06-25,Senate,"Do pass, but first be re-referred to the Committee on [Appropriations]",3,2,0,0,5
1072265,733844,2018-04-04,Senate,"Do pass as amended, but first amend, and re-refer to the Committee on [Appropriations]",6,0,0,0,6
1072265,742160,2018-04-23,Senate,"Placed on suspense file",7,0,0,0,7
1072265,756345,2018-05-25,Senate,"Do pass as amended",7,0,0,0,7
1072265,757716,2018-05-30,Senate,"Senate 3rd Reading SB933 Allen et al",37,0,2,0,39
1072265,768906,2018-06-27,Assembly,"Do pass as amended and be re-referred to the Committee on [Appropriations]",7,0,0,0,7
1072265,771536,2018-08-16,Assembly,"Do pass",15,0,2,0,17
1072265,772808,2018-08-27,Assembly,"SB 933 Allen Senate Third Reading By O'DONNELL",75,3,2,0,80
1072265,773143,2018-08-28,Senate,"Unfinished Business SB933 Allen et al. Concurrence",39,0,1,0,40
1072270,718437,2018-03-06,Assembly,"Do pass as amended and be re-referred to the Committee on [Appropriations]",5,1,1,0,7
1072270,756337,2018-05-25,Assembly,"Do pass",12,3,2,0,17
1072270,758765,2018-05-31,Assembly,"AB 1940 MCCARTY Assembly Third Reading",35,35,8,0,78
1072274,747007,2018-05-01,Senate,"Be adopted, but first be re-referred to the Committee on [Appropriations] with recommendation: To Consent Calendar",12,0,1,0,13
1072274,756970,2018-05-29,Senate,"Senate 3rd Reading SCR92 McGuire et al",38,0,1,0,39
1072274,767943,2018-06-25,Assembly,"Be adopted. To Consent Calendar",13,0,1,0,14
1072274,769212,2018-06-28,Assembly,"SCR 92 McGuire Consent Calendar Second Day Regular Session",75,0,5,0,80
1072279,733320,2018-04-03,Assembly,"Do pass and be re-referred to the Committee on [Appropriations]",6,0,1,0,7
1072279,756560,2018-05-25,Assembly,"Do pass",15,0,2,0,17
1072279,757760,2018-05-30,Assembly,"AB 1939 STEINORTH Assembly Third Reading",75,1,2,0,78
1072279,765223,2018-06-19,Senate,"Do pass, but first be re-referred to the Committee on [Appropriations]",7,0,0,0,7
1072279,769669,2018-07-02,Senate,"Placed on suspense file",7,0,0,0,7
1072279,772018,2018-08-16,Senate,"Do pass as amended",7,0,0,0,7
1072279,772917,2018-08-27,Senate,"Assembly 3rd Reading AB1939 Steinorth et al. By Roth",39,0,1,0,40
1072279,773590,2018-08-29,Assembly,"AB 1939 STEINORTH Concurrence in Senate Amendments",78,2,0,0,80
1072283,739723,2018-04-17,Senate,"Do pass, but first be re-referred to the Committee on [Appropriations] with the recommendation: To Consent Calendar",7,0,0,0,7
1072283,746162,2018-04-30,Senate,"Placed on suspense file",6,0,1,0,7
1073805,738267,2018-04-11,Assembly,"Do pass and be re-referred to the Committee on [Appropriations]",6,0,1,0,7
1073805,756543,2018-05-25,Assembly,"Do pass as amended",12,0,5,0,17
1073805,757714,2018-05-30,Assembly,"AB 1951 O'DONNELL Assembly Third Reading",75,0,3,0,78
1073805,766163,2018-06-20,Senate,"Do pass as amended, but first amend, and re-refer to the Committee on [Appropriations]",6,0,1,0,7
1073805,770246,2018-08-06,Senate,"Placed on suspense file",7,0,0,0,7
1073805,771689,2018-08-16,Senate,"Do pass",7,0,0,0,7
1073805,772972,2018-08-27,Senate,"Assembly 3rd Reading AB1951 O'Donnell et al. By Allen",38,0,2,0,40
1073805,773553,2018-08-29,Assembly,"AB 1951 O'DONNELL Concurrence in Senate Amendments",79,0,1,0,80
1073808,736230,2018-04-10,Assembly,"Do pass as amended and be re-referred to the Committee on [Appropriations]",12,0,3,0,15
1073808,744455,2018-04-25,Assembly,"Do pass. To Consent Calendar",17,0,0,0,17
1073808,748963,2018-05-03,Assembly,"AB 1944 GARCIA, E. Consent Calendar Second Day Regular Session",71,0,7,0,78
1073808,763380,2018-06-12,Senate,"Do pass as amended, but first amend, and re-refer to the Committee on [Appropriations]",9,0,0,0,9
1073808,771269,2018-08-13,Senate,"Assembly 3rd Reading AB1944 Eduardo Garcia et al. By Hueso",36,0,4,0,40
1073808,772251,2018-08-20,Assembly,"AB 1944 GARCIA, E. Concurrence in Senate Amendments",80,0,0,0,80
1073812,737165,2018-04-09,Assembly,"Do pass as amended and be re-referred to the Committee on [Appropriations]",9,0,1,0,10
1073812,748370,2018-05-02,Assembly,"Do pass. To Consent Calendar",17,0,0,0,17
1073812,751932,2018-05-10,Assembly,"AB 1954 PATTERSON Consent Calendar Second Day Regular Session",73,0,5,0,78
1073812,762355,2018-06-12,Senate,"Do pass, but first be re-referred to the Committee on [Appropriations] with the recommendation: To Consent Calendar",9,0,0,0,9
1073812,770576,2018-08-06,Senate,"Consent Calendar AB1954 Patterson et al",37,0,2,0,39
1073823,740062,2018-04-16,Assembly,"Do pass as amended and be re-referred to the Committee on [Appropriations]",7,2,1,0,10
1073823,756760,2018-05-25,Assembly,"Do pass as amended",13,3,1,0,17
1073823,757653,2018-05-30,Assembly,"AB 1945 GARCIA, E. Assembly Third Reading",62,7,9,0,78
1073823,767367,2018-06-20,Senate,"Do pass as amended, but first amend, and re-refer to the Committee on [Appropriations]",4,2,1,0,7
1073823,770383,2018-08-06,Senate,"Placed on suspense file",7,0,0,0,7
1073823,772019,2018-08-16,Senate,"Do pass",6,0,1,0,7
1073823,772399,2018-08-21,Senate,"Assembly 3rd Reading AB1945 Eduardo Garcia et al. By Hueso",33,3,4,0,40
1073823,773611,2018-08-29,Senate,"Assembly 3rd Reading AB1945 Eduardo Garcia et al. By Hueso",31,4,5,0,40
1073823,773739,2018-08-30,Assembly,"AB 1945 GARCIA, E. Concurrence in Senate Amendments",64,5,11,0,80
1073827,722928,2018-03-14,Senate,"Do pass as amended, but first amend, and re-refer to the Committee on [Appropriations]",6,0,0,0,6
1073827,738883,2018-04-16,Senate,"Placed on suspense file",7,0,0,0,7
1073827,756347,2018-05-25,Senate,"Do pass",7,0,0,0,7
1073827,757114,2018-05-29,Senate,"Senate 3rd Reading SB940 Beall et al",36,0,3,0,39
1073829,740689,2018-04-18,Senate,"Do pass, but first be re-referred to the Committee on [Judiciary]",8,0,1,0,9
1073829,743960,2018-04-24,Senate,"Do pass as amended, but first amend, and re-refer to the Committee on [Appropriations]",6,1,0,0,7
1073829,752687,2018-05-14,Senate,"Placed on suspense file",7,0,0,0,7
1073829,756233,2018-05-25,Senate,"Do pass as amended",4,0,3,0,7
1073829,757689,2018-05-30,Senate,"Senate 3rd Reading SB944 Hertzberg",28,8,3,0,39
1073829,768113,2018-06-26,Assembly,"Do pass and be re-referred to the Committee on [Appropriations]",13,0,2,0,15
1073833,719781,2018-03-08,Assembly,"Be adopted. To third reading",8,0,3,0,11
1073833,735510,2018-04-09,Senate,"Special Consent ACR165",39,0,0,0,39
1073836,694771,2018-02-05,Assembly,"Be adopted. To third reading",9,0,2,0,11
1073836,727786,2018-03-22,Senate,"Special Consent ACR166",37,0,2,0,39
1073841,751407,2018-05-09,Assembly,"Do pass as amended and be re-referred to the Committee on [Appropriations]",7,0,0,0,7
1073841,755729,2018-05-23,Assembly,"Do pass. To Consent Calendar",16,0,1,0,17
1073841,757197,2018-05-29,Assembly,"AB 1943 WALDRON Consent Calendar Second Day Regular Session",78,0,0,0,78
1073841,768409,2018-06-26,Senate,"Do pass, but first be re-referred to the Committee on [Appropriations] with the recommendation: To Consent Calendar",8,0,5,0,13
1073841,771382,2018-08-13,Senate,"Consent Calendar AB1943 Waldron et al. Urgency Clause",37,0,3,0,40
1073844,692858,2018-02-01,Senate,"Senate 3rd Reading SCR93 Skinner et al",39,0,1,0,40
1073844,697887,2018-02-08,Assembly,"Be adopted. To Consent Calendar",7,0,4,0,11
1073844,703960,2018-02-16,Assembly,"SCR 93 Skinner Consent Calendar Second Day",62,0,15,0,77
1073848,717745,2018-03-06,Assembly,"Do pass. To Consent Calendar",7,0,0,0,7
1073848,723591,2018-03-15,Assembly,"AB 1941 JONES-SAWYER Consent Calendar Second Day Regular Session",66,0,11,0,77
1073848,753270,2018-05-15,Senate,"Do pass and be ordered to the Consent Calendar",7,0,0,0,7
1073848,754960,2018-05-21,Senate,"Consent Calendar AB1941 Jones-Sawyer",39,0,0,0,39
1073851,737484,2018-04-10,Assembly,"Do pass as amended, and be re-referred to the Committee on [Agriculture] with recommendation: To Consent Calendar",7,0,0,0,7
1073851,743856,2018-04-25,Assembly,"Do pass and be re-referred to the Committee on [Appropriations] with recommendation: To Consent Calendar",10,0,0,0,10
1073851,756331,2018-05-25,Assembly,"Do pass",16,0,1,0,17
1073851,757000,2018-05-29,Assembly,"AB 1952 MAYES Assembly Third Reading",77,0,1,0,78
1073851,762729,2018-06-12,Senate,"Do pass, but first be re-referred to the Committee on [Agriculture]",6,0,1,0,7
1073851,764957,2018-06-19,Senate,"Do pass, but first be re-referred to the Committee on [Appropriations]",4,0,1,0,5
1073851,769595,2018-07-02,Senate,"Placed on suspense file",7,0,0,0,7
1073851,777919,2018-05-25,Assembly,,10,0,1,0,11
1073857,717844,2018-03-06,Assembly,"Do pass and be re-referred to the Committee on [Appropriations] with recommendation: To Consent Calendar",7,0,0,0,7
1073857,756615,2018-05-25,Assembly,"Do pass",16,0,1,0,17
1073857,757186,2018-05-29,Assembly,"AB 1948 JONES-SAWYER Assembly Third Reading",77,1,0,0,78
1073857,765888,2018-06-19,Senate,"Do pass, but first be re-referred to the Committee on [Appropriations]",7,0,0,0,7
1073857,769670,2018-07-02,Senate,"Placed on suspense file",7,0,0,0,7
1073857,771979,2018-08-16,Senate,"Do pass as amended",7,0,0,0,7
1073857,772328,2018-08-21,Senate,"Assembly 3rd Reading AB1948 Jones-Sawyer et al. By Stone",39,0,1,0,40
1073857,773044,2018-08-27,Assembly,"AB 1948 JONES-SAWYER Concurrence in Senate Amendments",80,0,0,0,80
1073859,740778,2018-04-18,Senate,"Do pass as amended",5,1,1,0,7
1073859,748606,2018-05-03,Senate,"Senate 3rd Reading SB946 Lara et al",22,10,7,0,39
1073859,766164,2018-06-20,Assembly,"Do pass",6,1,2,0,9
1073859,772220,2018-08-20,Assembly,"SB 946 Lara Senate Third Reading By GARCIA, E",56,17,7,0,80
1073859,772331,2018-08-21,Senate,"Unfinished Business SB946 Lara et al. Concurrence",24,12,4,0,40
1073862,757128,2018-05-29,Senate,"Senate 3rd Reading SB942 Lara Urgency Clause",38,0,1,0,39
1073862,769126,2018-06-27,Assembly,"Do pass. To Consent Calendar",16,0,1,0,17
1073862,769788,2018-07-05,Assembly,"SB 942 Lara Consent Calendar Second Day Regular Session",69,0,11,0,80
1073866,743603,2018-04-23,Assembly,"Do pass as amended and be re-referred to the Committee on [Appropriations]",7,0,3,0,10
1073870,738884,2018-04-16,Senate,"Do pass",7,0,0,0,7
1073870,742074,2018-04-23,Senate,"Senate 3rd Reading SB941 Lara Urgency Clause",38,0,1,0,39
1073870,747815,2018-05-02,Assembly,"Do pass. To Consent Calendar",17,0,0,0,17
1073870,751997,2018-05-10,Assembly,"SB 941 Lara Consent Calendar Second Day Regular Session",73,0,5,0,78
1073873,771430,2018-08-13,Senate,"Do pass as amended",5,1,1,0,7
1073873,773047,2018-08-27,Senate,"Senate 3rd Reading SB939 Portantino Urgency Clause",30,4,6,0,40
1073873,773276,2018-08-29,Assembly,"Do pass",16,0,1,0,17
1073873,773998,2018-08-31,Assembly,"SB 939 Portantino Third Reading Urgency By GONZALEZ FLETCHER",78,0,2,0,80
1073877,740640,2018-04-17,Assembly,"Do pass and be re-referred to the Committee on [Appropriations]",12,0,3,0,15
1073877,743834,2018-04-25,Assembly,"Do pass",12,5,0,0,17
1073877,746097,2018-04-30,Assembly,"AB 1953 WOOD Assembly Third Reading",58,15,5,0,78
1073877,766226,2018-06-20,Senate,"Do pass as amended, but first amend, and re-refer to the Committee on [Appropriations]",8,0,1,0,9
1073877,771356,2018-08-13,Senate,"Placed on suspense file",7,0,0,0,7
1073877,771735,2018-08-16,Senate,"Do pass",5,0,2,0,7
1073877,773161,2018-08-28,Senate,"Assembly 3rd Reading AB1953 Wood By McGuire",37,0,3,0,40
1073877,773384,2018-08-29,Assembly,"AB 1953 WOOD Concurrence in Senate Amendments",66,7,7,0,80
1073881,736111,2018-04-10,Assembly,"Do pass and be re-referred to the Committee on [Judiciary]",6,1,0,0,7
1073881,739886,2018-04-17,Assembly,"Do pass as amended and be re-referred to the Committee on [Appropriations]",9,1,0,0,10
1073883,694703,2018-02-05,Assembly,"Be adopted. To third reading",9,0,2,0,11
1073883,727730,2018-03-22,Senate,"Special Consent ACR164",37,0,2,0,39
1073887,726301,2018-03-21,Assembly,"Do pass and be re-referred to the Committee on [Appropriations]",5,1,1,0,7
1073887,733942,2018-04-04,Assembly,"Do pass",11,4,2,0,17
1073887,746244,2018-04-30,Assembly,"AB 1947 LOW Assembly Third Reading",50,26,2,0,78
1073887,760569,2018-06-06,Senate,"Do pass, but first be re-referred to the Committee on [Appropriations]",4,1,0,0,5
1073887,767857,2018-06-25,Senate,"Placed on suspense file",7,0,0,0,7
1073887,771995,2018-08-16,Senate,"Do pass",5,2,0,0,7
1073887,772530,2018-08-23,Senate,"Assembly 3rd Reading AB1947 Low By Stern",25,14,1,0,40
1073890,736100,2018-04-09,Assembly,"Do pass as amended and be re-referred to the Committee on [Appropriations]",10,0,0,0,10
1073890,756365,2018-05-25,Assembly,"Do pass",16,0,1,0,17
1073890,757044,2018-05-29,Assembly,"AB 1956 LIMÓN Assembly Third Reading",78,0,0,0,78
1073890,768174,2018-06-26,Senate,"Do pass as amended, but first amend, and re-refer to the Committee on [Appropriations]",9,0,0,0,9
1073890,771355,2018-08-13,Senate,"Placed on suspense file",7,0,0,0,7
1073890,771864,2018-08-16,Senate,"Do pass as amended",7,0,0,0,7
1073890,773496,2018-08-29,Senate,"Assembly 3rd Reading AB1956 Limón By Jackson",39,0,1,0,40
1073890,773846,2018-08-30,Assembly,"AB 1956 LIMÓN Concurrence in Senate Amendments",79,0,1,0,80
1073897,744228,2018-04-25,Senate,"Do pass, but first be re-referred to the Committee on [Appropriations]",9,0,0,0,9
1073897,755248,2018-05-22,Senate,"Placed on suspense file",7,0,0,0,7
1073897,756754,2018-05-25,Senate,"Do pass",7,0,0,0,7
1073897,756991,2018-05-29,Senate,"Senate 3rd Reading SB945 Atkins et al",38,0,1,0,39
1073905,694698,2018-02-05,Assembly,"Be adopted. To third reading",9,0,2,0,11
1073907,740772,2018-04-17,Assembly,"Do pass and be re-referred to the Committee on [Appropriations]",6,0,1,0,7
1075045,740516,2018-04-17,Assembly,"Do pass as amended and be re-referred to the Committee on [Appropriations]",12,0,3,0,15
1075049,725521,2018-03-20,Assembly,"Do pass as amended and be re-referred to the Committee on [Privacy and Consumer Protection]",7,0,0,0,7
1075049,740902,2018-04-17,Assembly,"Do pass as amended, and be re-referred to the Committee on [Appropriations] with recommendation: To Consent Calendar",10,0,0,0,10
1075049,756731,2018-05-25,Assembly,"Do pass",16,0,1,0,17
1075049,757217,2018-05-29,Assembly,"AB 1957 BERMAN Assembly Third Reading",78,0,0,0,78
1075049,762840,2018-06-12,Senate,"Do pass, but first be re-referred to the Committee on [Judiciary]",6,0,1,0,7
1075049,768832,2018-06-26,Senate,"Do pass, but first be re-referred to the Committee on [Appropriations] with the recommendation: To Consent Calendar",7,0,0,0,7
1075049,770821,2018-08-06,Senate,"Placed on suspense file",7,0,0,0,7
1075049,772038,2018-08-16,Senate,"Do pass as amended",7,0,0,0,7
1075049,772374,2018-08-21,Senate,"Assembly 3rd Reading AB1957 Berman By Wiener",39,0,1,0,40
1075049,773029,2018-08-27,Assembly,"AB 1957 BERMAN Concurrence in Senate Amendments",80,0,0,0,80
1075055,751351,2018-05-09,Senate,"Do pass",4,2,1,0,7
1075055,752108,2018-05-09,Senate,"Do pass as amended",4,2,1,0,7
1075055,754975,2018-05-21,Senate,"Senate 3rd Reading SB958 Dodd",24,9,6,0,39
1075055,765840,2018-06-18,Assembly,"Do pass",6,3,1,0,10
1075055,773135,2018-08-28,Assembly,"SB 958 Dodd Senate Third Reading By AGUIAR-CURRY",37,31,12,0,80
1075055,773803,2018-08-30,Assembly,"SB 958 Dodd Senate Third Reading By AGUIAR-CURRY",41,35,4,0,80
1075055,774028,2018-08-31,Senate,"Unfinished Business SB958 Dodd Concurrence",24,12,4,0,40
1075061,744010,2018-04-24,Senate,"Do pass, but first be re-referred to the Committee on [Appropriations]",11,0,2,0,13
1075061,752764,2018-05-14,Senate,"Placed on suspense file",7,0,0,0,7
1075061,756257,2018-05-25,Senate,"Do pass",7,0,0,0,7
1075061,757707,2018-05-30,Senate,"Senate 3rd Reading SB957 Lara et al",32,5,2,0,39
1075061,767847,2018-06-25,Assembly,"Do pass and be re-referred to the Committee on [Appropriations]",9,1,4,0,14
1075061,771530,2018-08-16,Assembly,"Do pass as amended",13,3,1,0,17
1075061,773603,2018-08-29,Assembly,"SB 957 Lara Senate Third Reading By CERVANTES",53,18,9,0,80
1075061,773809,2018-08-30,Senate,"Unfinished Business SB957 Lara et al. Concurrence",32,4,4,0,40
1075066,733758,2018-04-04,Senate,"Do pass, but first be re-referred to the Committee on [Rules]",6,0,0,0,6
1075072,751264,2018-05-08,Senate,"Do pass as amended",7,0,0,0,7
1075072,754235,2018-05-17,Senate,"Senate 3rd Reading SB954 Wieckowski",38,0,1,0,39
1075072,769686,2018-07-03,Assembly,"Do pass as amended",10,0,0,0,10
1075072,772212,2018-08-20,Assembly,"SB 954 Wieckowski Senate Third Reading By CUNNINGHAM",79,0,1,0,80
1075072,772360,2018-08-21,Senate,"Unfinished Business SB954 Wieckowski Concurrence",36,0,4,0,40
1075078,739793,2018-04-16,Senate,"Do pass as amended, but first amend, and re-refer to the Committee on [Judiciary]",9,0,0,0,9
1075078,750163,2018-05-07,Senate,"Placed on suspense file",6,0,1,0,7
1075078,756292,2018-05-25,Senate,"Do pass",7,0,0,0,7
1075078,758749,2018-05-31,Senate,"Special Consent SB955",39,0,0,0,39
1075078,768356,2018-06-26,Assembly,"Do pass and be re-referred to the Committee on [Appropriations]",15,0,0,0,15
1075078,771893,2018-08-16,Assembly,"Do pass as amended",13,0,4,0,17
1075078,773574,2018-08-29,Assembly,"SB 955 Nielsen Senate Third Reading By GALLAGHER",80,0,0,0,80
1075078,774147,2018-08-31,Senate,"Unfinished Business SB955 Nielsen et al. Concurrence",39,0,1,0,40
1075084,727767,2018-03-21,Assembly,"Do pass as amended, and be re-referred to the Committee on [Appropriations] with recommendation: To Consent Calendar",6,0,1,0,7
1075084,740743,2018-04-18,Assembly,"Do pass. To Consent Calendar",15,0,2,0,17
1075084,744869,2018-04-26,Assembly,"AB 1962 WOOD Consent Calendar Second Day Regular Session",74,0,4,0,78
1075084,760455,2018-06-06,Senate,"Do pass, but first be re-referred to the Committee on [Appropriations] with the recommendation: To Consent Calendar",6,0,0,0,6
1075084,767869,2018-06-25,Senate,"Placed on suspense file",7,0,0,0,7
1075084,771677,2018-08-16,Senate,"Do pass",7,0,0,0,7
1075084,772660,2018-08-24,Senate,"Special Consent AB1962",39,0,1,0,40
1075084,773523,2018-08-29,Assembly,"AB 1962 WOOD Concurrence in Senate Amendments",79,0,1,0,80
1075089,722625,2018-03-13,Assembly,"Do pass as amended and be re-referred to the Committee on [Appropriations]",8,2,3,0,13
1075089,756474,2018-05-25,Assembly,"Do pass as amended",14,0,3,0,17
1075089,757594,2018-05-30,Assembly,"AB 1961 CHOI Assembly Third Reading",76,0,2,0,78
1075089,766126,2018-06-20,Senate,"Do pass, but first be re-referred to the Committee on [Appropriations]",7,0,0,0,7
1075089,769619,2018-07-02,Senate,"Placed on suspense file",7,0,0,0,7
1075089,771705,2018-08-16,Senate,"Do pass",7,0,0,0,7
1075089,772686,2018-08-24,Senate,"Special Consent AB1961",39,0,1,0,40
1075095,697902,2018-02-08,Assembly,"Be adopted. To third reading",7,0,4,0,11
1075100,740993,2018-04-18,Senate,"Do pass, but first be re-referred to the Committee on [Rules]",4,3,0,0,7
1075110,740773,2018-04-18,Senate,"Do pass as amended, but first amend, and re-refer to the Committee on [Appropriations]",5,1,1,0,7
1075110,749803,2018-05-07,Senate,"Placed on suspense file",6,0,1,0,7
1075110,756229,2018-05-25,Senate,"Do pass as amended",6,0,1,0,7
1075110,758427,2018-05-31,Senate,"Senate 3rd Reading SB951 Mitchell et al",37,0,2,0,39
1075110,768295,2018-06-26,Assembly,"Do pass and be re-referred to the Committee on [Revenue and Taxation]",7,0,0,0,7
1075110,770974,2018-08-06,Assembly,"Do pass as amended and be re-referred to the Committee on [Appropriations]",8,0,2,0,10
1075110,771495,2018-08-15,Assembly,"Do pass",17,0,0,0,17
1075116,736045,2018-04-10,Assembly,"Do pass. To Consent Calendar",10,0,0,0,10
1075116,739223,2018-04-16,Assembly,"AB 1960 OBERNOLTE Consent Calendar Second Day Regular Session",73,0,5,0,78
1075116,763010,2018-06-12,Senate,"Do pass and be ordered to the Consent Calendar",7,0,0,0,7
1075116,768062,2018-06-25,Senate,"Consent Calendar AB1960",36,0,3,0,39
1075122,722894,2018-03-14,Senate,"Do pass, but first be re-referred to the Committee on [Appropriations]",4,2,0,0,6
1075122,738813,2018-04-16,Senate,"Placed on suspense file",7,0,0,0,7
1075122,756249,2018-05-25,Senate,"Do pass as amended",5,2,0,0,7
1075122,757584,2018-05-30,Senate,"Senate 3rd Reading SB947 Jackson et al",25,13,1,0,39
1075122,762896,2018-06-13,Assembly,"Do pass as amended and be re-referred to the Committee on [Appropriations]",4,1,2,0,7
1075122,768695,2018-06-27,Assembly,"Do pass",13,3,1,0,17
1075122,772149,2018-08-20,Assembly,"SB 947 Jackson Senate Third Reading By THURMOND",59,20,1,0,80
1075122,772339,2018-08-21,Senate,"Unfinished Business SB947 Jackson et al. Concurrence",27,11,2,0,40
1075126,736118,2018-04-10,Assembly,"Do pass and be re-referred to the Committee on [Appropriations]",15,0,0,0,15
1075132,699766,2018-02-12,Senate,"Senate 3rd Reading SCR94 Leyva et al",38,0,2,0,40
1075132,710658,2018-02-26,Assembly,"Be adopted. To third reading",8,0,3,0,11
1075143,737306,2018-04-11,Assembly,"Do pass and be re-referred to the Committee on [Appropriations]",13,0,0,0,13
1075143,756599,2018-05-25,Assembly,"Do pass",15,0,2,0,17
1075143,757213,2018-05-29,Assembly,"AB 1959 WOOD Third Reading Urgency",75,0,3,0,78
1075143,765504,2018-06-19,Senate,"Do pass, but first be re-referred to the Committee on [Appropriations]",11,0,0,0,11
1075143,770387,2018-08-06,Senate,"Placed on suspense file",7,0,0,0,7
1075143,772022,2018-08-16,Senate,"Do pass",7,0,0,0,7
1075143,772262,2018-08-20,Senate,"Assembly 3rd Reading AB1959 Wood et al. By Fuller Urgency Clause",35,2,3,0,40
1075149,771462,2018-08-14,Assembly,"Be adopted. To third reading",5,0,2,0,7
1075149,772286,2018-08-20,Assembly,"AJR 30 AGUIAR-CURRY Assembly Third Reading",56,3,21,0,80
1075149,773153,2018-08-28,Senate,"Assembly 3rd Reading AJR30 Aguiar-Curry et al. By Wiener",24,8,8,0,40
1075155,738812,2018-04-16,Senate,"Do pass, but first be re-referred to the Committee on [Governmental Organization]",7,1,1,0,9
1075155,746189,2018-04-30,Senate,"Placed on suspense file",6,0,1,0,7
1076524,724780,2018-03-19,Assembly,"Be adopted. To Consent Calendar",13,0,1,0,14
1076524,727781,2018-03-22,Assembly,"ACR 169 MATHIS Consent Calendar Second Day Regular Session",69,0,8,0,77
1076524,769685,2018-07-03,Senate,"Be adopted and be ordered to the Consent Calendar",12,0,1,0,13
1076524,771346,2018-08-13,Senate,"Consent Calendar ACR169",37,0,3,0,40
1076539,717900,2018-03-06,Assembly,"Do pass. To Consent Calendar",7,0,0,0,7
1076539,723663,2018-03-15,Assembly,"AB 1985 TING Consent Calendar Second Day Regular Session",66,0,11,0,77
1076539,753267,2018-05-15,Senate,"Do pass and be ordered to the Consent Calendar",7,0,0,0,7
1076539,754959,2018-05-21,Senate,"Consent Calendar AB1985",39,0,0,0,39
1076539,759153,2018-06-04,Assembly,"AB 1985 TING Concurrence in Senate Amendments",70,0,8,0,78
1076548,735665,2018-04-09,Senate,"Do pass, but first be re-referred to the Committee on [Appropriations]",3,2,0,0,5
1076548,738842,2018-04-16,Senate,"Placed on suspense file",7,0,0,0,7
1076548,756246,2018-05-25,Senate,"Do pass",5,2,0,0,7
1076548,757039,2018-05-29,Senate,"Senate 3rd Reading SB964 Allen",27,11,1,0,39
1076548,766259,2018-06-20,Assembly,"Do pass and be re-referred to the Committee on [Appropriations]",4,1,2,0,7
1076548,771687,2018-08-16,Assembly,"Do pass",12,5,0,0,17
1076548,773879,2018-08-30,Assembly,"SB 964 Allen Senate Third Reading By KALRA",53,25,2,0,80
1076556,736862,2018-04-10,Senate,"Do pass, but first be re-referred to the Committee on [Appropriations]",2,4,1,0,7
1076556,736863,2018-04-10,Senate,"[04-10-2018] hearing: Motion to Reconsider. [Reconsideration Granted.]",7,0,0,0,7
1076563,744012,2018-04-25,Senate,"Do pass, but first be re-referred to the Committee on [Transportation and Housing]",7,0,0,0,7
1076563,746944,2018-05-01,Senate,"Do pass as amended",13,0,0,0,13
1076563,755331,2018-05-22,Senate,"Placed on suspense file",7,0,0,0,7
1076563,756657,2018-05-25,Senate,"Do pass",6,1,0,0,7
1076563,757035,2018-05-29,Senate,"Senate 3rd Reading SB961 Allen",38,0,1,0,39
1076563,766244,2018-06-20,Assembly,"Do pass and be re-referred to the Committee on [Housing and Community Development]",7,0,2,0,9
1076563,768956,2018-06-27,Assembly,"Do pass and be re-referred to the Committee on [Appropriations]",6,1,0,0,7
1076563,771567,2018-08-16,Assembly,"Do pass",12,4,1,0,17
1076563,773829,2018-08-30,Assembly,"SB 961 Allen Senate Third Reading By GABRIEL",53,25,2,0,80
1076563,774175,2018-08-31,Senate,"Unfinished Business SB961 Allen et al. Concurrence",38,1,1,0,40
1076571,727785,2018-03-21,Assembly,"Do pass as amended and be re-referred to the Committee on [Appropriations]",4,2,1,0,7
1076571,756755,2018-05-25,Assembly,"Do pass",12,4,1,0,17
1076571,757103,2018-05-29,Assembly,"AB 1974 GONZALEZ FLETCHER Assembly Third Reading",56,20,2,0,78
1076571,762699,2018-06-13,Senate,"Do pass as amended, but first amend, and re-refer to the Committee on [Appropriations]",7,0,0,0,7
1076571,769635,2018-07-02,Senate,"Placed on suspense file",7,0,0,0,7
1076571,771631,2018-08-16,Senate,"Do pass as amended",6,0,1,0,7
1076571,772926,2018-08-27,Senate,"Assembly 3rd Reading AB1974 Gonzalez Fletcher et al. By Hertzberg",33,6,1,0,40
1076571,773429,2018-08-29,Assembly,"AB 1974 GONZALEZ FLETCHER Concurrence in Senate Amendments",57,21,2,0,80
1076581,737718,2018-04-11,Senate,"Do pass as amended, but first amend, and re-refer to the Committee on [Appropriations]",6,0,0,0,6
1076581,746172,2018-04-30,Senate,"Placed on suspense file",6,0,1,0,7
1076581,756360,2018-05-25,Senate,"Do pass",7,0,0,0,7
1076581,758456,2018-05-31,Senate,"Special Consent SB967",39,0,0,0,39
1076581,764912,2018-06-19,Assembly,"Do pass and be re-referred to the Committee on [Appropriations]",13,0,0,0,13
1076581,771083,2018-08-08,Assembly,"Do pass. To Consent Calendar",17,0,0,0,17
1076581,771640,2018-08-16,Assembly,"SB 967 Berryhill, T. Consent Calendar Second Day Regular Session",76,0,4,0,80
1076581,773507,2018-08-29,Assembly,"SB 967 Berryhill, T. Senate Third Reading By ACOSTA",80,0,0,0,80
1076581,774094,2018-08-31,Senate,"Unfinished Business SB967 Berryhill et al. Concurrence",39,0,1,0,40
1076588,737202,2018-04-11,Assembly,"Do pass as amended and be re-referred to the Committee on [Revenue and Taxation]",7,0,0,0,7
1076588,750621,2018-05-07,Assembly,"Do pass as amended and be re-referred to the Committee on [Appropriations]",9,1,0,0,10
1076605,740487,2018-04-18,Assembly,"Do pass and be re-referred to the Committee on [Appropriations]",21,0,0,0,21
1076605,755731,2018-05-23,Assembly,"Do pass. To Consent Calendar",16,0,1,0,17
1076605,757031,2018-05-29,Assembly,"AB 1965 AGUIAR-CURRY Consent Calendar Second Day Regular Session",78,0,0,0,78
1076605,768337,2018-06-26,Senate,"Do pass, but first be re-referred to the Committee on [Appropriations]",13,0,0,0,13
1076605,773309,2018-08-29,Senate,"Assembly 3rd Reading AB1965 Aguiar-Curry et al. By McGuire Urgency Clause",26,0,14,0,40
1076605,773310,2018-08-29,Senate,"Assembly 3rd Reading AB1965 Aguiar-Curry et al. By McGuire Reconsider",38,0,2,0,40
1076605,774167,2018-08-31,Senate,"Assembly 3rd Reading AB1965 Aguiar-Curry et al. By McGuire Urgency Clause",38,0,2,0,40
1076605,774168,2018-08-31,Assembly,"AB 1965 Aguiar-Curry Concurrence - Urgency Added",79,0,1,0,80
1076612,733216,2018-04-03,Senate,"Do pass, but first be re-referred to the Committee on [Judiciary]",12,0,1,0,13
1076612,740948,2018-04-17,Senate,"Do pass, but first be re-referred to the Committee on [Appropriations] with the recommendation: To Consent Calendar",7,0,0,0,7
1076612,746548,2018-04-30,Senate,"Placed on suspense file",6,0,1,0,7
1076612,756746,2018-05-25,Senate,"Do pass",7,0,0,0,7
1076612,758536,2018-05-31,Senate,"Special Consent SB969",39,0,0,0,39
1076612,769001,2018-06-27,Assembly,"Do pass and be re-referred to the Committee on [Judiciary]",7,0,0,0,7
1076612,769707,2018-07-03,Assembly,"Do pass",10,0,0,0,10
1076612,771521,2018-08-16,Assembly,"SB 969 Dodd Senate Third Reading By AGUIAR-CURRY",64,7,9,0,80
1076612,772177,2018-08-20,Senate,"Unfinished Business SB969 Dodd et al. Concurrence",37,0,3,0,40
1076620,743138,2018-04-23,Assembly,"Do pass as amended and be re-referred to the Committee on [Appropriations]",10,0,0,0,10
1076620,755776,2018-05-23,Assembly,"Do pass. To Consent Calendar",16,0,1,0,17
1076620,757034,2018-05-29,Assembly,"AB 1981 LIMÓN Consent Calendar Second Day Regular Session",78,0,0,0,78
1076620,767191,2018-06-20,Senate,"Do pass as amended, but first amend, and re-refer to the Committee on [Appropriations]",7,0,0,0,7
1076620,773234,2018-08-28,Senate,"Assembly 3rd Reading AB1981 Limón By Stern",39,0,1,0,40
1076620,773895,2018-08-30,Assembly,"AB 1981 LIMÓN Concurrence in Senate Amendments",79,0,1,0,80
1076637,733361,2018-04-03,Senate,"Do pass, but first be re-referred to the Committee on [Rules]",4,0,1,0,5
1076637,750226,2018-05-07,Senate,"Do pass",6,0,1,0,7
1076637,754357,2018-05-17,Senate,"Senate 3rd Reading SB965 McGuire",33,0,6,0,39
1076637,768947,2018-06-27,Assembly,"Do pass and be re-referred to the Committee on [Appropriations]",9,0,1,0,10
1076637,771095,2018-08-08,Assembly,"Do pass",16,0,1,0,17
1076637,772303,2018-08-20,Assembly,"SB 965 McGuire Senate Third Reading By GARCIA, E",78,0,2,0,80
1076637,772454,2018-08-22,Senate,"Unfinished Business SB965 McGuire et al. Concurrence",36,0,4,0,40
1076645,742996,2018-04-24,Senate,"Do pass, but first be re-referred to the Committee on [Appropriations] with the recommendation: To Consent Calendar",7,0,0,0,7
1076645,750194,2018-05-07,Senate,"Placed on suspense file",6,0,1,0,7
1076645,756707,2018-05-25,Senate,"Do pass as amended",7,0,0,0,7
1076645,757837,2018-05-30,Senate,"Senate 3rd Reading SB960 Leyva",38,0,1,0,39
1076645,765419,2018-06-19,Assembly,"Do pass and be re-referred to the Committee on [Appropriations] with recommendation: To Consent Calendar",7,0,0,0,7
1076645,771719,2018-08-16,Assembly,"Do pass as amended",12,0,5,0,17
1076645,773626,2018-08-29,Assembly,"SB 960 Leyva Senate Third Reading By WEBER",79,0,1,0,80
1076645,773777,2018-08-30,Senate,"Unfinished Business SB960 Leyva Concurrence",39,0,1,0,40
1076661,743191,2018-04-23,Assembly,"Do pass as amended and be re-referred to the Committee on [Appropriations]",7,3,0,0,10
1076661,756660,2018-05-25,Assembly,"Do pass as amended",12,4,1,0,17
1076661,758702,2018-05-31,Assembly,"AB 1970 GARCIA, E. Assembly Third Reading",52,24,2,0,78
1076669,736173,2018-04-09,Assembly,"Do pass as amended and be re-referred to the Committee on [Appropriations]",6,4,0,0,10
1076669,756478,2018-05-25,Assembly,"Do pass",12,3,2,0,17
1076669,757216,2018-05-29,Assembly,"AB 1975 CHU Assembly Third Reading",30,26,22,0,78
1076676,737410,2018-04-11,Assembly,"Do pass and be re-referred to the Committee on [Appropriations] with recommendation: To Consent Calendar",6,0,1,0,7
1076676,740898,2018-04-18,Assembly,"Do pass. To Consent Calendar",15,0,2,0,17
1076676,744854,2018-04-26,Assembly,"AB 1977 A & A.R. Consent Calendar Second Day Regular Session",74,0,4,0,78
1076676,762282,2018-06-12,Senate,"Do pass as amended, but first amend, and re-refer to the Committee on [Appropriations]",10,0,2,0,12
1076676,769661,2018-07-02,Senate,"Do pass",7,0,0,0,7
1076676,771434,2018-08-13,Senate,"Special Consent AB1977 A. & A.R",37,0,3,0,40
1076676,772243,2018-08-20,Assembly,"AB 1977 A & A.R. Concurrence in Senate Amendments By EGGMAN",80,0,0,0,80
1076684,722854,2018-03-14,Assembly,"Do pass and be re-referred to the Committee on [Appropriations]",6,0,1,0,7
1076684,733832,2018-04-04,Assembly,"Do pass",13,0,4,0,17
1076684,735468,2018-04-09,Assembly,"AB 1976 LIMÓN Assembly Third Reading",57,1,19,0,77
1076684,762826,2018-06-13,Senate,"Do pass, but first be re-referred to the Committee on [Appropriations]",4,1,0,0,5
1076684,771370,2018-08-13,Senate,"Do pass",6,0,1,0,7
1076684,773536,2018-08-29,Senate,"Assembly 3rd Reading AB1976 Limón et al. By Wiener",35,0,5,0,40
1076684,773859,2018-08-30,Assembly,"AB 1976 LIMÓN Concurrence in Senate Amendments",78,0,2,0,80
1076694,743869,2018-04-25,Senate,"Do pass as amended, but first amend, and re-refer to the Committee on [Appropriations]",6,0,0,0,6
1076694,752634,2018-05-14,Senate,"Placed on suspense file",7,0,0,0,7
1076694,756381,2018-05-25,Senate,"Do pass as amended",7,0,0,0,7
1076694,757724,2018-05-30,Senate,"Senate 3rd Reading SB968 Pan",38,0,1,0,39
1076694,765103,2018-06-19,Assembly,"Do pass and be re-referred to the Committee on [Appropriations]",13,0,0,0,13
1076694,771543,2018-08-16,Assembly,"Do pass as amended",14,0,3,0,17
1076694,773329,2018-08-29,Assembly,"SB 968 Pan Senate Third Reading By BONTA",80,0,0,0,80
1076694,773774,2018-08-30,Senate,"Unfinished Business SB968 Pan et al. Concurrence",39,0,1,0,40
1076701,732706,2018-04-02,Assembly,"Be re-referred to the Committee on [Education]",6,0,5,0,11
1076701,744787,2018-04-25,Assembly,"Do pass as amended and be re-referred to the Committee on [Appropriations]",7,0,0,0,7
1076709,725654,2018-03-20,Assembly,"Do pass as amended, and be re-referred to the Committee on [Appropriations] with recommendation: To Consent Calendar",7,0,0,0,7
1076709,733856,2018-04-04,Assembly,"Do pass. To Consent Calendar",15,0,2,0,17
1076709,738289,2018-04-12,Assembly,"AB 1973 QUIRK Consent Calendar Second Day Regular Session",68,0,9,0,77
1076709,753266,2018-05-15,Senate,"Do pass as amended, but first amend, and re-refer to the Committee on [Appropriations] with the recommendation: To Consent Calendar",7,0,0,0,7
1076709,769606,2018-07-02,Senate,"Consent Calendar AB1973",37,0,2,0,39
1076709,770404,2018-08-06,Assembly,"AB 1973 QUIRK Concurrence in Senate Amendments",77,0,3,0,80
1076716,734461,2018-04-04,Assembly,"Do pass. To Consent Calendar",21,0,0,0,21
1076716,738300,2018-04-12,Assembly,"AB 1966 AGUIAR-CURRY Consent Calendar Second Day Regular Session",68,0,9,0,77
1076716,762177,2018-06-12,Senate,"Do pass and be ordered to the Consent Calendar",10,0,2,0,12
1076716,767549,2018-06-18,Senate,"Consent Calendar AB1966 Aguiar-Curry",37,0,1,0,38
1076716,773302,2018-08-29,Senate,"Assembly 3rd Reading AB1966 Aguiar-Curry et al. By McGuire Urgency Clause",26,0,14,0,40
1076716,773303,2018-08-29,Senate,"Assembly 3rd Reading AB1966 Aguiar-Curry et al. By McGuire Reconsider",39,0,1,0,40
1076716,774224,2018-08-31,Senate,"Assembly 3rd Reading AB1966 Aguiar-Curry et al. By McGuire Urgency Clause",38,0,2,0,40
1076716,774225,2018-08-31,Assembly,"AB 1966 Aguiar-Curry Concurrence - Urgency Added",79,0,1,0,80
1076725,737940,2018-04-11,Senate,"Do pass, but first be re-referred to the Committee on [Judiciary] with the recommendation: To Consent Calendar",5,0,0,0,5
1076725,740719,2018-04-17,Senate,"Do pass, but first be re-referred to the Committee on [Appropriations] with the recommendation: To Consent Calendar",7,0,0,0,7
1076725,752037,2018-05-10,Senate,"Consent Calendar SB970",38,0,1,0,39
1076725,767307,2018-06-20,Assembly,"Do pass and be re-referred to the Committee on [Appropriations] with recommendation: To Consent Calendar",7,0,0,0,7
1076725,771514,2018-08-15,Assembly,"Do pass. To Consent Calendar",17,0,0,0,17
1076725,773668,2018-08-29,Assembly,"SB 970 Atkins Senate Third Reading By SANTIAGO",80,0,0,0,80
1076725,773937,2018-08-30,Senate,"Unfinished Business SB970 Atkins et al. Concurrence",39,0,1,0,40
1076733,743992,2018-04-25,Assembly,"Do pass and be re-referred to the Committee on [Appropriations]",7,0,0,0,7
1076750,733432,2018-04-03,Senate,"Do pass",11,0,0,0,11
1076750,734338,2018-04-05,Senate,"Senate 3rd Reading SB959 Beall",37,0,2,0,39
1076750,769755,2018-07-03,Assembly,"Do pass. To Consent Calendar",14,0,1,0,15
1076750,771182,2018-08-09,Assembly,"SB 959 Beall Consent Calendar Second Day",71,0,9,0,80
1076750,771297,2018-08-13,Senate,"Unfinished Business SB959 Beall Concurrence",36,0,4,0,40
1076758,726143,2018-03-20,Assembly,"Do pass and be re-referred to the Committee on [Judiciary]",6,0,1,0,7
1076758,739745,2018-04-17,Assembly,"Do pass",10,0,0,0,10
1076758,744885,2018-04-26,Assembly,"AB 1980 QUIRK Assembly Third Reading",68,1,9,0,78
1076758,760435,2018-06-06,Senate,"Do pass, but first be re-referred to the Committee on [Judiciary]",5,0,2,0,7
1076758,762803,2018-06-12,Senate,"Do pass",5,1,1,0,7
1076758,769596,2018-07-02,Senate,"Assembly 3rd Reading AB1980 Quirk By Wieckowski",26,10,3,0,39
1076773,736259,2018-04-10,Assembly,"Do pass as amended and be re-referred to the Committee on [Appropriations]",15,0,0,0,15
1076773,756205,2018-05-25,Assembly,"Do pass",16,0,1,0,17
1076773,757627,2018-05-30,Assembly,"AB 1971 SANTIAGO Assembly Third Reading",75,0,3,0,78
1076773,766318,2018-06-20,Senate,"Do pass, but first be re-referred to the Committee on [Judiciary]",7,2,0,0,9
1076773,768806,2018-06-26,Senate,"Do pass as amended, but first amend, and re-refer to the Committee on [Appropriations]",5,1,1,0,7
1076773,770343,2018-08-06,Senate,"Placed on suspense file",7,0,0,0,7
1076773,771732,2018-08-16,Senate,"Do pass",5,1,1,0,7
1076782,733865,2018-04-04,Senate,"Do pass as amended, but first amend, and re-refer to the Committee on [Appropriations]",6,0,1,0,7
1076782,742218,2018-04-23,Senate,"Placed on suspense file",7,0,0,0,7
1076782,756248,2018-05-25,Senate,"Do pass",7,0,0,0,7
1076782,758619,2018-05-31,Senate,"Special Consent SB966",39,0,0,0,39
1076782,768360,2018-06-26,Assembly,"Do pass and be re-referred to the Committee on [Appropriations]",6,0,1,0,7
1076782,771542,2018-08-16,Assembly,"Do pass as amended",12,0,5,0,17
1076782,773644,2018-08-29,Assembly,"SB 966 Wiener Senate Third Reading By LACKEY",80,0,0,0,80
1076782,773727,2018-08-30,Senate,"Unfinished Business SB966 Wiener et al. Concurrence",39,0,1,0,40
1076789,733152,2018-04-03,Assembly,"Do pass as amended and be re-referred to the Committee on [Appropriations]",7,0,0,0,7
1076789,756400,2018-05-25,Assembly,"Do pass",15,0,2,0,17
1076789,756947,2018-05-29,Assembly,"AB 1968 LOW Assembly Third Reading",64,1,13,0,78
1076789,765181,2018-06-19,Senate,"Do pass, but first be re-referred to the Committee on [Appropriations]",6,1,0,0,7
1076789,770527,2018-08-06,Senate,"Placed on suspense file",7,0,0,0,7
1076789,771635,2018-08-16,Senate,"Do pass as amended",5,1,1,0,7
1076789,772439,2018-08-22,Senate,"Assembly 3rd Reading AB1968 Low et al. By Allen",33,4,3,0,40
1076789,772888,2018-08-27,Assembly,"AB 1968 LOW Concurrence in Senate Amendments",68,0,12,0,80
1076797,737495,2018-04-11,Senate,"Do pass as amended, but first amend, and re-refer to the Committee on [Appropriations]",6,0,1,0,7
1076797,746794,2018-04-30,Senate,"Senate 3rd Reading SB963 Allen",37,0,2,0,39
1076797,763061,2018-06-13,Assembly,"Do pass as amended",7,0,2,0,9
1076797,771777,2018-08-16,Assembly,"SB 963 Allen Senate Third Reading By MURATSUCHI",76,0,4,0,80
1076797,772261,2018-08-20,Senate,"Unfinished Business SB963 Allen Concurrence",37,0,3,0,40
1078721,719947,2018-03-08,Assembly,"Be adopted. To third reading",8,0,3,0,11
1078724,740791,2018-04-18,Assembly,"Do pass and be re-referred to the Committee on [Appropriations] with recommendation: To Consent Calendar",21,0,0,0,21
1078724,748076,2018-05-02,Assembly,"Do pass. To Consent Calendar",17,0,0,0,17
1078724,752056,2018-05-10,Assembly,"AB 1986 CUNNINGHAM Consent Calendar Second Day Regular Session",73,0,5,0,78
1078724,762181,2018-06-12,Senate,"Do pass",10,0,2,0,12
1078724,773468,2018-08-29,Senate,"Assembly 3rd Reading AB1986 Cunningham By Skinner",39,0,1,0,40
1078724,773934,2018-08-30,Assembly,"AB 1986 CUNNINGHAM Concurrence in Senate Amendments",80,0,0,0,80
1078726,737404,2018-04-10,Assembly,"Do pass as amended",12,0,4,0,16
1078726,745006,2018-04-26,Assembly,"AB 1993 GIPSON Assembly Third Reading",66,4,8,0,78
1078726,762046,2018-06-11,Senate,"Do pass, but first be re-referred to the Committee on [Public Safety]",7,0,2,0,9
1078726,768443,2018-06-26,Senate,"Do pass",6,0,1,0,7
1078726,770810,2018-08-06,Senate,"Assembly 3rd Reading AB1993 Gipson By Hill",34,0,5,0,39
1078729,739855,2018-04-17,Assembly,"Do pass and be re-referred to the Committee on [Appropriations] with recommendation: To Consent Calendar",16,0,0,0,16
1078729,748309,2018-05-02,Assembly,"Do pass. To Consent Calendar",17,0,0,0,17
1078729,751928,2018-05-10,Assembly,"AB 1996 LACKEY Consent Calendar Second Day Regular Session",73,0,5,0,78
1078729,761676,2018-06-11,Senate,"Do pass, but first be re-referred to the Committee on [Appropriations]",8,0,1,0,9
1078729,772249,2018-08-20,Senate,"Assembly 3rd Reading AB1996 Lackey et al. By Wilk",38,1,1,0,40
1078729,772496,2018-08-23,Assembly,"AB 1996 LACKEY Concurrence in Senate Amendments",78,0,2,0,80
1078735,736171,2018-04-10,Assembly,"Do pass as amended, and be re-referred to the Committee on [Appropriations] with recommendation: To Consent Calendar",7,0,0,0,7
1078735,751805,2018-05-09,Assembly,"Do pass. To Consent Calendar",16,0,1,0,17
1078735,754219,2018-05-17,Assembly,"AB 1987 LACKEY Consent Calendar Second Day Regular Session",73,0,5,0,78
1078735,768426,2018-06-26,Senate,"Do pass, but first be re-referred to the Committee on [Appropriations] with the recommendation: To Consent Calendar",7,0,0,0,7
1078735,773121,2018-08-28,Senate,"Assembly 3rd Reading AB1987 Lackey et al. By Skinner",38,0,2,0,40
1078735,773350,2018-08-29,Assembly,"AB 1987 LACKEY Concurrence in Senate Amendments",79,0,1,0,80
1078742,722848,2018-03-14,Senate,"Do pass",6,0,0,0,6
1078742,744825,2018-04-26,Senate,"Senate 3rd Reading SB972 Portantino et al",36,0,3,0,39
1078742,762877,2018-06-13,Assembly,"Do pass as amended and be re-referred to the Committee on [Appropriations]",6,0,1,0,7
1078742,771073,2018-08-08,Assembly,"Do pass. To Consent Calendar",17,0,0,0,17
1078742,771661,2018-08-16,Assembly,"SB 972 Portantino Consent Calendar Second Day Regular Session",76,0,4,0,80
1078742,772222,2018-08-20,Senate,"Unfinished Business SB972 Portantino et al. Concurrence",37,0,3,0,40
1078745,722395,2018-03-12,Assembly,"Do pass as amended and be re-referred to the Committee on [Appropriations]",7,0,3,0,10
1078747,735876,2018-04-09,Senate,"Do pass, but first be re-referred to the Committee on [Judiciary]",9,0,0,0,9
1078747,743974,2018-04-24,Senate,"Do pass, but first be re-referred to the Committee on [Appropriations] with the recommendation: To Consent Calendar",7,0,0,0,7
1078747,752107,2018-05-10,Senate,"Senate 3rd Reading SB981 Dodd",38,0,1,0,39
1078747,765160,2018-06-19,Assembly,"Do pass and be re-referred to the Committee on [Appropriations]",10,0,0,0,10
1078747,771134,2018-08-08,Assembly,"Do pass. To Consent Calendar",17,0,0,0,17
1078747,772959,2018-08-27,Assembly,"SB 981 Dodd Senate Third Reading By RUBIO",80,0,0,0,80
1078747,773249,2018-08-28,Senate,"Unfinished Business SB981 Dodd Concurrence",39,0,1,0,40
1078751,722328,2018-03-13,Senate,"Do pass, but first be re-referred to the Committee on [Appropriations] with the recommendation: To Consent Calendar",10,0,2,0,12
1078751,742355,2018-04-23,Senate,"Consent Calendar SB977",38,0,1,0,39
1078751,766459,2018-06-20,Assembly,"Do pass and be re-referred to the Committee on [Appropriations] with recommendation: To Consent Calendar",19,0,2,0,21
1078751,771136,2018-08-08,Assembly,"Do pass. To Consent Calendar",17,0,0,0,17
1078751,771953,2018-08-16,Assembly,"SB 977 Galgiani Consent Calendar Second Day Regular Session",76,0,4,0,80
1078753,699652,2018-02-12,Senate,"Senate 3rd Reading SR80 Atkins et al",37,0,3,0,40
1078756,751821,2018-05-09,Assembly,"Do pass",2,3,2,0,7
1078758,717743,2018-03-06,Assembly,"Do pass as amended and be re-referred to the Committee on [Appropriations]",7,0,0,0,7
1078758,756776,2018-05-25,Assembly,"Do pass as amended",15,0,2,0,17
1078758,757771,2018-05-30,Assembly,"AB 1992 CHU Assembly Third Reading",56,16,6,0,78
1078758,768954,2018-06-26,Senate,"Do pass, but first be re-referred to the Committee on [Appropriations]",4,0,3,0,7
1078758,770298,2018-08-06,Senate,"Placed on suspense file",7,0,0,0,7
1078758,771791,2018-08-16,Senate,"Do pass as amended",5,2,0,0,7
1078758,772346,2018-08-21,Senate,"Assembly 3rd Reading AB1992 Chu By Portantino",28,9,3,0,40
1078758,772990,2018-08-27,Assembly,"AB 1992 CHU Concurrence in Senate Amendments",58,19,3,0,80
1078763,733854,2018-04-04,Senate,"Do pass, but first be re-referred to the Committee on [Appropriations]",6,2,1,0,9
1078763,755280,2018-05-22,Senate,"Placed on suspense file",7,0,0,0,7
1078763,756213,2018-05-25,Senate,"Do pass as amended",5,2,0,0,7
1078763,757617,2018-05-30,Senate,"Senate 3rd Reading SB974 Lara et al",21,12,6,0,39
1078763,764929,2018-06-19,Assembly,"Do pass and be re-referred to the Committee on [Appropriations]",11,4,0,0,15
1078768,744872,2018-04-25,Assembly,"Do pass and be re-referred to the Committee on [Appropriations]",7,0,0,0,7
1078771,743182,2018-04-24,Senate,"Do pass, but first be re-referred to the Committee on [Appropriations]",2,5,0,0,7
1078776,743261,2018-04-24,Senate,"Do pass, but first be re-referred to the Committee on [Appropriations]",6,0,1,0,7
1078776,750198,2018-05-07,Senate,"Placed on suspense file",6,0,1,0,7
1078776,756327,2018-05-25,Senate,"Do pass as amended",6,1,0,0,7
1078776,758576,2018-05-31,Senate,"Senate 3rd Reading SB982 Mitchell et al",39,0,0,0,39
1078776,769080,2018-06-26,Assembly,"Do pass and be re-referred to the Committee on [Appropriations]",7,0,0,0,7
1078778,726050,2018-03-20,Assembly,"Do pass and be re-referred to the Committee on [Appropriations] with recommendation: To Consent Calendar",7,0,0,0,7
1078778,734236,2018-04-04,Assembly,"Do pass. To Consent Calendar",15,0,2,0,17
1078778,738355,2018-04-12,Assembly,"AB 1994 CERVANTES Consent Calendar Second Day Regular Session",68,0,9,0,77
1078778,753215,2018-05-15,Senate,"Do pass, but first be re-referred to the Committee on [Appropriations] with the recommendation: To Consent Calendar",7,0,0,0,7
1078778,772669,2018-08-24,Senate,"Assembly 3rd Reading AB1994 Cervantes et al. By Galgiani",39,0,1,0,40
1078778,773448,2018-08-29,Assembly,"AB 1994 CERVANTES Concurrence in Senate Amendments",79,0,1,0,80
1078781,722195,2018-03-13,Senate,"Do pass, but first be re-referred to the Committee on [Appropriations]",10,0,2,0,12
1078781,742180,2018-04-23,Senate,"Senate 3rd Reading SB973 Dodd et al",36,2,1,0,39
1078781,766091,2018-06-20,Assembly,"Do pass and be re-referred to the Committee on [Appropriations]",18,0,3,0,21
1078781,771859,2018-08-16,Assembly,"Do pass as amended",12,0,5,0,17
1078781,773480,2018-08-29,Assembly,"SB 973 Dodd Senate Third Reading By LACKEY",68,0,12,0,80
1078781,773805,2018-08-30,Senate,"Unfinished Business SB973 Dodd et al. Concurrence",38,1,1,0,40
1078783,744724,2018-04-25,Assembly,"Do pass and be re-referred to the Committee on [Communications and Conveyance]",7,1,1,0,9
1078783,751259,2018-05-09,Assembly,"Do pass",9,3,1,0,13
1078783,754957,2018-05-21,Assembly,"AB 1999 CHAU Assembly Third Reading",52,20,6,0,78
1078783,766254,2018-06-20,Senate,"Do pass, but first be re-referred to the Committee on [Energy, Utilities and Communications]",5,0,2,0,7
1078783,768935,2018-06-27,Senate,"Do pass",10,0,1,0,11
1078783,773191,2018-08-28,Senate,"Assembly 3rd Reading AB1999 Chau By McGuire",28,4,8,0,40
1078783,773439,2018-08-29,Assembly,"AB 1999 CHAU Concurrence in Senate Amendments",57,22,1,0,80
1078787,722910,2018-03-14,Assembly,"Do pass",7,0,0,0,7
1078787,727810,2018-03-22,Assembly,"AB 2004 OBERNOLTE Third Reading Urgency",70,0,7,0,77
1078787,762054,2018-06-11,Senate,"Do pass and be ordered to the Consent Calendar",5,0,0,0,5
1078787,764172,2018-06-18,Senate,"Consent Calendar AB2004 Obernolte Urgency Clause",37,0,2,0,39
1078792,717702,2018-03-06,Assembly,"Do pass and be re-referred to the Committee on [Appropriations]",6,1,0,0,7
1078792,734118,2018-04-04,Assembly,"Do pass",11,4,2,0,17
1078792,741503,2018-04-19,Assembly,"AB 2001 REYES Assembly Third Reading",51,17,10,0,78
1078792,751381,2018-05-09,Senate,"Do pass, but first be re-referred to the Committee on [Appropriations]",6,0,0,0,6
1078792,767996,2018-06-25,Senate,"Placed on suspense file",7,0,0,0,7
1078794,733874,2018-04-03,Assembly,"Do pass and be re-referred to the Committee on [Education]",9,3,1,0,13
1078794,751161,2018-05-09,Assembly,"Do pass",4,2,1,0,7
1078794,754334,2018-05-17,Assembly,"AB 2012 MEDINA Assembly Third Reading",51,20,7,0,78
1078794,762913,2018-06-13,Senate,"Do pass, but first be re-referred to the Committee on [Appropriations]",6,0,1,0,7
1078794,767836,2018-06-25,Senate,"Placed on suspense file",7,0,0,0,7
1078794,771655,2018-08-16,Senate,"Do pass",5,2,0,0,7
1078794,772883,2018-08-27,Senate,"Assembly 3rd Reading AB2012 Medina et al. By Skinner",29,9,2,0,40
1078794,773501,2018-08-29,Assembly,"AB 2012 MEDINA Concurrence in Senate Amendments",57,23,0,0,80
1078797,725547,2018-03-20,Assembly,"Do pass and be re-referred to the Committee on [Appropriations]",7,0,0,0,7
1078797,756533,2018-05-25,Assembly,"Do pass as amended",12,0,5,0,17
1078797,757527,2018-05-30,Assembly,"AB 2005 SANTIAGO Assembly Third Reading",78,0,0,0,78
1078797,765221,2018-06-19,Senate,"Do pass, but first be re-referred to the Committee on [Appropriations]",7,0,0,0,7
1078797,770411,2018-08-06,Senate,"Placed on suspense file",7,0,0,0,7
1078797,772072,2018-08-16,Senate,"Do pass as amended",7,0,0,0,7
1078797,773242,2018-08-28,Senate,"Assembly 3rd Reading AB2005 Santiago By Delgado",38,0,2,0,40
1078797,773519,2018-08-29,Assembly,"AB 2005 SANTIAGO Concurrence in Senate Amendments",78,0,2,0,80
1078799,724577,2018-03-19,Assembly,"Do pass and be re-referred to the Committee on [Natural Resources]",13,0,1,0,14
1078799,738860,2018-04-16,Assembly,"Do pass as amended and be re-referred to the Committee on [Appropriations]",10,0,0,0,10
1078799,756464,2018-05-25,Assembly,"Do pass as amended",16,0,1,0,17
1078799,757570,2018-05-30,Assembly,"AB 2006 EGGMAN Assembly Third Reading",78,0,0,0,78
1078799,765201,2018-06-19,Senate,"Do pass as amended, but first amend, and re-refer to the Committee on [Environmental Quality] with the recommendation: To Consent Calendar",12,0,1,0,13
1078799,771378,2018-08-13,Senate,"Consent Calendar AB2006",37,0,3,0,40
1078799,772230,2018-08-20,Assembly,"AB 2006 EGGMAN Concurrence in Senate Amendments",80,0,0,0,80
1078802,722196,2018-03-13,Senate,"Do pass, but first be re-referred to the Committee on [Appropriations]",5,2,0,0,7
1078802,738839,2018-04-16,Senate,"Placed on suspense file",7,0,0,0,7
1078802,756216,2018-05-25,Senate,"Do pass",5,2,0,0,7
1078802,757110,2018-05-29,Senate,"Senate 3rd Reading SB978 Bradford",26,12,1,0,39
1078802,768171,2018-06-26,Assembly,"Do pass and be re-referred to the Committee on [Appropriations]",5,2,0,0,7
1078802,771535,2018-08-16,Assembly,"Do pass",12,5,0,0,17
1078802,772824,2018-08-27,Assembly,"SB 978 Bradford Senate Third Reading By JONES-SAWYER",43,29,8,0,80
1078805,727736,2018-03-21,Assembly,"Do pass and be re-referred to the Committee on [Judiciary] with recommendation: To Consent Calendar",6,0,1,0,7
1078805,733270,2018-04-03,Assembly,"Do pass as amended. To Consent Calendar",10,0,0,0,10
1078805,738296,2018-04-12,Assembly,"AB 2009 MAIENSCHEIN Consent Calendar Second Day Regular Session",68,0,9,0,77
1078805,751177,2018-05-09,Senate,"Do pass, but first be re-referred to the Committee on [Judiciary] with the recommendation: To Consent Calendar",6,0,0,0,6
1078805,768685,2018-06-26,Senate,"Do pass, but first be re-referred to the Committee on [Appropriations] with the recommendation: To Consent Calendar",7,0,0,0,7
1078805,770399,2018-08-06,Senate,"Placed on suspense file",7,0,0,0,7
1078805,771749,2018-08-16,Senate,"Do pass",7,0,0,0,7
1078805,773395,2018-08-29,Senate,"Assembly 3rd Reading AB2009 Maienschein et al. By Stern",39,0,1,0,40
1078805,773786,2018-08-30,Assembly,"AB 2009 MAIENSCHEIN Concurrence in Senate Amendments",80,0,0,0,80
1078808,743732,2018-04-24,Assembly,"Do pass and be re-referred to the Committee on [Appropriations]",7,0,0,0,7
1078810,736853,2018-04-10,Assembly,"Do pass and be re-referred to the Committee on [Appropriations]",15,0,0,0,15
1078813,740734,2018-04-17,Assembly,"Do pass and be re-referred to the Committee on [Business and Professions]",10,1,4,0,15
1078813,742894,2018-04-24,Assembly,"Do pass and be re-referred to the Committee on [Appropriations]",14,0,2,0,16
1078813,756340,2018-05-25,Assembly,"Do pass as amended",12,0,5,0,17
1078813,757785,2018-05-30,Assembly,"AB 1998 RODRIGUEZ Assembly Third Reading",77,0,1,0,78
1078813,765061,2018-06-18,Senate,"Do pass, but first be re-referred to the Committee on [Health]",9,0,0,0,9
1078813,768898,2018-06-27,Senate,"Do pass, but first be re-referred to the Committee on [Appropriations]",9,0,0,0,9
1078813,769191,2018-06-27,Senate,"Do pass as amended, but first amend, and re-refer to the Committee on [Appropriations]",9,0,0,0,9
1078813,770391,2018-08-06,Senate,"Placed on suspense file",7,0,0,0,7
1078813,774862,2018-05-25,Assembly,,14,0,5,0,19
1078820,734409,2018-04-04,Assembly,"Do pass and be re-referred to the Committee on [Appropriations] with recommendation: To Consent Calendar",21,0,0,0,21
1078820,740845,2018-04-18,Assembly,"Do pass. To Consent Calendar",15,0,2,0,17
1078820,744926,2018-04-26,Assembly,"AB 2000 KALRA Consent Calendar Second Day Regular Session",74,0,4,0,78
1078820,768367,2018-06-26,Senate,"Do pass, but first be re-referred to the Committee on [Appropriations]",13,0,0,0,13
1078820,772451,2018-08-22,Senate,"Assembly 3rd Reading AB2000 Kalra et al. By Wieckowski",39,0,1,0,40
1078820,773120,2018-08-28,Assembly,"With recommendation: That Senate amendments be concurred in",17,0,3,0,20
1078820,773725,2018-08-30,Assembly,"AB 2000 KALRA Concurrence in Senate Amendments",80,0,0,0,80
1081394,733282,2018-04-03,Assembly,"Do pass as amended and be re-referred to the Committee on [Judiciary]",6,0,1,0,7
1081394,736128,2018-04-10,Assembly,"Do pass as amended and be re-referred to the Committee on [Appropriations]",10,0,0,0,10
1081419,736472,2018-04-10,Senate,"Do pass, but first be re-referred to the Committee on [Judiciary]",6,0,1,0,7
1081419,744180,2018-04-24,Senate,"Do pass, but first be re-referred to the Committee on [Appropriations]",7,0,0,0,7
1081419,752875,2018-05-14,Senate,"Placed on suspense file",7,0,0,0,7
1081419,756465,2018-05-25,Senate,"Do pass as amended",5,0,2,0,7
1081419,757530,2018-05-30,Senate,"Senate 3rd Reading SB990 Wiener et al",31,0,8,0,39
1081419,764803,2018-06-19,Assembly,"Do pass and be re-referred to the Committee on [Judiciary]",5,0,2,0,7
1081419,768298,2018-06-26,Assembly,"Do pass and be re-referred to the Committee on [Appropriations]",8,1,1,0,10
1081426,744816,2018-04-25,Assembly,"Do pass as amended and be re-referred to the Committee on [Appropriations]",7,0,0,0,7
1081426,756441,2018-05-25,Assembly,"Do pass",13,2,2,0,17
1081426,757071,2018-05-29,Assembly,"AB 2015 REYES Assembly Third Reading",60,12,6,0,78
1081426,766240,2018-06-20,Senate,"Do pass as amended, but first amend, and re-refer to the Committee on [Appropriations]",7,0,0,0,7
1081426,770263,2018-08-06,Senate,"Placed on suspense file",7,0,0,0,7
1081426,771676,2018-08-16,Senate,"Do pass",5,2,0,0,7
1081426,772667,2018-08-24,Senate,"Assembly 3rd Reading AB2015 Reyes By Allen",35,0,5,0,40
1081426,773539,2018-08-29,Assembly,"AB 2015 REYES Concurrence in Senate Amendments",66,11,3,0,80
1081429,733083,2018-04-02,Senate,"Do pass",9,0,0,0,9
1081429,752152,2018-05-10,Senate,"Senate 3rd Reading SB988 Galgiani",38,0,1,0,39
1081429,762105,2018-06-12,Assembly,"Do pass",14,2,3,0,19
1081429,771222,2018-08-09,Assembly,"SB 988 Galgiani Senate Third Reading By ARAMBULA",59,5,16,0,80
1081439,740720,2018-04-17,Assembly,"Do pass and be re-referred to the Committee on [Appropriations]",6,0,1,0,7
1081446,736133,2018-04-10,Senate,"Do pass, but first be re-referred to the Committee on [Judiciary]",7,3,2,0,12
1081446,744097,2018-04-24,Senate,"Do pass as amended, but first amend, and re-refer to the Committee on [Appropriations]",5,2,0,0,7
1081446,755355,2018-05-22,Senate,"Placed on suspense file",7,0,0,0,7
1081446,756532,2018-05-25,Senate,"Do pass as amended",5,2,0,0,7
1081446,757651,2018-05-30,Senate,"Senate 3rd Reading SB984 Skinner",28,9,2,0,39
1081446,769003,2018-06-27,Assembly,"Do pass and be re-referred to the Committee on [Judiciary]",6,0,1,0,7
1081446,769205,2018-06-28,Assembly,"Do pass as amended and be re-referred to the Committee on [Appropriations]",7,1,2,0,10
1081454,736041,2018-04-10,Senate,"Do pass, but first be re-referred to the Committee on [Appropriations] with the recommendation: To Consent Calendar",13,0,0,0,13
1081454,742402,2018-04-23,Senate,"Do pass",7,0,0,0,7
1081454,746042,2018-04-30,Senate,"Senate 3rd Reading SB989 Wieckowski",36,0,3,0,39
1081454,761839,2018-06-11,Assembly,"Do pass and be re-referred to the Committee on [Appropriations] with recommendation: To Consent Calendar",14,0,0,0,14
1081454,771854,2018-08-16,Assembly,"Do pass",17,0,0,0,17
1081454,772838,2018-08-27,Assembly,"SB 989 Wieckowski Senate Third Reading By QUIRK",80,0,0,0,80
1081465,740763,2018-04-18,Assembly,"Do pass and be re-referred to the Committee on [Appropriations]",6,2,1,0,9
1081465,751235,2018-05-09,Assembly,"Do pass",11,5,1,0,17
1081465,752747,2018-05-14,Assembly,"AB 2019 AGUIAR-CURRY Assembly Third Reading",52,24,2,0,78
1081465,766260,2018-06-20,Senate,"Do pass, but first be re-referred to the Committee on [Appropriations]",5,1,1,0,7
1081465,770281,2018-08-06,Senate,"Do pass",5,2,0,0,7
1081465,772250,2018-08-20,Senate,"Assembly 3rd Reading AB2019 Aguiar-Curry By McGuire",26,12,2,0,40
1081465,772487,2018-08-23,Assembly,"AB 2019 AGUIAR-CURRY Concurrence in Senate Amendments",54,22,4,0,80
1081472,738155,2018-04-11,Assembly,"Do pass as amended and be re-referred to the Committee on [Health]",6,0,1,0,7
1081472,743453,2018-04-24,Assembly,"Do pass and be re-referred to the Committee on [Appropriations]",11,2,2,0,15
1081472,756576,2018-05-25,Assembly,"Do pass as amended",13,2,2,0,17
1081472,757826,2018-05-30,Assembly,"AB 2022 CHU Assembly Third Reading",78,0,0,0,78
1081472,765995,2018-06-20,Senate,"Do pass, but first be re-referred to the Committee on [Health]",7,0,0,0,7
1081472,768930,2018-06-27,Senate,"Do pass, but first be re-referred to the Committee on [Appropriations]",9,0,0,0,9
1081472,770374,2018-08-06,Senate,"Placed on suspense file",7,0,0,0,7
1081472,771709,2018-08-16,Senate,"Do pass as amended",7,0,0,0,7
1081472,772369,2018-08-21,Senate,"Assembly 3rd Reading AB2022 Chu By Beall",39,0,1,0,40
1081472,772857,2018-08-27,Assembly,"AB 2022 CHU Concurrence in Senate Amendments",80,0,0,0,80
1081476,722506,2018-03-12,Assembly,"Do pass and be re-referred to the Committee on [Appropriations]",6,1,3,0,10
1081476,756617,2018-05-25,Assembly,"Do pass as amended",12,3,2,0,17
1081476,758651,2018-05-31,Assembly,"AB 2023 CABALLERO Assembly Third Reading",69,4,5,0,78
1081476,769307,2018-06-27,Senate,"Do pass as amended, but first amend, and re-refer to the Committee on [Appropriations]",6,0,1,0,7
1081476,770949,2018-08-06,Senate,"Placed on suspense file",7,0,0,0,7
1081481,737290,2018-04-11,Senate,"Do pass, but first be re-referred to the Committee on [Appropriations]",9,0,0,0,9
1081481,752735,2018-05-14,Senate,"Placed on suspense file",7,0,0,0,7
1081481,756569,2018-05-25,Senate,"Do pass as amended",7,0,0,0,7
1081481,757748,2018-05-30,Senate,"Senate 3rd Reading SB992 Hernandez",38,0,1,0,39
1081481,765069,2018-06-19,Assembly,"Do pass as amended and be re-referred to the Committee on [Appropriations]",15,0,0,0,15
1081481,771500,2018-08-15,Assembly,"Do pass. To Consent Calendar",17,0,0,0,17
1081481,772566,2018-08-23,Assembly,"SB 992 Hernandez Consent Calendar Second Day By FRIEDMAN",75,0,5,0,80
1081481,772648,2018-08-24,Senate,"Unfinished Business SB992 Hernandez et al. Concurrence",39,0,1,0,40
1081492,741709,2018-04-18,Assembly,"Do pass and be re-referred to the Committee on [Judiciary]",2,5,0,0,7
1081492,741710,2018-04-18,Assembly,Reconsideration,6,0,1,0,7
1081503,736098,2018-04-10,Senate,"Do pass, but first be re-referred to the Committee on [Appropriations] with the recommendation: To Consent Calendar",13,0,0,0,13
1081503,750360,2018-05-07,Senate,"Do pass",6,0,1,0,7
1081503,756984,2018-05-29,Senate,"Senate 3rd Reading SB987 Galgiani",38,0,1,0,39
1081503,768058,2018-06-25,Assembly,"Do pass and be re-referred to the Committee on [Appropriations] with recommendation: To Consent Calendar",13,0,1,0,14
1081503,771120,2018-08-08,Assembly,"Do pass. To Consent Calendar",17,0,0,0,17
1081503,773011,2018-08-27,Assembly,"SB 987 Galgiani Senate Third Reading By OBERNOLTE",80,0,0,0,80
1081503,773193,2018-08-28,Senate,"Unfinished Business SB987 Galgiani Concurrence",39,0,1,0,40
1081507,734170,2018-04-04,Assembly,"Do pass and be re-referred to the Committee on [Appropriations]",5,0,2,0,7
1081507,740692,2018-04-18,Assembly,"Do pass",11,4,2,0,17
1081507,742165,2018-04-23,Assembly,"AB 2017 CHIU Assembly Third Reading",50,22,6,0,78
1081507,767926,2018-06-25,Senate,"Do pass, but first be re-referred to the Committee on [Appropriations]",3,2,0,0,5
1081523,733378,2018-04-03,Assembly,"Do pass as amended and be re-referred to the Committee on [Appropriations]",15,0,0,0,15
1081523,744714,2018-04-25,Assembly,"Do pass. To Consent Calendar",17,0,0,0,17
1081523,748958,2018-05-03,Assembly,"AB 2018 MAIENSCHEIN Consent Calendar Second Day Regular Session",71,0,7,0,78
1081523,760350,2018-06-06,Senate,"Do pass as amended, but first amend, and re-refer to the Committee on [Appropriations]",8,0,1,0,9
1081523,768020,2018-06-25,Senate,"Placed on suspense file",7,0,0,0,7
1081528,736183,2018-04-10,Assembly,"Do pass and be re-referred to the Committee on [Appropriations] with recommendation: To Consent Calendar",7,0,0,0,7
1081528,756661,2018-05-25,Assembly,"Do pass as amended",12,0,5,0,17
1081528,758782,2018-05-31,Assembly,"AB 2028 RODRIGUEZ Assembly Third Reading",78,0,0,0,78
1081528,768621,2018-06-26,Senate,"Do pass, but first be re-referred to the Committee on [Appropriations] with the recommendation: To Consent Calendar",7,0,0,0,7
1081528,770550,2018-08-06,Senate,"Placed on suspense file",7,0,0,0,7
1081528,772066,2018-08-16,Senate,"Do pass as amended",7,0,0,0,7
1081528,772322,2018-08-21,Senate,"Assembly 3rd Reading AB2028 Rodriguez By Leyva",39,0,1,0,40
1081528,772933,2018-08-27,Assembly,"AB 2028 RODRIGUEZ Concurrence in Senate Amendments",80,0,0,0,80
1081532,739546,2018-04-17,Assembly,"Do pass as amended and be re-referred to the Committee on [Appropriations]",13,1,2,0,16
1081532,751386,2018-05-09,Assembly,"Do pass",12,4,1,0,17
1081532,757088,2018-05-29,Assembly,"AB 2020 QUIRK Assembly Third Reading",60,16,2,0,78
1081532,767879,2018-06-25,Senate,"Do pass, but first be re-referred to the Committee on [Appropriations]",8,1,0,0,9
1081532,772819,2018-08-27,Senate,"Assembly 3rd Reading AB2020 Quirk et al. By Skinner",30,9,1,0,40
1081532,773372,2018-08-29,Assembly,"AB 2020 QUIRK Concurrence in Senate Amendments",61,15,4,0,80
1081539,738857,2018-04-16,Assembly,"Do pass and be re-referred to the Committee on [Appropriations]",14,0,0,0,14
1081539,751513,2018-05-09,Assembly,"Do pass. To Consent Calendar",16,0,1,0,17
1081539,754207,2018-05-17,Assembly,"AB 2026 LACKEY Consent Calendar Second Day Regular Session",73,0,5,0,78
1081539,762232,2018-06-12,Senate,"Do pass, but first be re-referred to the Committee on [Appropriations] with the recommendation: To Consent Calendar",12,0,1,0,13
1081539,772148,2018-08-20,Senate,"Assembly 3rd Reading AB2026 Lackey By Wilk",39,0,1,0,40
1081539,772502,2018-08-23,Assembly,"AB 2026 LACKEY Concurrence in Senate Amendments",79,0,1,0,80
1081606,743165,2018-04-24,Assembly,"Do pass as amended, and be re-referred to the Committee on [Appropriations] with recommendation: To Consent Calendar",15,0,0,0,15
1081606,756558,2018-05-25,Assembly,"Do pass",16,0,1,0,17
1081606,757184,2018-05-29,Assembly,"AB 2029 GARCIA, E. Assembly Third Reading",78,0,0,0,78
1081606,768795,2018-06-27,Senate,"Do pass as amended, but first amend, and re-refer to the Committee on [Appropriations]",9,0,0,0,9
1081606,770941,2018-08-06,Senate,"Placed on suspense file",7,0,0,0,7
1081630,733263,2018-04-03,Senate,"Do pass, but first be re-referred to the Committee on [Environmental Quality]",8,1,2,0,11
1081630,740592,2018-04-18,Senate,"Do pass as amended, but first amend, and re-refer to the Committee on [Judiciary]",6,0,1,0,7
1081630,743710,2018-04-24,Senate,"Do pass as amended, but first amend, and re-refer to the Committee on [Appropriations]",4,2,1,0,7
1081630,757090,2018-05-29,Senate,"Senate 3rd Reading SB998 Dodd",25,10,4,0,39
1081630,768401,2018-06-26,Assembly,"Do pass and be re-referred to the Committee on [Appropriations]",4,1,2,0,7
1081630,771478,2018-08-15,Assembly,"Do pass",12,4,1,0,17
1081630,773077,2018-08-28,Assembly,"SB 998 Dodd Senate Third Reading By QUIRK",44,26,10,0,80
1081630,773571,2018-08-29,Senate,"Unfinished Business SB998 Dodd Concurrence",25,13,2,0,40
1081657,722892,2018-03-14,Senate,"Do pass, but first be re-referred to the Committee on [Appropriations] with the recommendation: To Consent Calendar",9,0,0,0,9
1081657,754227,2018-05-17,Senate,"Consent Calendar SB997",38,0,1,0,39
1081657,765200,2018-06-19,Assembly,"Do pass and be re-referred to the Committee on [Appropriations] with recommendation: To Consent Calendar",15,0,0,0,15
1081657,768777,2018-06-27,Assembly,"Do pass. To Consent Calendar",16,0,1,0,17
1081657,769780,2018-07-05,Assembly,"SB 997 Monning Consent Calendar Second Day Regular Session",69,0,11,0,80
1081681,699713,2018-02-12,Senate,"Senate 3rd Reading SCR95 Jackson",38,0,2,0,40
1081681,710979,2018-02-26,Assembly,"Be adopted. To Consent Calendar",8,0,3,0,11
1081681,714550,2018-03-01,Assembly,"SCR 95 Jackson Consent Calendar Second Day",69,0,8,0,77
1081705,740040,2018-04-17,Senate,"Do pass as amended, but first amend, and re-refer to the Committee on [Transportation and Housing]",11,0,0,0,11
1081705,744070,2018-04-24,Senate,"Do pass as amended, but first amend, and re-refer to the Committee on [Appropriations] with the recommendation: To Consent Calendar",11,0,2,0,13
1081705,755286,2018-05-22,Senate,"Placed on suspense file",7,0,0,0,7
1081705,756414,2018-05-25,Senate,"Do pass as amended",6,1,0,0,7
1081705,757539,2018-05-30,Senate,"Senate 3rd Reading SB1000 Lara",37,0,2,0,39
1081705,767891,2018-06-25,Assembly,"Do pass and be re-referred to the Committee on [Utilities and Energy]",13,0,1,0,14
1081705,768708,2018-06-27,Assembly,"Do pass and be re-referred to the Committee on [Appropriations]",15,0,0,0,15
1081705,771571,2018-08-16,Assembly,"Do pass as amended",12,0,5,0,17
1081705,773396,2018-08-29,Assembly,"SB 1000 Lara Senate Third Reading By BURKE",80,0,0,0,80
1081705,773726,2018-08-30,Senate,"Unfinished Business SB1000 Lara Concurrence",39,0,1,0,40
1081732,699758,2018-02-12,Assembly,"Be adopted. To third reading",8,0,3,0,11
1081756,725617,2018-03-20,Assembly,"Do pass as amended, and be re-referred to the Committee on [Appropriations] with recommendation: To Consent Calendar",7,0,0,0,7
1081756,756470,2018-05-25,Assembly,"Do pass as amended",12,0,5,0,17
1081756,758799,2018-05-31,Assembly,"AB 2030 LIMÓN Assembly Third Reading",78,0,0,0,78
1081756,768773,2018-06-26,Senate,"Do pass, but first be re-referred to the Committee on [Appropriations]",6,0,1,0,7
1081756,770401,2018-08-06,Senate,"Placed on suspense file",7,0,0,0,7
1081756,771691,2018-08-16,Senate,"Do pass as amended",7,0,0,0,7
1081756,772422,2018-08-22,Senate,"Assembly 3rd Reading AB2030 Limón By Wiener",39,0,1,0,40
1081756,772863,2018-08-27,Assembly,"AB 2030 LIMÓN Concurrence in Senate Amendments",79,0,1,0,80
1081780,738823,2018-04-16,Senate,"Do pass, but first be re-referred to the Committee on [Judiciary]",8,1,0,0,9
1081780,743902,2018-04-24,Senate,"Do pass as amended, but first amend, and re-refer to the Committee on [Appropriations]",5,1,1,0,7
1081780,757737,2018-05-30,Senate,"Senate 3rd Reading SB1001 Hertzberg",26,10,3,0,39
1081780,765009,2018-06-19,Assembly,"Do pass as amended and be re-referred to the Committee on [Arts, Entertainment, Sports, Tourism, and Internet Media]",7,1,2,0,10
1081780,768289,2018-06-26,Assembly,"Do pass and be re-referred to the Committee on [Appropriations]",6,1,0,0,7
1081780,771482,2018-08-15,Assembly,"Do pass",12,5,0,0,17
1081780,773844,2018-08-30,Assembly,"SB 1001 Hertzberg Senate Third Reading By MULLIN",64,14,2,0,80
1081780,774209,2018-08-31,Senate,"Unfinished Business SB1001 Hertzberg et al. Concurrence",32,7,1,0,40
1081806,738780,2018-04-16,Senate,"Do pass as amended, but first amend, and re-refer to the Committee on [Appropriations]",6,1,2,0,9
1081806,752711,2018-05-14,Senate,"Placed on suspense file",7,0,0,0,7
1081806,756630,2018-05-25,Senate,"Do pass as amended",7,0,0,0,7
1081806,758525,2018-05-31,Senate,"Senate 3rd Reading SB999 Morrell et al",34,2,3,0,39
1081806,768327,2018-06-26,Assembly,"Do pass and be re-referred to the Committee on [Appropriations]",3,14,2,0,19
1081830,699786,2018-02-12,Assembly,"Be adopted. To third reading",8,0,3,0,11
1081830,719941,2018-03-08,Senate,"Assembly 3rd Reading ACR170 O'Donnell et al. By Lara",34,0,5,0,39
1082836,733794,2018-04-03,Assembly,"Do pass and be re-referred to the Committee on [Appropriations]",9,4,0,0,13
1082836,756775,2018-05-25,Assembly,"Do pass as amended",12,4,1,0,17
1082836,757855,2018-05-30,Assembly,"AB 2041 CABALLERO Assembly Third Reading",53,23,2,0,78
1082836,769005,2018-06-27,Senate,"Do pass, but first be re-referred to the Committee on [Appropriations]",6,1,0,0,7
1082836,771388,2018-08-13,Senate,"Assembly 3rd Reading AB2041 Caballero et al. By Mitchell",27,8,5,0,40
1082836,772287,2018-08-20,Assembly,"AB 2041 CABALLERO Concurrence in Senate Amendments",56,23,1,0,80
1082841,722903,2018-03-14,Assembly,"Do pass and be re-referred to the Committee on [Appropriations] with recommendation: To Consent Calendar",7,0,0,0,7
1082841,734117,2018-04-04,Assembly,"Do pass. To Consent Calendar",15,0,2,0,17
1082841,738233,2018-04-12,Assembly,"AB 2052 BONTA Consent Calendar Second Day Regular Session",68,0,9,0,77
1082841,762025,2018-06-11,Senate,"Do pass, but first be re-referred to the Committee on [Appropriations] with the recommendation: To Consent Calendar",5,0,0,0,5
1082841,769537,2018-07-02,Senate,"Consent Calendar AB2052",37,0,2,0,39
1082844,727742,2018-03-22,Senate,"Senate 3rd Reading SJR19 Wilk et al",37,0,2,0,39
1082844,762911,2018-06-13,Assembly,"Be adopted. To Consent Calendar",5,0,2,0,7
1082844,767231,2018-06-21,Assembly,"SJR 19 Wilk Consent Calendar Second Day Regular Session",75,0,5,0,80
1082844,769641,2018-07-02,Senate,"Unfinished Business SJR19 Wilk et al. Concurrence",37,0,2,0,39
1082847,743830,2018-04-25,Senate,"Do pass as amended, but first amend, and re-refer to the Committee on [Appropriations]",7,1,1,0,9
1082847,752616,2018-05-14,Senate,"Placed on suspense file",7,0,0,0,7
1082847,756357,2018-05-25,Senate,"Do pass as amended",5,2,0,0,7
1082847,757727,2018-05-30,Senate,"Senate 3rd Reading SB1008 Skinner",31,6,2,0,39
1082847,768262,2018-06-26,Assembly,"Do pass as amended and be re-referred to the Committee on [Appropriations]",15,0,0,0,15
1082847,771755,2018-08-16,Assembly,"Do pass",17,0,0,0,17
1082847,773700,2018-08-30,Assembly,"SB 1008 Skinner Senate Third Reading By WOOD",80,0,0,0,80
1082847,774099,2018-08-31,Senate,"Unfinished Business SB1008 Skinner Concurrence",35,2,3,0,40
1082850,725851,2018-03-20,Assembly,"Do pass and be re-referred to the Committee on [Appropriations]",13,0,3,0,16
1082850,756541,2018-05-25,Assembly,"Do pass as amended",13,0,4,0,17
1082850,757575,2018-05-30,Assembly,"AB 2037 BONTA Assembly Third Reading",70,1,7,0,78
1082850,767982,2018-06-25,Senate,"Do pass, but first be re-referred to the Committee on [Appropriations]",9,0,0,0,9
1082850,770345,2018-08-06,Senate,"Placed on suspense file",7,0,0,0,7
1082850,771965,2018-08-16,Senate,"Do pass",7,0,0,0,7
1082850,774107,2018-08-31,Senate,"Assembly 3rd Reading AB2037 Bonta By Hernandez Urgency Clause",35,0,5,0,40
1082850,774108,2018-08-31,Assembly,"AB 2037 Bonta Concurrence - Urgency Added",74,1,5,0,80
1082853,737505,2018-04-11,Assembly,"Do pass as amended and be re-referred to the Committee on [Judiciary]",4,0,3,0,7
1082853,743184,2018-04-24,Assembly,"Do pass as amended and be re-referred to the Committee on [Appropriations]",10,0,0,0,10
1082853,758838,2018-05-31,Assembly,"Do pass",9,0,2,0,11
1082853,758839,2018-05-31,Assembly,"AB 2055 LEVINE Assembly Third Reading",77,0,1,0,78
1082853,769733,2018-07-03,Senate,"Do pass and be ordered to the Consent Calendar",4,0,1,0,5
1082853,771412,2018-08-13,Senate,"Consent Calendar AB2055 Levine",37,0,3,0,40
1082857,744112,2018-04-25,Senate,"Do pass, but first be re-referred to the Committee on [Appropriations]",7,0,0,0,7
1082857,750405,2018-05-07,Senate,"Placed on suspense file",6,0,1,0,7
1082857,756592,2018-05-25,Senate,"Do pass",7,0,0,0,7
1082857,756962,2018-05-29,Senate,"Senate 3rd Reading SB1007 Hertzberg et al",37,0,2,0,39
1082857,764828,2018-06-18,Assembly,"Do pass as amended and be re-referred to the Committee on [Appropriations]",9,0,1,0,10
1082857,771127,2018-08-08,Assembly,"Do pass as amended",17,0,0,0,17
1082857,774255,2018-08-31,Senate,"Unfinished Business SB1007 Hertzberg et al. Concurrence",39,0,1,0,40
1082857,774256,2018-08-31,Assembly,"SB 1007 Hertzberg Senate Third Reading By MURATSUCHI",80,0,0,0,80
1082859,738423,2018-04-11,Assembly,"Do pass and be re-referred to the Committee on [Appropriations] with recommendation: To Consent Calendar",10,0,0,0,10
1082859,756733,2018-05-25,Assembly,"Do pass",16,0,1,0,17
1082859,756976,2018-05-29,Assembly,"AB 2054 GONZALEZ FLETCHER Assembly Third Reading",78,0,0,0,78
1082859,764975,2018-06-19,Senate,"Do pass, but first be re-referred to the Committee on [Appropriations]",4,0,1,0,5
1082859,771463,2018-08-14,Senate,"Do pass as amended, but first amend, and re-refer to the Committee on [Appropriations]",9,0,0,0,9
1082859,771818,2018-08-16,Senate,"Placed on suspense file",7,0,0,0,7
1082859,771819,2018-08-16,Senate,"Do pass",7,0,0,0,7
1082859,774102,2018-08-31,Assembly,"With recommendation: That Senate amendments be concurred in",11,0,4,0,15
1082859,774103,2018-08-31,Senate,"Assembly 3rd Reading AB2054 Gonzalez Fletcher et al. By McGuire Urgency Clause",38,0,2,0,40
1082859,774104,2018-08-31,Assembly,"AB 2054 Gonzalez Fletcher Concurrence - Urgency Added",77,0,3,0,80
1082862,739622,2018-04-17,Senate,"Do pass as amended, but first amend, and re-refer to the Committee on [Environmental Quality]",7,3,1,0,11
1082862,743874,2018-04-24,Senate,"Do pass as amended, but first amend, and re-refer to the Committee on [Appropriations]",8,3,2,0,13
1082862,752688,2018-05-14,Senate,"Placed on suspense file",7,0,0,0,7
1082862,756628,2018-05-25,Senate,"Do pass as amended",5,2,0,0,7
1082862,758573,2018-05-31,Senate,"Senate 3rd Reading SB1014 Skinner",24,12,3,0,39
1082862,766186,2018-06-20,Assembly,"Do pass and be re-referred to the Committee on [Transportation]",8,3,2,0,13
1082862,767903,2018-06-25,Assembly,"Do pass as amended and be re-referred to the Committee on [Appropriations]",8,4,2,0,14
1082862,771800,2018-08-16,Assembly,"Do pass",12,5,0,0,17
1082862,773770,2018-08-30,Assembly,"SB 1014 Skinner Senate Third Reading By TING",47,24,9,0,80
1082862,774068,2018-08-31,Senate,"Unfinished Business SB1014 Skinner Concurrence",23,13,4,0,40
1082862,774516,2018-06-25,Assembly,?,8,3,2,0,13
1082864,709234,2018-02-22,Assembly,"Be adopted. To third reading",7,0,4,0,11
1082868,754276,2018-05-17,Assembly,"Do pass",9,0,2,0,11
1082868,756946,2018-05-29,Assembly,"AB 2036 GIPSON Assembly Third Reading",78,0,0,0,78
1082868,768314,2018-06-26,Senate,"Do pass, but first be re-referred to the Committee on [Appropriations] with the recommendation: To Consent Calendar",13,0,0,0,13
1082868,772371,2018-08-21,Senate,"Assembly 3rd Reading AB2036 Gipson By Hertzberg",39,0,1,0,40
1082868,772923,2018-08-27,Assembly,"AB 2036 GIPSON Concurrence in Senate Amendments",79,0,1,0,80
1082872,743734,2018-04-25,Assembly,"Do pass and be re-referred to the Committee on [Appropriations]",2,5,0,0,7
1082874,725745,2018-03-20,Assembly,"Do pass and be re-referred to the Committee on [Appropriations] with recommendation: To Consent Calendar",10,0,0,0,10
1082874,756687,2018-05-25,Assembly,"Do pass as amended",12,0,5,0,17
1082874,757839,2018-05-30,Assembly,"AB 2034 KALRA Assembly Third Reading",78,0,0,0,78
1082874,766434,2018-06-19,Senate,"Do pass, but first be re-referred to the Committee on [Appropriations] with the recommendation: To Consent Calendar",7,0,0,0,7
1082874,770360,2018-08-06,Senate,"Placed on suspense file",7,0,0,0,7
1082874,772009,2018-08-16,Senate,"Do pass as amended",7,0,0,0,7
1082874,772449,2018-08-22,Senate,"Assembly 3rd Reading AB2034 Kalra By Beall",39,0,1,0,40
1082874,772934,2018-08-27,Assembly,"AB 2034 KALRA Concurrence in Senate Amendments",80,0,0,0,80
1082881,742874,2018-04-23,Assembly,"Do pass as amended and be re-referred to the Committee on [Appropriations]",9,1,0,0,10
1082884,735424,2018-04-09,Assembly,"Do pass and be re-referred to the Committee on [Appropriations]",12,0,2,0,14
1082884,756208,2018-05-25,Assembly,"Do pass as amended",16,0,1,0,17
1082884,758639,2018-05-31,Assembly,"AB 2058 CHAU Assembly Third Reading",64,4,10,0,78
1082884,768237,2018-06-26,Senate,"Do pass as amended",6,0,1,0,7
1082884,772498,2018-08-23,Senate,"Assembly 3rd Reading AB2058 Chau By Hill",38,1,1,0,40
1082884,772953,2018-08-27,Assembly,"AB 2058 CHAU Concurrence in Senate Amendments",77,1,2,0,80
1082886,744096,2018-04-24,Senate,"Do pass",5,2,0,0,7
1082886,750052,2018-05-07,Senate,"Senate 3rd Reading SB1012 Hertzberg",25,10,4,0,39
1082886,769690,2018-07-03,Assembly,"Do pass",9,1,0,0,10
1082886,773094,2018-08-27,Assembly,"Do pass as amended",6,0,1,0,7
1082886,773966,2018-08-31,Senate,"That the Assembly amendments be concurred in",6,0,1,0,7
1082886,774080,2018-08-31,Senate,"Unfinished Business SB1012 Delgado Concurrence",39,0,1,0,40
1082886,774081,2018-08-31,Assembly,"SB 1012 Delgado Senate Third Reading By LIMÓN",80,0,0,0,80
1082888,726393,2018-03-21,Senate,"Do pass as amended, but first amend, and re-refer to the Committee on [Appropriations]",5,0,1,0,6
1082888,746025,2018-04-30,Senate,"Placed on suspense file",6,0,1,0,7
1082893,737405,2018-04-10,Assembly,"Do pass as amended, and be re-referred to the Committee on [Appropriations] with recommendation: To Consent Calendar",7,0,0,0,7
1082893,756461,2018-05-25,Assembly,"Do pass as amended",16,0,1,0,17
1082893,757549,2018-05-30,Assembly,"AB 2043 ARAMBULA Assembly Third Reading",78,0,0,0,78
1082893,768793,2018-06-26,Senate,"Do pass as amended, but first amend, and re-refer to the Committee on [Appropriations]",6,0,1,0,7
1082893,770420,2018-08-06,Senate,"Placed on suspense file",7,0,0,0,7
1082893,771756,2018-08-16,Senate,"Do pass as amended",7,0,0,0,7
1082893,772379,2018-08-21,Senate,"Assembly 3rd Reading AB2043 Arambula et al. By Wiener",39,0,1,0,40
1082893,773080,2018-08-28,Assembly,"AB 2043 ARAMBULA Concurrence in Senate Amendments",80,0,0,0,80
1082895,699528,2018-02-12,Assembly,"Be adopted. To third reading",8,0,3,0,11
1082895,727735,2018-03-22,Senate,"Special Consent ACR171",37,0,2,0,39
1082898,733290,2018-04-03,Assembly,"Do pass",8,1,1,0,10
1082898,734457,2018-04-05,Assembly,"AB 2044 STONE Assembly Third Reading",51,0,26,0,77
1082898,762865,2018-06-12,Senate,"Do pass, but first be re-referred to the Committee on [Appropriations]",6,0,1,0,7
1082898,769534,2018-07-02,Senate,"Assembly 3rd Reading AB2044 Mark Stone et al. By Jackson",37,0,2,0,39
1082898,772342,2018-08-21,Senate,"Assembly 3rd Reading AB2044 Mark Stone et al. By Jackson",39,0,1,0,40
1082898,772874,2018-08-27,Assembly,"AB 2044 STONE Concurrence in Senate Amendments",79,0,1,0,80
1082902,733812,2018-04-04,Assembly,"Do pass and be re-referred to the Committee on [Higher Education]",5,0,2,0,7
1082902,743859,2018-04-24,Assembly,"Do pass and be re-referred to the Committee on [Appropriations]",9,3,1,0,13
1082902,756493,2018-05-25,Assembly,"Do pass",12,4,1,0,17
1082902,757057,2018-05-29,Assembly,"AB 2049 GONZALEZ FLETCHER Assembly Third Reading",53,24,1,0,78
1082902,767928,2018-06-25,Senate,"Do pass, but first be re-referred to the Committee on [Appropriations]",3,2,0,0,5
1082905,725427,2018-03-20,Senate,"Do pass as amended, but first amend, and re-refer to the Committee on [Appropriations]",6,1,0,0,7
1082905,725428,2018-03-20,Senate,"[03-20-2018] set for [First] hearing: Reconsideration of favorable vote granted",6,0,1,0,7
1082905,725429,2018-03-20,Senate,"Do pass as amended, but first amend, and re-refer to the Committee on [Appropriations]",7,0,0,0,7
1082905,738841,2018-04-16,Senate,"Placed on suspense file",7,0,0,0,7
1082905,756490,2018-05-25,Senate,"Do pass",7,0,0,0,7
1082905,758524,2018-05-31,Senate,"Special Consent SB1010",39,0,0,0,39
1082905,764889,2018-06-19,Assembly,"Do pass and be re-referred to the Committee on [Appropriations] with recommendation: To Consent Calendar",7,0,0,0,7
1082907,727674,2018-03-21,Assembly,"Do pass and be re-referred to the Committee on [Appropriations] with recommendation: To Consent Calendar",6,0,1,0,7
1082907,756762,2018-05-25,Assembly,"Do pass",16,0,1,0,17
1082907,757046,2018-05-29,Assembly,"AB 2031 O'DONNELL Assembly Third Reading",78,0,0,0,78
1082907,763018,2018-06-13,Senate,"Do pass, but first be re-referred to the Committee on [Appropriations]",7,0,0,0,7
1082907,768042,2018-06-25,Senate,"Placed on suspense file",7,0,0,0,7
1082907,771730,2018-08-16,Senate,"Do pass",7,0,0,0,7
1082907,772460,2018-08-22,Senate,"Assembly 3rd Reading AB2031 O'Donnell et al. By Hernandez",36,2,2,0,40
1082910,735818,2018-04-09,Senate,"Do pass, but first be re-referred to the Committee on [Appropriations]",9,0,0,0,9
1082910,746100,2018-04-30,Senate,"Senate 3rd Reading SB1003 Roth",37,0,2,0,39
1082910,762404,2018-06-12,Assembly,"Do pass and be re-referred to the Committee on [Appropriations]",18,0,1,0,19
1082910,769052,2018-06-27,Assembly,"Do pass. To Consent Calendar",16,0,1,0,17
1082910,769771,2018-07-05,Assembly,"SB 1003 Roth Consent Calendar Second Day Regular Session",69,0,11,0,80
1082910,770905,2018-08-06,Senate,"Unfinished Business SB1003 Roth et al. Concurrence",37,0,2,0,39
1082914,736195,2018-04-10,Assembly,"Do pass and be re-referred to the Committee on [Appropriations]",14,0,1,0,15
1082916,740544,2018-04-18,Assembly,"Do pass and be re-referred to the Committee on [Appropriations]",2,2,3,0,7
1082919,734020,2018-04-04,Senate,"Do pass as amended, but first amend, and re-refer to the Committee on [Rules]",5,2,0,0,7
1082919,743829,2018-04-25,Senate,"Do pass as amended, but first amend, and re-refer to the Committee on [Appropriations]",8,2,1,0,11
1082919,755346,2018-05-22,Senate,"Placed on suspense file",7,0,0,0,7
1082919,756598,2018-05-25,Senate,"Do pass as amended",5,2,0,0,7
1082919,757699,2018-05-30,Senate,"Senate 3rd Reading SB1013 Lara et al",23,12,4,0,39
1082919,764931,2018-06-18,Assembly,"Do pass as amended and be re-referred to the Committee on [Appropriations]",7,3,0,0,10
1082919,771569,2018-08-16,Assembly,"Do pass as amended",12,0,5,0,17
1082919,773400,2018-08-29,Assembly,"SB 1013 Lara Senate Third Reading By EGGMAN",63,12,5,0,80
1082919,773841,2018-08-30,Senate,"Unfinished Business SB1013 Lara et al. Concurrence",28,10,2,0,40
1082922,737535,2018-04-11,Assembly,"Do pass as amended and be re-referred to the Committee on [Housing and Community Development]",6,3,0,0,9
1082922,751443,2018-05-09,Assembly,"Do pass as amended",6,1,0,0,7
1082922,757997,2018-05-30,Assembly,"AB 2035 MULLIN Assembly Third Reading",54,23,1,0,78
1082922,766479,2018-06-20,Senate,"Do pass, but first be re-referred to the Committee on [Transportation and Housing]",5,0,2,0,7
1082922,769747,2018-07-03,Senate,"Do pass",10,3,0,0,13
1082922,773197,2018-08-28,Senate,"Assembly 3rd Reading AB2035 Mullin et al. By Wieckowski",26,11,3,0,40
1082922,773330,2018-08-29,Assembly,"AB 2035 MULLIN Concurrence in Senate Amendments",54,25,1,0,80
1082928,726376,2018-03-19,Assembly,"Do pass as amended and be re-referred to the Committee on [Appropriations]",9,1,0,0,10
1082932,733294,2018-04-03,Senate,"Do pass, but first be re-referred to the Committee on [Appropriations] with the recommendation: To Consent Calendar",6,0,1,0,7
1082932,738880,2018-04-16,Senate,"Do pass",7,0,0,0,7
1082932,742339,2018-04-23,Senate,"Senate 3rd Reading SB1005 Atkins et al",38,0,1,0,39
1082932,762145,2018-06-12,Assembly,"Do pass and be re-referred to the Committee on [Appropriations] with recommendation: To Consent Calendar",7,0,0,0,7
1082932,771832,2018-08-16,Assembly,"Do pass",16,0,1,0,17
1082932,773046,2018-08-27,Assembly,"SB 1005 Atkins Senate Third Reading By WALDRON",76,0,4,0,80
1082932,773128,2018-08-28,Senate,"Unfinished Business SB1005 Atkins et al. Concurrence",39,0,1,0,40
1082935,697834,2018-02-08,Senate,"W/O REF. TO FILE SR81 Mitchell",37,0,3,0,40
1082940,733878,2018-04-04,Assembly,"Do pass and be re-referred to the Committee on [Appropriations] with recommendation: To Consent Calendar",13,0,0,0,13
1082940,740730,2018-04-18,Assembly,"Do pass. To Consent Calendar",15,0,2,0,17
1082940,744715,2018-04-26,Assembly,"AB 2045 INS. Consent Calendar Second Day Regular Session",74,0,4,0,78
1082940,769218,2018-06-27,Senate,"Do pass as amended, but first amend, and re-refer to the Committee on [Appropriations]",12,0,1,0,13
1082940,771196,2018-08-09,Senate,"Assembly 3rd Reading AB2045 INS. (Daly) By Glazer",36,0,3,0,39
1082940,771379,2018-08-13,Assembly,"AB 2045 INS. Concurrence in Senate Amendments By DALY",78,0,2,0,80
1082943,725738,2018-03-20,Assembly,"Do pass and be re-referred to the Committee on [Environmental Safety and Toxic Materials]",15,0,0,0,15
1082943,736693,2018-04-10,Assembly,"Do pass as amended and be re-referred to the Committee on [Appropriations]",7,0,0,0,7
1082943,756761,2018-05-25,Assembly,"Do pass as amended",12,0,5,0,17
1082943,758773,2018-05-31,Assembly,"AB 2060 GARCIA, E. Assembly Third Reading",78,0,0,0,78
1082943,767057,2018-06-20,Senate,"Do pass, but first be re-referred to the Committee on [Natural Resources and Water]",5,0,2,0,7
1082943,768363,2018-06-26,Senate,"Do pass as amended, but first amend, and re-refer to the Committee on [Appropriations]",9,0,0,0,9
1082943,770925,2018-08-06,Senate,"Placed on suspense file",7,0,0,0,7
1082943,772042,2018-08-16,Senate,"Do pass",7,0,0,0,7
1082943,772772,2018-08-27,Senate,"Assembly 3rd Reading AB2060 Eduardo Garcia et al. By Hueso",39,0,1,0,40
1082943,773579,2018-08-29,Assembly,"AB 2060 GARCIA, E. Concurrence in Senate Amendments",79,0,1,0,80
1082945,743801,2018-04-25,Assembly,"Do pass and be re-referred to the Committee on [Appropriations]",6,1,0,0,7
1082945,756413,2018-05-25,Assembly,"Do pass",13,2,2,0,17
1082945,758714,2018-05-31,Assembly,"AB 2056 GARCIA, E. Assembly Third Reading",60,17,1,0,78
1082945,768236,2018-06-26,Senate,"Do pass, but first be re-referred to the Committee on [Appropriations]",9,3,1,0,13
1082945,770839,2018-08-06,Senate,"Placed on suspense file",7,0,0,0,7
1082945,772000,2018-08-16,Senate,"Do pass as amended",6,1,0,0,7
1082945,773045,2018-08-27,Senate,"Assembly 3rd Reading AB2056 Eduardo Garcia By McGuire",28,11,1,0,40
1082945,773453,2018-08-29,Assembly,"AB 2056 GARCIA, E. Concurrence in Senate Amendments",61,18,1,0,80
1082949,736157,2018-04-09,Assembly,"Do pass as amended and be re-referred to the Committee on [Appropriations]",6,1,3,0,10
1082949,743930,2018-04-25,Assembly,"Do pass",14,0,3,0,17
1082949,748612,2018-05-03,Assembly,"AB 2057 SALAS Assembly Third Reading",59,2,17,0,78
1082956,737344,2018-04-11,Senate,"Do pass as amended, but first amend, and re-refer to the Committee on [Appropriations]",9,0,0,0,9
1082956,752655,2018-05-14,Senate,"Placed on suspense file",7,0,0,0,7
1082956,756378,2018-05-25,Senate,"Do pass as amended",7,0,0,0,7
1082956,757682,2018-05-30,Senate,"Senate 3rd Reading SB1004 Wiener et al",38,0,1,0,39
1082956,765144,2018-06-19,Assembly,"Do pass and be re-referred to the Committee on [Appropriations]",15,0,0,0,15
1082956,771729,2018-08-16,Assembly,"Do pass as amended",12,0,5,0,17
1082956,773531,2018-08-29,Assembly,"SB 1004 Wiener Senate Third Reading By MULLIN",80,0,0,0,80
1082956,774172,2018-08-31,Senate,"Unfinished Business SB1004 Wiener et al. Concurrence",39,0,1,0,40
1082958,736198,2018-04-10,Assembly,"Do pass and be re-referred to the Committee on [Local Government]",5,2,0,0,7
1082958,744722,2018-04-25,Assembly,"Do pass and be re-referred to the Committee on [Appropriations]",6,1,2,0,9
1082958,756433,2018-05-25,Assembly,"Do pass as amended",12,1,4,0,17
1082958,757628,2018-05-30,Assembly,"AB 2050 CABALLERO Assembly Third Reading",56,19,3,0,78
1082958,767119,2018-06-20,Senate,"Do pass, but first be re-referred to the Committee on [Governance and Finance]",6,1,0,0,7
1082958,769273,2018-06-27,Senate,"Do pass, but first be re-referred to the Committee on [Appropriations]",7,0,0,0,7
1082958,771351,2018-08-13,Senate,"Placed on suspense file",7,0,0,0,7
1082958,771881,2018-08-16,Senate,"Do pass",5,0,2,0,7
1082958,772432,2018-08-22,Senate,"Assembly 3rd Reading AB2050 Caballero By Roth",34,3,3,0,40
1082958,772770,2018-08-27,Assembly,"AB 2050 CABALLERO Concurrence in Senate Amendments",58,21,1,0,80
1082966,733848,2018-04-04,Assembly,"Do pass as amended and be re-referred to the Committee on [Appropriations]",13,0,0,0,13
1082966,756521,2018-05-25,Assembly,"Do pass",16,0,1,0,17
1082966,757079,2018-05-29,Assembly,"AB 2046 DALY Assembly Third Reading",78,0,0,0,78
1082966,769252,2018-06-27,Senate,"Do pass, but first be re-referred to the Committee on [Appropriations] with the recommendation: To Consent Calendar",12,0,1,0,13
1082966,770261,2018-08-06,Senate,"Placed on suspense file",7,0,0,0,7
1082966,771654,2018-08-16,Senate,"Do pass as amended",7,0,0,0,7
1082966,772362,2018-08-21,Senate,"Assembly 3rd Reading AB2046 Daly By Glazer",39,0,1,0,40
1082966,772951,2018-08-27,Assembly,"AB 2046 DALY Concurrence in Senate Amendments",79,0,1,0,80
1083776,737352,2018-04-10,Assembly,"Do pass and be re-referred to the Committee on [Appropriations] with recommendation: To Consent Calendar",7,0,0,0,7
1083776,756428,2018-05-25,Assembly,"Do pass as amended",12,0,5,0,17
1083776,757552,2018-05-30,Assembly,"AB 2083 COOLEY Assembly Third Reading",78,0,0,0,78
1083776,762934,2018-06-12,Senate,"Do pass, but first be re-referred to the Committee on [Judiciary]",6,0,1,0,7
1083776,768730,2018-06-26,Senate,"Do pass as amended, but first amend, and re-refer to the Committee on [Appropriations] with the recommendation: To Consent Calendar",7,0,0,0,7
1083776,770563,2018-08-06,Senate,"Placed on suspense file",7,0,0,0,7
1083776,771685,2018-08-16,Senate,"Do pass as amended",7,0,0,0,7
1083776,772975,2018-08-27,Senate,"Assembly 3rd Reading AB2083 Cooley By Leyva",39,0,1,0,40
1083776,773371,2018-08-29,Assembly,"AB 2083 COOLEY Concurrence in Senate Amendments",80,0,0,0,80
1083778,733787,2018-04-03,Assembly,"Do pass and be re-referred to the Committee on [Judiciary]",4,7,2,0,13
1083780,743338,2018-04-23,Senate,"Do pass, but first be re-referred to the Committee on [Appropriations] with the recommendation: To Consent Calendar",4,0,1,0,5
1083780,752190,2018-05-10,Senate,"Consent Calendar SB1022",38,0,1,0,39
1083780,766590,2018-06-20,Assembly,"Do pass and be re-referred to the Committee on [Appropriations]",6,0,1,0,7
1083780,771097,2018-08-08,Assembly,"Do pass. To Consent Calendar",17,0,0,0,17
1083780,771526,2018-08-16,Assembly,"SB 1022 Pan Consent Calendar Second Day Regular Session",76,0,4,0,80
1083782,747279,2018-05-01,Assembly,"Do pass",7,3,0,0,10
1083784,750672,2018-05-07,Assembly,"Do pass as amended and be re-referred to the Committee on [Appropriations]",7,1,2,0,10
1083786,724036,2018-03-15,Senate,"Senate 3rd Reading SCR97 Leyva et al",39,0,0,0,39
1083786,754445,2018-05-17,Assembly,"Be adopted. To Consent Calendar",9,0,2,0,11
1083786,756250,2018-05-25,Assembly,"SCR 97 Leyva Consent Calendar Second Day Regular Session",70,0,8,0,78
1083788,725598,2018-03-20,Assembly,"Do pass and be re-referred to the Committee on [Appropriations]",7,0,0,0,7
1083793,743329,2018-04-24,Senate,"Do pass as amended, but first amend, and re-refer to the Committee on [Appropriations]",7,2,0,0,9
1083793,752909,2018-05-14,Senate,"Placed on suspense file",7,0,0,0,7
1083793,756271,2018-05-25,Senate,"Do pass as amended",5,2,0,0,7
1083793,757679,2018-05-30,Senate,"Senate 3rd Reading SB1017 Allen et al",33,0,6,0,39
1083793,768225,2018-06-26,Assembly,"Do pass and be re-referred to the Committee on [Appropriations]",10,2,3,0,15
1083793,771894,2018-08-16,Assembly,"Do pass as amended",12,0,5,0,17
1083793,773337,2018-08-29,Assembly,"SB 1017 Allen Senate Third Reading By GLORIA",78,0,2,0,80
1083793,773872,2018-08-30,Senate,"Unfinished Business SB1017 Allen et al. Concurrence",36,1,3,0,40
1083795,725723,2018-03-20,Assembly,"Be adopted. To third reading",8,0,2,0,10
1083795,763814,2018-06-14,Senate,"Assembly 3rd Reading ACR172 Low et al. By Wiener",26,2,11,0,39
1083795,767036,2018-06-21,Assembly,"ACR 172 LOW Concurrence in Senate Amendments",57,0,23,0,80
1083798,725484,2018-03-20,Assembly,"Do pass and be re-referred to the Committee on [Appropriations] with recommendation: To Consent Calendar",7,0,0,0,7
1083798,734277,2018-04-04,Assembly,"Do pass. To Consent Calendar",15,0,2,0,17
1083798,738298,2018-04-12,Assembly,"AB 2080 CERVANTES Consent Calendar Second Day Regular Session",68,0,9,0,77
1083798,762129,2018-06-12,Senate,"Do pass, but first be re-referred to the Committee on [Appropriations] with the recommendation: To Consent Calendar",7,0,0,0,7
1083798,769561,2018-07-02,Senate,"Placed on suspense file",7,0,0,0,7
1083798,771637,2018-08-16,Senate,"Do pass",7,0,0,0,7
1083798,772368,2018-08-21,Senate,"Assembly 3rd Reading AB2080 Cervantes By Wiener",37,0,3,0,40
1083800,737284,2018-04-11,Assembly,"Do pass as amended and be re-referred to the Committee on [Appropriations]",6,3,0,0,9
1083802,725709,2018-03-20,Senate,"Do pass as amended, but first amend, and re-refer to the Committee on [Judiciary]",11,0,2,0,13
1083802,736092,2018-04-10,Senate,"Do pass as amended, and be ordered to the Consent Calendar",7,0,0,0,7
1083802,742207,2018-04-23,Senate,"Consent Calendar SB1016",38,0,1,0,39
1083802,763149,2018-06-13,Assembly,"Do pass and be re-referred to the Committee on [Judiciary]",6,0,1,0,7
1083802,769727,2018-07-03,Assembly,"Do pass",10,0,0,0,10
1083802,773881,2018-08-30,Assembly,"SB 1016 Allen Senate Third Reading By MURATSUCHI",74,4,2,0,80
1083802,774254,2018-08-31,Senate,"Unfinished Business SB1016 Allen et al. Concurrence",39,0,1,0,40
1083804,710411,2018-02-26,Senate,"Senate 3rd Reading SCR96 Dodd et al",35,0,4,0,39
1083804,719896,2018-03-08,Assembly,"Be adopted. To third reading",8,0,3,0,11
1083806,737231,2018-04-10,Assembly,"Do pass and be re-referred to the Committee on [Appropriations]",16,0,0,0,16
1083806,744479,2018-04-25,Assembly,"Do pass. To Consent Calendar",17,0,0,0,17
1083806,748737,2018-05-03,Assembly,"AB 2086 GALLAGHER Consent Calendar Second Day Regular Session",71,0,7,0,78
1083806,765078,2018-06-18,Senate,"Do pass, but first be re-referred to the Committee on [Appropriations] with the recommendation: To Consent Calendar",9,0,0,0,9
1083806,772278,2018-08-20,Senate,"Assembly 3rd Reading AB2086 Gallagher et al. By Hernandez",39,0,1,0,40
1083806,772602,2018-08-23,Assembly,"AB 2086 GALLAGHER Concurrence in Senate Amendments",78,0,2,0,80
1083810,722733,2018-03-13,Senate,"Do pass, but first be re-referred to the Committee on [Environmental Quality]",6,2,1,0,9
1083810,741012,2018-04-18,Senate,"Do pass, but first be re-referred to the Committee on [Appropriations]",4,2,1,0,7
1083810,755255,2018-05-22,Senate,"Placed on suspense file",7,0,0,0,7
1083810,756659,2018-05-25,Senate,"Do pass",5,2,0,0,7
1083810,757073,2018-05-29,Senate,"Senate 3rd Reading SB1015 Allen et al",27,9,3,0,39
1083810,764876,2018-06-18,Assembly,"Do pass as amended and be re-referred to the Committee on [Water, Parks, and Wildlife]",8,1,1,0,10
1083810,768169,2018-06-26,Assembly,"Do pass and be re-referred to the Committee on [Appropriations]",9,6,0,0,15
1083813,740653,2018-04-18,Senate,"Do pass, but first be re-referred to the Committee on [Appropriations]",8,0,1,0,9
1083813,752707,2018-05-14,Senate,"Placed on suspense file",7,0,0,0,7
1083813,756199,2018-05-25,Senate,"Do pass as amended",5,1,1,0,7
1083813,757603,2018-05-30,Senate,"Senate 3rd Reading SB1023 Hernandez",27,7,5,0,39
1083813,768123,2018-06-26,Assembly,"Do pass and be re-referred to the Committee on [Appropriations]",13,1,1,0,15
1083813,771583,2018-08-16,Assembly,"Do pass",14,1,2,0,17
1083815,722334,2018-03-13,Senate,"Do pass, but first be re-referred to the Committee on [Appropriations]",6,1,0,0,7
1083815,738791,2018-04-16,Senate,"Placed on suspense file",7,0,0,0,7
1083815,756210,2018-05-25,Senate,"Do pass",5,2,0,0,7
1083815,758516,2018-05-31,Senate,"Senate 3rd Reading SB1025 Skinner",28,10,1,0,39
1083815,764950,2018-06-19,Assembly,"Do pass as amended and be re-referred to the Committee on [Appropriations]",5,2,0,0,7
1083815,771556,2018-08-16,Assembly,"Do pass",12,5,0,0,17
1083817,725543,2018-03-20,Assembly,"Do pass and be re-referred to the Committee on [Appropriations] with recommendation: To Consent Calendar",7,0,0,0,7
1083817,756495,2018-05-25,Assembly,"Do pass",16,0,1,0,17
1083817,757124,2018-05-29,Assembly,"AB 2078 DALY Assembly Third Reading",76,2,0,0,78
1083817,765533,2018-06-19,Senate,"Do pass as amended, but first amend, and re-refer to the Committee on [Appropriations]",7,0,0,0,7
1083817,770971,2018-08-06,Senate,"Placed on suspense file",7,0,0,0,7
1083819,747021,2018-05-01,Assembly,"Do pass",10,0,0,0,10
1083819,749798,2018-05-07,Assembly,"AB 2073 CHIU Assembly Third Reading",74,0,4,0,78
1083819,762968,2018-06-12,Senate,"Do pass, but first be re-referred to the Committee on [Environmental Quality] with the recommendation: To Consent Calendar",7,0,0,0,7
1083819,766944,2018-06-20,Senate,"Do pass and be ordered to the Consent Calendar",7,0,0,0,7
1083824,733196,2018-04-03,Senate,"Do pass as amended, but first amend, and re-refer to the Committee on [Rules]",4,0,1,0,5
1083824,748072,2018-05-02,Senate,"Do pass",7,0,0,0,7
1083824,754938,2018-05-21,Senate,"Senate 3rd Reading SB1018 Allen",36,0,3,0,39
1083824,763082,2018-06-13,Assembly,"Do pass as amended and be re-referred to the Committee on [Local Government]",6,0,1,0,7
1083824,769082,2018-06-27,Assembly,"Do pass",8,0,1,0,9
1083824,771586,2018-08-16,Assembly,"SB 1018 Allen Senate Third Reading By BERMAN",67,3,10,0,80
1083824,772200,2018-08-20,Senate,"Unfinished Business SB1018 Allen Concurrence",36,0,4,0,40
1083826,741016,2018-04-18,Assembly,"Do pass and be re-referred to the Committee on [Judiciary]",8,1,0,0,9
1083826,750704,2018-05-08,Assembly,"Do pass as amended",10,0,0,0,10
1083826,754985,2018-05-21,Assembly,"AB 2071 BLOOM Assembly Third Reading",69,0,9,0,78
1083826,769704,2018-07-03,Senate,"Do pass as amended",5,0,2,0,7
1083828,724812,2018-03-19,Assembly,"Do pass and be re-referred to the Committee on [Appropriations] with recommendation: To Consent Calendar",13,0,1,0,14
1083828,733881,2018-04-04,Assembly,"Do pass. To Consent Calendar",15,0,2,0,17
1083828,738088,2018-04-12,Assembly,"AB 2062 MAIENSCHEIN Consent Calendar Second Day Regular Session",68,0,9,0,77
1083828,753304,2018-05-15,Senate,"Do pass, but first be re-referred to the Committee on [Appropriations] with the recommendation: To Consent Calendar",11,0,2,0,13
1083828,769607,2018-07-02,Senate,"Consent Calendar AB2062",37,0,2,0,39
1083828,770288,2018-08-06,Assembly,"AB 2062 MAIENSCHEIN Concurrence in Senate Amendments",77,0,3,0,80
1083830,739735,2018-04-17,Assembly,"Do pass and be re-referred to the Committee on [Appropriations]",13,0,0,0,13
1083830,747808,2018-05-02,Assembly,"Do pass. To Consent Calendar",17,0,0,0,17
1083830,752023,2018-05-10,Assembly,"AB 2070 REYES Consent Calendar Second Day Regular Session",73,0,5,0,78
1083830,760294,2018-06-06,Senate,"Do pass, but first be re-referred to the Committee on [Appropriations] with the recommendation: To Consent Calendar",6,0,0,0,6
1083830,769614,2018-07-02,Senate,"Consent Calendar AB2070",37,0,2,0,39
1083836,722781,2018-03-14,Assembly,"Do pass. To Consent Calendar",7,0,0,0,7
1083836,727733,2018-03-22,Assembly,"AB 2076 RODRIGUEZ Consent Calendar Second Day",69,0,8,0,77
1083836,768050,2018-06-25,Senate,"Do pass and be ordered to the Consent Calendar",5,0,0,0,5
1083836,769613,2018-07-02,Senate,"Consent Calendar AB2076",37,0,2,0,39
1083838,725651,2018-03-20,Assembly,"Do pass and be re-referred to the Committee on [Appropriations]",4,2,1,0,7
1083838,756646,2018-05-25,Assembly,"Do pass",12,4,1,0,17
1083838,757162,2018-05-29,Assembly,"AB 2094 KALRA Assembly Third Reading",44,27,7,0,78
1083838,767281,2018-06-20,Senate,"Do pass, but first be re-referred to the Committee on [Appropriations]",5,2,0,0,7
1083838,770268,2018-08-06,Senate,"Placed on suspense file",7,0,0,0,7
1083840,743120,2018-04-24,Assembly,"Do pass as amended and be re-referred to the Committee on [Appropriations]",7,0,0,0,7
1083845,744837,2018-04-25,Assembly,"Do pass and be re-referred to the Committee on [Appropriations]",5,2,0,0,7
1083845,756537,2018-05-25,Assembly,"Do pass",12,4,1,0,17
1083845,757082,2018-05-29,Assembly,"AB 2079 GONZALEZ FLETCHER Assembly Third Reading",53,23,2,0,78
1083845,764960,2018-06-19,Senate,"Do pass as amended, but first amend, and re-refer to the Committee on [Appropriations]",4,1,0,0,5
1083845,773399,2018-08-29,Senate,"Assembly 3rd Reading AB2079 Gonzalez Fletcher et al. By Lara",26,11,3,0,40
1083845,773792,2018-08-30,Assembly,"AB 2079 GONZALEZ FLETCHER Concurrence in Senate Amendments",52,26,2,0,80
1083847,737275,2018-04-11,Assembly,"Do pass and be re-referred to the Committee on [Appropriations] with recommendation: To Consent Calendar",7,0,0,0,7
1083847,744491,2018-04-25,Assembly,"Do pass. To Consent Calendar",17,0,0,0,17
1083847,748537,2018-05-03,Assembly,"AB 2095 QUIRK-SILVA Consent Calendar Second Day Regular Session",71,0,7,0,78
1083847,765170,2018-06-19,Senate,"Do pass, but first be re-referred to the Committee on [Appropriations] with the recommendation: To Consent Calendar",5,0,0,0,5
1083847,770505,2018-08-06,Senate,"Consent Calendar AB2095 Quirk-Silva",37,0,2,0,39
1083849,743777,2018-04-25,Assembly,"Do pass as amended and be re-referred to the Committee on [Appropriations]",14,0,1,0,15
1083852,743841,2018-04-25,Senate,"Do pass as amended, but first amend, and re-refer to the Committee on [Appropriations]",7,2,0,0,9
1083852,755293,2018-05-22,Senate,"Do pass as amended",5,2,0,0,7
1083852,757122,2018-05-29,Senate,"Senate 3rd Reading SB1021 Wiener et al",23,13,3,0,39
1083852,765171,2018-06-19,Assembly,"Do pass and be re-referred to the Committee on [Appropriations]",15,0,0,0,15
1083852,771588,2018-08-16,Assembly,"Do pass",16,0,1,0,17
1083852,772829,2018-08-27,Assembly,"SB 1021 Wiener Senate Third Reading By GABRIEL",78,0,2,0,80
1083852,773148,2018-08-28,Senate,"Unfinished Business SB1021 Wiener et al. Concurrence",33,3,4,0,40
1083854,740812,2018-04-18,Assembly,"Do pass and be re-referred to the Committee on [Banking and Finance]",9,0,0,0,9
1083854,742107,2018-04-23,Assembly,"Do pass and be re-referred to the Committee on [Appropriations]",11,0,0,0,11
1083854,753986,2018-05-16,Assembly,"Do pass. To Consent Calendar",17,0,0,0,17
1083854,756203,2018-05-25,Assembly,"AB 2063 AGUIAR-CURRY Consent Calendar Second Day Regular Session",70,0,8,0,78
1083854,766497,2018-06-20,Senate,"Do pass, but first be re-referred to the Committee on [Appropriations]",7,0,0,0,7
1083854,773315,2018-08-29,Senate,"Assembly 3rd Reading AB2063 Aguiar-Curry et al. By Roth",37,1,2,0,40
1083854,773853,2018-08-30,Assembly,"AB 2063 AGUIAR-CURRY Concurrence in Senate Amendments",79,0,1,0,80
1083856,725412,2018-03-20,Assembly,"Do pass and be re-referred to the Committee on [Appropriations]",15,0,0,0,15
1083856,734212,2018-04-04,Assembly,"Do pass. To Consent Calendar",15,0,2,0,17
1083856,738117,2018-04-12,Assembly,"AB 2088 SANTIAGO Consent Calendar Second Day Regular Session",68,0,9,0,77
1083856,763299,2018-06-13,Senate,"Do pass, but first be re-referred to the Committee on [Appropriations] with the recommendation: To Consent Calendar",8,0,1,0,9
1083856,772057,2018-08-16,Senate,"Assembly 3rd Reading AB2088 Santiago By Pan",37,0,3,0,40
1083858,736168,2018-04-10,Assembly,"Do pass",9,0,1,0,10
1083858,738293,2018-04-12,Assembly,"AB 2090 GONZALEZ FLETCHER Assembly Third Reading",52,0,25,0,77
1083858,763020,2018-06-12,Senate,"Do pass",5,1,1,0,7
1083858,771206,2018-08-09,Senate,"Assembly 3rd Reading AB2090 Gonzalez Fletcher By Glazer",29,4,6,0,39
1083860,733862,2018-04-04,Senate,"Do pass, but first be re-referred to the Committee on [Appropriations]",6,0,1,0,7
1083860,738845,2018-04-16,Senate,"Placed on suspense file",7,0,0,0,7
1083862,743566,2018-04-24,Senate,"Do pass as amended, but first amend, and re-refer to the Committee on [Appropriations]",4,1,2,0,7
1083862,752813,2018-05-14,Senate,"Placed on suspense file",7,0,0,0,7
1083862,756743,2018-05-25,Senate,"Do pass as amended",7,0,0,0,7
1083862,757498,2018-05-30,Senate,"Senate 3rd Reading SB1024 Wilk et al",37,0,2,0,39
1083862,764823,2018-06-19,Assembly,"Do pass as amended and be re-referred to the Committee on [Appropriations]",7,0,0,0,7
1083864,725495,2018-03-20,Assembly,"Do pass as amended and be re-referred to the Committee on [Appropriations]",15,0,0,0,15
1083864,756690,2018-05-25,Assembly,"Do pass as amended",12,0,5,0,17
1083864,757844,2018-05-30,Assembly,"AB 2064 GLORIA Assembly Third Reading",78,0,0,0,78
1083864,762121,2018-06-12,Senate,"Do pass as amended, but first amend, and re-refer to the Committee on [Environmental Quality]",9,0,0,0,9
1083864,767224,2018-06-20,Senate,"Do pass as amended, but first amend, and re-refer to the Committee on [Appropriations]",7,0,0,0,7
1083864,770441,2018-08-06,Senate,"Placed on suspense file",7,0,0,0,7
1083864,772063,2018-08-16,Senate,"Do pass",7,0,0,0,7
1083864,772709,2018-08-24,Senate,"Special Consent AB2064",39,0,1,0,40
1083864,773398,2018-08-29,Assembly,"AB 2064 GLORIA Concurrence in Senate Amendments",80,0,0,0,80
1083866,724612,2018-03-19,Assembly,"Do pass and be re-referred to the Committee on [Appropriations]",12,0,2,0,14
1083866,756489,2018-05-25,Assembly,"Do pass as amended",16,0,1,0,17
1083866,757688,2018-05-30,Assembly,"AB 2061 FRAZIER Assembly Third Reading",78,0,0,0,78
1083866,768316,2018-06-26,Senate,"Do pass as amended, but first amend, and re-refer to the Committee on [Appropriations]",12,0,1,0,13
1083866,770509,2018-08-06,Senate,"Placed on suspense file",7,0,0,0,7
1083866,771793,2018-08-16,Senate,"Do pass",7,0,0,0,7
1083866,772199,2018-08-20,Senate,"Assembly 3rd Reading AB2061 Frazier et al. By Hueso",37,1,2,0,40
1083866,772504,2018-08-23,Assembly,"AB 2061 FRAZIER Concurrence in Senate Amendments",76,0,4,0,80
1083866,774575,2018-08-06,Senate,,12,0,0,0,12
1083869,736884,2018-04-09,Assembly,"Do pass as amended and be re-referred to the Committee on [Appropriations]",9,0,1,0,10
1083869,756586,2018-05-25,Assembly,"Do pass as amended",12,0,5,0,17
1083869,758650,2018-05-31,Assembly,"AB 2091 GRAYSON Assembly Third Reading",76,1,1,0,78
1083869,768465,2018-06-26,Senate,"Do pass as amended, but first amend, and re-refer to the Committee on [Appropriations]",9,0,0,0,9
1083869,770773,2018-08-06,Senate,"Placed on suspense file",7,0,0,0,7
1083869,772088,2018-08-16,Senate,"Do pass as amended",7,0,0,0,7
1083869,773604,2018-08-29,Senate,"Assembly 3rd Reading AB2091 Grayson By Jackson",39,0,1,0,40
1083869,773724,2018-08-30,Assembly,"AB 2091 GRAYSON Concurrence in Senate Amendments",80,0,0,0,80
1083872,716490,2018-03-05,Senate,"Senate 3rd Reading SCR98 Nguyen",36,0,3,0,39
1083872,743968,2018-04-24,Assembly,"Be adopted. To Consent Calendar",10,0,0,0,10
1083872,746198,2018-04-30,Assembly,"SCR 98 Nguyen Consent Calendar Second Day Regular Session",76,0,2,0,78
1083874,744796,2018-04-25,Assembly,"Do pass and be re-referred to the Committee on [Appropriations]",5,1,1,0,7
1083876,743051,2018-04-24,Senate,"Do pass as amended, but first amend, and re-refer to the Committee on [Appropriations] with the recommendation: To Consent Calendar",6,0,1,0,7
1083876,752692,2018-05-14,Senate,"Placed on suspense file",7,0,0,0,7
1083876,756677,2018-05-25,Senate,"Do pass",7,0,0,0,7
1083876,758517,2018-05-31,Senate,"Special Consent SB1026",39,0,0,0,39
1083876,765186,2018-06-19,Assembly,"Do pass and be re-referred to the Committee on [Appropriations]",6,0,1,0,7
1083878,744032,2018-04-25,Assembly,"Do pass and be re-referred to the Committee on [Rules]",7,0,0,0,7
1083878,754902,2018-05-21,Assembly,"Do pass and be re-referred to the Committee on [Appropriations]",9,0,2,0,11
1083878,755709,2018-05-23,Assembly,"Do pass. To Consent Calendar",16,0,1,0,17
1083878,757020,2018-05-29,Assembly,"AB 2087 WALDRON Consent Calendar Second Day Regular Session",78,0,0,0,78
1083878,768383,2018-06-26,Senate,"Do pass as amended, but first amend, and re-refer to the Committee on [Appropriations]",13,0,0,0,13
1083878,770827,2018-08-06,Senate,"Placed on suspense file",7,0,0,0,7
1083878,777240,2018-05-21,Assembly,,7,0,2,0,9
1083880,727679,2018-03-21,Assembly,"Do pass as amended and be re-referred to the Committee on [Appropriations]",5,0,2,0,7
1083884,740020,2018-04-17,Assembly,"Do pass and be re-referred to the Committee on [Appropriations]",10,5,1,0,16
1083884,748287,2018-05-02,Assembly,"Do pass",13,4,0,0,17
1083884,751892,2018-05-10,Assembly,"AB 2084 KALRA Assembly Third Reading",46,23,9,0,78
1083884,765669,2018-06-18,Senate,"Do pass, but first be re-referred to the Committee on [Appropriations]",7,2,0,0,9
1083884,773274,2018-08-29,Senate,"That the measure be returned to Senate Floor for consideration. Ordered to third reading",7,2,0,0,9
1083884,773818,2018-08-30,Senate,"Assembly 3rd Reading AB2084 Kalra By Hill",27,11,2,0,40
1083884,774037,2018-08-31,Assembly,"AB 2084 KALRA Concurrence in Senate Amendments",53,27,0,0,80
1083886,739858,2018-04-16,Assembly,"Do pass as amended and be re-referred to the Committee on [Appropriations]",8,0,2,0,10
1083886,747898,2018-05-02,Assembly,"Do pass. To Consent Calendar",17,0,0,0,17
1083886,752181,2018-05-10,Assembly,"AB 2096 FRAZIER Consent Calendar Second Day Regular Session",73,0,5,0,78
1083886,763292,2018-06-13,Senate,"Do pass as amended, but first amend, and re-refer to the Committee on [Appropriations]",7,0,0,0,7
1083886,769664,2018-07-02,Senate,"Do pass",7,0,0,0,7
1083886,771431,2018-08-13,Senate,"Special Consent AB2096",37,0,3,0,40
1083886,772280,2018-08-20,Assembly,"AB 2096 FRAZIER Concurrence in Senate Amendments",80,0,0,0,80
1083888,741323,2018-04-18,Assembly,"Do pass as amended and be re-referred to the Committee on [Appropriations]",14,0,1,0,15
1083888,751733,2018-05-09,Assembly,"Do pass. To Consent Calendar",16,0,1,0,17
1083888,754383,2018-05-17,Assembly,"AB 2068 CHU Consent Calendar Second Day Regular Session",73,0,5,0,78
1083888,765109,2018-06-19,Senate,"Do pass, but first be re-referred to the Committee on [Appropriations]",11,0,0,0,11
1083888,771191,2018-08-09,Senate,"Assembly 3rd Reading AB2068 Chu By Hueso",36,0,3,0,39
1083890,722776,2018-03-14,Senate,"Do pass, but first be re-referred to the Committee on [Education]",9,0,0,0,9
1083890,740556,2018-04-18,Senate,"Do pass as amended, but first amend, and re-refer to the Committee on [Appropriations]",6,0,0,0,6
1083890,750033,2018-05-07,Senate,"Placed on suspense file",6,0,1,0,7
1083890,756287,2018-05-25,Senate,"Do pass as amended",7,0,0,0,7
1083890,757625,2018-05-30,Senate,"Senate 3rd Reading SB1019 Beall et al",37,0,2,0,39
1083890,765056,2018-06-19,Assembly,"Do pass and be re-referred to the Committee on [Education]",15,0,0,0,15
1083890,768909,2018-06-27,Assembly,"Do pass as amended and be re-referred to the Committee on [Appropriations]",7,0,0,0,7
1083890,771533,2018-08-16,Assembly,"Do pass",17,0,0,0,17
1083890,772878,2018-08-27,Assembly,"SB 1019 Beall Senate Third Reading By RUBIO",80,0,0,0,80
1083890,773144,2018-08-28,Senate,"Unfinished Business SB1019 Beall et al. Concurrence",39,0,1,0,40
1084676,736029,2018-04-10,Senate,"Do pass, but first be re-referred to the Committee on [Natural Resources and Water]",12,0,1,0,13
1084676,743186,2018-04-24,Senate,"Do pass as amended, but first amend, and re-refer to the Committee on [Appropriations]",9,0,0,0,9
1084676,752922,2018-05-14,Senate,"Placed on suspense file",7,0,0,0,7
1084676,756312,2018-05-25,Senate,"Do pass as amended",7,0,0,0,7
1084676,757543,2018-05-30,Senate,"Senate 3rd Reading SB1029 McGuire",36,0,3,0,39
1084676,767924,2018-06-25,Assembly,"Do pass and be re-referred to the Committee on [Appropriations]",10,0,4,0,14
1084676,771869,2018-08-16,Assembly,"Do pass as amended",12,0,5,0,17
1084676,772721,2018-08-24,Assembly,"SB 1029 McGuire Senate Third Reading By WOOD Amendment Set #1",51,21,8,0,80
1084676,773905,2018-08-30,Assembly,"SB 1029 McGuire Senate Third Reading By WOOD",67,6,7,0,80
1084676,774010,2018-08-31,Senate,"Unfinished Business SB1029 McGuire Concurrence",36,1,3,0,40
1084678,727702,2018-03-21,Assembly,"Do pass as amended and be re-referred to the Committee on [Appropriations]",6,0,1,0,7
1084678,740779,2018-04-18,Assembly,"Do pass",12,0,5,0,17
1084678,746185,2018-04-30,Assembly,"AB 2121 CABALLERO Assembly Third Reading",73,1,4,0,78
1084678,760461,2018-06-06,Senate,"Do pass, but first be re-referred to the Committee on [Appropriations] with the recommendation: To Consent Calendar",6,0,0,0,6
1084678,767942,2018-06-25,Senate,"Placed on suspense file",7,0,0,0,7
1084678,771844,2018-08-16,Senate,"Do pass as amended",7,0,0,0,7
1084678,772349,2018-08-21,Senate,"Assembly 3rd Reading AB2121 Caballero By Hueso",39,0,1,0,40
1084678,772880,2018-08-27,Assembly,"AB 2121 CABALLERO Concurrence in Senate Amendments",76,1,3,0,80
1084680,742859,2018-04-23,Senate,"Do pass, but first be re-referred to the Committee on [Appropriations]",1,3,1,0,5
1084680,742860,2018-04-23,Senate,"[First] hearing set for [04-23-2018]: Failed passage in Committee. Reconsideration granted",4,0,1,0,5
1084682,740536,2018-04-17,Assembly,"Do pass as amended, and be re-referred to the Committee on [Appropriations] with recommendation: To Consent Calendar",15,0,0,0,15
1084682,756747,2018-05-25,Assembly,"Do pass as amended",12,0,5,0,17
1084682,758763,2018-05-31,Assembly,"AB 2122 REYES Assembly Third Reading",78,0,0,0,78
1084682,769036,2018-06-27,Senate,"Do pass as amended, but first amend, and re-refer to the Committee on [Appropriations] with the recommendation: To Consent Calendar",9,0,0,0,9
1084682,770801,2018-08-06,Senate,"Placed on suspense file",7,0,0,0,7
1084682,772065,2018-08-16,Senate,"Do pass as amended",7,0,0,0,7
1084682,772526,2018-08-23,Senate,"Assembly 3rd Reading AB2122 Reyes et al. By Leyva",39,0,1,0,40
1084682,773877,2018-08-30,Assembly,"AB 2122 REYES Concurrence in Senate Amendments",80,0,0,0,80
1084684,738856,2018-04-16,Senate,"Do pass, but first be re-referred to the Committee on [Appropriations] with the recommendation: To Consent Calendar",7,0,2,0,9
1084684,748719,2018-05-03,Senate,"Consent Calendar SB1042",38,0,1,0,39
1084684,762218,2018-06-12,Assembly,"Do pass and be re-referred to the Committee on [Appropriations]",18,0,1,0,19
1084684,768805,2018-06-27,Assembly,"Do pass. To Consent Calendar",16,0,1,0,17
1084684,769794,2018-07-05,Assembly,"SB 1042 Monning Consent Calendar Second Day Regular Session",69,0,11,0,80
1084689,739923,2018-04-17,Senate,"Do pass, but first be re-referred to the Committee on [Appropriations]",10,0,1,0,11
1084689,755370,2018-05-22,Senate,"Do pass",7,0,0,0,7
1084689,757025,2018-05-29,Senate,"Senate 3rd Reading SB1028 Hill",38,0,1,0,39
1084689,766765,2018-06-20,Assembly,"Do pass and be re-referred to the Committee on [Appropriations]",15,0,0,0,15
1084689,771131,2018-08-08,Assembly,"Do pass. To Consent Calendar",17,0,0,0,17
1084689,771920,2018-08-16,Assembly,"SB 1028 Hill Consent Calendar Second Day Regular Session",76,0,4,0,80
1084691,733148,2018-04-03,Senate,"Do pass, but first be re-referred to the Committee on [Appropriations]",12,0,1,0,13
1084691,738847,2018-04-16,Senate,"Do pass",7,0,0,0,7
1084691,745939,2018-04-30,Senate,"Senate 3rd Reading SB1030 Newman",36,0,3,0,39
1084693,742209,2018-04-23,Assembly,"Do pass as amended and be re-referred to the Committee on [Appropriations]",12,0,2,0,14
1084693,753876,2018-05-16,Assembly,"Do pass",15,0,2,0,17
1084693,757041,2018-05-29,Assembly,"AB 2107 REYES Assembly Third Reading",75,0,3,0,78
1084693,765108,2018-06-19,Senate,"Do pass as amended, but first amend, and re-refer to the Committee on [Judiciary]",12,0,1,0,13
1084693,768948,2018-06-26,Senate,"Do pass as amended, but first amend, and re-refer to the Committee on [Appropriations]",7,0,0,0,7
1084693,773298,2018-08-29,Senate,"Assembly 3rd Reading AB2107 Reyes By Stern",39,0,1,0,40
1084693,773918,2018-08-30,Assembly,"AB 2107 REYES Concurrence in Senate Amendments",77,0,3,0,80
1084695,743332,2018-04-24,Assembly,"Do pass as amended, and be re-referred to the Committee on [Appropriations] with recommendation: To Consent Calendar",15,0,0,0,15
1084695,756547,2018-05-25,Assembly,"Do pass",16,0,1,0,17
1084695,757144,2018-05-29,Assembly,"AB 2118 COOLEY Third Reading Urgency",78,0,0,0,78
1084695,763059,2018-06-13,Senate,"Do pass as amended, but first amend, and re-refer to the Committee on [Appropriations]",7,0,2,0,9
1084695,770264,2018-08-06,Senate,"Placed on suspense file",7,0,0,0,7
1084697,744923,2018-04-25,Assembly,"Do pass and be re-referred to the Committee on [Appropriations]",7,0,0,0,7
1084697,756665,2018-05-25,Assembly,"Do pass",16,0,1,0,17
1084697,756974,2018-05-29,Assembly,"AB 2098 MCCARTY Assembly Third Reading",77,0,1,0,78
1084697,768945,2018-06-27,Senate,"Do pass, but first be re-referred to the Committee on [Appropriations] with the recommendation: To Consent Calendar",7,0,0,0,7
1084697,769712,2018-06-27,Senate,"Do pass as amended, but first amend, and re-refer to the Committee on [Appropriations] with the recommendation: To Consent Calendar",7,0,0,0,7
1084697,770416,2018-08-06,Senate,"Placed on suspense file",7,0,0,0,7
1084697,772035,2018-08-16,Senate,"Do pass as amended",7,0,0,0,7
1084697,772897,2018-08-27,Senate,"Assembly 3rd Reading AB2098 McCarty et al. By Stern",39,0,1,0,40
1084697,773299,2018-08-29,Assembly,"With recommendation: That Senate amendments be concurred in, but first be re-referred to Com. on [Higher Education]",7,0,0,0,7
1084697,773697,2018-08-30,Assembly,"With recommendation: That Senate amendments be concurred in",11,0,2,0,13
1084697,774014,2018-08-31,Assembly,"AB 2098 MCCARTY Concurrence in Senate Amendments",80,0,0,0,80
1084699,743803,2018-04-25,Senate,"Do pass, but first be re-referred to the Committee on [Appropriations]",7,0,2,0,9
1084699,757140,2018-05-29,Senate,"Senate 3rd Reading SB1034 Mitchell et al",37,0,2,0,39
1084699,765599,2018-06-19,Assembly,"Do pass as amended and be re-referred to the Committee on [Appropriations]",15,0,0,0,15
1084699,771497,2018-08-15,Assembly,"Do pass. To Consent Calendar",17,0,0,0,17
1084699,772492,2018-08-23,Assembly,"SB 1034 Mitchell Consent Calendar Second Day Regular Session",75,0,5,0,80
1084699,772653,2018-08-24,Senate,"Unfinished Business SB1034 Mitchell et al. Concurrence",39,0,1,0,40
1084701,743927,2018-04-24,Assembly,"Do pass and be re-referred to the Committee on [Appropriations]",7,0,0,0,7
1084701,756703,2018-05-25,Assembly,"Do pass",14,1,2,0,17
1084701,757205,2018-05-29,Assembly,"AB 2111 QUIRK Assembly Third Reading",71,2,5,0,78
1084701,763084,2018-06-12,Senate,"Do pass as amended, but first amend, and re-refer to the Committee on [Appropriations]",6,0,1,0,7
1084701,769659,2018-07-02,Senate,"Placed on suspense file",7,0,0,0,7
1084701,772078,2018-08-16,Senate,"Do pass",7,0,0,0,7
1084701,773254,2018-08-28,Senate,"Assembly 3rd Reading AB2111 Quirk By Wieckowski",36,1,3,0,40
1084701,773345,2018-08-29,Assembly,"AB 2111 QUIRK Concurrence in Senate Amendments",74,1,5,0,80
1084703,733145,2018-04-03,Senate,"Do pass, but first be re-referred to the Committee on [Appropriations]",4,0,1,0,5
1084703,755102,2018-05-21,Senate,"Senate 3rd Reading SB1039 Pan",39,0,0,0,39
1084703,769017,2018-06-27,Assembly,"Do pass and be re-referred to the Committee on [Appropriations] with recommendation: To Consent Calendar",9,0,1,0,10
1084703,771114,2018-08-08,Assembly,"Do pass. To Consent Calendar",17,0,0,0,17
1084703,771605,2018-08-16,Assembly,"SB 1039 Pan Consent Calendar Second Day Regular Session",76,0,4,0,80
1084707,742970,2018-04-24,Senate,"Do pass, but first be re-referred to the Committee on [Appropriations]",7,0,0,0,7
1084707,750247,2018-05-07,Senate,"Placed on suspense file",6,0,1,0,7
1084707,756269,2018-05-25,Senate,"Do pass",7,0,0,0,7
1084707,758387,2018-05-31,Senate,"Special Consent SB1043 Newman Urgency Clause",39,0,0,0,39
1084709,742221,2018-04-23,Assembly,"Do pass and be re-referred to the Committee on [Appropriations] with recommendation: To Consent Calendar",14,0,0,0,14
1084709,751314,2018-05-09,Assembly,"Do pass. To Consent Calendar",16,0,1,0,17
1084709,754203,2018-05-17,Assembly,"AB 2115 SANTIAGO Consent Calendar Second Day Regular Session",73,0,5,0,78
1084709,762144,2018-06-12,Senate,"Do pass, but first be re-referred to the Committee on [Appropriations] with the recommendation: To Consent Calendar",12,0,1,0,13
1084709,769579,2018-07-02,Senate,"Do pass",7,0,0,0,7
1084709,772238,2018-08-20,Senate,"Assembly 3rd Reading AB2115 Santiago By Beall",38,0,2,0,40
1084709,772239,2018-08-20,Senate,"Assembly 3rd Reading AB2115 Santiago By Beall Reconsider",38,0,2,0,40
1084709,772240,2018-08-20,Senate,"Assembly 3rd Reading AB2115 Santiago By Beall",39,0,1,0,40
1084709,772537,2018-08-23,Assembly,"AB 2115 SANTIAGO Concurrence in Senate Amendments",79,0,1,0,80
1084711,743046,2018-04-23,Senate,"Do pass, but first be re-referred to the Committee on [Appropriations]",1,3,1,0,5
1084711,743047,2018-04-23,Senate,"[First] hearing set for [04-23-2018]: Failed passage in Committee. Reconsideration granted",4,0,1,0,5
1084713,727472,2018-03-21,Assembly,"Do pass and be re-referred to the Committee on [Agriculture]",6,0,1,0,7
1084713,743738,2018-04-25,Assembly,"Do pass and be re-referred to the Committee on [Appropriations]",8,0,2,0,10
1084713,756200,2018-05-25,Assembly,"Do pass as amended",13,2,2,0,17
1084713,758628,2018-05-31,Assembly,"AB 2106 GARCIA, E. Assembly Third Reading",68,5,5,0,78
1084713,764961,2018-06-19,Senate,"Do pass, but first be re-referred to the Committee on [Governmental Organization]",4,0,1,0,5
1084713,768112,2018-06-26,Senate,"Do pass, but first be re-referred to the Committee on [Appropriations]",13,0,0,0,13
1084713,770780,2018-08-06,Senate,"Placed on suspense file",7,0,0,0,7
1084715,738450,2018-04-11,Assembly,"Do pass as amended and be re-referred to the Committee on [Judiciary]",7,0,0,0,7
1084715,742941,2018-04-24,Assembly,"Do pass as amended and be re-referred to the Committee on [Appropriations]",10,0,0,0,10
1084715,754919,2018-05-21,Assembly,"AB 2128 KILEY Assembly Third Reading",74,0,4,0,78
1084715,763215,2018-06-13,Senate,"Do pass, but first be re-referred to the Committee on [Judiciary] with the recommendation: To Consent Calendar",7,0,0,0,7
1084715,769695,2018-07-03,Senate,"Do pass as amended, and be ordered to the Consent Calendar",7,0,0,0,7
1084715,771352,2018-08-13,Senate,"Consent Calendar AB2128",37,0,3,0,40
1084715,772141,2018-08-20,Assembly,"AB 2128 KILEY Concurrence in Senate Amendments",80,0,0,0,80
1084719,736177,2018-04-10,Senate,"Do pass, but first be re-referred to the Committee on [Appropriations]",6,0,1,0,7
1084719,748536,2018-05-03,Senate,"Senate 3rd Reading SB1040 Dodd",38,0,1,0,39
1084719,762168,2018-06-12,Assembly,"Do pass as amended, and be re-referred to the Committee on [Housing and Community Development] with recommendation: To Consent Calendar",7,0,0,0,7
1084719,762977,2018-06-12,Assembly,"Do pass and be re-referred to the Committee on [Housing and Community Development] with recommendation: To Consent Calendar",7,0,0,0,7
1084719,768796,2018-06-27,Assembly,"Do pass and be re-referred to the Committee on [Appropriations]",7,0,0,0,7
1084719,771084,2018-08-08,Assembly,"Do pass. To Consent Calendar",17,0,0,0,17
1084719,771606,2018-08-16,Assembly,"SB 1040 Dodd Consent Calendar Second Day Regular Session",76,0,4,0,80
1084719,772206,2018-08-20,Senate,"Unfinished Business SB1040 Dodd Concurrence",39,0,1,0,40
1084721,742920,2018-04-23,Assembly,"Do pass as amended, and be re-referred to the Committee on [Appropriations] with recommendation: To Consent Calendar",10,0,0,0,10
1084721,744863,2018-04-23,Assembly,"Do pass and be re-referred to the Committee on [Appropriations] with recommendation: To Consent Calendar",10,0,0,0,10
1084723,736797,2018-04-09,Assembly,"Do pass and be re-referred to the Committee on [Appropriations] with recommendation: To Consent Calendar",7,0,3,0,10
1084723,740865,2018-04-18,Assembly,"Do pass",14,0,3,0,17
1084723,742329,2018-04-23,Assembly,"AB 2097 ACOSTA Assembly Third Reading",72,2,4,0,78
1084723,760518,2018-06-06,Senate,"Do pass, but first be re-referred to the Committee on [Appropriations]",5,0,2,0,7
1084723,772892,2018-08-27,Senate,"Assembly 3rd Reading AB2097 Acosta By Stone",39,0,1,0,40
1084725,738140,2018-04-11,Assembly,"Do pass and be re-referred to the Committee on [Appropriations]",7,0,0,0,7
1084725,744398,2018-04-25,Assembly,"Do pass. To Consent Calendar",17,0,0,0,17
1084725,748964,2018-05-03,Assembly,"AB 2109 O'DONNELL Consent Calendar Second Day Regular Session",71,0,7,0,78
1084725,760585,2018-06-06,Senate,"Do pass, but first be re-referred to the Committee on [Appropriations] with the recommendation: To Consent Calendar",6,0,0,0,6
1084725,769581,2018-07-02,Senate,"Consent Calendar AB2109",37,0,2,0,39
1084725,770954,2018-08-06,Assembly,"AB 2109 O'DONNELL Concurrence in Senate Amendments",77,0,3,0,80
1084727,737260,2018-04-10,Assembly,"Do pass and be re-referred to the Committee on [Appropriations]",5,1,1,0,7
1084727,751231,2018-05-09,Assembly,"Do pass",11,5,1,0,17
1084727,754927,2018-05-21,Assembly,"AB 2119 GLORIA Assembly Third Reading",46,22,10,0,78
1084727,762700,2018-06-12,Senate,"Do pass, but first be re-referred to the Committee on [Judiciary]",5,0,2,0,7
1084727,768749,2018-06-26,Senate,"Do pass, but first be re-referred to the Committee on [Appropriations]",5,2,0,0,7
1084727,772911,2018-08-27,Senate,"Assembly 3rd Reading AB2119 Gloria et al. By Wiener",26,12,2,0,40
1084727,773555,2018-08-29,Assembly,"AB 2119 GLORIA Concurrence in Senate Amendments",53,22,5,0,80
1084727,777806,2018-08-27,Senate,,5,12,2,0,19
1084729,737395,2018-04-11,Senate,"Do pass and be ordered to the Consent Calendar",6,0,0,0,6
1084729,742586,2018-04-23,Senate,"Consent Calendar SB1048",38,0,1,0,39
1084733,725610,2018-03-20,Assembly,"Do pass and be re-referred to the Committee on [Appropriations]",6,1,0,0,7
1084733,733820,2018-04-04,Assembly,"Do pass",11,3,3,0,17
1084733,746179,2018-04-30,Assembly,"AB 2103 GLORIA Assembly Third Reading",57,20,1,0,78
1084733,762139,2018-06-12,Senate,"Do pass, but first be re-referred to the Committee on [Appropriations]",5,2,0,0,7
1084733,769591,2018-07-02,Senate,"Placed on suspense file",7,0,0,0,7
1084733,771622,2018-08-16,Senate,"Do pass as amended",5,2,0,0,7
1084733,772365,2018-08-21,Senate,"Assembly 3rd Reading AB2103 Gloria et al. By Portantino",28,9,3,0,40
1084733,772792,2018-08-27,Assembly,"AB 2103 GLORIA Concurrence in Senate Amendments",61,16,3,0,80
1084736,726748,2018-03-21,Senate,"Do pass as amended, but first amend, and re-refer to the Committee on [Appropriations]",5,0,1,0,6
1084736,742201,2018-04-23,Senate,"Senate 3rd Reading SB1036 Wilk",38,0,1,0,39
1084736,762996,2018-06-13,Assembly,"Do pass as amended and be re-referred to the Committee on [Appropriations]",5,0,2,0,7
1084736,771061,2018-08-08,Assembly,"Do pass. To Consent Calendar",17,0,0,0,17
1084736,773990,2018-08-31,Senate,"Unfinished Business SB1036 Wilk Concurrence",39,0,1,0,40
1084736,773991,2018-08-31,Assembly,"SB 1036 Wilk Senate Third Reading By HOLDEN",80,0,0,0,80
1084738,744726,2018-04-25,Senate,"Do pass, but first be re-referred to the Committee on [Appropriations] with the recommendation: To Consent Calendar",11,0,2,0,13
1084738,745265,2018-04-25,Senate,"Do pass and be ordered to the Consent Calendar",11,0,2,0,13
1084738,748858,2018-05-03,Senate,"Consent Calendar SB1046",38,0,1,0,39
1084738,766255,2018-06-20,Assembly,"Do pass and be re-referred to the Committee on [Appropriations] with recommendation: To Consent Calendar",12,0,1,0,13
1084738,771506,2018-08-15,Assembly,"Do pass. To Consent Calendar",17,0,0,0,17
1084738,772512,2018-08-23,Assembly,"SB 1046 Roth Consent Calendar Second Day Regular Session",75,0,5,0,80
1084738,772681,2018-08-24,Senate,"Unfinished Business SB1046 Roth Concurrence",39,0,1,0,40
1084742,738072,2018-04-11,Assembly,"Do pass and be re-referred to the Committee on [Transportation]",13,0,0,0,13
1084742,742177,2018-04-23,Assembly,"Do pass and be re-referred to the Committee on [Appropriations] with recommendation: To Consent Calendar",14,0,0,0,14
1084742,756679,2018-05-25,Assembly,"Do pass",16,0,1,0,17
1084742,757171,2018-05-29,Assembly,"AB 2127 TING Assembly Third Reading",76,1,1,0,78
1084742,765800,2018-06-19,Senate,"Do pass, but first be re-referred to the Committee on [Environmental Quality]",11,0,0,0,11
1084742,767209,2018-06-20,Senate,"Do pass, but first be re-referred to the Committee on [Appropriations] with the recommendation: To Consent Calendar",7,0,0,0,7
1084742,770280,2018-08-06,Senate,"Placed on suspense file",7,0,0,0,7
1084742,772025,2018-08-16,Senate,"Do pass",7,0,0,0,7
1084742,773041,2018-08-27,Senate,"Assembly 3rd Reading AB2127 Ting By Stern",39,0,1,0,40
1084744,725744,2018-03-20,Assembly,"Do pass as amended",15,0,0,0,15
1084744,757214,2018-05-29,Assembly,"AB 2099 GLORIA Assembly Third Reading",78,0,0,0,78
1084744,763032,2018-06-13,Senate,"Do pass and be ordered to the Consent Calendar",8,0,1,0,9
1084744,771904,2018-08-16,Senate,"Assembly 3rd Reading AB2099 Gloria et al. By Beall",38,0,2,0,40
1084748,744005,2018-04-25,Assembly,"Do pass and be re-referred to the Committee on [Appropriations]",7,0,0,0,7
1084748,753839,2018-05-16,Assembly,"Do pass. To Consent Calendar",17,0,0,0,17
1084748,755995,2018-05-24,Assembly,"Do pass as amended",6,0,1,0,7
1084748,759158,2018-06-04,Assembly,"AB 2125 QUIRK Assembly Third Reading",70,0,8,0,78
1084748,765375,2018-06-19,Senate,"Do pass as amended, but first amend, and re-refer to the Committee on [Appropriations]",5,0,0,0,5
1084748,770351,2018-08-06,Senate,"Placed on suspense file",7,0,0,0,7
1084748,772075,2018-08-16,Senate,"Do pass as amended",7,0,0,0,7
1084748,773223,2018-08-28,Senate,"Assembly 3rd Reading AB2125 Quirk By Stern",38,0,2,0,40
1084748,773370,2018-08-29,Assembly,"AB 2125 QUIRK Concurrence in Senate Amendments",78,0,2,0,80
1084750,771212,2018-08-09,Senate,"Senate 3rd Reading SCR99 Roth et al",36,0,3,0,39
1084750,772274,2018-08-20,Assembly,"Be adopted. To Consent Calendar",9,0,2,0,11
1084750,772617,2018-08-23,Assembly,"SCR 99 Roth Consent Calendar Second Day Regular Session",75,0,5,0,80
1084756,734429,2018-04-05,Assembly,"Be re-referred to the Committee on [Health]",8,0,3,0,11
1084756,743481,2018-04-24,Assembly,"Do pass and be re-referred to the Committee on [Appropriations]",15,0,0,0,15
1084756,751744,2018-05-09,Assembly,"Do pass. To Consent Calendar",16,0,1,0,17
1084756,754320,2018-05-17,Assembly,"AB 2102 RODRIGUEZ Consent Calendar Second Day Regular Session",73,0,5,0,78
1084756,768694,2018-06-27,Senate,"Do pass, but first be re-referred to the Committee on [Appropriations] with the recommendation: To Consent Calendar",9,0,0,0,9
1084756,770972,2018-08-06,Senate,"Placed on suspense file",7,0,0,0,7
1084756,772056,2018-08-16,Senate,"Do pass",7,0,0,0,7
1084758,743113,2018-04-24,Assembly,"Do pass and be re-referred to the Committee on [Appropriations]",7,0,0,0,7
1084758,756768,2018-05-25,Assembly,"Do pass",16,0,1,0,17
1084758,757083,2018-05-29,Assembly,"AB 2124 RUBIO Assembly Third Reading",78,0,0,0,78
1084758,764905,2018-06-19,Senate,"Do pass, but first be re-referred to the Committee on [Governmental Organization]",7,0,0,0,7
1084758,768117,2018-06-26,Senate,"Do pass, but first be re-referred to the Committee on [Appropriations]",13,0,0,0,13
1084758,770417,2018-08-06,Senate,"Placed on suspense file",7,0,0,0,7
1084758,775035,2018-05-25,Assembly,,7,0,1,0,8
1084760,737485,2018-04-11,Senate,"Do pass as amended, but first amend, and re-refer to the Committee on [Environmental Quality]",5,0,2,0,7
1084760,740897,2018-04-18,Senate,"Do pass, but first be re-referred to the Committee on [Appropriations]",6,1,0,0,7
1084760,748720,2018-05-03,Senate,"Senate 3rd Reading SB1035 Jackson",30,6,3,0,39
1084760,762918,2018-06-13,Assembly,"Do pass and be re-referred to the Committee on [Appropriations]",6,2,1,0,9
1084760,768927,2018-06-27,Assembly,"Do pass",12,4,1,0,17
1084760,772831,2018-08-27,Assembly,"SB 1035 Jackson Senate Third Reading By AGUIAR-CURRY",56,23,1,0,80
1084760,773142,2018-08-28,Senate,"Unfinished Business SB1035 Jackson Concurrence",31,7,2,0,40
1084762,740750,2018-04-17,Senate,"Do pass, but first be re-referred to the Committee on [Public Safety]",6,1,0,0,7
1084762,743074,2018-04-24,Senate,"Do pass as amended, but first amend, and re-refer to the Committee on [Appropriations]",7,0,0,0,7
1084762,752748,2018-05-14,Senate,"Placed on suspense file",7,0,0,0,7
1084762,756247,2018-05-25,Senate,"Do pass as amended",5,2,0,0,7
1084762,757715,2018-05-30,Senate,"Senate 3rd Reading SB1045 Wiener et al",35,0,4,0,39
1084762,768164,2018-06-26,Assembly,"Do pass and be re-referred to the Committee on [Judiciary]",15,0,0,0,15
1084762,769271,2018-06-28,Assembly,"Do pass as amended and be re-referred to the Committee on [Appropriations]",10,0,0,0,10
1084762,771601,2018-08-16,Assembly,"Do pass as amended",12,0,5,0,17
1084762,773506,2018-08-29,Assembly,"SB 1045 Wiener Senate Third Reading By CHIU",78,0,2,0,80
1084762,773854,2018-08-30,Senate,"Unfinished Business SB1045 Wiener et al. Concurrence",39,0,1,0,40
1084764,737477,2018-04-11,Assembly,"Do pass as amended and be re-referred to the Committee on [Judiciary]",6,1,0,0,7
1084764,750735,2018-05-08,Assembly,"Do pass",9,1,0,0,10
1084764,752122,2018-05-10,Assembly,"AB 2123 CERVANTES Assembly Third Reading",60,3,15,0,78
1084764,765231,2018-06-19,Senate,"Do pass, but first be re-referred to the Committee on [Judiciary]",5,0,0,0,5
1084764,769677,2018-07-03,Senate,"Do pass",6,1,0,0,7
1084764,772221,2018-08-20,Senate,"Assembly 3rd Reading AB2123 Cervantes By Cannella",38,0,2,0,40
1084766,714329,2018-03-01,Assembly,"Be adopted. To third reading",6,0,5,0,11
1084768,725680,2018-03-20,Assembly,"Do pass as amended. To Consent Calendar",10,0,0,0,10
1084768,734346,2018-04-05,Assembly,"AB 2105 MAIENSCHEIN Consent Calendar Second Day",70,0,7,0,77
1084768,766008,2018-06-19,Senate,"Do pass as amended, and be ordered to the Consent Calendar",7,0,0,0,7
1084768,769626,2018-07-02,Senate,"Consent Calendar AB2105",37,0,2,0,39
1084768,770969,2018-08-06,Assembly,"AB 2105 MAIENSCHEIN Concurrence in Senate Amendments",76,0,4,0,80
1084770,733800,2018-04-04,Senate,"Do pass as amended, but first amend, and re-refer to the Committee on [Appropriations]",9,0,0,0,9
1084770,742194,2018-04-23,Senate,"Placed on suspense file",7,0,0,0,7
1084770,756318,2018-05-25,Senate,"Do pass",7,0,0,0,7
1084770,758574,2018-05-31,Senate,"Special Consent SB1041",39,0,0,0,39
1084770,768181,2018-06-26,Assembly,"Do pass and be re-referred to the Committee on [Appropriations] with recommendation: To Consent Calendar",15,0,0,0,15
1084770,771847,2018-08-16,Assembly,"Do pass as amended",12,0,5,0,17
1084770,773586,2018-08-29,Assembly,"SB 1041 Leyva Senate Third Reading By REYES",80,0,0,0,80
1084770,773705,2018-08-30,Senate,"Unfinished Business SB1041 Leyva et al. Concurrence",39,0,1,0,40
1084772,740709,2018-04-17,Assembly,"Do pass and be re-referred to the Committee on [Appropriations]",6,0,1,0,7
1084774,734305,2018-04-05,Assembly,"Be re-referred to the Committees on [Privacy and Consumer Protection] and [Business and Professions]",8,0,3,0,11
1084776,736834,2018-04-09,Assembly,"Do pass and be re-referred to the Committee on [Appropriations]",10,0,0,0,10
1084776,756642,2018-05-25,Assembly,"Do pass",16,0,1,0,17
1084776,757169,2018-05-29,Assembly,"AB 2126 EGGMAN Assembly Third Reading",78,0,0,0,78
1084776,768397,2018-06-26,Senate,"Do pass, but first be re-referred to the Committee on [Appropriations]",9,0,0,0,9
1084776,770410,2018-08-06,Senate,"Placed on suspense file",7,0,0,0,7
1084776,771976,2018-08-16,Senate,"Do pass",7,0,0,0,7
1084776,773434,2018-08-29,Senate,"Assembly 3rd Reading AB2126 Eggman et al. By McGuire",38,0,2,0,40
1084776,773927,2018-08-30,Assembly,"AB 2126 EGGMAN Concurrence in Senate Amendments",80,0,0,0,80
1084778,725883,2018-03-20,Assembly,"Do pass and be re-referred to the Committee on [Appropriations]",12,0,4,0,16
1084778,734246,2018-04-04,Assembly,"Do pass. To Consent Calendar",15,0,2,0,17
1084778,738287,2018-04-12,Assembly,"AB 2117 ARAMBULA Consent Calendar Second Day Regular Session",68,0,9,0,77
1084778,750065,2018-05-07,Senate,"Do pass, but first be re-referred to the Committee on [Appropriations] with the recommendation: To Consent Calendar",8,0,1,0,9
1084778,771270,2018-08-13,Senate,"Assembly 3rd Reading AB2117 Arambula By Galgiani",36,0,4,0,40
1084778,772182,2018-08-20,Assembly,"AB 2117 ARAMBULA Concurrence in Senate Amendments",80,0,0,0,80
1084780,726034,2018-03-20,Assembly,"Do pass. To Consent Calendar",10,0,0,0,10
1084780,733183,2018-04-02,Assembly,"AB 2113 OBERNOLTE Consent Calendar Second Day",73,0,4,0,77
1084780,763028,2018-06-12,Senate,"Do pass and be ordered to the Consent Calendar",7,0,0,0,7
1084780,768037,2018-06-25,Senate,"Consent Calendar AB2113",36,0,3,0,39
1084780,769253,2018-06-28,Assembly,"AB 2113 OBERNOLTE Concurrence in Senate Amendments",77,0,3,0,80
1084783,743893,2018-04-25,Senate,"Do pass, but first be re-referred to the Committee on [Appropriations]",2,4,1,0,7
1084783,743894,2018-04-25,Senate,"[04-25-2018] hearing: Motion to Reconsider. [Reconsideration Granted.]",7,0,0,0,7
1084785,725895,2018-03-20,Assembly,"Do pass and be re-referred to the Committee on [Appropriations]",7,0,0,0,7
1084787,733368,2018-04-03,Assembly,"Do pass and be re-referred to the Committee on [Appropriations] with recommendation: To Consent Calendar",15,0,0,0,15
1084787,756652,2018-05-25,Assembly,"Do pass as amended",16,0,1,0,17
1084787,758661,2018-05-31,Assembly,"AB 2112 SANTIAGO Assembly Third Reading",77,0,1,0,78
1084787,769058,2018-06-27,Senate,"Do pass as amended, but first amend, and re-refer to the Committee on [Appropriations] with the recommendation: To Consent Calendar",9,0,0,0,9
1084787,770844,2018-08-06,Senate,"Placed on suspense file",7,0,0,0,7
1084787,772007,2018-08-16,Senate,"Do pass",7,0,0,0,7
1084787,772784,2018-08-27,Senate,"Assembly 3rd Reading AB2112 Santiago By Beall",38,0,2,0,40
1084787,773671,2018-08-29,Assembly,"AB 2112 SANTIAGO Concurrence in Senate Amendments",80,0,0,0,80
1084789,740644,2018-04-17,Senate,"Do pass as amended, but first amend, and re-refer to the Committee on [Appropriations]",4,2,1,0,7
1084789,749912,2018-05-07,Senate,"Placed on suspense file",6,0,1,0,7
1084789,756391,2018-05-25,Senate,"Do pass as amended",5,2,0,0,7
1084789,757518,2018-05-30,Senate,"Senate 3rd Reading SB1038 Leyva",21,13,5,0,39
1084789,769694,2018-07-03,Assembly,"Do pass",10,0,0,0,10
1084791,744641,2018-04-25,Assembly,"Do pass and be re-referred to the Committee on [Appropriations]",9,0,1,0,10
1084791,751737,2018-05-09,Assembly,"Do pass. To Consent Calendar",16,0,1,0,17
1084791,754358,2018-05-17,Assembly,"AB 2114 BIGELOW Consent Calendar Second Day Regular Session",73,0,5,0,78
1084791,765076,2018-06-19,Senate,"Do pass, but first be re-referred to the Committee on [Appropriations] with the recommendation: To Consent Calendar",4,0,1,0,5
1084791,770554,2018-08-06,Senate,"Consent Calendar AB2114 Bigelow et al",37,0,2,0,39
1084791,771195,2018-08-09,Assembly,"AB 2114 BIGELOW Concurrence in Senate Amendments",77,0,3,0,80
1084791,777361,2018-08-06,Senate,,4,0,2,0,6
1086399,737457,2018-04-10,Assembly,"Do pass and be re-referred to the Committee on [Appropriations]",16,0,0,0,16
1086399,756668,2018-05-25,Assembly,"Do pass",16,0,1,0,17
1086399,757166,2018-05-29,Assembly,"AB 2221 BLOOM Assembly Third Reading",77,0,1,0,78
1086399,767950,2018-06-25,Senate,"Do pass as amended, but first amend, and re-refer to the Committee on [Appropriations]",9,0,0,0,9
1086399,773491,2018-08-29,Senate,"Assembly 3rd Reading AB2221 Bloom By Dodd",39,0,1,0,40
1086399,773907,2018-08-30,Assembly,"AB 2221 BLOOM Concurrence in Senate Amendments",79,0,1,0,80
1086401,743330,2018-04-24,Assembly,"Do pass as amended and be re-referred to the Committee on [Appropriations]",15,0,0,0,15
1086401,753817,2018-05-16,Assembly,"Do pass. To Consent Calendar",17,0,0,0,17
1086401,756723,2018-05-25,Assembly,"AB 2190 REYES Consent Calendar Second Day Regular Session",70,0,8,0,78
1086401,768803,2018-06-27,Senate,"Do pass as amended, but first amend, and re-refer to the Committee on [Appropriations]",9,0,0,0,9
1086401,773318,2018-08-29,Senate,"Assembly 3rd Reading AB2190 Reyes et al. By Pan",39,0,1,0,40
1086401,773692,2018-08-30,Assembly,"AB 2190 REYES Concurrence in Senate Amendments",80,0,0,0,80
1086406,743178,2018-04-24,Senate,"Do pass, but first be re-referred to the Committee on [Appropriations] with the recommendation: To Consent Calendar",12,0,0,0,12
1086406,752006,2018-05-10,Senate,"Consent Calendar SB1051",38,0,1,0,39
1086406,766752,2018-06-20,Assembly,"Do pass and be re-referred to the Committee on [Appropriations] with recommendation: To Consent Calendar",19,0,2,0,21
1086406,771137,2018-08-08,Assembly,"Do pass. To Consent Calendar",17,0,0,0,17
1086406,774251,2018-08-31,Senate,"Unfinished Business SB1051 Dodd et al. Urgency Clause Concurrence",39,0,1,0,40
1086406,774252,2018-08-31,Assembly,"SB 1051 Dodd Third Reading Urgency By GRAY",80,0,0,0,80
1086407,740073,2018-04-17,Senate,"Do pass, but first be re-referred to the Committee on [Environmental Quality]",9,1,1,0,11
1086407,740931,2018-04-18,Senate,"Do pass, but first be re-referred to the Committee on [Appropriations]",6,1,0,0,7
1086407,750197,2018-05-07,Senate,"Placed on suspense file",6,0,1,0,7
1086407,756749,2018-05-25,Senate,"Do pass",5,0,2,0,7
1086407,756965,2018-05-29,Senate,"Senate 3rd Reading SB1090 Monning et al",31,4,4,0,39
1086407,768929,2018-06-27,Assembly,"Do pass and be re-referred to the Committee on [Appropriations]",14,0,1,0,15
1086407,771091,2018-08-08,Assembly,"Do pass",12,1,4,0,17
1086407,772290,2018-08-20,Assembly,"SB 1090 Monning Senate Third Reading By CUNNINGHAM",67,1,12,0,80
1086409,725725,2018-03-20,Assembly,"Do pass as amended and be re-referred to the Committee on [Appropriations]",13,0,2,0,15
1086410,725544,2018-03-20,Senate,"Do pass and be ordered to the Consent Calendar",7,0,0,0,7
1086410,732591,2018-04-02,Senate,"Consent Calendar SB1089 Jackson",36,0,3,0,39
1086410,762226,2018-06-12,Assembly,"Do pass. To Consent Calendar",9,0,1,0,10
1086410,764299,2018-06-18,Assembly,"SB 1089 Jackson Consent Calendar Second Day",80,0,0,0,80
1086414,740766,2018-04-18,Assembly,"Do pass and be re-referred to the Committee on [Natural Resources]",10,0,5,0,15
1086414,743154,2018-04-23,Assembly,"Do pass and be re-referred to the Committee on [Appropriations]",7,2,1,0,10
1086416,727720,2018-03-21,Assembly,"Do pass and be re-referred to the Committee on [Appropriations]",6,0,1,0,7
1086416,756437,2018-05-25,Assembly,"Do pass as amended",12,3,2,0,17
1086416,758834,2018-05-31,Assembly,"AB 2153 THURMOND Assembly Third Reading",57,12,9,0,78
1086416,766212,2018-06-20,Senate,"Do pass, but first be re-referred to the Committee on [Appropriations]",7,0,0,0,7
1086416,769563,2018-07-02,Senate,"Placed on suspense file",7,0,0,0,7
1086416,771634,2018-08-16,Senate,"Do pass as amended",5,2,0,0,7
1086416,772799,2018-08-27,Senate,"Assembly 3rd Reading AB2153 Thurmond et al. By Skinner",34,3,3,0,40
1086416,773473,2018-08-29,Assembly,"AB 2153 THURMOND Concurrence in Senate Amendments",58,14,8,0,80
1086417,726142,2018-03-20,Assembly,"Do pass. To Consent Calendar",7,0,0,0,7
1086417,734802,2018-04-05,Assembly,"AB 2177 JONES-SAWYER Consent Calendar Second Day Regular Session",70,0,7,0,77
1086417,753229,2018-05-15,Senate,"Do pass, but first be re-referred to the Committee on [Appropriations] with the recommendation: To Consent Calendar",7,0,0,0,7
1086417,768029,2018-06-25,Senate,"Placed on suspense file",7,0,0,0,7
1086419,725925,2018-03-20,Assembly,"Do pass and be re-referred to the Committee on [Appropriations]",15,0,0,0,15
1086419,733880,2018-04-04,Assembly,"Do pass. To Consent Calendar",15,0,2,0,17
1086419,738189,2018-04-12,Assembly,"AB 2204 GRAY Consent Calendar Second Day Regular Session",68,0,9,0,77
1086419,760459,2018-06-06,Senate,"Do pass, but first be re-referred to the Committee on [Appropriations]",7,0,2,0,9
1086419,772578,2018-08-23,Senate,"Assembly 3rd Reading AB2204 Gray et al. By Portantino",38,0,2,0,40
1086420,725581,2018-03-20,Assembly,"Do pass as amended, and be re-referred to the Committee on [Appropriations] with recommendation: To Consent Calendar",7,0,0,0,7
1086420,756419,2018-05-25,Assembly,"Do pass",16,0,1,0,17
1086420,757061,2018-05-29,Assembly,"AB 2133 WEBER Assembly Third Reading",77,0,1,0,78
1086420,765019,2018-06-19,Senate,"Do pass, but first be re-referred to the Committee on [Appropriations] with the recommendation: To Consent Calendar",7,0,0,0,7
1086420,770508,2018-08-06,Senate,"Placed on suspense file",7,0,0,0,7
1086420,771653,2018-08-16,Senate,"Do pass",7,0,0,0,7
1086420,772343,2018-08-21,Senate,"Assembly 3rd Reading AB2133 Weber By Bradford",39,0,1,0,40
1086420,775328,2018-05-25,Assembly,,7,0,1,0,8
1086422,735991,2018-04-10,Assembly,"Do pass and be re-referred to the Committee on [Appropriations] with recommendation: To Consent Calendar",15,0,0,0,15
1086425,744729,2018-04-24,Senate,"Do pass, but first be re-referred to the Committee on [Appropriations] with the recommendation: To Consent Calendar",11,0,2,0,13
1086425,751964,2018-05-10,Senate,"Consent Calendar SB1078 T.&H",38,0,1,0,39
1086425,768746,2018-06-27,Assembly,"Do pass and be re-referred to the Committee on [Appropriations]",6,0,1,0,7
1086425,771130,2018-08-08,Assembly,"Do pass. To Consent Calendar",17,0,0,0,17
1086425,773875,2018-08-30,Assembly,"SB 1078 T. & H. Senate Third Reading By CHIU",80,0,0,0,80
1086425,774260,2018-08-31,Senate,"Unfinished Business SB1078 T.&H. (Beall) Concurrence",39,0,1,0,40
1086426,739844,2018-04-17,Assembly,"Do pass",8,2,0,0,10
1086426,754947,2018-05-21,Assembly,"AB 2185 CHIU Assembly Third Reading",61,6,11,0,78
1086426,769683,2018-07-03,Senate,"Do pass",5,2,0,0,7
1086426,772843,2018-08-27,Senate,"Assembly 3rd Reading AB2185 Chiu By Monning",29,7,4,0,40
1086426,773621,2018-08-29,Assembly,"AB 2185 CHIU Concurrence in Senate Amendments",77,2,1,0,80
1086430,753354,2018-05-14,Assembly,"Do pass and be re-referred to the Committee on [Appropriations]",7,0,3,0,10
1086430,756427,2018-05-25,Assembly,"Do pass",14,0,3,0,17
1086430,757506,2018-05-30,Assembly,"AB 2217 BURKE Assembly Third Reading",65,0,13,0,78
1086430,771067,2018-08-08,Senate,"Do pass, but first be re-referred to the Committee on [Appropriations]",5,1,1,0,7
1086430,771365,2018-08-13,Senate,"Placed on suspense file",7,0,0,0,7
1086430,771762,2018-08-16,Senate,"Do pass as amended",5,2,0,0,7
1086433,725668,2018-03-20,Assembly,"Do pass and be re-referred to the Committee on [Appropriations]",11,2,2,0,15
1086433,737430,2018-04-11,Assembly,"Do pass as amended",12,1,4,0,17
1086433,750087,2018-05-07,Assembly,"AB 2151 GRAY Assembly Third Reading",53,1,24,0,78
1086433,762364,2018-06-12,Senate,"Do pass as amended, but first amend, and re-refer to the Committee on [Appropriations]",6,0,3,0,9
1086433,772414,2018-08-21,Senate,"Assembly 3rd Reading AB2151 Gray et al. By Nielsen",32,3,5,0,40
1086433,772997,2018-08-27,Assembly,"AB 2151 GRAY Concurrence in Senate Amendments",68,6,6,0,80
1086438,725711,2018-03-20,Assembly,"Do pass as amended and be re-referred to the Committee on [Health]",13,0,3,0,16
1086438,743173,2018-04-24,Assembly,"Do pass as amended and be re-referred to the Committee on [Appropriations]",15,0,0,0,15
1086438,753745,2018-05-16,Assembly,"Do pass. To Consent Calendar",17,0,0,0,17
1086438,756744,2018-05-25,Assembly,"AB 2143 CABALLERO Consent Calendar Second Day Regular Session",70,0,8,0,78
1086438,764824,2018-06-18,Senate,"Do pass, but first be re-referred to the Committee on [Health]",9,0,0,0,9
1086438,768946,2018-06-27,Senate,"Do pass, but first be re-referred to the Committee on [Appropriations]",9,0,0,0,9
1086438,770386,2018-08-06,Senate,"Do pass",7,0,0,0,7
1086438,772179,2018-08-20,Senate,"Assembly 3rd Reading AB2143 Caballero et al. By Pan",39,0,1,0,40
1086438,772519,2018-08-23,Assembly,"AB 2143 CABALLERO Concurrence in Senate Amendments",79,0,1,0,80
1086439,725527,2018-03-20,Assembly,"Do pass and be re-referred to the Committee on [Appropriations] with recommendation: To Consent Calendar",10,0,0,0,10
1086439,734223,2018-04-04,Assembly,"Do pass. To Consent Calendar",15,0,2,0,17
1086439,738256,2018-04-12,Assembly,"AB 2201 MAYES Consent Calendar Second Day Regular Session",68,0,9,0,77
1086439,763004,2018-06-12,Senate,"Do pass, but first be re-referred to the Committee on [Appropriations]",7,0,0,0,7
1086439,771923,2018-08-16,Senate,"Assembly 3rd Reading AB2201 Mayes By Fuller",39,0,1,0,40
1086439,772301,2018-08-20,Assembly,"AB 2201 MAYES Concurrence in Senate Amendments",80,0,0,0,80
1086441,742238,2018-04-23,Assembly,"Be adopted. To Consent Calendar",14,0,0,0,14
1086441,744748,2018-04-26,Assembly,"ACR 173 GLORIA Consent Calendar Second Day Regular Session",74,0,4,0,78
1086441,769748,2018-07-03,Senate,"Be adopted, but first be re-referred to the Committee on [Appropriations] with recommendation: To Consent Calendar",12,0,1,0,13
1086441,772644,2018-08-24,Senate,"Special Consent ACR173",39,0,1,0,40
1086441,773421,2018-08-29,Assembly,"ACR 173 GLORIA Concurrence in Senate Amendments",80,0,0,0,80
1086444,742915,2018-04-24,Assembly,"Do pass and be re-referred to the Committee on [Appropriations]",14,0,1,0,15
1086444,756508,2018-05-25,Assembly,"Do pass",16,0,1,0,17
1086444,758638,2018-05-31,Assembly,"AB 2191 O'DONNELL Assembly Third Reading",78,0,0,0,78
1086445,736170,2018-04-10,Assembly,"Do pass. To Consent Calendar",7,0,0,0,7
1086445,742212,2018-04-23,Assembly,"AB 2213 COOLEY Third Reading Urgency",74,0,4,0,78
1086445,765057,2018-06-19,Senate,"Do pass, but first be re-referred to the Committee on [Appropriations] with the recommendation: To Consent Calendar",7,0,0,0,7
1086445,770402,2018-08-06,Senate,"Placed on suspense file",7,0,0,0,7
1086449,740981,2018-04-18,Senate,"Do pass, but first be re-referred to the Committee on [Appropriations]",7,0,0,0,7
1086449,746263,2018-04-30,Senate,"Placed on suspense file",6,0,1,0,7
1086449,756416,2018-05-25,Senate,"Do pass as amended",7,0,0,0,7
1086449,757710,2018-05-30,Senate,"Senate 3rd Reading SB1087 Roth",38,0,1,0,39
1086449,766076,2018-06-20,Assembly,"Do pass and be re-referred to the Committee on [Banking and Finance]",7,0,2,0,9
1086449,767988,2018-06-25,Assembly,"Do pass and be re-referred to the Committee on [Appropriations]",11,0,0,0,11
1086449,771580,2018-08-16,Assembly,"Do pass as amended",12,0,5,0,17
1086449,773364,2018-08-29,Assembly,"SB 1087 Roth Senate Third Reading By AGUIAR-CURRY",79,0,1,0,80
1086449,773785,2018-08-30,Senate,"Unfinished Business SB1087 Roth Concurrence",39,0,1,0,40
1086453,733311,2018-04-03,Assembly,"Do pass and be re-referred to the Committee on [Appropriations]",7,0,0,0,7
1086453,756469,2018-05-25,Assembly,"Do pass as amended",15,0,2,0,17
1086453,758790,2018-05-31,Assembly,"AB 2222 QUIRK Assembly Third Reading",78,0,0,0,78
1086453,768322,2018-06-26,Senate,"Do pass, but first be re-referred to the Committee on [Appropriations] with the recommendation: To Consent Calendar",7,0,0,0,7
1086453,770297,2018-08-06,Senate,"Placed on suspense file",7,0,0,0,7
1086453,771902,2018-08-16,Senate,"Do pass",7,0,0,0,7
1086453,772527,2018-08-23,Senate,"Assembly 3rd Reading AB2222 Quirk et al. By Hertzberg",38,0,2,0,40
1086453,772528,2018-08-23,Senate,"Assembly 3rd Reading AB2222 Quirk et al. By Hertzberg Reconsider",39,0,1,0,40
1086453,773404,2018-08-29,Senate,"Assembly 3rd Reading AB2222 Quirk et al. By Hertzberg",39,0,1,0,40
1086453,773871,2018-08-30,Assembly,"AB 2222 QUIRK Concurrence in Senate Amendments",79,0,1,0,80
1086456,725464,2018-03-20,Assembly,"Do pass and be re-referred to the Committee on [Appropriations]",7,0,0,0,7
1086456,734092,2018-04-04,Assembly,"Do pass. To Consent Calendar",15,0,2,0,17
1086456,738228,2018-04-12,Assembly,"AB 2176 JONES-SAWYER Consent Calendar Second Day Regular Session",68,0,9,0,77
1086456,753504,2018-05-15,Senate,"Do pass, but first be re-referred to the Committee on [Judiciary] with the recommendation: To Consent Calendar",7,0,0,0,7
1086456,762997,2018-06-12,Senate,"Do pass, but first be re-referred to the Committee on [Appropriations] with the recommendation: To Consent Calendar",7,0,0,0,7
1086456,770903,2018-08-06,Senate,"Consent Calendar AB2176 Jones-Sawyer",37,0,2,0,39
1086458,740033,2018-04-17,Assembly,"Do pass as amended and be re-referred to the Committee on [Appropriations]",14,2,0,0,16
1086458,751391,2018-05-09,Assembly,"Do pass",11,4,2,0,17
1086458,757131,2018-05-29,Assembly,"AB 2215 KALRA Assembly Third Reading",60,10,8,0,78
1086458,767846,2018-06-25,Senate,"Do pass as amended, but first amend, and re-refer to the Committee on [Appropriations]",9,0,0,0,9
1086458,773608,2018-08-29,Senate,"Assembly 3rd Reading AB2215 Kalra et al. By Hernandez",37,1,2,0,40
1086458,773878,2018-08-30,Assembly,"AB 2215 KALRA Concurrence in Senate Amendments",64,5,11,0,80
1086459,726845,2018-03-21,Assembly,"Do pass and be re-referred to the Committee on [Appropriations] with recommendation: To Consent Calendar",6,0,1,0,7
1086459,733889,2018-04-04,Assembly,"Do pass. To Consent Calendar",15,0,2,0,17
1086459,738299,2018-04-12,Assembly,"AB 2198 OBERNOLTE Consent Calendar Second Day Regular Session",68,0,9,0,77
1086459,762271,2018-06-12,Senate,"Do pass, but first be re-referred to the Committee on [Appropriations] with the recommendation: To Consent Calendar",10,0,2,0,12
1086459,770952,2018-08-06,Senate,"Consent Calendar AB2198 Obernolte",37,0,2,0,39
1086468,733815,2018-04-04,Assembly,"Do pass. To Consent Calendar",13,0,0,0,13
1086468,738119,2018-04-12,Assembly,"AB 2180 KALRA Consent Calendar Second Day",68,0,9,0,77
1086468,762720,2018-06-13,Senate,"Do pass",11,0,2,0,13
1086468,769777,2018-07-05,Senate,"Assembly 3rd Reading AB2180 Kalra By Gaines",35,0,4,0,39
1086470,740744,2018-04-18,Assembly,"Do pass and be re-referred to the Committee on [Appropriations] with recommendation: To Consent Calendar",13,0,0,0,13
1086470,747813,2018-05-02,Assembly,"Do pass. To Consent Calendar",17,0,0,0,17
1086470,751986,2018-05-10,Assembly,"AB 2142 BIGELOW Consent Calendar Second Day Regular Session",73,0,5,0,78
1086470,769242,2018-06-27,Senate,"Do pass as amended, but first amend, and re-refer to the Committee on [Appropriations] with the recommendation: To Consent Calendar",11,0,2,0,13
1086470,769572,2018-06-27,Senate,"Do pass as amended, but first amend, and re-refer to the Committee on [Appropriations]",11,0,2,0,13
1086470,770444,2018-08-06,Senate,"Placed on suspense file",7,0,0,0,7
1086470,771764,2018-08-16,Senate,"Do pass as amended",7,0,0,0,7
1086470,772367,2018-08-21,Senate,"Assembly 3rd Reading AB2142 Bigelow By Wilk",37,0,3,0,40
1086470,772873,2018-08-27,Assembly,"AB 2142 BIGELOW Concurrence in Senate Amendments",80,0,0,0,80
1086473,725616,2018-03-20,Assembly,"Do pass and be re-referred to the Committee on [Appropriations] with recommendation: To Consent Calendar",7,0,0,0,7
1086473,756564,2018-05-25,Assembly,"Do pass as amended",16,0,1,0,17
1086473,758625,2018-05-31,Assembly,"AB 2136 BONTA Assembly Third Reading",78,0,0,0,78
1086475,733987,2018-04-04,Assembly,"Do pass and be re-referred to the Committee on [Higher Education]",5,0,2,0,7
1086475,739693,2018-04-17,Assembly,"Do pass and be re-referred to the Committee on [Appropriations]",9,4,0,0,13
1086475,756503,2018-05-25,Assembly,"Do pass",12,4,1,0,17
1086475,757076,2018-05-29,Assembly,"AB 2160 THURMOND Assembly Third Reading",51,26,1,0,78
1086475,768835,2018-06-27,Senate,"Do pass as amended, but first amend, and re-refer to the Committee on [Appropriations]",4,1,0,0,5
1086475,770266,2018-08-06,Senate,"Placed on suspense file",7,0,0,0,7
1086475,771700,2018-08-16,Senate,"Do pass",5,2,0,0,7
1086475,773228,2018-08-28,Senate,"Assembly 3rd Reading AB2160 Thurmond By Lara",26,11,3,0,40
1086475,773389,2018-08-29,Assembly,"AB 2160 THURMOND Concurrence in Senate Amendments",54,24,2,0,80
1086479,734591,2018-04-04,Assembly,"Do pass and be re-referred to the Committee on [Appropriations] with recommendation: To Consent Calendar",21,0,0,0,21
1086479,740866,2018-04-18,Assembly,"Do pass. To Consent Calendar",15,0,2,0,17
1086479,744930,2018-04-26,Assembly,"AB 2146 GLORIA Consent Calendar Second Day Regular Session",74,0,4,0,78
1086479,762130,2018-06-12,Senate,"Do pass, but first be re-referred to the Committee on [Appropriations]",10,0,2,0,12
1086479,772858,2018-08-27,Senate,"Assembly 3rd Reading AB2146 Gloria et al. By Hueso",39,0,1,0,40
1086479,773600,2018-08-29,Assembly,"AB 2146 GLORIA Concurrence in Senate Amendments",80,0,0,0,80
1086486,751547,2018-05-09,Assembly,"Do pass",9,0,0,0,9
1086486,757255,2018-05-29,Assembly,"AB 2179 GIPSON Assembly Third Reading",71,2,5,0,78
1086486,765835,2018-06-19,Senate,"Do pass, but first be re-referred to the Committee on [Governance and Finance]",10,0,1,0,11
1086486,769217,2018-06-27,Senate,"Do pass",7,0,0,0,7
1086486,772431,2018-08-22,Senate,"Assembly 3rd Reading AB2179 Gipson By Hertzberg",38,0,2,0,40
1086486,773096,2018-08-28,Assembly,"AB 2179 GIPSON Concurrence in Senate Amendments",75,2,3,0,80
1086487,734466,2018-04-04,Assembly,"Do pass and be re-referred to the Committee on [Appropriations] with recommendation: To Consent Calendar",21,0,0,0,21
1086490,751404,2018-05-09,Senate,"Do pass and be ordered to the Consent Calendar",6,0,1,0,7
1086490,754211,2018-05-17,Senate,"Consent Calendar SB1084",38,0,1,0,39
1086490,765931,2018-06-20,Assembly,"Do pass. To Consent Calendar",8,0,1,0,9
1086490,769294,2018-06-28,Assembly,"SB 1084 Berryhill, T. Consent Calendar Second Day Regular Session",75,0,5,0,80
1086498,751390,2018-05-09,Senate,"Do pass, but first be re-referred to the Committee on [Appropriations]",6,0,1,0,7
1086498,755300,2018-05-22,Senate,"Placed on suspense file",7,0,0,0,7
1086507,741130,2018-04-18,Senate,"[First] hearing set for [04-18-2018]: Failed passage in Committee. Reconsideration granted",7,0,0,0,7
1086507,741131,2018-04-18,Senate,"Do pass, but first be re-referred to the Committee on [Judiciary]",2,4,1,0,7
1086513,743648,2018-04-24,Senate,"Do pass as amended, but first amend, and re-refer to the Committee on [Appropriations] with the recommendation: To Consent Calendar",9,0,0,0,9
1086513,752189,2018-05-10,Senate,"Consent Calendar SB1079 Monning et al. Urgency Clause",38,0,1,0,39
1086513,761786,2018-06-11,Assembly,"Do pass as amended and be re-referred to the Committee on [Appropriations]",10,0,0,0,10
1086513,769012,2018-06-27,Assembly,"Do pass as amended",16,0,1,0,17
1086513,772279,2018-08-20,Assembly,"SB 1079 Monning Third Reading Urgency By STONE",80,0,0,0,80
1086513,772341,2018-08-21,Senate,"Unfinished Business SB1079 Monning et al. Urgency Clause Concurrence",37,0,3,0,40
1086515,741293,2018-04-18,Assembly,"Do pass and be re-referred to the Committee on [Appropriations] with recommendation: To Consent Calendar",6,0,1,0,7
1086515,748180,2018-05-02,Assembly,"Do pass. To Consent Calendar",17,0,0,0,17
1086515,751954,2018-05-10,Assembly,"AB 2196 COOPER Consent Calendar Second Day Regular Session",73,0,5,0,78
1086515,761787,2018-06-11,Senate,"Do pass as amended, but first amend, and re-refer to the Committee on [Appropriations] with the recommendation: To Consent Calendar",5,0,0,0,5
1086515,769531,2018-07-02,Senate,"Consent Calendar AB2196",37,0,2,0,39
1086515,770306,2018-08-06,Assembly,"AB 2196 COOPER Concurrence in Senate Amendments",76,0,4,0,80
1086518,742919,2018-04-24,Assembly,"Do pass and be re-referred to the Committee on [Appropriations]",11,5,0,0,16
1086518,756367,2018-05-25,Assembly,"Do pass as amended",12,4,1,0,17
1086518,758665,2018-05-31,Assembly,"AB 2138 CHIU Assembly Third Reading",45,29,4,0,78
1086518,765025,2018-06-18,Senate,"Do pass, but first be re-referred to the Committee on [Public Safety]",6,3,0,0,9
1086518,768293,2018-06-26,Senate,"Do pass, but first be re-referred to the Committee on [Appropriations]",4,2,1,0,7
1086518,770389,2018-08-06,Senate,"Placed on suspense file",7,0,0,0,7
1086518,771883,2018-08-16,Senate,"Do pass",5,2,0,0,7
1086518,773169,2018-08-28,Senate,"Assembly 3rd Reading AB2138 Chiu et al. By Skinner",24,13,3,0,40
1086518,773791,2018-08-30,Assembly,"AB 2138 CHIU Concurrence in Senate Amendments",47,29,4,0,80
1086522,724860,2018-03-19,Assembly,"Do pass and be re-referred to the Committee on [Appropriations]",13,0,1,0,14
1086522,755669,2018-05-23,Assembly,"Do pass. To Consent Calendar",16,0,1,0,17
1086522,757407,2018-05-29,Assembly,"AB 2145 REYES Consent Calendar Second Day Regular Session",78,0,0,0,78
1086522,765761,2018-06-19,Senate,"Do pass, but first be re-referred to the Committee on [Environmental Quality]",12,0,1,0,13
1086522,767183,2018-06-20,Senate,"Do pass, but first be re-referred to the Committee on [Appropriations] with the recommendation: To Consent Calendar",7,0,0,0,7
1086522,770970,2018-08-06,Senate,"Placed on suspense file",7,0,0,0,7
1086522,772021,2018-08-16,Senate,"Do pass as amended",7,0,0,0,7
1086522,773136,2018-08-28,Senate,"Assembly 3rd Reading AB2145 Reyes By Lara",38,0,2,0,40
1086522,773304,2018-08-29,Assembly,"AB 2145 REYES Concurrence in Senate Amendments",78,0,2,0,80
1086524,738254,2018-04-11,Assembly,"Do pass and be re-referred to the Committee on [Higher Education]",8,0,2,0,10
1086524,743755,2018-04-24,Assembly,"Do pass as amended and be re-referred to the Committee on [Appropriations]",13,0,0,0,13
1086525,743262,2018-04-24,Assembly,"Do pass as amended and be re-referred to the Committee on [Appropriations]",12,1,2,0,15
1086525,756207,2018-05-25,Assembly,"Do pass",14,1,2,0,17
1086525,758620,2018-05-31,Assembly,"AB 2193 MAIENSCHEIN Assembly Third Reading",68,0,10,0,78
1086525,768887,2018-06-27,Senate,"Do pass as amended, but first amend, and re-refer to the Committee on [Appropriations]",9,0,0,0,9
1086525,770445,2018-08-06,Senate,"Placed on suspense file",7,0,0,0,7
1086525,771625,2018-08-16,Senate,"Do pass as amended",7,0,0,0,7
1086525,772800,2018-08-27,Senate,"Assembly 3rd Reading AB2193 Maienschein et al. By Beall",39,0,1,0,40
1086525,773514,2018-08-29,Assembly,"AB 2193 MAIENSCHEIN Concurrence in Senate Amendments",80,0,0,0,80
1086528,751353,2018-05-09,Assembly,"Do pass",8,0,1,0,9
1086528,758694,2018-05-31,Assembly,"AB 2164 COOLEY Assembly Third Reading",77,0,1,0,78
1086528,769263,2018-06-27,Senate,"Do pass",7,0,0,0,7
1086528,771272,2018-08-13,Senate,"Special Consent AB2164",37,0,3,0,40
1086528,774501,2018-05-09,Assembly,,0,0,1,0,1
1086529,745001,2018-04-25,Assembly,"Do pass as amended and be re-referred to the Committee on [Appropriations]",7,0,0,0,7
1086529,756766,2018-05-25,Assembly,"Do pass",16,0,1,0,17
1086529,757117,2018-05-29,Assembly,"AB 2168 THURMOND Assembly Third Reading",77,0,1,0,78
1086529,762731,2018-06-13,Senate,"Do pass as amended, but first amend, and re-refer to the Committee on [Appropriations]",7,0,0,0,7
1086529,769656,2018-07-02,Senate,"Placed on suspense file",7,0,0,0,7
1086529,771974,2018-08-16,Senate,"Do pass as amended",7,0,0,0,7
1086529,773554,2018-08-29,Senate,"Assembly 3rd Reading AB2168 Thurmond By Beall",39,0,1,0,40
1086529,773945,2018-08-30,Assembly,"AB 2168 THURMOND Concurrence in Senate Amendments",80,0,0,0,80
1086531,743733,2018-04-25,Assembly,"Do pass",5,2,0,0,7
1086531,748721,2018-05-03,Assembly,"AB 2172 WEBER Assembly Third Reading",47,24,7,0,78
1086531,764875,2018-06-19,Senate,"Do pass, but first be re-referred to the Committee on [Public Safety]",4,1,0,0,5
1086531,768223,2018-06-26,Senate,"Do pass, but first be re-referred to the Committee on [Appropriations]",5,2,0,0,7
1086531,771204,2018-08-09,Senate,"Assembly 3rd Reading AB2172 Weber By Hertzberg",24,12,3,0,39
1086531,771249,2018-08-13,Assembly,"AB 2172 WEBER Concurrence in Senate Amendments",53,23,4,0,80
1086533,743570,2018-04-23,Assembly,"Do pass as amended and be re-referred to the Committee on [Appropriations]",10,0,0,0,10
1086533,756730,2018-05-25,Assembly,"Do pass",16,0,1,0,17
1086533,756972,2018-05-29,Assembly,"AB 2211 LIMÓN Assembly Third Reading",78,0,0,0,78
1086533,767140,2018-06-20,Senate,"Do pass as amended, but first amend, and re-refer to the Committee on [Appropriations] with the recommendation: To Consent Calendar",7,0,0,0,7
1086533,770808,2018-08-06,Senate,"Placed on suspense file",7,0,0,0,7
1086541,744451,2018-04-25,Assembly,"Do pass as amended and be re-referred to the Committee on [Appropriations]",7,0,0,0,7
1086541,755722,2018-05-23,Assembly,"Do pass. To Consent Calendar",16,0,1,0,17
1086541,757204,2018-05-29,Assembly,"AB 2155 MULLIN Consent Calendar Second Day Regular Session",78,0,0,0,78
1086541,764940,2018-06-19,Senate,"Do pass, but first be re-referred to the Committee on [Appropriations]",4,1,0,0,5
1086541,773238,2018-08-28,Senate,"Assembly 3rd Reading AB2155 Mullin By Hill",28,5,7,0,40
1086541,774150,2018-08-31,Assembly,"AB 2155 MULLIN Concurrence in Senate Amendments",66,6,8,0,80
1086543,740110,2018-04-17,Senate,"Do pass, but first be re-referred to the Committee on [Appropriations]",7,0,0,0,7
1086543,748706,2018-05-03,Senate,"Senate 3rd Reading SB1050 Lara et al",38,0,1,0,39
1086543,762287,2018-06-12,Assembly,"Do pass and be re-referred to the Committee on [Appropriations] with recommendation: To Consent Calendar",7,0,0,0,7
1086543,771865,2018-08-16,Assembly,"Do pass as amended",12,0,5,0,17
1086543,773325,2018-08-29,Assembly,"SB 1050 Lara Senate Third Reading By JONES-SAWYER",78,0,2,0,80
1086543,773776,2018-08-30,Senate,"Unfinished Business SB1050 Lara et al. Concurrence",39,0,1,0,40
1086545,737480,2018-04-11,Assembly,"Do pass and be re-referred to the Committee on [Budget] with recommendation: To Consent Calendar",6,0,1,0,7
1086545,752773,2018-05-14,Assembly,"Do pass",26,0,3,0,29
1086545,754930,2018-05-21,Assembly,"AB 2199 IRWIN Assembly Third Reading",74,0,4,0,78
1086547,744018,2018-04-24,Assembly,"Do pass and be re-referred to the Committee on [Appropriations]",11,0,2,0,13
1086547,756530,2018-05-25,Assembly,"Do pass",13,3,1,0,17
1086547,757797,2018-05-30,Assembly,"AB 2202 GRAY Assembly Third Reading",67,5,6,0,78
1086547,768849,2018-06-27,Senate,"Do pass, but first be re-referred to the Committee on [Appropriations]",7,0,0,0,7
1086547,770532,2018-08-06,Senate,"Placed on suspense file",7,0,0,0,7
1086547,771651,2018-08-16,Senate,"Do pass as amended",7,0,0,0,7
1086547,772334,2018-08-21,Senate,"Assembly 3rd Reading AB2202 Gray By Cannella",39,0,1,0,40
1086547,772777,2018-08-27,Assembly,"AB 2202 GRAY Concurrence in Senate Amendments",79,0,1,0,80
1086549,747798,2018-05-02,Senate,"Do pass as amended, but first amend, and re-refer to the Committee on [Appropriations]",7,0,0,0,7
1086549,755282,2018-05-22,Senate,"Placed on suspense file",7,0,0,0,7
1086549,756278,2018-05-25,Senate,"Do pass",7,0,0,0,7
1086549,757094,2018-05-29,Senate,"Senate 3rd Reading SB1056 Beall et al",36,2,1,0,39
1086549,769675,2018-07-02,Assembly,"Do pass as amended and be re-referred to the Committee on [Appropriations]",9,0,1,0,10
1086550,740762,2018-04-17,Assembly,"Do pass and be re-referred to the Committee on [Judiciary]",4,1,2,0,7
1086550,743200,2018-04-24,Assembly,"Do pass as amended and be re-referred to the Committee on [Appropriations]",9,0,1,0,10
1086552,737339,2018-04-11,Assembly,"Do pass as amended and be re-referred to the Committee on [Appropriations]",9,0,0,0,9
1086552,744795,2018-04-26,Assembly,"AB 2132 LEVINE Assembly Third Reading",73,0,5,0,78
1086552,762146,2018-06-12,Senate,"Do pass as amended",12,0,1,0,13
1086552,772272,2018-08-20,Senate,"Assembly 3rd Reading AB2132 Levine et al. By Wiener",39,0,1,0,40
1086552,772525,2018-08-23,Assembly,"AB 2132 LEVINE Concurrence in Senate Amendments",79,0,1,0,80
1086555,736578,2018-04-10,Assembly,"Do pass and be re-referred to the Committee on [Appropriations]",7,0,0,0,7
1086555,756299,2018-05-25,Assembly,"Do pass as amended",14,0,3,0,17
1086555,758635,2018-05-31,Assembly,"AB 2189 SANTIAGO Assembly Third Reading",78,0,0,0,78
1086555,767101,2018-06-20,Senate,"Do pass, but first be re-referred to the Committee on [Appropriations]",7,0,0,0,7
1086555,771260,2018-08-13,Senate,"Placed on suspense file",7,0,0,0,7
1086556,743978,2018-04-25,Assembly,"Do pass and be re-referred to the Committee on [Appropriations]",5,2,0,0,7
1086556,756358,2018-05-25,Assembly,"Do pass",12,4,1,0,17
1086556,758669,2018-05-31,Assembly,"AB 2188 MULLIN Assembly Third Reading",62,13,3,0,78
1086556,764865,2018-06-19,Senate,"Do pass, but first be re-referred to the Committee on [Appropriations]",4,1,0,0,5
1086556,770577,2018-08-06,Senate,"Placed on suspense file",7,0,0,0,7
1086556,771850,2018-08-16,Senate,"Do pass as amended",5,2,0,0,7
1086556,774019,2018-08-31,Senate,"Assembly 3rd Reading AB2188 Mullin et al. By Hill",31,8,1,0,40
1086556,774020,2018-08-31,Assembly,"AB 2188 Mullin Concurrence in Senate Amendments",69,3,8,0,80
1086558,739521,2018-04-17,Senate,"Do pass, but first be re-referred to the Committee on [Governmental Organization]",9,1,1,0,11
1086558,742907,2018-04-24,Senate,"Do pass, but first be re-referred to the Committee on [Appropriations]",11,1,0,0,12
1086558,755368,2018-05-22,Senate,"Placed on suspense file",7,0,0,0,7
1086558,756363,2018-05-25,Senate,"Do pass as amended",4,2,1,0,7
1086558,757609,2018-05-30,Senate,"Senate 3rd Reading SB1088 Dodd",34,2,3,0,39
1086558,766087,2018-06-20,Assembly,"Do pass and be re-referred to the Committee on [Governmental Organization]",8,2,5,0,15
1086558,769231,2018-06-28,Assembly,"Do pass as amended and be re-referred to the Committee on [Appropriations]",15,1,5,0,21
1086559,743953,2018-04-24,Assembly,"Do pass and be re-referred to the Committee on [Appropriations]",7,0,0,0,7
1086562,726866,2018-03-21,Assembly,"Do pass and be re-referred to the Committee on [Appropriations]",5,1,1,0,7
1086562,756621,2018-05-25,Assembly,"Do pass as amended",13,2,2,0,17
1086562,758667,2018-05-31,Assembly,"AB 2161 CHIU Assembly Third Reading",59,17,2,0,78
1086562,768177,2018-06-26,Senate,"Do pass as amended, but first amend, and re-refer to the Committee on [Appropriations]",10,2,1,0,13
1086562,770394,2018-08-06,Senate,"Placed on suspense file",7,0,0,0,7
1086564,743875,2018-04-24,Assembly,"Do pass as amended and be re-referred to the Committee on [Appropriations]",7,0,0,0,7
1086564,753821,2018-05-16,Assembly,"Do pass",12,5,0,0,17
1086564,757134,2018-05-29,Assembly,"AB 2152 WEBER Assembly Third Reading",56,19,3,0,78
1086564,768790,2018-06-26,Senate,"Do pass, but first be re-referred to the Committee on [Appropriations]",6,0,1,0,7
1086564,770373,2018-08-06,Senate,"Placed on suspense file",7,0,0,0,7
1086564,771638,2018-08-16,Senate,"Do pass",6,1,0,0,7
1086564,772363,2018-08-21,Senate,"Assembly 3rd Reading AB2152 Weber By Leyva",31,7,2,0,40
1086564,772965,2018-08-27,Assembly,"AB 2152 WEBER Concurrence in Senate Amendments",63,14,3,0,80
1086567,741321,2018-04-18,Senate,"Do pass, but first be re-referred to the Committee on [Appropriations] with the recommendation: To Consent Calendar",7,0,0,0,7
1086567,748742,2018-05-03,Senate,"Consent Calendar SB1054",38,0,1,0,39
1086567,768403,2018-06-26,Assembly,"Do pass and be re-referred to the Committee on [Appropriations] with recommendation: To Consent Calendar",6,0,1,0,7
1086567,771118,2018-08-08,Assembly,"Do pass. To Consent Calendar",17,0,0,0,17
1086567,773182,2018-08-28,Assembly,"SB 1054 Hertzberg Senate Third Reading By BONTA",75,1,4,0,80
1086567,773331,2018-08-29,Senate,"Unfinished Business SB1054 Hertzberg et al. Concurrence",38,1,1,0,40
1086567,773332,2018-08-29,Senate,"Unfinished Business SB1054 Hertzberg et al. Concurrence Reconsider",39,0,1,0,40
1086567,773333,2018-08-29,Senate,"Unfinished Business SB1054 Hertzberg et al. Concurrence",39,0,1,0,40
1086569,733890,2018-04-04,Assembly,"Do pass as amended and be re-referred to the Committee on [Higher Education]",4,2,1,0,7
1086569,739680,2018-04-17,Assembly,"Do pass and be re-referred to the Committee on [Appropriations]",8,4,1,0,13
1086569,756466,2018-05-25,Assembly,"Do pass as amended",12,4,1,0,17
1086569,758785,2018-05-31,Assembly,"AB 2220 BONTA Assembly Third Reading",52,24,2,0,78
1086569,768716,2018-06-27,Senate,"Do pass, but first be re-referred to the Committee on [Appropriations]",4,2,1,0,7
1086569,770356,2018-08-06,Senate,"Placed on suspense file",7,0,0,0,7
1086570,725728,2018-03-19,Assembly,"Do pass as amended and be re-referred to the Committee on [Appropriations]",9,0,1,0,10
1086571,737334,2018-04-11,Assembly,"Do pass and be re-referred to the Committee on [Appropriations]",6,0,1,0,7
1086571,743935,2018-04-25,Assembly,"Do pass. To Consent Calendar",17,0,0,0,17
1086571,748741,2018-05-03,Assembly,"AB 2192 STONE Consent Calendar Second Day Regular Session",71,0,7,0,78
1086571,762204,2018-06-12,Senate,"Do pass, but first be re-referred to the Committee on [Judiciary]",10,0,2,0,12
1086571,766141,2018-06-19,Senate,"Do pass as amended, but first amend, and re-refer to the Committee on [Appropriations]",7,0,0,0,7
1086571,770553,2018-08-06,Senate,"Placed on suspense file",7,0,0,0,7
1086571,771861,2018-08-16,Senate,"Do pass",7,0,0,0,7
1086571,772337,2018-08-21,Senate,"Assembly 3rd Reading AB2192 Mark Stone et al. By Hill",39,0,1,0,40
1086571,772875,2018-08-27,Assembly,"AB 2192 STONE Concurrence in Senate Amendments",79,0,1,0,80
1086574,740822,2018-04-17,Assembly,"Do pass as amended and be re-referred to the Committee on [Local Government]",8,1,1,0,10
1086574,744937,2018-04-25,Assembly,"Do pass and be re-referred to the Committee on [Appropriations]",7,0,2,0,9
1086574,756625,2018-05-25,Assembly,"Do pass",12,2,3,0,17
1086574,757105,2018-05-29,Assembly,"AB 2184 CHIU Assembly Third Reading",58,10,10,0,78
1086574,766302,2018-06-20,Senate,"Do pass, but first be re-referred to the Committee on [Judiciary]",6,0,1,0,7
1086574,768882,2018-06-26,Senate,"Do pass as amended, but first amend, and re-refer to the Committee on [Appropriations]",5,1,1,0,7
1086574,772184,2018-08-20,Senate,"Assembly 3rd Reading AB2184 Chiu et al. By Lara",31,2,7,0,40
1086574,772550,2018-08-23,Assembly,"AB 2184 CHIU Concurrence in Senate Amendments",64,9,7,0,80
1086576,733266,2018-04-03,Assembly,"Do pass as amended. To Consent Calendar",10,0,0,0,10
1086576,738239,2018-04-12,Assembly,"AB 2163 GRAYSON Consent Calendar Second Day Regular Session",68,0,9,0,77
1086576,762169,2018-06-12,Senate,"Do pass, but first be re-referred to the Committee on [Appropriations] with the recommendation: To Consent Calendar",10,0,2,0,12
1086576,769665,2018-07-02,Senate,"Do pass",7,0,0,0,7
1086576,772434,2018-08-22,Senate,"Assembly 3rd Reading AB2163 Grayson By Hill",39,0,1,0,40
1086578,740695,2018-04-17,Assembly,"Do pass and be re-referred to the Committee on [Appropriations]",6,2,2,0,10
1086578,756562,2018-05-25,Assembly,"Do pass as amended",11,4,2,0,17
1086578,758750,2018-05-31,Assembly,"AB 2182 LEVINE Assembly Third Reading",75,0,3,0,78
1086578,768983,2018-06-26,Senate,"Do pass, but first be re-referred to the Committee on [Appropriations]",5,2,0,0,7
1086580,735464,2018-04-09,Assembly,"Do pass and be re-referred to the Committee on [Appropriations]",13,0,1,0,14
1086580,756440,2018-05-25,Assembly,"Do pass",16,0,1,0,17
1086580,757783,2018-05-30,Assembly,"AB 2135 ACOSTA Assembly Third Reading",78,0,0,0,78
1086580,762228,2018-06-12,Senate,"Do pass, but first be re-referred to the Committee on [Appropriations] with the recommendation: To Consent Calendar",12,0,1,0,13
1086580,768007,2018-06-25,Senate,"Placed on suspense file",7,0,0,0,7
1086580,771973,2018-08-16,Senate,"Do pass as amended",7,0,0,0,7
1086580,773179,2018-08-28,Senate,"Assembly 3rd Reading AB2135 Acosta et al. By Bates",39,0,1,0,40
1086580,773415,2018-08-29,Assembly,"AB 2135 ACOSTA Concurrence in Senate Amendments",80,0,0,0,80
1086583,725534,2018-03-20,Assembly,"Do pass. To Consent Calendar",7,0,0,0,7
1086583,734381,2018-04-05,Assembly,"AB 2197 BIGELOW Consent Calendar Second Day Regular Session",70,0,7,0,77
1086583,753415,2018-05-15,Senate,"Do pass and be ordered to the Consent Calendar",7,0,0,0,7
1086583,754967,2018-05-21,Senate,"Consent Calendar AB2197",39,0,0,0,39
1086584,742192,2018-04-23,Assembly,"Do pass as amended and be re-referred to the Committee on [Appropriations]",11,1,2,0,14
1086586,737660,2018-04-11,Senate,"Do pass, but first be re-referred to the Committee on [Appropriations] with the recommendation: To Consent Calendar",5,0,0,0,5
1086586,742833,2018-04-23,Senate,"Placed on suspense file",7,0,0,0,7
1086586,756648,2018-05-25,Senate,"Do pass",7,0,0,0,7
1086586,758399,2018-05-31,Senate,"Special Consent SB1086",39,0,0,0,39
1086586,766211,2018-06-20,Assembly,"Do pass and be re-referred to the Committee on [Appropriations]",12,0,1,0,13
1086586,771842,2018-08-16,Assembly,"Do pass",17,0,0,0,17
1086586,773815,2018-08-30,Assembly,"SB 1086 Atkins Senate Third Reading By WOOD",80,0,0,0,80
1086587,736516,2018-04-10,Assembly,"Do pass and be re-referred to the Committee on [Appropriations]",15,0,0,0,15
1086593,726913,2018-03-21,Assembly,"Do pass and be re-referred to the Committee on [Governmental Organization]",5,1,1,0,7
1086593,734619,2018-04-04,Assembly,"Do pass and be re-referred to the Committee on [Appropriations]",14,5,2,0,21
1086597,736085,2018-04-10,Assembly,"Do pass and be re-referred to the Committee on [Appropriations]",3,7,0,0,10
1086598,726304,2018-03-21,Assembly,"Do pass and be re-referred to the Committee on [Local Government]",4,1,2,0,7
1086598,740761,2018-04-18,Assembly,"Do pass and be re-referred to the Committee on [Appropriations]",6,3,0,0,9
1086598,753714,2018-05-16,Assembly,"Do pass",12,5,0,0,17
1086598,757051,2018-05-29,Assembly,"AB 2162 CHIU Assembly Third Reading",52,22,4,0,78
1086598,765031,2018-06-19,Senate,"Do pass, but first be re-referred to the Committee on [Governance and Finance]",8,2,3,0,13
1086598,769224,2018-06-27,Senate,"Do pass as amended, but first amend, and re-refer to the Committee on [Appropriations]",6,0,1,0,7
1086598,773328,2018-08-29,Senate,"Assembly 3rd Reading AB2162 Chiu et al. By Allen",26,11,3,0,40
1086598,773778,2018-08-30,Assembly,"AB 2162 CHIU Concurrence in Senate Amendments",54,24,2,0,80
1086600,738177,2018-04-11,Assembly,"Do pass as amended and be re-referred to the Committee on [Human Services]",7,0,0,0,7
1086600,743980,2018-04-24,Assembly,"Do pass as amended and be re-referred to the Committee on [Appropriations]",7,0,0,0,7
1086600,756735,2018-05-25,Assembly,"Do pass as amended",16,0,1,0,17
1086600,758610,2018-05-31,Assembly,"AB 2171 FRAZIER Assembly Third Reading",78,0,0,0,78
1086600,766070,2018-06-20,Senate,"Do pass, but first be re-referred to the Committee on [Human Services]",7,0,0,0,7
1086600,768921,2018-06-26,Senate,"Do pass as amended, but first amend, and re-refer to the Committee on [Appropriations]",6,0,1,0,7
1086600,770766,2018-08-06,Senate,"Placed on suspense file",7,0,0,0,7
1086600,772031,2018-08-16,Senate,"Do pass",7,0,0,0,7
1086602,737376,2018-04-10,Assembly,"Do pass as amended and be re-referred to the Committee on [Public Safety]",7,0,0,0,7
1086602,743004,2018-04-24,Assembly,"Do pass and be re-referred to the Committee on [Appropriations] with recommendation: To Consent Calendar",7,0,0,0,7
1086602,756491,2018-05-25,Assembly,"Do pass as amended",16,0,1,0,17
1086602,758783,2018-05-31,Assembly,"AB 2207 EGGMAN Assembly Third Reading",78,0,0,0,78
1086602,765192,2018-06-19,Senate,"Do pass, but first be re-referred to the Committee on [Human Services] with the recommendation: To Consent Calendar",7,0,0,0,7
1086602,768834,2018-06-26,Senate,"Do pass, but first be re-referred to the Committee on [Appropriations]",6,0,1,0,7
1086602,770370,2018-08-06,Senate,"Placed on suspense file",7,0,0,0,7
1086602,771772,2018-08-16,Senate,"Do pass as amended",7,0,0,0,7
1086602,772862,2018-08-27,Senate,"Assembly 3rd Reading AB2207 Eggman By Skinner",39,0,1,0,40
1086602,773532,2018-08-29,Assembly,"AB 2207 EGGMAN Concurrence in Senate Amendments",80,0,0,0,80
1086603,744820,2018-04-25,Assembly,"Do pass as amended and be re-referred to the Committee on [Appropriations]",5,0,2,0,7
1086603,756420,2018-05-25,Assembly,"Do pass as amended",12,0,5,0,17
1086603,758701,2018-05-31,Assembly,"AB 2186 THURMOND Assembly Third Reading",78,0,0,0,78
1086603,766196,2018-06-20,Senate,"Do pass as amended, but first amend, and re-refer to the Committee on [Appropriations] with the recommendation: To Consent Calendar",7,0,0,0,7
1086603,770244,2018-08-06,Senate,"Placed on suspense file",7,0,0,0,7
1086611,742219,2018-04-23,Senate,"Do pass, but first be re-referred to the Committee on [Appropriations]",3,4,2,0,9
1086611,742220,2018-04-23,Senate,"[04-23-2018] hearing: Motion to Reconsider. [Reconsideration Granted.]",9,0,0,0,9
1086617,736156,2018-04-10,Assembly,"Do pass and be re-referred to the Committee on [Privacy and Consumer Protection]",15,0,0,0,15
1086617,740670,2018-04-17,Assembly,"Do pass as amended and be re-referred to the Committee on [Appropriations]",8,2,0,0,10
1086617,747801,2018-05-02,Assembly,"Do pass as amended",12,5,0,0,17
1086617,754299,2018-05-17,Assembly,"AB 2167 CHAU Assembly Third Reading",56,12,10,0,78
1086617,768807,2018-06-26,Senate,"Do pass, but first be re-referred to the Committee on [Appropriations]",5,0,2,0,7
1086617,770247,2018-08-06,Senate,"Placed on suspense file",7,0,0,0,7
1086617,771658,2018-08-16,Senate,"Do pass",5,2,0,0,7
1086617,773211,2018-08-28,Senate,"Assembly 3rd Reading AB2167 Chau By Jackson",16,14,10,0,40
1086617,773212,2018-08-28,Senate,"Assembly 3rd Reading AB2167 Chau By Jackson Reconsider",38,0,2,0,40
1086617,774064,2018-08-31,Senate,"Assembly 3rd Reading AB2167 Chau By Jackson",15,12,13,0,40
1086618,738039,2018-04-11,Assembly,"Do pass and be re-referred to the Committee on [Appropriations]",6,1,0,0,7
1086618,756603,2018-05-25,Assembly,"Do pass as amended",13,3,1,0,17
1086618,758662,2018-05-31,Assembly,"AB 2218 BERMAN Assembly Third Reading",64,14,0,0,78
1086618,765124,2018-06-19,Senate,"Do pass, but first be re-referred to the Committee on [Appropriations]",4,1,0,0,5
1086618,772410,2018-08-21,Senate,"Assembly 3rd Reading AB2218 Berman et al. By Allen",26,6,8,0,40
1086625,726889,2018-03-21,Assembly,"Do pass and be re-referred to the Committee on [Appropriations]",6,0,1,0,7
1086630,743781,2018-04-24,Senate,"Do pass, but first be re-referred to the Committee on [Appropriations] with the recommendation: To Consent Calendar",7,0,0,0,7
1086630,754318,2018-05-17,Senate,"Consent Calendar SB1077",38,0,1,0,39
1086630,765209,2018-06-19,Assembly,"Do pass and be re-referred to the Committee on [Appropriations]",10,0,0,0,10
1086630,771754,2018-08-16,Assembly,"Do pass as amended",12,0,5,0,17
1086632,771145,2018-08-09,Senate,"Senate 3rd Reading SCR101 Roth et al",36,0,3,0,39
1086632,772271,2018-08-20,Assembly,"Be adopted. To Consent Calendar",9,0,2,0,11
1086632,772618,2018-08-23,Assembly,"SCR 101 Roth Consent Calendar Second Day Regular Session",75,0,5,0,80
1086634,725835,2018-03-20,Assembly,"Do pass as amended and be re-referred to the Committee on [Appropriations]",7,0,0,0,7
1086634,733928,2018-04-04,Assembly,"Do pass. To Consent Calendar",15,0,2,0,17
1086634,738200,2018-04-12,Assembly,"AB 2169 VOEPEL Consent Calendar Second Day Regular Session",68,0,9,0,77
1086634,753265,2018-05-15,Senate,"Do pass as amended, but first amend, and re-refer to the Committee on [Appropriations]",5,0,2,0,7
1086634,770349,2018-08-06,Senate,"Assembly 3rd Reading AB2169 Voepel By Bates",35,0,4,0,39
1086634,771155,2018-08-09,Assembly,"AB 2169 VOEPEL Concurrence in Senate Amendments",75,1,4,0,80
1086634,777294,2018-08-06,Senate,,5,0,4,0,9
1086635,737681,2018-04-11,Assembly,"Do pass",9,0,0,0,9
1086635,741460,2018-04-19,Assembly,"AB 2137 MAYES Assembly Third Reading",72,0,6,0,78
1086635,763205,2018-06-13,Senate,"Do pass as amended",7,0,0,0,7
1086635,771271,2018-08-13,Senate,"Special Consent AB2137",37,0,3,0,40
1086635,772307,2018-08-20,Assembly,"AB 2137 MAYES Concurrence in Senate Amendments",80,0,0,0,80
1086637,736301,2018-04-10,Senate,"Do pass, but first be re-referred to the Committee on [Energy, Utilities and Communications]",13,0,0,0,13
1086637,744017,2018-04-25,Senate,"Do pass as amended, but first amend, and re-refer to the Committee on [Appropriations]",10,0,1,0,11
1086637,757818,2018-05-30,Senate,"Senate 3rd Reading SB1080 Newman",37,0,2,0,39
1086637,766166,2018-06-20,Assembly,"Do pass and be re-referred to the Committee on [Transportation]",11,0,2,0,13
1086637,767850,2018-06-25,Assembly,"Do pass and be re-referred to the Committee on [Appropriations] with recommendation: To Consent Calendar",13,0,1,0,14
1086637,771115,2018-08-08,Assembly,"Do pass. To Consent Calendar",17,0,0,0,17
1086637,771616,2018-08-16,Assembly,"SB 1080 Roth Consent Calendar Second Day Regular Session",76,0,4,0,80
1086637,772143,2018-08-20,Senate,"Unfinished Business SB1080 Roth Concurrence",39,0,1,0,40
1086638,733805,2018-04-03,Assembly,"Do pass and be re-referred to the Committee on [Appropriations]",13,0,0,0,13
1086638,740831,2018-04-18,Assembly,"Do pass",13,1,3,0,17
1086638,742154,2018-04-23,Assembly,"AB 2210 MCCARTY Assembly Third Reading",68,4,6,0,78
1086638,768717,2018-06-27,Senate,"Do pass as amended, but first amend, and re-refer to the Committee on [Appropriations] with the recommendation: To Consent Calendar",7,0,0,0,7
1086638,771274,2018-08-13,Senate,"Consent Calendar AB2210",37,0,3,0,40
1086638,773378,2018-08-29,Assembly,"AB 2210 MCCARTY Concurrence in Senate Amendments",75,3,2,0,80
1086640,740894,2018-04-17,Assembly,"Do pass and be re-referred to the Committee on [Appropriations]",15,0,0,0,15
1086642,750721,2018-05-08,Assembly,"Do pass as amended",10,0,0,0,10
1086642,754388,2018-05-17,Assembly,"AB 2219 TING Assembly Third Reading",68,0,10,0,78
1086642,765937,2018-06-19,Senate,"Do pass and be ordered to the Consent Calendar",7,0,0,0,7
1086642,769565,2018-07-02,Senate,"Consent Calendar AB2219 Ting",37,0,2,0,39
1086642,771252,2018-08-13,Assembly,"AB 2219 TING Concurrence in Senate Amendments",77,0,3,0,80
1086644,737317,2018-04-11,Senate,"Do pass as amended, but first amend, and re-refer to the Committee on [Appropriations] with the recommendation: To Consent Calendar",6,0,0,0,6
1086644,746144,2018-04-30,Senate,"Placed on suspense file",6,0,1,0,7
1086644,756193,2018-05-25,Senate,"Do pass",7,0,0,0,7
1086644,758477,2018-05-31,Senate,"Special Consent SB1071",39,0,0,0,39
1086644,768937,2018-06-26,Assembly,"Do pass and be re-referred to the Committee on [Appropriations]",12,0,1,0,13
1086644,771602,2018-08-16,Assembly,"Do pass as amended",12,0,5,0,17
1086644,773612,2018-08-29,Assembly,"SB 1071 Roth Senate Third Reading By IRWIN",79,0,1,0,80
1086644,773816,2018-08-30,Senate,"Unfinished Business SB1071 Roth et al. Concurrence",39,0,1,0,40
1086647,736075,2018-04-10,Assembly,"Do pass and be re-referred to the Committee on [Appropriations] with recommendation: To Consent Calendar",7,0,0,0,7
1086648,743176,2018-04-24,Senate,"Do pass as amended, but first amend, and re-refer to the Committee on [Appropriations]",12,0,0,0,12
1086648,757211,2018-05-29,Senate,"Senate 3rd Reading SB1076 Hertzberg et al",38,0,1,0,39
1086648,769192,2018-06-28,Assembly,"Do pass as amended and be re-referred to the Committee on [Appropriations]",19,0,2,0,21
1086648,771060,2018-08-08,Assembly,"Do pass as amended",17,0,0,0,17
1086648,772489,2018-08-23,Assembly,"SB 1076 Hertzberg Senate Third Reading By RIVAS",79,0,1,0,80
1086648,772713,2018-08-24,Senate,"Unfinished Business SB1076 Hertzberg et al. Concurrence",39,0,1,0,40
1086651,736153,2018-04-10,Assembly,"Do pass as amended, and be re-referred to the Committee on [Appropriations] with recommendation: To Consent Calendar",7,0,0,0,7
1086651,756528,2018-05-25,Assembly,"Do pass",16,0,1,0,17
1086651,757080,2018-05-29,Assembly,"AB 2175 AGUIAR-CURRY Assembly Third Reading",78,0,0,0,78
1086651,764899,2018-06-19,Senate,"Do pass, but first be re-referred to the Committee on [Appropriations] with the recommendation: To Consent Calendar",7,0,0,0,7
1086651,771273,2018-08-13,Senate,"Consent Calendar AB2175",37,0,3,0,40
1086651,772174,2018-08-20,Assembly,"AB 2175 AGUIAR-CURRY Concurrence in Senate Amendments",80,0,0,0,80
1086653,743168,2018-04-23,Assembly,"Do pass and be re-referred to the Committee on [Appropriations]",7,3,0,0,10
1086653,756608,2018-05-25,Assembly,"Do pass",12,4,1,0,17
1086653,757152,2018-05-29,Assembly,"AB 2195 CHAU Assembly Third Reading",52,23,3,0,78
1086653,767283,2018-06-20,Senate,"Do pass as amended, but first amend, and re-refer to the Committee on [Appropriations]",5,2,0,0,7
1086653,770252,2018-08-06,Senate,"Do pass",5,2,0,0,7
1086653,772317,2018-08-20,Senate,"Assembly 3rd Reading AB2195 Chau et al. By Stern",26,13,1,0,40
1086653,772590,2018-08-23,Assembly,"AB 2195 CHAU Concurrence in Senate Amendments",57,22,1,0,80
1086654,736030,2018-04-10,Senate,"Do pass, but first be re-referred to the Committee on [Appropriations]",6,0,1,0,7
1086654,745961,2018-04-30,Senate,"Placed on suspense file",6,0,1,0,7
1086654,756449,2018-05-25,Senate,"Do pass as amended",7,0,0,0,7
1086654,757569,2018-05-30,Senate,"Senate 3rd Reading SB1083 Mitchell et al",38,0,1,0,39
1086654,768742,2018-06-26,Assembly,"Do pass as amended and be re-referred to the Committee on [Appropriations]",7,0,0,0,7
1086654,771550,2018-08-16,Assembly,"Do pass as amended",12,0,5,0,17
1086654,773489,2018-08-29,Assembly,"SB 1083 Mitchell Senate Third Reading By STONE",80,0,0,0,80
1086654,773842,2018-08-30,Senate,"Unfinished Business SB1083 Mitchell et al. Concurrence",39,0,1,0,40
1086656,741234,2018-04-18,Senate,"Do pass, but first be re-referred to the Committee on [Appropriations]",7,0,0,0,7
1086656,746484,2018-04-30,Senate,"Placed on suspense file",6,0,1,0,7
1086657,742866,2018-04-24,Assembly,"Do pass as amended, and be re-referred to the Committee on [Appropriations] with recommendation: To Consent Calendar",16,0,0,0,16
1086657,751448,2018-05-09,Assembly,"Do pass. To Consent Calendar",16,0,1,0,17
1086657,754230,2018-05-17,Assembly,"AB 2134 RUBIO Consent Calendar Second Day Regular Session",73,0,5,0,78
1086657,767919,2018-06-25,Senate,"Do pass, but first be re-referred to the Committee on [Appropriations] with the recommendation: To Consent Calendar",9,0,0,0,9
1086657,771313,2018-08-13,Senate,"Consent Calendar AB2134",37,0,3,0,40
1086659,740576,2018-04-18,Senate,"Do pass and be ordered to the Consent Calendar",7,0,0,0,7
1086659,745965,2018-04-30,Senate,"Consent Calendar SB1055 Newman",36,0,3,0,39
1086659,767843,2018-06-25,Assembly,"Do pass. To Consent Calendar",10,0,1,0,11
1086659,771652,2018-08-16,Assembly,"SB 1055 Bradford Senate Third Reading By LIMÓN",77,0,3,0,80
1086659,773239,2018-08-28,Senate,"Unfinished Business SB1055 Bradford Concurrence",39,0,1,0,40
1086664,736518,2018-04-10,Senate,"Do pass, but first be re-referred to the Committee on [Appropriations]",7,0,0,0,7
1086664,742103,2018-04-23,Senate,"Senate 3rd Reading SB1053 Beall et al",38,0,1,0,39
1086664,762119,2018-06-12,Assembly,"Do pass",9,0,1,0,10
1086664,767892,2018-06-25,Assembly,"SB 1053 Beall Senate Third Reading By REYES",74,0,6,0,80
1086664,769587,2018-07-02,Senate,"Unfinished Business SB1053 Beall et al. Concurrence",37,0,2,0,39
1086666,740579,2018-04-18,Senate,"Do pass, but first be re-referred to the Committee on [Natural Resources and Water]",5,2,0,0,7
1086666,743013,2018-04-24,Senate,"Do pass as amended, but first amend, and re-refer to the Committee on [Appropriations]",7,2,0,0,9
1086666,755337,2018-05-22,Senate,"Placed on suspense file",7,0,0,0,7
1086666,756734,2018-05-25,Senate,"Do pass",5,2,0,0,7
1086666,757104,2018-05-29,Senate,"Senate 3rd Reading SB1072 Leyva",27,10,2,0,39
1086666,768376,2018-06-25,Assembly,"Do pass as amended and be re-referred to the Committee on [Appropriations]",9,1,0,0,10
1086666,771846,2018-08-16,Assembly,"Do pass as amended",12,1,4,0,17
1086666,773628,2018-08-29,Assembly,"SB 1072 Leyva Senate Third Reading By REYES",63,14,3,0,80
1086666,773928,2018-08-30,Senate,"Unfinished Business SB1072 Leyva et al. Concurrence",28,10,2,0,40
1086669,742865,2018-04-24,Senate,"Do pass, but first be re-referred to the Committee on [Appropriations] with the recommendation: To Consent Calendar",9,0,0,0,9
1086669,750135,2018-05-07,Senate,"Placed on suspense file",6,0,1,0,7
1086669,756697,2018-05-25,Senate,"Do pass",7,0,0,0,7
1086669,758535,2018-05-31,Senate,"Special Consent SB1073",39,0,0,0,39
1086669,768378,2018-06-26,Assembly,"Do pass and be re-referred to the Committee on [Appropriations]",15,0,0,0,15
1086669,771135,2018-08-08,Assembly,"Do pass. To Consent Calendar",17,0,0,0,17
1086669,771918,2018-08-16,Assembly,"SB 1073 Dodd Consent Calendar Second Day Regular Session",76,0,4,0,80
1086669,772299,2018-08-20,Senate,"Unfinished Business SB1073 Dodd Concurrence",39,0,1,0,40
1086671,725775,2018-03-20,Assembly,"Do pass as amended",10,0,0,0,10
1086671,734434,2018-04-05,Assembly,"AB 2173 SANTIAGO Assembly Third Reading",69,0,8,0,77
1086671,763022,2018-06-12,Senate,"Do pass and be ordered to the Consent Calendar",7,0,0,0,7
1086671,768101,2018-06-25,Senate,"Consent Calendar AB2173",36,0,3,0,39
1086674,743008,2018-04-23,Senate,"Do pass, but first be re-referred to the Committee on [Appropriations]",3,0,2,0,5
1086674,752070,2018-05-10,Senate,"Senate 3rd Reading SB1085 Skinner",25,12,2,0,39
1086674,766179,2018-06-20,Assembly,"Do pass and be re-referred to the Committee on [Appropriations]",5,1,1,0,7
1086674,771090,2018-08-08,Assembly,"Do pass",12,5,0,0,17
1086674,772568,2018-08-23,Assembly,"SB 1085 Skinner Senate Third Reading By CALDERON Amend By CALDERON Set #1",57,21,2,0,80
1086674,773074,2018-08-28,Assembly,"SB 1085 Skinner Senate Third Reading By CALDERON",55,21,4,0,80
1086674,773351,2018-08-29,Senate,"Unfinished Business SB1085 Skinner Concurrence",26,12,2,0,40
1086675,736189,2018-04-10,Assembly,"Do pass and be re-referred to the Committee on [Appropriations]",15,0,0,0,15
1086675,740855,2018-04-18,Assembly,"Do pass. To Consent Calendar",15,0,2,0,17
1086675,744940,2018-04-26,Assembly,"AB 2178 LIMÓN Consent Calendar Second Day Regular Session",74,0,4,0,78
1086675,768687,2018-06-27,Senate,"Do pass as amended, but first amend, and re-refer to the Committee on [Appropriations]",9,0,0,0,9
1086675,773635,2018-08-29,Senate,"Assembly 3rd Reading AB2178 Limón By Hill",39,0,1,0,40
1086675,773796,2018-08-30,Assembly,"AB 2178 LIMÓN Concurrence in Senate Amendments",79,0,1,0,80
1087465,736059,2018-04-10,Assembly,"Do pass and be re-referred to the Committee on [Appropriations] with recommendation: To Consent Calendar",7,0,0,0,7
1087766,740885,2018-04-17,Assembly,"Do pass as amended and be re-referred to the Committee on [Appropriations]",11,4,0,0,15
1087766,753835,2018-05-16,Assembly,"Do pass",12,5,0,0,17
1087766,757196,2018-05-29,Assembly,"AB 2299 CHU Assembly Third Reading",53,23,2,0,78
1087766,768865,2018-06-27,Senate,"Do pass as amended, but first amend, and re-refer to the Committee on [Appropriations]",9,0,0,0,9
1087766,771253,2018-08-13,Senate,"Placed on suspense file",7,0,0,0,7
1087766,771929,2018-08-16,Senate,"Do pass",5,2,0,0,7
1087766,772470,2018-08-22,Senate,"Assembly 3rd Reading AB2299 Chu By Pan",27,11,2,0,40
1087766,772901,2018-08-27,Assembly,"AB 2299 CHU Concurrence in Senate Amendments",54,25,1,0,80
1087767,733867,2018-04-04,Senate,"Do pass, but first be re-referred to the Committee on [Appropriations]",6,0,1,0,7
1087767,738830,2018-04-16,Senate,"Placed on suspense file",7,0,0,0,7
1087767,756209,2018-05-25,Senate,"Do pass",7,0,0,0,7
1087767,758494,2018-05-31,Senate,"Special Consent SB1115",39,0,0,0,39
1087767,768277,2018-06-25,Assembly,"Do pass as amended and be re-referred to the Committee on [Appropriations]",9,0,1,0,10
1087767,771561,2018-08-16,Assembly,"Do pass as amended",12,0,5,0,17
1087767,773546,2018-08-29,Assembly,"SB 1115 Hill Senate Third Reading By BERMAN",80,0,0,0,80
1087767,773857,2018-08-30,Senate,"Unfinished Business SB1115 Hill Concurrence",39,0,1,0,40
1087768,739878,2018-04-16,Assembly,"Do pass and be re-referred to the Committee on [Appropriations]",7,3,0,0,10
1087768,756674,2018-05-25,Assembly,"Do pass",12,4,1,0,17
1087768,772650,2018-08-24,Assembly,"AB 2303 THURMOND Third Reading Urgency Amend By THURMOND Set #1",47,24,9,0,80
1087769,743814,2018-04-24,Senate,"Do pass as amended, but first amend, and re-refer to the Committee on [Appropriations]",5,2,0,0,7
1087769,752573,2018-05-14,Senate,"Placed on suspense file",7,0,0,0,7
1087769,756492,2018-05-25,Senate,"Do pass as amended",5,2,0,0,7
1087769,757773,2018-05-30,Senate,"Senate 3rd Reading SB1121 Dodd",22,13,4,0,39
1087769,765027,2018-06-19,Assembly,"Do pass and be re-referred to the Committee on [Privacy and Consumer Protection]",6,3,1,0,10
1087769,769711,2018-07-03,Assembly,"Do pass as amended",9,0,1,0,10
1087769,772689,2018-08-24,Assembly,"SB 1121 Dodd Senate Third Reading Amend By CHAU Set #1",65,0,15,0,80
1087769,773065,2018-08-28,Assembly,"Do pass and be re-referred to the Committee on [Appropriations]",10,0,0,0,10
1087769,773961,2018-08-31,Assembly,"Do pass",12,0,5,0,17
1087769,774053,2018-08-31,Senate,"That the Assembly amendments be concurred in",7,0,0,0,7
1087769,774054,2018-08-31,Senate,"Unfinished Business SB1121 Dodd et al. Urgency Clause Concurrence",39,0,1,0,40
1087769,774055,2018-08-31,Assembly,"SB 1121 Dodd Third Reading Urgency",79,0,1,0,80
1087771,743511,2018-04-24,Assembly,"Do pass and be re-referred to the Committee on [Appropriations]",15,0,0,0,15
1087772,741217,2018-04-18,Senate,"Do pass as amended, but first amend, and re-refer to the Committee on [Appropriations]",7,0,0,0,7
1087772,752187,2018-05-10,Senate,"Senate 3rd Reading SB1133 Portantino",38,0,1,0,39
1087772,768425,2018-06-26,Assembly,"Do pass and be re-referred to the Committee on [Appropriations] with recommendation: To Consent Calendar",6,0,1,0,7
1087772,771051,2018-08-08,Assembly,"Do pass. To Consent Calendar",17,0,0,0,17
1087772,771822,2018-08-16,Assembly,"SB 1133 Portantino Consent Calendar Second Day Regular Session",76,0,4,0,80
1087772,772223,2018-08-20,Senate,"Unfinished Business SB1133 Portantino Concurrence",39,0,1,0,40
1087773,738444,2018-04-11,Assembly,"Do pass as amended. To Consent Calendar",7,0,0,0,7
1087773,742216,2018-04-23,Assembly,"AB 2239 GARCIA, E. Consent Calendar Second Day",75,0,3,0,78
1087773,763275,2018-06-13,Senate,"Do pass, but first be re-referred to the Committee on [Appropriations] with the recommendation: To Consent Calendar",7,0,0,0,7
1087773,769608,2018-07-02,Senate,"Consent Calendar AB2239",37,0,2,0,39
1087773,771213,2018-08-09,Assembly,"AB 2239 GARCIA, E. Concurrence in Senate Amendments",77,0,3,0,80
1087775,738783,2018-04-16,Assembly,"Do pass and be re-referred to the Committee on [Appropriations] with recommendation: To Consent Calendar",14,0,0,0,14
1087775,743806,2018-04-25,Assembly,"Do pass. To Consent Calendar",17,0,0,0,17
1087775,748725,2018-05-03,Assembly,"AB 2357 VOEPEL Consent Calendar Second Day Regular Session",71,0,7,0,78
1087775,762242,2018-06-12,Senate,"Do pass, but first be re-referred to the Committee on [Appropriations] with the recommendation: To Consent Calendar",12,0,1,0,13
1087775,769528,2018-07-02,Senate,"Consent Calendar AB2357",37,0,2,0,39
1087775,770365,2018-08-06,Assembly,"AB 2357 VOEPEL Concurrence in Senate Amendments",76,0,4,0,80
1087776,743718,2018-04-25,Assembly,"Do pass and be re-referred to the Committee on [Judiciary]",2,4,1,0,7
1087778,738225,2018-04-11,Assembly,"Do pass as amended and be re-referred to the Committee on [Judiciary]",7,0,0,0,7
1087778,743215,2018-04-24,Assembly,"Do pass as amended and be re-referred to the Committee on [Appropriations]",10,0,0,0,10
1087778,756388,2018-05-25,Assembly,"Do pass as amended",16,0,1,0,17
1087778,758833,2018-05-31,Assembly,"AB 2234 JONES-SAWYER Assembly Third Reading",77,0,1,0,78
1087778,766326,2018-06-20,Senate,"Do pass, but first be re-referred to the Committee on [Judiciary]",7,0,0,0,7
1087778,768985,2018-06-26,Senate,"Do pass as amended, but first amend, and re-refer to the Committee on [Appropriations]",7,0,0,0,7
1087778,770956,2018-08-06,Senate,"Placed on suspense file",7,0,0,0,7
1087778,771997,2018-08-16,Senate,"Do pass",7,0,0,0,7
1087778,772730,2018-08-24,Senate,"Special Consent AB2234",39,0,1,0,40
1087778,773418,2018-08-29,Assembly,"AB 2234 JONES-SAWYER Concurrence in Senate Amendments",79,0,1,0,80
1087779,727795,2018-03-21,Assembly,"Do pass and be re-referred to the Committee on [Appropriations] with recommendation: To Consent Calendar",6,0,1,0,7
1087779,743963,2018-04-25,Assembly,"Do pass. To Consent Calendar",17,0,0,0,17
1087779,748907,2018-05-03,Assembly,"AB 2301 BURKE Consent Calendar Second Day Regular Session",71,0,7,0,78
1087779,760510,2018-06-06,Senate,"Do pass, but first be re-referred to the Committee on [Appropriations] with the recommendation: To Consent Calendar",6,0,0,0,6
1087779,769540,2018-07-02,Senate,"Consent Calendar AB2301",37,0,2,0,39
1087781,733269,2018-04-03,Assembly,"Do pass as amended",9,0,1,0,10
1087781,741333,2018-04-19,Assembly,"AB 2298 CHAU Assembly Third Reading",72,0,6,0,78
1087781,769739,2018-07-03,Senate,"Do pass and be ordered to the Consent Calendar",7,0,0,0,7
1087781,772622,2018-08-23,Senate,"Assembly 3rd Reading AB2298 Chau By Monning",39,0,1,0,40
1087781,772787,2018-08-27,Assembly,"AB 2298 CHAU Concurrence in Senate Amendments",64,8,8,0,80
1087782,725667,2018-03-19,Assembly,"Do pass and be re-referred to the Committee on [Appropriations]",10,0,0,0,10
1087783,725440,2018-03-20,Assembly,"Do pass and be re-referred to the Committee on [Appropriations] with recommendation: To Consent Calendar",10,0,0,0,10
1087783,756649,2018-05-25,Assembly,"Do pass",16,0,1,0,17
1087783,757161,2018-05-29,Assembly,"AB 2350 OBERNOLTE Assembly Third Reading",78,0,0,0,78
1087783,766228,2018-06-19,Senate,"Do pass, but first be re-referred to the Committee on [Appropriations] with the recommendation: To Consent Calendar",7,0,0,0,7
1087783,770767,2018-08-06,Senate,"Placed on suspense file",7,0,0,0,7
1087783,771968,2018-08-16,Senate,"Do pass as amended",7,0,0,0,7
1087783,772581,2018-08-23,Senate,"Assembly 3rd Reading AB2350 Obernolte By Hertzberg",39,0,1,0,40
1087783,772846,2018-08-27,Assembly,"AB 2350 OBERNOLTE Concurrence in Senate Amendments",79,0,1,0,80
1087785,740769,2018-04-17,Assembly,"Do pass and be re-referred to the Committee on [Appropriations]",10,0,0,0,10
1087785,751687,2018-05-09,Assembly,"Do pass. To Consent Calendar",16,0,1,0,17
1087785,754303,2018-05-17,Assembly,"AB 2225 LIMÓN Consent Calendar Second Day Regular Session",73,0,5,0,78
1087785,768386,2018-06-26,Senate,"Do pass, but first be re-referred to the Committee on [Appropriations]",13,0,0,0,13
1087785,772989,2018-08-27,Senate,"Assembly 3rd Reading AB2225 Limón By Allen",39,0,1,0,40
1087785,773467,2018-08-29,Assembly,"AB 2225 LIMÓN Concurrence in Senate Amendments",80,0,0,0,80
1087786,733222,2018-04-03,Assembly,"Do pass and be re-referred to the Committee on [Appropriations]",6,1,0,0,7
1087787,744701,2018-04-24,Senate,"Do pass, but first be re-referred to the Committee on [Appropriations] with the recommendation: To Consent Calendar",11,0,2,0,13
1087787,750282,2018-05-07,Senate,"Placed on suspense file",6,0,1,0,7
1087787,756352,2018-05-25,Senate,"Do pass as amended",7,0,0,0,7
1087787,757597,2018-05-30,Senate,"Senate 3rd Reading SB1112 Roth",38,0,1,0,39
1087787,768102,2018-06-25,Assembly,"Do pass and be re-referred to the Committee on [Appropriations] with recommendation: To Consent Calendar",13,0,1,0,14
1087788,743754,2018-04-25,Senate,"Do pass, but first be re-referred to the Committee on [Appropriations]",8,0,1,0,9
1087788,752681,2018-05-14,Senate,"Placed on suspense file",7,0,0,0,7
1087791,735467,2018-04-09,Assembly,"Do pass and be re-referred to the Committee on [Appropriations]",14,0,0,0,14
1087791,756473,2018-05-25,Assembly,"Do pass",16,0,1,0,17
1087791,757078,2018-05-29,Assembly,"AB 2304 HOLDEN Assembly Third Reading",78,0,0,0,78
1087792,736123,2018-04-10,Assembly,"Do pass",3,2,2,0,7
1087792,736124,2018-04-10,Assembly,Reconsideration,7,0,0,0,7
1087792,742988,2018-04-24,Assembly,"Do pass",2,5,0,0,7
1087793,734172,2018-04-04,Senate,"Do pass as amended, but first amend, and re-refer to the Committee on [Appropriations]",6,0,0,0,6
1087793,742724,2018-04-23,Senate,"Placed on suspense file",7,0,0,0,7
1087793,756701,2018-05-25,Senate,"Do pass",7,0,0,0,7
1087793,758458,2018-05-31,Senate,"Special Consent SB1104",39,0,0,0,39
1087793,769008,2018-06-27,Assembly,"Do pass and be re-referred to the Committee on [Appropriations] with recommendation: To Consent Calendar",7,0,0,0,7
1087793,771775,2018-08-16,Assembly,"Do pass",17,0,0,0,17
1087793,773027,2018-08-27,Assembly,"SB 1104 Roth Senate Third Reading By O'DONNELL",80,0,0,0,80
1087793,773165,2018-08-28,Senate,"Unfinished Business SB1104 Roth et al. Concurrence",39,0,1,0,40
1087797,733218,2018-04-03,Assembly,"Do pass as amended, and be re-referred to the Committee on [Appropriations] with recommendation: To Consent Calendar",7,0,0,0,7
1087797,756387,2018-05-25,Assembly,"Do pass as amended",16,0,1,0,17
1087797,758791,2018-05-31,Assembly,"AB 2226 PATTERSON Assembly Third Reading",78,0,0,0,78
1087797,768158,2018-06-26,Senate,"Do pass and be ordered to the Consent Calendar",7,0,0,0,7
1087797,769612,2018-07-02,Senate,"Consent Calendar AB2226",37,0,2,0,39
1087798,740683,2018-04-17,Assembly,"Do pass as amended and be re-referred to the Committee on [Appropriations]",12,3,0,0,15
1087798,756242,2018-05-25,Assembly,"Do pass as amended",12,4,1,0,17
1087798,757698,2018-05-30,Assembly,"AB 2275 ARAMBULA Assembly Third Reading",53,23,2,0,78
1087798,766169,2018-06-20,Senate,"Do pass as amended, but first amend, and re-refer to the Committee on [Appropriations]",8,0,1,0,9
1087798,770516,2018-08-06,Senate,"Placed on suspense file",7,0,0,0,7
1087798,771835,2018-08-16,Senate,"Do pass",6,1,0,0,7
1087798,772440,2018-08-22,Senate,"Assembly 3rd Reading AB2275 Arambula By Pan",26,12,2,0,40
1087798,773055,2018-08-28,Assembly,"AB 2275 ARAMBULA Concurrence in Senate Amendments",56,23,1,0,80
1087800,726291,2018-03-21,Assembly,"Do pass as amended and be re-referred to the Committee on [Appropriations]",6,0,1,0,7
1087800,756635,2018-05-25,Assembly,"Do pass",16,0,1,0,17
1087800,757160,2018-05-29,Assembly,"AB 2252 LIMÓN Assembly Third Reading",78,0,0,0,78
1087800,768390,2018-06-26,Senate,"Do pass, but first be re-referred to the Committee on [Appropriations]",13,0,0,0,13
1087800,770842,2018-08-06,Senate,"Placed on suspense file",7,0,0,0,7
1087800,772005,2018-08-16,Senate,"Do pass as amended",7,0,0,0,7
1087800,772543,2018-08-23,Senate,"Assembly 3rd Reading AB2252 Limón By Hertzberg",39,0,1,0,40
1087800,773004,2018-08-27,Assembly,"AB 2252 LIMÓN Concurrence in Senate Amendments",80,0,0,0,80
1087803,733707,2018-04-04,Senate,"Do pass as amended, but first amend, and re-refer to the Committee on [Appropriations]",9,0,0,0,9
1087803,742181,2018-04-23,Senate,"Do pass",7,0,0,0,7
1087803,744871,2018-04-26,Senate,"Senate 3rd Reading SB1113 Monning",35,0,4,0,39
1087803,762417,2018-06-12,Assembly,"Do pass and be re-referred to the Committee on [Appropriations] with recommendation: To Consent Calendar",13,0,2,0,15
1087803,768891,2018-06-27,Assembly,"Do pass. To Consent Calendar",16,0,1,0,17
1087803,772294,2018-08-20,Assembly,"SB 1113 Monning Senate Third Reading By CARRILLO",80,0,0,0,80
1087803,772397,2018-08-21,Senate,"Unfinished Business SB1113 Monning et al. Concurrence",38,0,2,0,40
1087804,742927,2018-04-24,Assembly,"Do pass",15,0,0,0,15
1087806,725582,2018-03-20,Assembly,"Do pass and be re-referred to the Committee on [Appropriations] with recommendation: To Consent Calendar",7,0,0,0,7
1087806,734067,2018-04-04,Assembly,"Do pass. To Consent Calendar",15,0,2,0,17
1087806,738280,2018-04-12,Assembly,"AB 2313 STONE Consent Calendar Second Day Regular Session",68,0,9,0,77
1087806,762721,2018-06-12,Senate,"Do pass as amended, but first amend, and re-refer to the Committee on [Appropriations]",6,0,1,0,7
1087806,769559,2018-07-02,Senate,"Placed on suspense file",7,0,0,0,7
1087806,771991,2018-08-16,Senate,"Do pass as amended",7,0,0,0,7
1087806,773031,2018-08-27,Senate,"Assembly 3rd Reading AB2313 Mark Stone By Wiener",39,0,1,0,40
1087806,773290,2018-08-29,Assembly,"AB 2313 STONE Concurrence in Senate Amendments",80,0,0,0,80
1087807,733194,2018-04-03,Assembly,"Do pass and be re-referred to the Committee on [Appropriations] with recommendation: To Consent Calendar",15,0,0,0,15
1087809,734465,2018-04-05,Assembly,"Be re-referred to the Committees on [Judiciary] and [Human Services]",8,0,3,0,11
1087809,739579,2018-04-17,Assembly,"Do pass and be re-referred to the Committee on [Human Services] with recommendation: To Consent Calendar",10,0,0,0,10
1087809,743722,2018-04-24,Assembly,"Do pass and be re-referred to the Committee on [Appropriations]",7,0,0,0,7
1087812,736006,2018-04-10,Senate,"Do pass, but first be re-referred to the Committee on [Environmental Quality] with the recommendation: To Consent Calendar",13,0,0,0,13
1087812,740671,2018-04-18,Senate,"Do pass, but first be re-referred to the Committee on [Appropriations]",7,0,0,0,7
1087812,752180,2018-05-10,Senate,"Senate 3rd Reading SB1119 Newman",38,0,1,0,39
1087812,767959,2018-06-25,Assembly,"Do pass and be re-referred to the Committee on [Appropriations]",13,0,1,0,14
1087812,771892,2018-08-16,Assembly,"Do pass",17,0,0,0,17
1087812,773015,2018-08-27,Assembly,"SB 1119 Beall Senate Third Reading By BERMAN",80,0,0,0,80
1087812,773160,2018-08-28,Senate,"Unfinished Business SB1119 Beall Concurrence",39,0,1,0,40
1087813,750292,2018-05-02,Assembly,"Do pass and be re-referred to the Committee on [Health]",5,10,6,0,21
1087816,737337,2018-04-11,Assembly,"Do pass and be re-referred to the Committee on [Appropriations]",7,0,0,0,7
1087816,755736,2018-05-23,Assembly,"Do pass",16,0,1,0,17
1087816,757018,2018-05-29,Assembly,"AB 2245 BERMAN Assembly Third Reading",78,0,0,0,78
1087816,765902,2018-06-19,Senate,"Do pass, but first be re-referred to the Committee on [Appropriations]",5,0,0,0,5
1087816,769650,2018-07-02,Senate,"Placed on suspense file",7,0,0,0,7
1087816,771985,2018-08-16,Senate,"Do pass as amended",6,0,1,0,7
1087816,772443,2018-08-22,Senate,"Assembly 3rd Reading AB2245 Berman et al. By Jackson",39,0,1,0,40
1087816,772946,2018-08-27,Assembly,"AB 2245 BERMAN Concurrence in Senate Amendments",80,0,0,0,80
1087817,744507,2018-04-25,Senate,"Do pass as amended, but first amend, and re-refer to the Committee on [Appropriations]",10,0,1,0,11
1087817,755352,2018-05-22,Senate,"Placed on suspense file",7,0,0,0,7
1087817,756259,2018-05-25,Senate,"Do pass",6,0,1,0,7
1087817,757086,2018-05-29,Senate,"Senate 3rd Reading SB1135 Bradford",32,4,3,0,39
1087817,768784,2018-06-27,Assembly,"Do pass as amended and be re-referred to the Committee on [Appropriations]",10,0,5,0,15
1087817,771132,2018-08-08,Assembly,"Do pass",12,4,1,0,17
1087817,772311,2018-08-20,Assembly,"SB 1135 Bradford Senate Third Reading By QUIRK",59,17,4,0,80
1087817,772458,2018-08-22,Senate,"That the Assembly amendments be concurred in",10,1,0,0,11
1087817,772495,2018-08-23,Senate,"Unfinished Business SB1135 Bradford Concurrence",30,6,4,0,40
1087818,727763,2018-03-21,Assembly,"Do pass and be re-referred to the Committee on [Appropriations] with recommendation: To Consent Calendar",6,0,1,0,7
1087818,737197,2018-04-11,Assembly,"Do pass. To Consent Calendar",15,0,2,0,17
1087818,741384,2018-04-19,Assembly,"AB 2285 O'DONNELL Consent Calendar Second Day Regular Session",71,0,7,0,78
1087818,751237,2018-05-09,Senate,"Do pass, but first be re-referred to the Committee on [Appropriations] with the recommendation: To Consent Calendar",6,0,0,0,6
1087818,769554,2018-07-02,Senate,"Consent Calendar AB2285",37,0,2,0,39
1087819,735497,2018-04-09,Assembly,"Do pass and be re-referred to the Committee on [Appropriations] with recommendation: To Consent Calendar",12,0,2,0,14
1087819,756415,2018-05-25,Assembly,"Do pass",16,0,1,0,17
1087819,757077,2018-05-29,Assembly,"AB 2272 MAYES Assembly Third Reading",78,0,0,0,78
1087819,762156,2018-06-12,Senate,"Do pass, but first be re-referred to the Committee on [Appropriations] with the recommendation: To Consent Calendar",12,0,1,0,13
1087819,767829,2018-06-25,Senate,"Placed on suspense file",7,0,0,0,7
1087819,771742,2018-08-16,Senate,"Do pass",7,0,0,0,7
1087819,772330,2018-08-21,Senate,"Assembly 3rd Reading AB2272 Mayes By Stone",39,0,1,0,40
1087822,733261,2018-04-03,Assembly,"Do pass and be re-referred to the Committee on [Appropriations]",6,0,1,0,7
1087823,744874,2018-04-25,Assembly,"Do pass and be re-referred to the Committee on [Appropriations]",7,0,0,0,7
1087823,756456,2018-05-25,Assembly,"Do pass as amended",12,0,5,0,17
1087823,758695,2018-05-31,Assembly,"AB 2317 EGGMAN Assembly Third Reading",77,0,1,0,78
1087823,766024,2018-06-19,Senate,"Do pass, but first be re-referred to the Committee on [Appropriations] with the recommendation: To Consent Calendar",7,0,0,0,7
1087823,770397,2018-08-06,Senate,"Placed on suspense file",7,0,0,0,7
1087823,771838,2018-08-16,Senate,"Do pass",7,0,0,0,7
1087823,772690,2018-08-24,Senate,"Special Consent AB2317",39,0,1,0,40
1087824,739602,2018-04-17,Senate,"Do pass as amended, but first amend, and re-refer to the Committee on [Appropriations]",7,0,0,0,7
1087824,752738,2018-05-14,Senate,"Placed on suspense file",7,0,0,0,7
1087824,756338,2018-05-25,Senate,"Do pass",7,0,0,0,7
1087824,758421,2018-05-31,Senate,"Special Consent SB1094",39,0,0,0,39
1087824,768301,2018-06-26,Assembly,"Do pass and be re-referred to the Committee on [Appropriations] with recommendation: To Consent Calendar",7,0,0,0,7
1087826,725496,2018-03-20,Assembly,"Do pass",7,0,0,0,7
1087826,734458,2018-04-05,Assembly,"AB 2243 FRIEDMAN Assembly Third Reading",67,0,10,0,77
1087826,753256,2018-05-15,Senate,"Do pass and be ordered to the Consent Calendar",7,0,0,0,7
1087826,754909,2018-05-21,Senate,"Consent Calendar AB2243",39,0,0,0,39
1087826,757042,2018-05-29,Assembly,"AB 2243 FRIEDMAN Concurrence in Senate Amendments",77,0,1,0,78
1087829,740089,2018-04-17,Senate,"Do pass, but first be re-referred to the Committee on [Health]",6,0,1,0,7
1087829,743946,2018-04-25,Senate,"Do pass as amended, but first amend, and re-refer to the Committee on [Appropriations]",9,0,0,0,9
1087829,752965,2018-05-14,Senate,"Placed on suspense file",7,0,0,0,7
1087829,756396,2018-05-25,Senate,"Do pass",7,0,0,0,7
1087829,758495,2018-05-31,Senate,"Special Consent SB1138",39,0,0,0,39
1087829,765478,2018-06-19,Assembly,"Do pass and be re-referred to the Committee on [Public Safety] with recommendation: To Consent Calendar",15,0,0,0,15
1087829,768140,2018-06-26,Assembly,"Do pass and be re-referred to the Committee on [Appropriations] with recommendation: To Consent Calendar",7,0,0,0,7
1087829,771891,2018-08-16,Assembly,"Do pass as amended",15,1,1,0,17
1087829,773563,2018-08-29,Assembly,"SB 1138 Skinner Senate Third Reading By KALRA",70,9,1,0,80
1087829,773821,2018-08-30,Senate,"Unfinished Business SB1138 Skinner Concurrence",39,0,1,0,40
1087830,740674,2018-04-18,Assembly,"Do pass and be re-referred to the Committee on [Appropriations]",13,0,0,0,13
1087830,756497,2018-05-25,Assembly,"Do pass as amended",12,0,5,0,17
1087830,758649,2018-05-31,Assembly,"AB 2276 BURKE Assembly Third Reading",75,0,3,0,78
1087830,769200,2018-06-27,Senate,"Do pass as amended, but first amend, and re-refer to the Committee on [Appropriations]",9,1,3,0,13
1087830,770392,2018-08-06,Senate,"Placed on suspense file",7,0,0,0,7
1087830,771518,2018-08-16,Senate,"Do pass",6,0,1,0,7
1087834,736899,2018-04-10,Senate,"Do pass, but first be re-referred to the Committee on [Natural Resources and Water]",2,2,3,0,7
1087834,736900,2018-04-10,Senate,"[04-10-2018] hearing: Motion to Reconsider. [Reconsideration Granted.]",7,0,0,0,7
1087837,736856,2018-04-09,Assembly,"Do pass as amended",7,1,2,0,10
1087837,742186,2018-04-23,Assembly,"AB 2341 MATHIS Assembly Third Reading",61,9,8,0,78
1087837,760497,2018-06-06,Senate,"Do pass as amended",4,0,3,0,7
1087837,771275,2018-08-13,Senate,"Assembly 3rd Reading AB2341 Mathis et al. By Wiener",27,8,5,0,40
1087837,772147,2018-08-20,Assembly,"AB 2341 MATHIS Concurrence in Senate Amendments",65,8,7,0,80
1087838,738858,2018-04-16,Assembly,"Do pass and be re-referred to the Committee on [Appropriations]",8,0,6,0,14
1087838,756758,2018-05-25,Assembly,"Do pass as amended",13,3,1,0,17
1087838,758815,2018-05-31,Assembly,"AB 2336 SALAS Assembly Third Reading",58,14,6,0,78
1087841,750710,2018-05-08,Assembly,"Do pass as amended",10,0,0,0,10
1087841,756392,2018-05-25,Assembly,"AB 2353 FRAZIER Assembly Third Reading",71,0,7,0,78
1087841,769702,2018-07-03,Senate,"Do pass and be ordered to the Consent Calendar",7,0,0,0,7
1087842,744886,2018-04-25,Assembly,"Do pass and be re-referred to the Committee on [Appropriations] with recommendation: To Consent Calendar",6,0,1,0,7
1087842,751707,2018-05-09,Assembly,"Do pass. To Consent Calendar",16,0,1,0,17
1087842,754307,2018-05-17,Assembly,"AB 2282 EGGMAN Consent Calendar Second Day Regular Session",73,0,5,0,78
1087842,763062,2018-06-13,Senate,"Do pass, but first be re-referred to the Committee on [Appropriations]",5,0,0,0,5
1087842,769773,2018-07-05,Senate,"Assembly 3rd Reading AB2282 Eggman By Jackson",35,0,4,0,39
1087843,743098,2018-04-24,Senate,"Do pass and be ordered to the Consent Calendar",6,0,1,0,7
1087843,746114,2018-04-30,Senate,"Consent Calendar SB1107 Leyva",36,0,3,0,39
1087843,762166,2018-06-12,Assembly,"Do pass",7,0,0,0,7
1087843,769184,2018-06-28,Assembly,"SB 1107 Leyva Senate Third Reading By REYES",75,0,5,0,80
1087846,734021,2018-04-04,Senate,"Do pass as amended, but first amend, and re-refer to the Committee on [Appropriations]",8,1,0,0,9
1087846,754942,2018-05-21,Senate,"Senate 3rd Reading SB1108 Hernandez et al",28,11,0,0,39
1087846,768129,2018-06-26,Assembly,"Do pass and be re-referred to the Committee on [Appropriations]",11,3,1,0,15
1087846,771493,2018-08-15,Assembly,"Do pass",12,5,0,0,17
1087846,772835,2018-08-27,Assembly,"SB 1108 Hernandez Senate Third Reading By BONTA",57,21,2,0,80
1087846,773199,2018-08-28,Senate,"Unfinished Business SB1108 Hernandez et al. Concurrence",29,10,1,0,40
1087848,744054,2018-04-24,Assembly,"Do pass and be re-referred to the Committee on [Appropriations]",7,0,0,0,7
1087848,756454,2018-05-25,Assembly,"Do pass",12,4,1,0,17
1087848,758611,2018-05-31,Assembly,"AB 2326 RUBIO Assembly Third Reading",54,21,3,0,78
1087848,769056,2018-06-26,Senate,"Do pass, but first be re-referred to the Committee on [Appropriations]",6,0,1,0,7
1087848,770835,2018-08-06,Senate,"Placed on suspense file",7,0,0,0,7
1087851,727892,2018-03-21,Assembly,"Do pass and be re-referred to the Committee on [Appropriations]",7,0,0,0,7
1087851,734264,2018-04-04,Assembly,"Do pass. To Consent Calendar",15,0,2,0,17
1087851,738257,2018-04-12,Assembly,"AB 2319 NAZARIAN Consent Calendar Second Day Regular Session",68,0,9,0,77
1087851,751897,2018-05-09,Senate,"Do pass, but first be re-referred to the Committee on [Appropriations] with the recommendation: To Consent Calendar",6,0,0,0,6
1087851,773217,2018-08-28,Senate,"Assembly 3rd Reading AB2319 Nazarian By McGuire",38,1,1,0,40
1087851,773346,2018-08-29,Assembly,"AB 2319 NAZARIAN Concurrence in Senate Amendments",76,2,2,0,80
1087852,753376,2018-05-14,Assembly,"Do pass and be re-referred to the Committee on [Appropriations]",8,0,2,0,10
1087853,738183,2018-04-11,Assembly,"Do pass and be re-referred to the Committee on [Appropriations]",7,1,2,0,10
1087853,756571,2018-05-25,Assembly,"Do pass as amended",12,4,1,0,17
1087853,757812,2018-05-30,Assembly,"AB 2335 TING Assembly Third Reading",62,16,0,0,78
1087853,765261,2018-06-19,Senate,"Do pass, but first be re-referred to the Committee on [Appropriations]",4,0,1,0,5
1087853,769624,2018-07-02,Senate,"Placed on suspense file",7,0,0,0,7
1087854,744898,2018-04-25,Assembly,"Do pass as amended and be re-referred to the Committee on [Appropriations]",7,0,0,0,7
1087856,738282,2018-04-11,Assembly,"Do pass as amended and be re-referred to the Committee on [Agriculture]",7,0,0,0,7
1087856,743877,2018-04-25,Assembly,"Do pass and be re-referred to the Committee on [Appropriations]",9,0,1,0,10
1087856,756516,2018-05-25,Assembly,"Do pass",16,0,1,0,17
1087856,757048,2018-05-29,Assembly,"AB 2360 RODRIGUEZ Assembly Third Reading",78,0,0,0,78
1087856,762713,2018-06-13,Senate,"Do pass, but first be re-referred to the Committee on [Agriculture] with the recommendation: To Consent Calendar",7,0,0,0,7
1087856,765320,2018-06-19,Senate,"Do pass, but first be re-referred to the Committee on [Appropriations]",4,0,1,0,5
1087856,769630,2018-07-02,Senate,"Placed on suspense file",7,0,0,0,7
1087856,771582,2018-08-16,Senate,"Do pass as amended",7,0,0,0,7
1087856,772387,2018-08-21,Senate,"Assembly 3rd Reading AB2360 Rodriguez By Wiener",38,0,2,0,40
1087856,773018,2018-08-27,Assembly,"AB 2360 RODRIGUEZ Concurrence in Senate Amendments",80,0,0,0,80
1087856,777826,2018-08-21,Senate,"Assembly 3rd Reading AB2360 Rodriguez",7,0,2,0,9
1087859,737222,2018-04-11,Senate,"Do pass as amended, but first amend, and re-refer to the Committee on [Appropriations]",6,0,1,0,7
1087859,746518,2018-04-30,Senate,"Placed on suspense file",6,0,1,0,7
1087859,756591,2018-05-25,Senate,"Do pass",7,0,0,0,7
1087859,758501,2018-05-31,Senate,"Special Consent SB1130",39,0,0,0,39
1087859,765997,2018-06-20,Assembly,"Do pass and be re-referred to the Committee on [Revenue and Taxation]",8,0,1,0,9
1087859,768110,2018-06-25,Assembly,"Do pass and be re-referred to the Committee on [Appropriations]",9,0,1,0,10
1087859,771879,2018-08-16,Assembly,"Do pass as amended",12,0,5,0,17
1087859,773494,2018-08-29,Assembly,"SB 1130 Leyva Senate Third Reading By AGUIAR-CURRY",80,0,0,0,80
1087859,773942,2018-08-30,Senate,"That the Assembly amendments be concurred in",7,0,0,0,7
1087859,773995,2018-08-31,Senate,"Unfinished Business SB1130 Leyva et al. Concurrence",39,0,1,0,40
1087862,733894,2018-04-03,Assembly,"Do pass and be re-referred to the Committee on [Appropriations]",9,2,2,0,13
1087863,726205,2018-03-19,Assembly,"Do pass and be re-referred to the Committee on [Appropriations]",10,0,0,0,10
1087865,733287,2018-04-03,Assembly,"Do pass and be re-referred to the Committee on [Appropriations]",16,0,0,0,16
1087865,740928,2018-04-18,Assembly,"Do pass. To Consent Calendar",15,0,2,0,17
1087865,744935,2018-04-26,Assembly,"AB 2281 IRWIN Consent Calendar Second Day Regular Session",74,0,4,0,78
1087865,761758,2018-06-11,Senate,"Do pass as amended, but first amend, and re-refer to the Committee on [Appropriations]",6,0,3,0,9
1087865,771193,2018-08-09,Senate,"Assembly 3rd Reading AB2281 Irwin By Hill",27,1,11,0,39
1087865,771250,2018-08-13,Assembly,"AB 2281 IRWIN Concurrence in Senate Amendments",71,0,9,0,80
1087866,742700,2018-04-23,Senate,"Do pass, but first be re-referred to the Committee on [Appropriations]",9,0,0,0,9
1087866,756996,2018-05-29,Senate,"Senate 3rd Reading SB1098 Cannella",38,0,1,0,39
1087866,756997,2018-05-29,Senate,"Senate 3rd Reading SB1098 Cannella Reconsider",38,0,1,0,39
1087866,756998,2018-05-29,Senate,"Senate 3rd Reading SB1098 Cannella",37,0,2,0,39
1087866,765199,2018-06-19,Assembly,"Do pass and be re-referred to the Committee on [Appropriations]",17,0,2,0,19
1087866,768998,2018-06-27,Assembly,"Do pass. To Consent Calendar",16,0,1,0,17
1087866,769791,2018-07-05,Assembly,"SB 1098 Cannella Consent Calendar Second Day Regular Session",69,0,11,0,80
1087868,733281,2018-04-03,Assembly,"Do pass as amended. To Consent Calendar",10,0,0,0,10
1087868,742487,2018-04-23,Assembly,"AB 2286 CHEN Assembly Third Reading",70,4,4,0,78
1087868,762763,2018-06-12,Senate,"Do pass as amended",7,0,0,0,7
1087868,769586,2018-07-02,Senate,"Assembly 3rd Reading AB2286 Chen By Anderson",37,0,2,0,39
1087868,771179,2018-08-09,Assembly,"AB 2286 CHEN Concurrence in Senate Amendments",75,1,4,0,80
1087869,742898,2018-04-24,Assembly,"Do pass and be re-referred to the Committee on [Appropriations]",15,0,0,0,15
1087869,756335,2018-05-25,Assembly,"Do pass",16,0,1,0,17
1087869,757121,2018-05-29,Assembly,"AB 2348 AGUIAR-CURRY Assembly Third Reading",77,0,1,0,78
1087869,768214,2018-06-26,Senate,"Do pass, but first be re-referred to the Committee on [Appropriations]",9,0,0,0,9
1087869,771254,2018-08-13,Senate,"Placed on suspense file",7,0,0,0,7
1087869,771877,2018-08-16,Senate,"Do pass as amended",7,0,0,0,7
1087869,773510,2018-08-29,Senate,"Assembly 3rd Reading AB2348 Aguiar-Curry By Nielsen",39,0,1,0,40
1087869,773789,2018-08-30,Assembly,"AB 2348 AGUIAR-CURRY Concurrence in Senate Amendments",78,0,2,0,80
1087873,727807,2018-03-21,Assembly,"Do pass and be re-referred to the Committee on [Appropriations]",6,1,0,0,7
1087873,756656,2018-05-25,Assembly,"Do pass",13,3,1,0,17
1087873,757833,2018-05-30,Assembly,"AB 2271 QUIRK-SILVA Assembly Third Reading",63,11,4,0,78
1087873,762769,2018-06-13,Senate,"Do pass, but first be re-referred to the Committee on [Appropriations]",7,0,0,0,7
1087873,769671,2018-07-02,Senate,"Placed on suspense file",7,0,0,0,7
1087873,771895,2018-08-16,Senate,"Do pass",5,2,0,0,7
1087873,772711,2018-08-24,Senate,"Assembly 3rd Reading AB2271 Quirk-Silva By Delgado",32,5,3,0,40
1087874,736169,2018-04-10,Assembly,"Do pass and be re-referred to the Committee on [Appropriations] with recommendation: To Consent Calendar",7,0,0,0,7
1087878,743364,2018-04-24,Assembly,"Do pass. To Consent Calendar",15,0,0,0,15
1087878,748853,2018-05-03,Assembly,"AB 2325 IRWIN Consent Calendar Second Day Regular Session",71,0,7,0,78
1087878,760349,2018-06-06,Senate,"Do pass, but first be re-referred to the Committee on [Veterans Affairs] with the recommendation: To Consent Calendar",8,0,1,0,9
1087878,768377,2018-06-26,Senate,"Do pass and be ordered to the Consent Calendar",6,0,0,0,6
1087878,769542,2018-07-02,Senate,"Consent Calendar AB2325",37,0,2,0,39
1087880,744490,2018-04-25,Senate,"Do pass as amended, but first amend, and re-refer to the Committee on [Appropriations]",10,0,1,0,11
1087880,755359,2018-05-22,Senate,"Placed on suspense file",7,0,0,0,7
1087880,756281,2018-05-25,Senate,"Do pass as amended",7,0,0,0,7
1087880,757664,2018-05-30,Senate,"Senate 3rd Reading SB1131 Hertzberg et al",36,0,3,0,39
1087880,768989,2018-06-27,Assembly,"Do pass as amended and be re-referred to the Committee on [Appropriations]",13,0,2,0,15
1087880,771863,2018-08-16,Assembly,"Do pass as amended",12,0,5,0,17
1087880,773485,2018-08-29,Assembly,"SB 1131 Hertzberg Senate Third Reading By HOLDEN",79,0,1,0,80
1087880,773939,2018-08-30,Senate,"Unfinished Business SB1131 Hertzberg et al. Concurrence",39,0,1,0,40
1087881,740794,2018-04-18,Assembly,"Do pass as amended and be re-referred to the Committee on [Appropriations]",6,3,0,0,9
1087881,756325,2018-05-25,Assembly,"Do pass",13,3,1,0,17
1087881,757721,2018-05-30,Assembly,"AB 2258 CABALLERO Assembly Third Reading",57,19,2,0,78
1087881,766071,2018-06-20,Senate,"Do pass, but first be re-referred to the Committee on [Natural Resources and Water]",5,1,1,0,7
1087881,768184,2018-06-26,Senate,"Do pass as amended, but first amend, and re-refer to the Committee on [Appropriations]",7,2,0,0,9
1087881,771368,2018-08-13,Senate,"Placed on suspense file",7,0,0,0,7
1087881,771944,2018-08-16,Senate,"Do pass",5,2,0,0,7
1087881,773595,2018-08-29,Senate,"Assembly 3rd Reading AB2258 Caballero et al. By Hertzberg",31,8,1,0,40
1087881,773701,2018-08-30,Assembly,"AB 2258 CABALLERO Concurrence in Senate Amendments",59,19,2,0,80
1087884,746180,2018-04-30,Assembly,"Do pass",11,0,0,0,11
1087884,750069,2018-05-07,Assembly,"AB 2237 MAIENSCHEIN Assembly Third Reading",74,0,4,0,78
1087884,760499,2018-06-06,Senate,"Do pass and be ordered to the Consent Calendar",6,0,1,0,7
1087884,763443,2018-06-14,Senate,"Consent Calendar AB2237",37,0,2,0,39
1087884,767222,2018-06-21,Assembly,"AB 2237 MAIENSCHEIN Concurrence in Senate Amendments",75,0,5,0,80
1087888,733213,2018-04-03,Assembly,"Do pass and be re-referred to the Committee on [Appropriations] with recommendation: To Consent Calendar",10,0,0,0,10
1087888,756587,2018-05-25,Assembly,"Do pass",16,0,1,0,17
1087888,757156,2018-05-29,Assembly,"AB 2294 OBERNOLTE Assembly Third Reading",78,0,0,0,78
1087888,768980,2018-06-26,Senate,"Do pass, but first be re-referred to the Committee on [Appropriations] with the recommendation: To Consent Calendar",7,0,0,0,7
1087888,771353,2018-08-13,Senate,"Consent Calendar AB2294",37,0,3,0,40
1087889,747698,2018-05-02,Assembly,"Do pass. To Consent Calendar",20,0,1,0,21
1087889,752043,2018-05-10,Assembly,"AB 2330 BIGELOW Consent Calendar Second Day Regular Session",73,0,5,0,78
1087889,762354,2018-06-12,Senate,"Do pass and be ordered to the Consent Calendar",10,0,2,0,12
1087889,771455,2018-08-14,Senate,"Do pass, but first be re-referred to the Committee on [Appropriations]",13,0,0,0,13
1087889,772604,2018-08-23,Senate,"Assembly 3rd Reading AB2330 Bigelow By Wilk Urgency Clause",38,0,2,0,40
1087889,773459,2018-08-29,Assembly,"With recommendation: That Senate amendments be concurred in",14,0,0,0,14
1087889,773935,2018-08-30,Assembly,"AB 2330 BIGELOW Concurrence - Urgency Added",79,0,1,0,80
1087892,741706,2018-04-18,Assembly,"Do pass and be re-referred to the Committee on [Appropriations]",7,0,0,0,7
1087892,756759,2018-05-25,Assembly,"Do pass as amended",12,0,5,0,17
1087892,758812,2018-05-31,Assembly,"AB 2338 LEVINE Assembly Third Reading",73,1,4,0,78
1087892,765220,2018-06-19,Senate,"Do pass, but first be re-referred to the Committee on [Appropriations]",5,0,0,0,5
1087892,769646,2018-07-02,Senate,"Placed on suspense file",7,0,0,0,7
1087892,772062,2018-08-16,Senate,"Do pass as amended",7,0,0,0,7
1087892,773177,2018-08-28,Senate,"Assembly 3rd Reading AB2338 Levine By Jackson",35,2,3,0,40
1087892,773438,2018-08-29,Assembly,"AB 2338 LEVINE Concurrence in Senate Amendments",72,4,4,0,80
1087894,750596,2018-05-08,Assembly,"Do pass as amended",10,0,0,0,10
1087894,754335,2018-05-17,Assembly,"AB 2230 BERMAN Assembly Third Reading",72,0,6,0,78
1087894,769703,2018-07-03,Senate,"Do pass and be ordered to the Consent Calendar",7,0,0,0,7
1087894,772518,2018-08-23,Senate,"Assembly 3rd Reading AB2230 Berman et al. By Wieckowski",39,0,1,0,40
1087894,772937,2018-08-27,Assembly,"AB 2230 BERMAN Concurrence in Senate Amendments",78,1,1,0,80
1087895,740619,2018-04-17,Senate,"Do pass, but first be re-referred to the Committee on [Judiciary]",11,0,2,0,13
1087895,751427,2018-05-08,Senate,"Do pass as amended",6,0,1,0,7
1087895,754976,2018-05-21,Senate,"Senate 3rd Reading SB1128 Roth",36,1,2,0,39
1087895,762978,2018-06-13,Assembly,"Do pass as amended and be re-referred to the Committee on [Judiciary]",7,0,0,0,7
1087895,769737,2018-07-03,Assembly,"Do pass as amended",8,0,2,0,10
1087895,773921,2018-08-30,Assembly,"SB 1128 Roth Senate Third Reading By CERVANTES",76,0,4,0,80
1087895,774105,2018-08-31,Senate,"Unfinished Business SB1128 Roth Concurrence",38,0,2,0,40
1087901,751633,2018-05-09,Senate,"Do pass as amended, but first amend, and re-refer to the Committee on [Appropriations]",6,0,1,0,7
1087901,755351,2018-05-22,Senate,"Placed on suspense file",7,0,0,0,7
1087904,743227,2018-04-24,Assembly,"Do pass as amended and be re-referred to the Committee on [Appropriations]",12,3,0,0,15
1087904,756540,2018-05-25,Assembly,"Do pass as amended",12,4,1,0,17
1087904,758794,2018-05-31,Assembly,"AB 2293 REYES Assembly Third Reading",42,29,7,0,78
1087904,768813,2018-06-27,Senate,"Do pass as amended, but first amend, and re-refer to the Committee on [Appropriations]",7,2,0,0,9
1087904,770384,2018-08-06,Senate,"Placed on suspense file",7,0,0,0,7
1087904,771870,2018-08-16,Senate,"Do pass",5,2,0,0,7
1087904,772540,2018-08-23,Senate,"Assembly 3rd Reading AB2293 Reyes By Skinner",26,13,1,0,40
1087904,772820,2018-08-27,Assembly,"AB 2293 REYES Concurrence in Senate Amendments",52,25,3,0,80
1087905,725432,2018-03-20,Assembly,"Do pass. To Consent Calendar",10,0,0,0,10
1087905,732551,2018-04-02,Assembly,"AB 2236 MAIENSCHEIN Consent Calendar Second Day Regular Session",73,0,4,0,77
1087905,762944,2018-06-12,Senate,"Do pass and be ordered to the Consent Calendar",7,0,0,0,7
1087905,767972,2018-06-25,Senate,"Consent Calendar AB2236",36,0,3,0,39
1087905,769623,2018-07-02,Assembly,"AB 2236 MAIENSCHEIN Concurrence in Senate Amendments",77,0,3,0,80
1087906,736099,2018-04-10,Senate,"Do pass, but first be re-referred to the Committee on [Appropriations]",5,2,0,0,7
1087906,742295,2018-04-23,Senate,"Placed on suspense file",7,0,0,0,7
1087907,743821,2018-04-25,Assembly,"Do pass and be re-referred to the Committee on [Appropriations]",14,0,1,0,15
1087907,755703,2018-05-23,Assembly,"Do pass. To Consent Calendar",16,0,1,0,17
1087907,757136,2018-05-29,Assembly,"AB 2346 QUIRK Consent Calendar Second Day Regular Session",78,0,0,0,78
1087907,768880,2018-06-27,Senate,"Do pass as amended, but first amend, and re-refer to the Committee on [Appropriations]",6,1,4,0,11
1087907,772877,2018-08-27,Senate,"Assembly 3rd Reading AB2346 Quirk By Bradford",39,0,1,0,40
1087907,773874,2018-08-30,Assembly,"With recommendation: That Senate amendments be concurred in",8,0,6,0,14
1087907,774043,2018-08-31,Assembly,"AB 2346 QUIRK Concurrence in Senate Amendments",80,0,0,0,80
1087910,727963,2018-03-21,Assembly,"Do pass as amended, and be re-referred to the Committee on [Appropriations] with recommendation: To Consent Calendar",6,0,1,0,7
1087910,756739,2018-05-25,Assembly,"Do pass as amended",16,0,1,0,17
1087910,758632,2018-05-31,Assembly,"AB 2228 WOOD Assembly Third Reading",78,0,0,0,78
1087911,743773,2018-04-25,Assembly,"Do pass and be re-referred to the Committee on [Appropriations]",7,0,0,0,7
1087911,756188,2018-05-25,Assembly,"Do pass",16,0,1,0,17
1087911,757137,2018-05-29,Assembly,"AB 2352 LOW Assembly Third Reading",78,0,0,0,78
1087911,765631,2018-06-19,Senate,"Do pass as amended, but first amend, and re-refer to the Committee on [Appropriations]",5,0,0,0,5
1087911,770799,2018-08-06,Senate,"Placed on suspense file",7,0,0,0,7
1087911,772026,2018-08-16,Senate,"Do pass",7,0,0,0,7
1087911,772927,2018-08-27,Senate,"Assembly 3rd Reading AB2352 Low By Beall",39,0,1,0,40
1087911,773666,2018-08-29,Assembly,"AB 2352 LOW Concurrence in Senate Amendments",79,0,1,0,80
1087914,740961,2018-04-18,Assembly,"Do pass as amended and be re-referred to the Committee on [Appropriations]",9,3,3,0,15
1087916,737741,2018-04-11,Assembly,"Do pass. To Consent Calendar",9,0,0,0,9
1087916,741470,2018-04-19,Assembly,"AB 2249 COOLEY Consent Calendar Second Day Regular Session",71,0,7,0,78
1087916,762760,2018-06-13,Senate,"Do pass, but first be re-referred to the Committee on [Appropriations] with the recommendation: To Consent Calendar",7,0,0,0,7
1087916,769550,2018-07-02,Senate,"Consent Calendar AB2249",37,0,2,0,39
1087916,770541,2018-08-06,Assembly,"AB 2249 COOLEY Concurrence in Senate Amendments",74,0,6,0,80
1087917,733885,2018-04-04,Senate,"Do pass as amended, but first amend, and re-refer to the Committee on [Judiciary]",5,1,0,0,6
1087917,751405,2018-05-08,Senate,"Do pass as amended",6,1,0,0,7
1087917,754968,2018-05-21,Senate,"Senate 3rd Reading SB1127 Hill et al",32,7,0,0,39
1087917,763079,2018-06-13,Assembly,"Do pass and be re-referred to the Committee on [Judiciary]",4,1,2,0,7
1087917,769717,2018-07-03,Assembly,"Do pass",7,3,0,0,10
1087917,772635,2018-08-23,Assembly,"SB 1127 Hill Senate Third Reading By MULLIN",39,24,17,0,80
1087917,772980,2018-08-27,Assembly,"SB 1127 Hill Senate Third Reading By MULLIN",42,29,9,0,80
1087918,733303,2018-04-03,Assembly,"Do pass as amended and be re-referred to the Committee on [Public Safety]",8,1,1,0,10
1087918,750707,2018-05-08,Assembly,"Do pass",5,1,1,0,7
1087918,758824,2018-05-31,Assembly,"AB 2240 GRAYSON Assembly Third Reading",59,7,12,0,78
1087918,768379,2018-06-26,Senate,"Do pass",4,2,1,0,7
1087918,772747,2018-08-24,Senate,"Assembly 3rd Reading AB2240 Grayson By Galgiani",27,9,4,0,40
1087920,724852,2018-03-19,Assembly,"Do pass and be re-referred to the Committee on [Appropriations] with recommendation: To Consent Calendar",13,0,1,0,14
1087920,733886,2018-04-04,Assembly,"Do pass. To Consent Calendar",15,0,2,0,17
1087920,738260,2018-04-12,Assembly,"AB 2322 DALY Consent Calendar Second Day Regular Session",68,0,9,0,77
1087920,753667,2018-05-15,Senate,"Do pass, but first be re-referred to the Committee on [Appropriations] with the recommendation: To Consent Calendar",7,0,0,0,7
1087920,771420,2018-08-13,Senate,"Assembly 3rd Reading AB2322 Daly By Wieckowski",36,0,4,0,40
1087920,772298,2018-08-20,Assembly,"AB 2322 DALY Concurrence in Senate Amendments",80,0,0,0,80
1087922,741443,2018-04-18,Assembly,"Do pass and be re-referred to the Committee on [Appropriations]",5,1,1,0,7
1087922,756436,2018-05-25,Assembly,"Do pass as amended",12,4,1,0,17
1087922,758722,2018-05-31,Assembly,"AB 2334 THURMOND Assembly Third Reading",48,24,6,0,78
1087922,768971,2018-06-27,Senate,"Do pass, but first be re-referred to the Committee on [Appropriations]",4,1,0,0,5
1087922,770561,2018-08-06,Senate,"Placed on suspense file",7,0,0,0,7
1087922,771636,2018-08-16,Senate,"Do pass as amended",5,2,0,0,7
1087922,773636,2018-08-29,Senate,"Assembly 3rd Reading AB2334 Thurmond By Monning",27,12,1,0,40
1087922,774070,2018-08-31,Assembly,"With recommendation: That Senate amendments be concurred in",7,0,0,0,7
1087922,774071,2018-08-31,Assembly,"AB 2334 Thurmond Concurrence in Senate Amendments",54,23,3,0,80
1087923,734469,2018-04-04,Assembly,"Do pass and be re-referred to the Committee on [Appropriations]",21,0,0,0,21
1087923,741213,2018-04-18,Assembly,"Do pass. To Consent Calendar",15,0,2,0,17
1087923,744859,2018-04-26,Assembly,"AB 2270 MCCARTY Consent Calendar Second Day Regular Session",74,0,4,0,78
1087923,762615,2018-06-12,Senate,"Do pass, but first be re-referred to the Committee on [Appropriations] with the recommendation: To Consent Calendar",10,0,2,0,12
1087923,767999,2018-06-25,Senate,"Do pass",7,0,0,0,7
1087923,769627,2018-07-02,Senate,"Assembly 3rd Reading AB2270 McCarty et al. By Pan",37,0,2,0,39
1087925,733147,2018-04-03,Senate,"Do pass as amended, but first amend, and re-refer to the Committee on [Appropriations]",5,1,1,0,7
1087925,744919,2018-04-26,Senate,"Senate 3rd Reading SB1106 Hill",27,6,6,0,39
1087925,762231,2018-06-12,Assembly,"Do pass and be re-referred to the Committee on [Appropriations]",6,0,1,0,7
1087925,771837,2018-08-16,Assembly,"Do pass",13,4,0,0,17
1087925,773008,2018-08-27,Assembly,"SB 1106 Hill Senate Third Reading By QUIRK",61,16,3,0,80
1087926,750673,2018-05-07,Assembly,"Do pass and be re-referred to the Committee on [Appropriations]",7,3,0,0,10
1087926,756499,2018-05-25,Assembly,"Do pass",12,4,1,0,17
1087927,736093,2018-04-10,Assembly,"Do pass and be re-referred to the Committee on [Appropriations]",15,0,0,0,15
1087930,725511,2018-03-20,Assembly,"Do pass as amended and be re-referred to the Committee on [Appropriations]",6,1,0,0,7
1087931,725720,2018-03-20,Assembly,"Do pass and be re-referred to the Committee on [Local Government]",14,0,1,0,15
1087931,737730,2018-04-11,Assembly,"Do pass as amended",9,0,0,0,9
1087931,742237,2018-04-23,Assembly,"AB 2262 WOOD Assembly Third Reading",75,0,3,0,78
1087931,762931,2018-06-13,Senate,"Do pass, but first be re-referred to the Committee on [Health] with the recommendation: To Consent Calendar",7,0,0,0,7
1087931,769150,2018-06-27,Senate,"Do pass and be ordered to the Consent Calendar",9,0,0,0,9
1087932,725602,2018-03-20,Assembly,"Do pass and be re-referred to the Committee on [Appropriations]",7,0,0,0,7
1087933,725724,2018-03-19,Assembly,"Do pass and be re-referred to the Committee on [Appropriations]",10,0,0,0,10
1087936,739782,2018-04-17,Assembly,"Do pass as amended and be re-referred to the Committee on [Appropriations]",7,3,0,0,10
1087936,756339,2018-05-25,Assembly,"Do pass as amended",12,4,1,0,17
1087936,758668,2018-05-31,Assembly,"AB 2343 CHIU Assembly Third Reading",42,27,9,0,78
1087936,769689,2018-07-03,Senate,"Do pass",5,2,0,0,7
1087936,772254,2018-08-20,Senate,"Assembly 3rd Reading AB2343 Chiu By Allen",25,12,3,0,40
1087936,772500,2018-08-23,Assembly,"AB 2343 CHIU Concurrence in Senate Amendments",46,27,7,0,80
1087937,737146,2018-04-10,Senate,"Do pass, but first be re-referred to the Committee on [Appropriations]",7,0,0,0,7
1087937,746167,2018-04-30,Senate,"Placed on suspense file",6,0,1,0,7
1087938,726199,2018-03-20,Assembly,"Do pass as amended and be re-referred to the Committee on [Appropriations]",12,0,4,0,16
1087938,737237,2018-04-11,Assembly,"Do pass. To Consent Calendar",15,0,2,0,17
1087938,741429,2018-04-19,Assembly,"AB 2300 MAIENSCHEIN Consent Calendar Second Day Regular Session",71,0,7,0,78
1087938,764857,2018-06-18,Senate,"Do pass, but first be re-referred to the Committee on [Appropriations]",8,0,1,0,9
1087938,771161,2018-08-09,Senate,"Assembly 3rd Reading AB2300 Maienschein et al. By Hill",34,0,5,0,39
1087938,771396,2018-08-13,Assembly,"AB 2300 MAIENSCHEIN Concurrence in Senate Amendments",77,0,3,0,80
1087940,743371,2018-04-24,Assembly,"Do pass and be re-referred to the Committee on [Appropriations]",13,0,2,0,15
1087942,739837,2018-04-16,Senate,"Do pass as amended, but first amend, and re-refer to the Committee on [Appropriations] with the recommendation: To Consent Calendar",9,0,0,0,9
1087942,750455,2018-05-07,Senate,"Placed on suspense file",6,0,1,0,7
1087942,756706,2018-05-25,Senate,"Do pass",7,0,0,0,7
1087942,758727,2018-05-31,Senate,"Special Consent SB1126 Portantino Urgency Clause",39,0,0,0,39
1087942,768422,2018-06-26,Assembly,"Do pass and be re-referred to the Committee on [Appropriations]",15,0,0,0,15
1087942,771889,2018-08-16,Assembly,"Do pass",16,0,1,0,17
1087942,772848,2018-08-27,Assembly,"SB 1126 Portantino Third Reading Urgency By RIVAS",79,0,1,0,80
1087942,773247,2018-08-28,Senate,"Unfinished Business SB1126 Portantino et al. Urgency Clause Concurrence",39,0,1,0,40
1087943,743752,2018-04-25,Senate,"Do pass, but first be re-referred to the Committee on [Appropriations] with the recommendation: To Consent Calendar",9,0,0,0,9
1087943,755348,2018-05-22,Senate,"Placed on suspense file",7,0,0,0,7
1087943,756212,2018-05-25,Senate,"Do pass as amended",7,0,0,0,7
1087943,757608,2018-05-30,Senate,"Senate 3rd Reading SB1125 Atkins et al",37,0,2,0,39
1087943,768190,2018-06-26,Assembly,"Do pass and be re-referred to the Committee on [Appropriations] with recommendation: To Consent Calendar",15,0,0,0,15
1087943,771581,2018-08-16,Assembly,"Do pass",17,0,0,0,17
1087943,774121,2018-08-31,Senate,"Unfinished Business SB1125 Atkins et al. Concurrence",31,0,9,0,40
1087943,774122,2018-08-31,Assembly,"SB 1125 Atkins Senate Third Reading By ARAMBULA",79,0,1,0,80
1087944,751590,2018-05-08,Senate,"Do pass as amended",5,1,1,0,7
1087944,754966,2018-05-21,Senate,"Senate 3rd Reading SB1129 Monning",30,7,2,0,39
1087944,769678,2018-07-03,Assembly,"Do pass as amended",9,0,1,0,10
1087944,773187,2018-08-28,Assembly,"SB 1129 Monning Senate Third Reading By CHIU",68,0,12,0,80
1087944,773470,2018-08-29,Senate,"Unfinished Business SB1129 Monning Concurrence",31,7,2,0,40
1087946,733965,2018-04-04,Senate,"Do pass, but first be re-referred to the Committee on [Judiciary] with the recommendation: To Consent Calendar",7,0,0,0,7
1087946,748040,2018-05-01,Senate,"Do pass and be ordered to the Consent Calendar",7,0,0,0,7
1087946,752130,2018-05-10,Senate,"Consent Calendar SB1139 Morrell",38,0,1,0,39
1087946,764572,2018-06-18,Assembly,"Do pass",11,0,0,0,11
1087946,766205,2018-06-18,Assembly,"Do pass. To Consent Calendar",11,0,0,0,11
1087946,767845,2018-06-25,Assembly,"SB 1139 Morrell Consent Calendar Second Day",75,0,5,0,80
1087948,740760,2018-04-17,Assembly,"Do pass and be re-referred to the Committee on [Human Services]",15,0,0,0,15
1087948,744006,2018-04-24,Assembly,"Do pass as amended, and be re-referred to the Committee on [Appropriations] with recommendation: To Consent Calendar",7,0,0,0,7
1087949,744511,2018-04-25,Senate,"Do pass, but first be re-referred to the Committee on [Appropriations]",10,0,1,0,11
1087949,754322,2018-05-17,Senate,"Senate 3rd Reading SB1136 Hertzberg",38,0,1,0,39
1087949,766189,2018-06-20,Assembly,"Do pass and be re-referred to the Committee on [Appropriations]",15,0,0,0,15
1087949,771106,2018-08-08,Assembly,"Do pass. To Consent Calendar",17,0,0,0,17
1087949,771910,2018-08-16,Assembly,"SB 1136 Hertzberg Consent Calendar Second Day Regular Session",76,0,4,0,80
1087949,772329,2018-08-21,Senate,"Unfinished Business SB1136 Hertzberg Concurrence",39,0,1,0,40
1087951,740515,2018-04-18,Assembly,"Do pass and be re-referred to the Committee on [Appropriations]",5,0,2,0,7
1087951,756412,2018-05-25,Assembly,"Do pass",13,2,2,0,17
1087951,757062,2018-05-29,Assembly,"AB 2305 RODRIGUEZ Assembly Third Reading",59,8,11,0,78
1087951,767927,2018-06-25,Senate,"Do pass, but first be re-referred to the Committee on [Appropriations]",3,2,0,0,5
1087951,770579,2018-08-06,Senate,"Placed on suspense file",7,0,0,0,7
1087951,771668,2018-08-16,Senate,"Do pass as amended",5,1,1,0,7
1087951,772426,2018-08-22,Senate,"Assembly 3rd Reading AB2305 Rodriguez By Pan",31,4,5,0,40
1087951,772984,2018-08-27,Assembly,"AB 2305 RODRIGUEZ Concurrence in Senate Amendments",64,9,7,0,80
1087952,751406,2018-05-09,Assembly,"Do pass as amended. To Consent Calendar",6,0,1,0,7
1087952,756728,2018-05-25,Assembly,"Do pass",16,0,1,0,17
1087952,757735,2018-05-30,Assembly,"AB 2235 QUIRK-SILVA Assembly Third Reading",76,1,1,0,78
1087952,763101,2018-06-13,Senate,"Do pass, but first be re-referred to the Committee on [Appropriations] with the recommendation: To Consent Calendar",7,0,0,0,7
1087952,769631,2018-07-02,Senate,"Consent Calendar AB2235",37,0,2,0,39
1087954,738948,2018-04-16,Senate,"Do pass, but first be re-referred to the Committee on [Health]",8,0,1,0,9
1087954,743790,2018-04-25,Senate,"Do pass as amended, but first amend, and re-refer to the Committee on [Appropriations]",9,0,0,0,9
1087954,752680,2018-05-14,Senate,"Do pass",7,0,0,0,7
1087954,754941,2018-05-21,Senate,"Senate 3rd Reading SB1109 Bates et al",39,0,0,0,39
1087954,762266,2018-06-12,Assembly,"Do pass and be re-referred to the Committee on [Health]",18,0,1,0,19
1087954,768127,2018-06-26,Assembly,"Do pass and be re-referred to the Committee on [Appropriations] with recommendation: To Consent Calendar",15,0,0,0,15
1087954,771484,2018-08-15,Assembly,"Do pass. To Consent Calendar",17,0,0,0,17
1087954,774033,2018-08-31,Senate,"Unfinished Business SB1109 Bates et al. Concurrence",39,0,1,0,40
1087954,774034,2018-08-31,Assembly,"SB 1109 Bates Senate Third Reading By ARAMBULA",80,0,0,0,80
1087956,725684,2018-03-20,Assembly,"Do pass and be re-referred to the Committee on [Appropriations]",8,1,1,0,10
1087956,756459,2018-05-25,Assembly,"Do pass",12,3,2,0,17
1087956,757063,2018-05-29,Assembly,"AB 2354 RUBIO Assembly Third Reading",54,24,0,0,78
1087956,768726,2018-06-26,Senate,"Do pass, but first be re-referred to the Committee on [Appropriations]",6,1,0,0,7
1087956,770438,2018-08-06,Senate,"Placed on suspense file",7,0,0,0,7
1087957,752642,2018-05-14,Assembly,"Be adopted. To third reading",8,0,3,0,11
1087957,760913,2018-06-07,Senate,"Special Consent ACR174",37,0,2,0,39
1087958,737210,2018-04-10,Assembly,"Do pass and be re-referred to the Committee on [Public Safety] with recommendation: To Consent Calendar",7,0,0,0,7
1087958,743628,2018-04-24,Assembly,"Do pass and be re-referred to the Committee on [Appropriations] with recommendation: To Consent Calendar",7,0,0,0,7
1087959,737399,2018-04-10,Assembly,"Do pass and be re-referred to the Committee on [Public Safety]",15,0,1,0,16
1087959,742986,2018-04-24,Assembly,"Do pass and be re-referred to the Committee on [Appropriations] with recommendation: To Consent Calendar",7,0,0,0,7
1087959,747623,2018-05-02,Assembly,"Do pass. To Consent Calendar",17,0,0,0,17
1087959,751894,2018-05-10,Assembly,"AB 2256 SANTIAGO Consent Calendar Second Day Regular Session",73,0,5,0,78
1087959,761620,2018-06-11,Senate,"Do pass, but first be re-referred to the Committee on [Public Safety] with the recommendation: To Consent Calendar",8,0,1,0,9
1087959,765068,2018-06-19,Senate,"Do pass, but first be re-referred to the Committee on [Appropriations] with the recommendation: To Consent Calendar",7,0,0,0,7
1087959,770555,2018-08-06,Senate,"Consent Calendar AB2256 Santiago",37,0,2,0,39
1087959,772146,2018-08-20,Assembly,"AB 2256 SANTIAGO Concurrence in Senate Amendments",80,0,0,0,80
1087962,733242,2018-04-03,Assembly,"Do pass as amended",7,1,2,0,10
1087962,754275,2018-05-17,Assembly,"AB 2274 QUIRK Assembly Third Reading",57,4,17,0,78
1087962,766777,2018-06-19,Senate,"Do pass",6,1,0,0,7
1087962,771717,2018-08-16,Senate,"Assembly 3rd Reading AB2274 Quirk By Jackson",34,3,3,0,40
1087963,733036,2018-04-02,Assembly,"Be re-referred to the Committee on [Natural Resources]",6,0,5,0,11
1087963,742985,2018-04-23,Assembly,"Do pass and be re-referred to the Committee on [Appropriations]",10,0,0,0,10
1087963,747838,2018-05-02,Assembly,"Do pass. To Consent Calendar",17,0,0,0,17
1087963,752061,2018-05-10,Assembly,"AB 2267 WOOD Consent Calendar Second Day Regular Session",73,0,5,0,78
1087963,767125,2018-06-20,Senate,"Do pass, but first be re-referred to the Committee on [Rules]",5,1,1,0,7
1087963,768967,2018-06-26,Senate,"Do pass, but first be re-referred to the Committee on [Appropriations]",4,1,2,0,7
1087963,771409,2018-08-13,Senate,"Placed on suspense file",7,0,0,0,7
1087963,771945,2018-08-16,Senate,"Do pass as amended",7,0,0,0,7
1087964,741000,2018-04-18,Assembly,"Do pass and be re-referred to the Committee on [Appropriations]",9,0,0,0,9
1087964,747749,2018-05-02,Assembly,"Do pass. To Consent Calendar",17,0,0,0,17
1087964,752058,2018-05-10,Assembly,"AB 2238 AGUIAR-CURRY Consent Calendar Second Day Regular Session",73,0,5,0,78
1087964,766016,2018-06-20,Senate,"Do pass, but first be re-referred to the Committee on [Appropriations] with the recommendation: To Consent Calendar",7,0,0,0,7
1087964,773606,2018-08-29,Senate,"Assembly 3rd Reading AB2238 Aguiar-Curry By Dodd",39,0,1,0,40
1087964,773880,2018-08-30,Assembly,"AB 2238 AGUIAR-CURRY Concurrence in Senate Amendments",78,0,2,0,80
1087967,736116,2018-04-10,Senate,"Do pass as amended, but first amend, and re-refer to the Committee on [Appropriations]",2,3,2,0,7
1087967,736117,2018-04-10,Senate,"[04-10-2018] hearing: Motion to Reconsider. [Reconsideration Granted.]",7,0,0,0,7
1087967,743205,2018-04-24,Senate,"Do pass, but first be re-referred to the Committee on [Appropriations]",2,4,1,0,7
1087968,741381,2018-04-18,Assembly,"Do pass and be re-referred to the Committee on [Appropriations]",6,0,1,0,7
1087968,756769,2018-05-25,Assembly,"Do pass as amended",12,3,2,0,17
1087968,757848,2018-05-30,Assembly,"AB 2314 TING Assembly Third Reading",62,13,3,0,78
1087968,763023,2018-06-13,Senate,"Do pass, but first be re-referred to the Committee on [Appropriations]",5,0,0,0,5
1087968,768072,2018-06-25,Senate,"Placed on suspense file",7,0,0,0,7
1087968,772046,2018-08-16,Senate,"Do pass",5,2,0,0,7
1087968,772596,2018-08-23,Senate,"Assembly 3rd Reading AB2314 Ting et al. By Leyva",26,12,2,0,40
1087970,738459,2018-04-11,Assembly,"Do pass as amended, and be re-referred to the Committee on [Appropriations] with recommendation: To Consent Calendar",7,0,0,0,7
1087970,747859,2018-05-02,Assembly,"Do pass. To Consent Calendar",17,0,0,0,17
1087970,751925,2018-05-10,Assembly,"AB 2291 CHIU Consent Calendar Second Day Regular Session",73,0,5,0,78
1087970,760465,2018-06-06,Senate,"Do pass as amended, but first amend, and re-refer to the Committee on [Appropriations]",6,0,0,0,6
1087970,769674,2018-07-02,Senate,"Placed on suspense file",7,0,0,0,7
1087970,771857,2018-08-16,Senate,"Do pass",7,0,0,0,7
1087970,772515,2018-08-23,Senate,"Assembly 3rd Reading AB2291 Chiu By Pan",39,0,1,0,40
1087970,773005,2018-08-27,Assembly,"AB 2291 CHIU Concurrence in Senate Amendments",79,0,1,0,80
1087973,739737,2018-04-17,Assembly,"Do pass as amended and be re-referred to the Committee on [Revenue and Taxation]",7,0,0,0,7
1087973,753598,2018-05-14,Assembly,"Do pass and be re-referred to the Committee on [Appropriations]",8,1,1,0,10
1087974,733264,2018-04-03,Senate,"Do pass, but first be re-referred to the Committee on [Appropriations]",12,0,1,0,13
1087974,738885,2018-04-16,Senate,"Placed on suspense file",7,0,0,0,7
1087974,756720,2018-05-25,Senate,"Do pass",7,0,0,0,7
1087974,758630,2018-05-31,Senate,"Special Consent SB1132",39,0,0,0,39
1087974,767944,2018-06-25,Assembly,"Do pass and be re-referred to the Committee on [Appropriations]",12,0,2,0,14
1087977,736142,2018-04-10,Senate,"Do pass, but first be re-referred to the Committee on [Business, Professions and Economic Development]",7,0,0,0,7
1087977,738801,2018-04-16,Senate,"Do pass, but first be re-referred to the Committee on [Appropriations] with the recommendation: To Consent Calendar",7,0,2,0,9
1087977,755052,2018-05-21,Senate,"Senate 3rd Reading SB1137 Vidak",38,0,1,0,39
1087977,763150,2018-06-12,Assembly,"Do pass as amended and be re-referred to the Committee on [Business and Professions]",10,0,0,0,10
1087977,768412,2018-06-26,Assembly,"Do pass and be re-referred to the Committee on [Appropriations]",19,0,0,0,19
1087977,771105,2018-08-08,Assembly,"Do pass. To Consent Calendar",17,0,0,0,17
1087977,771932,2018-08-16,Assembly,"SB 1137 Vidak Consent Calendar Second Day Regular Session",76,0,4,0,80
1087977,772393,2018-08-21,Senate,"Unfinished Business SB1137 Vidak Concurrence",39,0,1,0,40
1087978,743155,2018-04-24,Assembly,"Do pass and be re-referred to the Committee on [Appropriations]",15,0,0,0,15
1087978,756408,2018-05-25,Assembly,"Do pass as amended",16,0,1,0,17
1087978,758827,2018-05-31,Assembly,"AB 2342 BURKE Assembly Third Reading",78,0,0,0,78
1087978,768830,2018-06-27,Senate,"Do pass as amended, but first amend, and re-refer to the Committee on [Appropriations]",9,0,0,0,9
1087978,770270,2018-08-06,Senate,"Placed on suspense file",7,0,0,0,7
1087978,771619,2018-08-16,Senate,"Do pass as amended",7,0,0,0,7
1087978,773810,2018-08-30,Senate,"Assembly 3rd Reading AB2342 Burke et al. By Portantino",38,1,1,0,40
1087978,774230,2018-08-31,Assembly,"AB 2342 BURKE Concurrence in Senate Amendments",80,0,0,0,80
1087979,733259,2018-04-03,Assembly,"Do pass and be re-referred to the Committee on [Appropriations]",15,0,0,0,15
1087979,756520,2018-05-25,Assembly,"Do pass as amended",12,0,5,0,17
1087979,758810,2018-05-31,Assembly,"AB 2233 KALRA Assembly Third Reading",77,1,0,0,78
1087979,766281,2018-06-20,Senate,"Do pass as amended, but first amend, and re-refer to the Committee on [Appropriations]",9,0,0,0,9
1087979,770436,2018-08-06,Senate,"Placed on suspense file",7,0,0,0,7
1087979,771578,2018-08-16,Senate,"Do pass as amended",7,0,0,0,7
1087979,772944,2018-08-27,Senate,"Assembly 3rd Reading AB2233 Kalra et al. By Pan",39,0,1,0,40
1087979,773646,2018-08-29,Assembly,"AB 2233 KALRA Concurrence in Senate Amendments",78,0,2,0,80
1087981,733289,2018-04-03,Assembly,"Do pass and be re-referred to the Committee on [Appropriations]",16,0,0,0,16
1087981,737448,2018-04-11,Assembly,"Do pass. To Consent Calendar",15,0,2,0,17
1087981,741468,2018-04-19,Assembly,"AB 2311 ARAMBULA Consent Calendar Second Day Regular Session",71,0,7,0,78
1087981,761783,2018-06-11,Senate,"Do pass, but first be re-referred to the Committee on [Appropriations] with the recommendation: To Consent Calendar",8,0,1,0,9
1087981,769585,2018-07-02,Senate,"Consent Calendar AB2311",37,0,2,0,39
1087982,744510,2018-04-25,Senate,"Do pass, but first be re-referred to the Committee on [Appropriations] with the recommendation: To Consent Calendar",9,0,0,0,9
1087982,755364,2018-05-22,Senate,"Placed on suspense file",7,0,0,0,7
1087982,756224,2018-05-25,Senate,"Do pass as amended",7,0,0,0,7
1087982,757722,2018-05-30,Senate,"Senate 3rd Reading SB1097 Hueso et al",37,0,2,0,39
1087982,765540,2018-06-19,Assembly,"Do pass and be re-referred to the Committee on [Appropriations] with recommendation: To Consent Calendar",15,0,0,0,15
1087982,771834,2018-08-16,Assembly,"Do pass as amended",12,0,5,0,17
1087982,773428,2018-08-29,Assembly,"SB 1097 Hueso Senate Third Reading By REYES",80,0,0,0,80
1087982,773890,2018-08-30,Senate,"Unfinished Business SB1097 Hueso et al. Concurrence",39,0,1,0,40
1087983,733254,2018-04-03,Assembly,"Do pass as amended and be re-referred to the Committee on [Appropriations]",15,0,0,0,15
1087983,747811,2018-05-02,Assembly,"Do pass",17,0,0,0,17
1087983,752111,2018-05-10,Assembly,"AB 2316 EGGMAN Assembly Third Reading",73,0,5,0,78
1087983,763019,2018-06-13,Senate,"Do pass as amended, but first amend, and re-refer to the Committee on [Appropriations]",8,0,1,0,9
1087983,771190,2018-08-09,Senate,"Assembly 3rd Reading AB2316 Eggman By Nguyen",36,0,3,0,39
1087983,771362,2018-08-13,Assembly,"AB 2316 EGGMAN Concurrence in Senate Amendments",78,0,2,0,80
1087985,726076,2018-03-20,Assembly,"Do pass and be re-referred to the Committee on [Judiciary] with recommendation: To Consent Calendar",7,0,0,0,7
1087985,736288,2018-04-10,Assembly,"Do pass and be re-referred to the Committee on [Appropriations] with recommendation: To Consent Calendar",10,0,0,0,10
1087985,756524,2018-05-25,Assembly,"Do pass",16,0,1,0,17
1087985,758631,2018-05-31,Assembly,"AB 2337 GIPSON Assembly Third Reading",78,0,0,0,78
1087985,766168,2018-06-19,Senate,"Do pass, but first be re-referred to the Committee on [Human Services] with the recommendation: To Consent Calendar",7,0,0,0,7
1087985,768992,2018-06-26,Senate,"Do pass, but first be re-referred to the Committee on [Appropriations]",6,0,1,0,7
1087985,770833,2018-08-06,Senate,"Placed on suspense file",7,0,0,0,7
1087985,772082,2018-08-16,Senate,"Do pass as amended",7,0,0,0,7
1087985,772398,2018-08-21,Senate,"Assembly 3rd Reading AB2337 Gipson et al. By Wiener",39,0,1,0,40
1087985,773033,2018-08-27,Assembly,"AB 2337 GIPSON Concurrence in Senate Amendments",80,0,0,0,80
1087987,725494,2018-03-20,Assembly,"Do pass and be re-referred to the Committee on [Local Government]",12,1,2,0,15
1087987,737235,2018-04-11,Assembly,"Do pass and be re-referred to the Committee on [Appropriations]",7,0,2,0,9
1087987,756585,2018-05-25,Assembly,"Do pass",13,2,2,0,17
1087987,758663,2018-05-31,Assembly,"AB 2339 GIPSON Assembly Third Reading",59,13,6,0,78
1087987,769313,2018-06-27,Senate,"Do pass as amended",7,0,0,0,7
1087987,772420,2018-08-22,Senate,"Assembly 3rd Reading AB2339 Gipson et al. By Delgado",38,1,1,0,40
1087987,773118,2018-08-28,Assembly,"AB 2339 GIPSON Concurrence in Senate Amendments",64,11,5,0,80
1087988,740599,2018-04-17,Assembly,"Do pass and be re-referred to the Committee on [Public Safety]",4,0,3,0,7
1087988,743065,2018-04-24,Assembly,"Do pass as amended, and be re-referred to the Committee on [Appropriations] with recommendation: To Consent Calendar",7,0,0,0,7
1087989,733232,2018-04-03,Assembly,"Do pass and be re-referred to the Committee on [Appropriations]",7,2,1,0,10
1087989,741099,2018-04-18,Assembly,"Do pass",12,0,5,0,17
1087989,742189,2018-04-23,Assembly,"AB 2227 FRIEDMAN Assembly Third Reading",54,13,11,0,78
1087989,763016,2018-06-12,Senate,"Do pass, but first be re-referred to the Committee on [Appropriations]",7,0,0,0,7
1087989,771173,2018-08-09,Senate,"Assembly 3rd Reading AB2227 Friedman By Moorlach",36,0,3,0,39
1087993,737452,2018-04-10,Assembly,"Do pass as amended and be re-referred to the Committee on [Appropriations]",16,0,0,0,16
1087993,742870,2018-04-24,Assembly,"Do pass as amended and be re-referred to the Committee on [Appropriations]",7,0,0,0,7
1087993,755723,2018-05-23,Assembly,"Do pass. To Consent Calendar",16,0,1,0,17
1087993,757008,2018-05-29,Assembly,"AB 2255 LACKEY Consent Calendar Second Day Regular Session",78,0,0,0,78
1087993,765059,2018-06-18,Senate,"Do pass, but first be re-referred to the Committee on [Public Safety]",9,0,0,0,9
1087993,768250,2018-06-26,Senate,"Do pass as amended, but first amend, and re-refer to the Committee on [Appropriations]",7,0,0,0,7
1087993,772545,2018-08-23,Senate,"Assembly 3rd Reading AB2255 Lackey By Wilk",39,0,1,0,40
1087993,772957,2018-08-27,Assembly,"AB 2255 LACKEY Concurrence in Senate Amendments",79,0,1,0,80
1087997,739490,2018-04-17,Assembly,"Do pass and be re-referred to the Committee on [Accountability and Administrative Review]",9,4,0,0,13
1087997,743868,2018-04-25,Assembly,"Do pass as amended and be re-referred to the Committee on [Appropriations]",5,2,0,0,7
1087997,756515,2018-05-25,Assembly,"Do pass",12,4,1,0,17
1087997,758670,2018-05-31,Assembly,"AB 2361 WEBER Assembly Third Reading",54,22,2,0,78
1087997,768719,2018-06-27,Senate,"Do pass, but first be re-referred to the Committee on [Appropriations]",4,2,1,0,7
1087997,770257,2018-08-06,Senate,"Placed on suspense file",7,0,0,0,7
1087997,772060,2018-08-16,Senate,"Do pass",5,2,0,0,7
1087997,772714,2018-08-24,Senate,"Assembly 3rd Reading AB2361 Weber et al. By Lara",23,13,4,0,40
1087998,738120,2018-04-11,Assembly,"Do pass as amended and be re-referred to the Committee on [Health]",7,0,0,0,7
1087998,743327,2018-04-24,Assembly,"Do pass and be re-referred to the Committee on [Appropriations]",15,0,0,0,15
1087998,756290,2018-05-25,Assembly,"Do pass",12,4,1,0,17
1087998,757752,2018-05-30,Assembly,"AB 2315 QUIRK-SILVA Assembly Third Reading",77,0,1,0,78
1087998,762839,2018-06-13,Senate,"Do pass, but first be re-referred to the Committee on [Health]",7,0,0,0,7
1087998,766057,2018-06-20,Senate,"Do pass, but first be re-referred to the Committee on [Appropriations]",9,0,0,0,9
1087998,770342,2018-08-06,Senate,"Placed on suspense file",7,0,0,0,7
1087998,771656,2018-08-16,Senate,"Do pass as amended",7,0,0,0,7
1087998,773335,2018-08-29,Senate,"Assembly 3rd Reading AB2315 Quirk-Silva By Bradford",39,0,1,0,40
1087998,773775,2018-08-30,Assembly,"AB 2315 QUIRK-SILVA Concurrence in Senate Amendments",79,0,1,0,80
1087999,733540,2018-04-03,Senate,"Do pass as amended, but first amend, and re-refer to the Committee on [Appropriations]",9,0,2,0,11
1087999,757170,2018-05-29,Senate,"Senate 3rd Reading SB1110 Bradford",36,0,3,0,39
1087999,766238,2018-06-20,Assembly,"Do pass and be re-referred to the Committee on [Natural Resources]",14,0,1,0,15
1087999,768153,2018-06-25,Assembly,"Do pass as amended and be re-referred to the Committee on [Appropriations]",9,0,1,0,10
1087999,771058,2018-08-08,Assembly,"Do pass. To Consent Calendar",17,0,0,0,17
1087999,773001,2018-08-27,Assembly,"SB 1110 Bradford Senate Third Reading By DAHLE",77,0,3,0,80
1087999,773130,2018-08-28,Senate,"Unfinished Business SB1110 Bradford Concurrence",39,0,1,0,40
1088001,740842,2018-04-18,Assembly,"Do pass and be re-referred to the Committee on [Appropriations]",6,0,1,0,7
1088001,748183,2018-05-02,Assembly,"Do pass. To Consent Calendar",17,0,0,0,17
1088001,751976,2018-05-10,Assembly,"AB 2310 AGUIAR-CURRY Consent Calendar Second Day Regular Session",73,0,5,0,78
1088001,761832,2018-06-11,Senate,"Do pass, but first be re-referred to the Committee on [Appropriations]",5,0,0,0,5
1088001,770769,2018-08-06,Senate,"Assembly 3rd Reading AB2310 Aguiar-Curry By Dodd",37,0,2,0,39
1088002,725418,2018-03-20,Assembly,"Do pass as amended and be re-referred to the Committee on [Appropriations]",7,0,0,0,7
1088002,756310,2018-05-25,Assembly,"Do pass as amended",12,0,5,0,17
1088002,758734,2018-05-31,Assembly,"AB 2247 GIPSON Assembly Third Reading",78,0,0,0,78
1088002,768833,2018-06-26,Senate,"Do pass as amended, but first amend, and re-refer to the Committee on [Appropriations]",6,0,1,0,7
1088002,770513,2018-08-06,Senate,"Placed on suspense file",7,0,0,0,7
1088002,771665,2018-08-16,Senate,"Do pass as amended",7,0,0,0,7
1088002,772481,2018-08-23,Senate,"Assembly 3rd Reading AB2247 Gipson et al. By Stone",39,0,1,0,40
1088002,772855,2018-08-27,Assembly,"AB 2247 GIPSON Concurrence in Senate Amendments",78,1,1,0,80
1088003,739891,2018-04-17,Assembly,"Do pass and be re-referred to the Committee on [Judiciary]",16,0,0,0,16
1088003,743080,2018-04-24,Assembly,"Do pass as amended, and be re-referred to the Committee on [Appropriations] with recommendation: To Consent Calendar",10,0,0,0,10
1088003,751392,2018-05-09,Assembly,"Do pass. To Consent Calendar",16,0,1,0,17
1088003,754405,2018-05-17,Assembly,"AB 2296 WALDRON Consent Calendar Second Day Regular Session",73,0,5,0,78
1088003,765117,2018-06-18,Senate,"Do pass, but first be re-referred to the Committee on [Judiciary] with the recommendation: To Consent Calendar",9,0,0,0,9
1088003,768991,2018-06-26,Senate,"Do pass, but first be re-referred to the Committee on [Appropriations] with the recommendation: To Consent Calendar",7,0,0,0,7
1088003,772340,2018-08-21,Senate,"Assembly 3rd Reading AB2296 Waldron By Wilk",39,0,1,0,40
1088003,772841,2018-08-27,Assembly,"AB 2296 WALDRON Concurrence in Senate Amendments",80,0,0,0,80
1088006,738288,2018-04-12,Assembly,"Be re-referred to the Committee on [Local Government]",7,0,4,0,11
1088006,751540,2018-05-09,Assembly,"Do pass as amended",9,0,0,0,9
1088006,754949,2018-05-21,Assembly,"AB 2329 OBERNOLTE Assembly Third Reading",71,0,7,0,78
1088006,766198,2018-06-20,Senate,"Do pass as amended",7,0,0,0,7
1088006,769774,2018-07-05,Senate,"Assembly 3rd Reading AB2329 Obernolte By Morrell",35,0,4,0,39
1088006,770814,2018-08-06,Assembly,"AB 2329 OBERNOLTE Concurrence in Senate Amendments",77,0,3,0,80
1088007,740925,2018-04-18,Assembly,"Do pass and be re-referred to the Committee on [Health]",21,0,0,0,21
1088007,743459,2018-04-24,Assembly,"Do pass and be re-referred to the Committee on [Appropriations]",15,0,0,0,15
1088007,756527,2018-05-25,Assembly,"Do pass",16,0,1,0,17
1088007,757138,2018-05-29,Assembly,"AB 2333 WOOD Assembly Third Reading",77,0,1,0,78
1088007,762120,2018-06-12,Senate,"Do pass, but first be re-referred to the Committee on [Health]",10,0,2,0,12
1088007,768986,2018-06-27,Senate,"Do pass as amended, but first amend, and re-refer to the Committee on [Appropriations] with the recommendation: To Consent Calendar",9,0,0,0,9
1088007,770285,2018-08-06,Senate,"Placed on suspense file",7,0,0,0,7
1088009,737224,2018-04-10,Assembly,"Do pass and be re-referred to the Committee on [Education]",7,0,0,0,7
1088009,744851,2018-04-25,Assembly,"Do pass and be re-referred to the Committee on [Appropriations]",7,0,0,0,7
1088009,756410,2018-05-25,Assembly,"Do pass",16,0,1,0,17
1088009,757129,2018-05-29,Assembly,"AB 2292 AGUIAR-CURRY Assembly Third Reading",78,0,0,0,78
1088009,762846,2018-06-13,Senate,"Do pass, but first be re-referred to the Committee on [Human Services]",7,0,0,0,7
1088009,768823,2018-06-26,Senate,"Do pass, but first be re-referred to the Committee on [Appropriations] with the recommendation: To Consent Calendar",6,0,1,0,7
1088009,770369,2018-08-06,Senate,"Placed on suspense file",7,0,0,0,7
1088009,777241,2018-05-25,Assembly,,7,0,1,0,8
1088011,737394,2018-04-11,Assembly,"Do pass as amended and be re-referred to the Committee on [Appropriations]",9,0,0,0,9
1088012,740584,2018-04-18,Assembly,"Do pass. To Consent Calendar",13,0,0,0,13
1088012,744864,2018-04-26,Assembly,"AB 2229 WOOD Consent Calendar Second Day Regular Session",74,0,4,0,78
1088012,762732,2018-06-13,Senate,"Do pass and be ordered to the Consent Calendar",11,0,2,0,13
1088012,768023,2018-06-25,Senate,"Consent Calendar AB2229",36,0,3,0,39
1088013,725517,2018-03-20,Assembly,"Do pass. To Consent Calendar",7,0,0,0,7
1088013,734718,2018-04-05,Assembly,"AB 2349 CHEN Consent Calendar Second Day Regular Session",70,0,7,0,77
1088013,753450,2018-05-15,Senate,"Do pass and be ordered to the Consent Calendar",7,0,0,0,7
1088013,754962,2018-05-21,Senate,"Consent Calendar AB2349",39,0,0,0,39
1088016,725918,2018-03-20,Assembly,"Do pass and be re-referred to the Committee on [Appropriations]",7,0,0,0,7
1088016,733946,2018-04-04,Assembly,"Do pass. To Consent Calendar",15,0,2,0,17
1088016,738163,2018-04-12,Assembly,"AB 2345 REYES Assembly Third Reading",69,0,8,0,77
1088016,753764,2018-05-16,Senate,"Do pass, but first be re-referred to the Committee on [Appropriations]",7,0,0,0,7
1088017,740564,2018-04-18,Assembly,"Do pass and be re-referred to the Committee on [Appropriations]",5,1,1,0,7
1088017,756536,2018-05-25,Assembly,"Do pass",12,4,1,0,17
1088017,757098,2018-05-29,Assembly,"AB 2261 FRIEDMAN Assembly Third Reading",53,25,0,0,78
1088017,762776,2018-06-13,Senate,"Do pass, but first be re-referred to the Committee on [Appropriations]",4,1,0,0,5
1088017,767940,2018-06-25,Senate,"Placed on suspense file",7,0,0,0,7
1088017,771647,2018-08-16,Senate,"Do pass",5,2,0,0,7
1088017,772333,2018-08-21,Senate,"Assembly 3rd Reading AB2261 Friedman By Leyva",26,13,1,0,40
1088018,743861,2018-04-24,Assembly,"Do pass as amended and be re-referred to the Committee on [Appropriations]",12,0,1,0,13
1088018,751349,2018-05-09,Assembly,"Do pass. To Consent Calendar",16,0,1,0,17
1088018,754326,2018-05-17,Assembly,"AB 2248 MCCARTY Consent Calendar Second Day Regular Session",73,0,5,0,78
1088018,768965,2018-06-27,Senate,"Do pass as amended, but first amend, and re-refer to the Committee on [Appropriations]",7,0,0,0,7
1088018,772263,2018-08-20,Senate,"Assembly 3rd Reading AB2248 McCarty et al. By Glazer",39,0,1,0,40
1088018,772982,2018-08-27,Assembly,"AB 2248 MCCARTY Concurrence in Senate Amendments",79,0,1,0,80
1088022,736833,2018-04-10,Senate,"Do pass as amended, but first amend, and re-refer to the Committee on [Appropriations]",7,0,0,0,7
1088022,746245,2018-04-30,Senate,"Placed on suspense file",6,0,1,0,7
1088023,743270,2018-04-24,Senate,"Do pass as amended, but first amend, and re-refer to the Committee on [Appropriations]",4,1,2,0,7
1088023,752871,2018-05-14,Senate,"Placed on suspense file",7,0,0,0,7
1088024,736197,2018-04-10,Assembly,"Do pass",6,0,1,0,7
1088024,741335,2018-04-19,Assembly,"AB 2302 BAKER Assembly Third Reading",71,0,7,0,78
1088024,768647,2018-06-26,Senate,"Do pass as amended",7,0,0,0,7
1088024,772352,2018-08-21,Senate,"Assembly 3rd Reading AB2302 Baker et al. By Galgiani",39,0,1,0,40
1088024,772909,2018-08-27,Assembly,"AB 2302 BAKER Concurrence in Senate Amendments",80,0,0,0,80
1088026,739637,2018-04-17,Senate,"Do pass, but first be re-referred to the Committee on [Appropriations]",5,2,0,0,7
1088026,746178,2018-04-30,Senate,"Placed on suspense file",6,0,1,0,7
1088026,756342,2018-05-25,Senate,"Do pass",5,1,1,0,7
1088026,757005,2018-05-29,Senate,"Senate 3rd Reading SB1100 Portantino et al",26,9,4,0,39
1088026,757006,2018-05-29,Senate,"Senate 3rd Reading SB1100 Portantino et al. Reconsider",37,0,2,0,39
1088026,757007,2018-05-29,Senate,"Senate 3rd Reading SB1100 Portantino et al",24,10,5,0,39
1088026,765017,2018-06-19,Assembly,"Do pass and be re-referred to the Committee on [Appropriations]",5,2,0,0,7
1088026,771725,2018-08-16,Assembly,"Do pass",12,5,0,0,17
1088026,773084,2018-08-28,Assembly,"SB 1100 Portantino Senate Third Reading By BONTA",47,30,3,0,80
1088026,773361,2018-08-29,Senate,"Unfinished Business SB1100 Portantino et al. Concurrence",26,12,2,0,40
1088029,743360,2018-04-23,Senate,"Do pass, but first be re-referred to the Committee on [Appropriations]",4,0,1,0,5
1088029,750195,2018-05-07,Senate,"Placed on suspense file",6,0,1,0,7
1088029,756214,2018-05-25,Senate,"Do pass as amended",7,0,0,0,7
1088029,757875,2018-05-30,Senate,"Senate 3rd Reading SB1124 Leyva",35,0,4,0,39
1088029,766757,2018-06-20,Assembly,"Do pass and be re-referred to the Committee on [Appropriations]",6,0,1,0,7
1088029,771778,2018-08-16,Assembly,"Do pass",17,0,0,0,17
1088029,773028,2018-08-27,Assembly,"SB 1124 Leyva Senate Third Reading By CERVANTES",80,0,0,0,80
1088029,773185,2018-08-28,Senate,"Unfinished Business SB1124 Leyva Concurrence",39,0,1,0,40
1088031,744897,2018-04-25,Assembly,"Do pass and be re-referred to the Committee on [Appropriations]",7,0,0,0,7
1088031,756570,2018-05-25,Assembly,"Do pass",16,0,1,0,17
1088031,756980,2018-05-29,Assembly,"AB 2358 CARRILLO Assembly Third Reading",78,0,0,0,78
1088031,763021,2018-06-13,Senate,"Do pass, but first be re-referred to the Committee on [Judiciary]",5,0,0,0,5
1088031,769106,2018-06-26,Senate,"Do pass as amended, but first amend, and re-refer to the Committee on [Appropriations]",7,0,0,0,7
1088031,770825,2018-08-06,Senate,"Placed on suspense file",7,0,0,0,7
1088031,772061,2018-08-16,Senate,"Do pass",7,0,0,0,7
1088031,773583,2018-08-29,Senate,"Assembly 3rd Reading AB2358 Carrillo et al. By Jackson",39,0,1,0,40
1088031,773708,2018-08-30,Assembly,"AB 2358 CARRILLO Concurrence in Senate Amendments",80,0,0,0,80
1088034,725712,2018-03-20,Assembly,"Do pass and be re-referred to the Committee on [Appropriations] with recommendation: To Consent Calendar",10,0,0,0,10
1088034,734265,2018-04-04,Assembly,"Do pass. To Consent Calendar",15,0,2,0,17
1088034,738283,2018-04-12,Assembly,"AB 2309 BLOOM Consent Calendar Second Day Regular Session",68,0,9,0,77
1088034,766813,2018-06-19,Senate,"Do pass, but first be re-referred to the Committee on [Appropriations] with the recommendation: To Consent Calendar",7,0,0,0,7
1088034,769667,2018-07-02,Senate,"Placed on suspense file",7,0,0,0,7
1088034,771990,2018-08-16,Senate,"Do pass",7,0,0,0,7
1088034,773487,2018-08-29,Senate,"Assembly 3rd Reading AB2309 Bloom By Allen Urgency Clause",26,1,13,0,40
1088034,773488,2018-08-29,Senate,"Assembly 3rd Reading AB2309 Bloom By Allen Reconsider",38,0,2,0,40
1088034,774151,2018-08-31,Senate,"Assembly 3rd Reading AB2309 Bloom By Allen Urgency Clause",38,0,2,0,40
1088034,774152,2018-08-31,Assembly,"AB 2309 Bloom Concurrence in Senate Amendments",78,0,2,0,80
1088035,725660,2018-03-20,Assembly,"Do pass and be re-referred to the Committee on [Appropriations] with recommendation: To Consent Calendar",7,0,0,0,7
1088035,756627,2018-05-25,Assembly,"Do pass",16,0,1,0,17
1088035,757167,2018-05-29,Assembly,"AB 2269 LACKEY Assembly Third Reading",76,0,2,0,78
1088035,762874,2018-06-12,Senate,"Do pass, but first be re-referred to the Committee on [Appropriations]",6,0,1,0,7
1088035,768015,2018-06-25,Senate,"Placed on suspense file",7,0,0,0,7
1088037,743831,2018-04-25,Senate,"Do pass as amended, but first amend, and re-refer to the Committee on [Appropriations]",5,0,0,0,5
1088037,752767,2018-05-14,Senate,"Placed on suspense file",7,0,0,0,7
1088037,756326,2018-05-25,Senate,"Do pass",7,0,0,0,7
1088037,758488,2018-05-31,Senate,"Special Consent SB1123",39,0,0,0,39
1088037,766203,2018-06-20,Assembly,"Do pass and be re-referred to the Committee on [Appropriations] with recommendation: To Consent Calendar",12,0,1,0,13
1088037,771565,2018-08-16,Assembly,"Do pass as amended",17,0,0,0,17
1088037,773445,2018-08-29,Assembly,"SB 1123 Jackson Senate Third Reading By EGGMAN",80,0,0,0,80
1088037,773795,2018-08-30,Senate,"Unfinished Business SB1123 Jackson et al. Concurrence",39,0,1,0,40
1088039,751882,2018-05-09,Assembly,"Do pass as amended",6,1,0,0,7
1088039,755734,2018-05-23,Assembly,"Do pass",11,5,1,0,17
1088039,757113,2018-05-29,Assembly,"AB 2263 FRIEDMAN Assembly Third Reading",51,25,2,0,78
1088039,765157,2018-06-19,Senate,"Do pass, but first be re-referred to the Committee on [Governance and Finance]",12,1,0,0,13
1088039,769210,2018-06-27,Senate,"Do pass, but first be re-referred to the Committee on [Appropriations]",6,0,1,0,7
1088039,771163,2018-08-09,Senate,"Assembly 3rd Reading AB2263 Friedman By Beall",30,5,4,0,39
1088039,771251,2018-08-13,Assembly,"AB 2263 FRIEDMAN Concurrence in Senate Amendments",53,22,5,0,80
1088042,725502,2018-03-20,Assembly,"Do pass and be re-referred to the Committee on [Appropriations] with recommendation: To Consent Calendar",7,0,0,0,7
1088042,733873,2018-04-04,Assembly,"Do pass. To Consent Calendar",15,0,2,0,17
1088042,738277,2018-04-12,Assembly,"AB 2327 QUIRK Consent Calendar Second Day Regular Session",68,0,9,0,77
1088042,753259,2018-05-15,Senate,"Do pass, but first be re-referred to the Committee on [Appropriations] with the recommendation: To Consent Calendar",7,0,0,0,7
1088042,767838,2018-06-25,Senate,"Placed on suspense file",7,0,0,0,7
1088042,771886,2018-08-16,Senate,"Do pass",7,0,0,0,7
1088042,772687,2018-08-24,Senate,"Special Consent AB2327",39,0,1,0,40
1088043,738226,2018-04-11,Assembly,"Do pass as amended and be re-referred to the Committee on [Appropriations]",7,0,0,0,7
1088043,756276,2018-05-25,Assembly,"Do pass",16,0,1,0,17
1088043,757155,2018-05-29,Assembly,"AB 2289 WEBER Assembly Third Reading",78,0,0,0,78
1088043,766661,2018-06-20,Senate,"Do pass as amended, but first amend, and re-refer to the Committee on [Appropriations]",7,0,0,0,7
1088043,770961,2018-08-06,Senate,"Placed on suspense file",7,0,0,0,7
1088043,772067,2018-08-16,Senate,"Do pass",7,0,0,0,7
1088043,773567,2018-08-29,Senate,"Assembly 3rd Reading AB2289 Weber et al. By Galgiani",39,0,1,0,40
1088043,773693,2018-08-30,Assembly,"AB 2289 WEBER Concurrence in Senate Amendments",80,0,0,0,80
1088044,738862,2018-04-16,Assembly,"Do pass. To Consent Calendar",14,0,0,0,14
1088044,742292,2018-04-23,Assembly,"AB 2307 FRAZIER Consent Calendar Second Day Regular Session",75,0,3,0,78
1088044,753413,2018-05-15,Senate,"Do pass and be ordered to the Consent Calendar",11,0,2,0,13
1088044,754925,2018-05-21,Senate,"Consent Calendar AB2307",39,0,0,0,39
1088849,726139,2018-03-20,Assembly,"Do pass and be re-referred to the Committee on [Health] with recommendation: To Consent Calendar",7,0,0,0,7
1088849,733490,2018-04-03,Assembly,"Do pass and be re-referred to the Committee on [Appropriations] with recommendation: To Consent Calendar",15,0,0,0,15
1088849,741221,2018-04-18,Assembly,"Do pass. To Consent Calendar",15,0,2,0,17
1088849,744922,2018-04-26,Assembly,"AB 2397 OBERNOLTE Consent Calendar Second Day Regular Session",74,0,4,0,78
1088849,762943,2018-06-12,Senate,"Do pass, but first be re-referred to the Committee on [Appropriations]",6,0,1,0,7
1088849,769658,2018-07-02,Senate,"Placed on suspense file",7,0,0,0,7
1088849,771982,2018-08-16,Senate,"Do pass",7,0,0,0,7
1088849,772722,2018-08-24,Senate,"Special Consent AB2397",39,0,1,0,40
1088929,736104,2018-04-09,Assembly,"Do pass and be re-referred to the Committee on [Appropriations]",9,0,1,0,10
1088929,756366,2018-05-25,Assembly,"Do pass",16,0,1,0,17
1088929,757106,2018-05-29,Assembly,"AB 2404 O'DONNELL Assembly Third Reading",77,0,1,0,78
1088929,768384,2018-06-26,Senate,"Do pass, but first be re-referred to the Committee on [Appropriations] with the recommendation: To Consent Calendar",9,0,0,0,9
1088929,770806,2018-08-06,Senate,"Placed on suspense file",7,0,0,0,7
1089007,743245,2018-04-24,Assembly,"Do pass and be re-referred to the Committee on [Appropriations]",13,1,1,0,15
1089007,756688,2018-05-25,Assembly,"Do pass",12,1,4,0,17
1089007,757179,2018-05-29,Assembly,"AB 2421 STONE Assembly Third Reading",67,4,7,0,78
1089007,768308,2018-06-26,Senate,"Do pass as amended, but first amend, and re-refer to the Committee on [Appropriations]",8,1,0,0,9
1089007,770381,2018-08-06,Senate,"Placed on suspense file",7,0,0,0,7
1089007,771987,2018-08-16,Senate,"Do pass",7,0,0,0,7
1089007,772651,2018-08-24,Senate,"Assembly 3rd Reading AB2421 Mark Stone et al. By Galgiani",33,5,2,0,40
1089007,773347,2018-08-29,Assembly,"AB 2421 STONE Concurrence in Senate Amendments",69,8,3,0,80
1089080,746935,2018-04-30,Assembly,"Do pass and be re-referred to the Committee on [Appropriations]",9,0,1,0,10
1089088,733255,2018-04-03,Assembly,"Do pass and be re-referred to the Committee on [Appropriations]",5,2,0,0,7
1089089,726133,2018-03-20,Assembly,"Do pass and be re-referred to the Committee on [Appropriations]",13,0,3,0,16
1089089,733801,2018-04-04,Assembly,"Do pass. To Consent Calendar",15,0,2,0,17
1089089,738161,2018-04-12,Assembly,"AB 2457 IRWIN Consent Calendar Second Day Regular Session",68,0,9,0,77
1089089,750032,2018-05-07,Senate,"Do pass, but first be re-referred to the Committee on [Appropriations] with the recommendation: To Consent Calendar",8,0,1,0,9
1089089,769551,2018-07-02,Senate,"Consent Calendar AB2457",37,0,2,0,39
1089092,743230,2018-04-24,Senate,"Do pass as amended, but first amend, and re-refer to the Committee on [Appropriations]",12,0,0,0,12
1089092,754280,2018-05-17,Senate,"Senate 3rd Reading SB1164 Skinner et al",37,0,2,0,39
1089092,766167,2018-06-20,Assembly,"Do pass and be re-referred to the Committee on [Appropriations]",19,0,2,0,21
1089092,771504,2018-08-15,Assembly,"Do pass. To Consent Calendar",17,0,0,0,17
1089092,773336,2018-08-29,Assembly,"SB 1164 Skinner Senate Third Reading By DALY",80,0,0,0,80
1089092,773912,2018-08-30,Senate,"Unfinished Business SB1164 Skinner et al. Concurrence",39,0,1,0,40
1089094,744434,2018-04-24,Senate,"Do pass as amended, but first amend, and re-refer to the Committee on [Appropriations]",6,0,1,0,7
1089094,757058,2018-05-29,Senate,"Senate 3rd Reading SB1155 Hueso",34,0,5,0,39
1089094,768361,2018-06-26,Assembly,"Do pass as amended and be re-referred to the Committee on [Appropriations]",6,0,4,0,10
1089094,771831,2018-08-16,Assembly,"Do pass as amended",10,0,7,0,17
1089094,773762,2018-08-30,Assembly,"SB 1155 Hueso Senate Third Reading By STONE",64,6,10,0,80
1089094,774039,2018-08-31,Senate,"Unfinished Business SB1155 Hueso et al. Concurrence",31,4,5,0,40
1089096,725491,2018-03-20,Assembly,"Do pass as amended, and be re-referred to the Committee on [Environmental Safety and Toxic Materials] with recommendation: To Consent Calendar",7,0,0,0,7
1089096,736630,2018-04-10,Assembly,"Do pass and be re-referred to the Committee on [Appropriations]",6,0,1,0,7
1089096,756404,2018-05-25,Assembly,"Do pass as amended",14,0,3,0,17
1089096,758730,2018-05-31,Assembly,"AB 2370 HOLDEN Assembly Third Reading",75,0,3,0,78
1089096,766887,2018-06-20,Senate,"Do pass, but first be re-referred to the Committee on [Human Services]",7,0,0,0,7
1089096,768886,2018-06-26,Senate,"Do pass as amended, but first amend, and re-refer to the Committee on [Appropriations]",6,0,1,0,7
1089096,771337,2018-08-13,Senate,"Placed on suspense file",7,0,0,0,7
1089096,771875,2018-08-16,Senate,"Do pass",7,0,0,0,7
1089096,773573,2018-08-29,Senate,"Assembly 3rd Reading AB2370 Holden et al. By Leyva",39,0,1,0,40
1089096,773860,2018-08-30,Assembly,"AB 2370 HOLDEN Concurrence in Senate Amendments",79,0,1,0,80
1089097,733327,2018-04-03,Assembly,"Do pass and be re-referred to the Committee on [Appropriations]",14,0,1,0,15
1089097,737431,2018-04-11,Assembly,"Do pass. To Consent Calendar",15,0,2,0,17
1089097,741465,2018-04-19,Assembly,"AB 2476 RUBIO Consent Calendar Second Day Regular Session",71,0,7,0,78
1089097,777391,2018-04-11,Assembly,"Do pass. To Consent Cass=""columnField"" style=""text-align:left"">",14,0,2,0,16
1089098,733146,2018-04-03,Assembly,"Do pass and be re-referred to the Committee on [Natural Resources]",14,0,1,0,15
1089098,742852,2018-04-23,Assembly,"Do pass and be re-referred to the Committee on [Appropriations] with recommendation: To Consent Calendar",10,0,0,0,10
1089098,756444,2018-05-25,Assembly,"Do pass",16,0,1,0,17
1089098,757066,2018-05-29,Assembly,"AB 2434 BLOOM Assembly Third Reading",76,0,2,0,78
1089098,762188,2018-06-12,Senate,"Do pass, but first be re-referred to the Committee on [Environmental Quality]",7,0,2,0,9
1089098,766905,2018-06-20,Senate,"Do pass as amended, but first amend, and re-refer to the Committee on [Appropriations]",5,0,2,0,7
1089098,770267,2018-08-06,Senate,"Placed on suspense file",7,0,0,0,7
1089100,739493,2018-04-17,Assembly,"Do pass and be re-referred to the Committee on [Appropriations] with recommendation: To Consent Calendar",10,0,0,0,10
1089101,740974,2018-04-17,Assembly,"Do pass and be re-referred to the Committee on [Appropriations] with recommendation: To Consent Calendar",15,0,0,0,15
1089101,751833,2018-05-09,Assembly,"Do pass. To Consent Calendar",16,0,1,0,17
1089101,754220,2018-05-17,Assembly,"AB 2428 GONZALEZ FLETCHER Consent Calendar Second Day Regular Session",73,0,5,0,78
1089101,763227,2018-06-13,Senate,"Do pass as amended, but first amend, and re-refer to the Committee on [Appropriations]",8,0,1,0,9
1089101,769672,2018-07-02,Senate,"Placed on suspense file",7,0,0,0,7
1089101,772090,2018-08-16,Senate,"Do pass",7,0,0,0,7
1089101,774199,2018-08-31,Senate,"Assembly 3rd Reading AB2428 Gonzalez Fletcher By Hernandez",39,0,1,0,40
1089101,774200,2018-08-31,Assembly,"AB 2428 Gonzalez Fletcher Concurrence in Senate Amendments",76,0,4,0,80
1089102,736034,2018-04-10,Senate,"Do pass, but first be re-referred to the Committee on [Appropriations]",12,0,0,0,12
1089102,742837,2018-04-23,Senate,"Placed on suspense file",7,0,0,0,7
1089102,756689,2018-05-25,Senate,"Do pass",7,0,0,0,7
1089102,758715,2018-05-31,Senate,"Special Consent SB1181",39,0,0,0,39
1089102,766041,2018-06-20,Assembly,"Do pass and be re-referred to the Committee on [Appropriations] with recommendation: To Consent Calendar",19,0,2,0,21
1089102,771856,2018-08-16,Assembly,"Do pass",17,0,0,0,17
1089102,773952,2018-08-30,Assembly,"SB 1181 Hueso Senate Third Reading By GONZALEZ FLETCHER",80,0,0,0,80
1089105,736089,2018-04-09,Assembly,"Do pass as amended and be re-referred to the Committee on [Appropriations]",8,0,2,0,10
1089105,743965,2018-04-25,Assembly,"Do pass. To Consent Calendar",17,0,0,0,17
1089105,748909,2018-05-03,Assembly,"AB 2458 WEBER Consent Calendar Second Day Regular Session",71,0,7,0,78
1089105,763143,2018-06-13,Senate,"Do pass, but first be re-referred to the Committee on [Appropriations]",7,0,0,0,7
1089105,771277,2018-08-13,Senate,"Assembly 3rd Reading AB2458 Weber By McGuire",36,0,4,0,40
1089105,772135,2018-08-20,Assembly,"AB 2458 WEBER Concurrence in Senate Amendments",79,0,1,0,80
1089107,742868,2018-04-23,Assembly,"Do pass and be re-referred to the Committee on [Appropriations]",10,0,0,0,10
1089107,756770,2018-05-25,Assembly,"Do pass",16,0,1,0,17
1089107,758836,2018-05-31,Assembly,"AB 2493 BLOOM Assembly Third Reading",78,0,0,0,78
1089107,767137,2018-06-20,Senate,"Do pass as amended, but first amend, and re-refer to the Committee on [Appropriations]",7,0,0,0,7
1089107,770759,2018-08-06,Senate,"Placed on suspense file",7,0,0,0,7
1089107,772085,2018-08-16,Senate,"Do pass",7,0,0,0,7
1089107,773634,2018-08-29,Senate,"Assembly 3rd Reading AB2493 Bloom By Wieckowski",39,0,1,0,40
1089107,773904,2018-08-30,Assembly,"AB 2493 BLOOM Concurrence in Senate Amendments",80,0,0,0,80
1089108,736017,2018-04-10,Assembly,"Do pass",3,4,0,0,7
1089108,736018,2018-04-10,Assembly,Reconsideration,7,0,0,0,7
1089108,743644,2018-04-24,Assembly,"Do pass",2,5,0,0,7
1089109,736001,2018-04-10,Assembly,"Do pass and be re-referred to the Committee on [Appropriations]",6,1,0,0,7
1089109,756605,2018-05-25,Assembly,"Do pass",14,2,1,0,17
1089109,757023,2018-05-29,Assembly,"AB 2533 STONE Assembly Third Reading",56,17,5,0,78
1089109,764841,2018-06-19,Senate,"Do pass, but first be re-referred to the Committee on [Appropriations]",5,2,0,0,7
1089109,770283,2018-08-06,Senate,"Placed on suspense file",7,0,0,0,7
1089109,771688,2018-08-16,Senate,"Do pass as amended",5,2,0,0,7
1089109,773469,2018-08-29,Senate,"Assembly 3rd Reading AB2533 Mark Stone By Wiener",27,12,1,0,40
1089109,773797,2018-08-30,Assembly,"AB 2533 STONE Concurrence in Senate Amendments",58,17,5,0,80
1089109,775337,2018-05-29,Assembly,,14,2,5,0,21
1089111,738889,2018-04-16,Senate,"Do pass and be ordered to the Consent Calendar",7,0,2,0,9
1089111,742080,2018-04-23,Senate,"Consent Calendar SB1170 Morrell Urgency Clause",38,0,1,0,39
1089113,737262,2018-04-11,Assembly,"Do pass as amended and be re-referred to the Committee on [Local Government]",7,0,0,0,7
1089113,751287,2018-05-09,Assembly,"Do pass",9,0,0,0,9
1089113,754240,2018-05-17,Assembly,"AB 2372 GLORIA Assembly Third Reading",69,0,9,0,78
1089113,762210,2018-06-12,Senate,"Do pass, but first be re-referred to the Committee on [Governance and Finance] with the recommendation: To Consent Calendar",12,0,1,0,13
1089113,769255,2018-06-27,Senate,"Do pass",7,0,0,0,7
1089113,772201,2018-08-20,Senate,"Assembly 3rd Reading AB2372 Gloria et al. By Beall",39,0,1,0,40
1089113,773548,2018-08-29,Assembly,"AB 2372 GLORIA Concurrence in Senate Amendments",78,0,2,0,80
1089114,743891,2018-04-24,Assembly,"Do pass as amended and be re-referred to the Committee on [Appropriations]",5,2,0,0,7
1089114,756407,2018-05-25,Assembly,"Do pass as amended",12,4,1,0,17
1089114,758682,2018-05-31,Assembly,"AB 2455 KALRA Assembly Third Reading",47,29,2,0,78
1089114,768896,2018-06-26,Senate,"Do pass as amended, but first amend, and re-refer to the Committee on [Appropriations]",4,1,2,0,7
1089114,770255,2018-08-06,Senate,"Placed on suspense file",7,0,0,0,7
1089114,771897,2018-08-16,Senate,"Do pass",5,2,0,0,7
1089114,772656,2018-08-24,Senate,"Assembly 3rd Reading AB2455 Kalra By Leyva",23,14,3,0,40
1089114,773461,2018-08-29,Assembly,"AB 2455 KALRA Concurrence in Senate Amendments",47,26,7,0,80
1089116,741259,2018-04-17,Assembly,"Do pass as amended, and be re-referred to the Committee on [Appropriations] with recommendation: To Consent Calendar",15,0,0,0,15
1089116,755718,2018-05-23,Assembly,"Do pass. To Consent Calendar",16,0,1,0,17
1089116,757181,2018-05-29,Assembly,"AB 2524 WOOD Consent Calendar Second Day Regular Session",78,0,0,0,78
1089116,766485,2018-06-20,Senate,"Do pass as amended, but first amend, and re-refer to the Committee on [Appropriations] with the recommendation: To Consent Calendar",8,0,1,0,9
1089116,773458,2018-08-29,Senate,"Assembly 3rd Reading AB2524 Wood By Cannella",39,0,1,0,40
1089116,773931,2018-08-30,Assembly,"AB 2524 WOOD Concurrence in Senate Amendments",79,1,0,0,80
1089118,733235,2018-04-03,Assembly,"Do pass and be re-referred to the Committee on [Appropriations]",6,0,1,0,7
1089121,739859,2018-04-16,Senate,"Do pass, but first be re-referred to the Committee on [Appropriations]",7,0,2,0,9
1089121,750246,2018-05-07,Senate,"Placed on suspense file",6,0,1,0,7
1089121,756700,2018-05-25,Senate,"Do pass as amended",5,1,1,0,7
1089121,757856,2018-05-30,Senate,"Senate 3rd Reading SB1147 Hertzberg",30,3,6,0,39
1089121,768253,2018-06-25,Assembly,"Do pass and be re-referred to the Committee on [Appropriations]",8,1,1,0,10
1089121,771675,2018-08-16,Assembly,"Do pass as amended",12,0,5,0,17
1089121,773475,2018-08-29,Assembly,"SB 1147 Hertzberg Senate Third Reading By STONE",77,0,3,0,80
1089121,773753,2018-08-30,Senate,"Unfinished Business SB1147 Hertzberg Concurrence",39,0,1,0,40
1089123,733171,2018-04-03,Assembly,"Do pass as amended and be re-referred to the Committee on [Appropriations]",15,0,0,0,15
1089123,743969,2018-04-25,Assembly,"Do pass. To Consent Calendar",17,0,0,0,17
1089123,748913,2018-05-03,Assembly,"AB 2539 MATHIS Consent Calendar Second Day Regular Session",71,0,7,0,78
1089123,763113,2018-06-13,Senate,"Do pass, but first be re-referred to the Committee on [Appropriations]",8,0,1,0,9
1089123,768004,2018-06-25,Senate,"Placed on suspense file",7,0,0,0,7
1089124,743979,2018-04-25,Assembly,"Do pass and be re-referred to the Committee on [Appropriations]",7,0,0,0,7
1089124,751346,2018-05-09,Assembly,"Do pass. To Consent Calendar",16,0,1,0,17
1089124,754323,2018-05-17,Assembly,"AB 2456 BLOOM Consent Calendar Second Day Regular Session",73,0,5,0,78
1089124,762212,2018-06-12,Senate,"Do pass, but first be re-referred to the Committee on [Appropriations]",10,0,2,0,12
1089124,771276,2018-08-13,Senate,"Assembly 3rd Reading AB2456 Bloom By Allen",37,0,3,0,40
1089125,741435,2018-04-18,Assembly,"Do pass and be re-referred to the Committee on [Appropriations]",7,0,0,0,7
1089125,747826,2018-05-02,Assembly,"Do pass. To Consent Calendar",17,0,0,0,17
1089125,752055,2018-05-10,Assembly,"AB 2420 QUIRK-SILVA Consent Calendar Second Day Regular Session",73,0,5,0,78
1089125,762791,2018-06-13,Senate,"Do pass, but first be re-referred to the Committee on [Appropriations]",5,0,0,0,5
1089125,771154,2018-08-09,Senate,"Assembly 3rd Reading AB2420 Quirk-Silva By Jackson",36,0,3,0,39
1089127,735994,2018-04-10,Senate,"Do pass, but first be re-referred to the Committee on [Health]",5,0,2,0,7
1089127,743839,2018-04-25,Senate,"Do pass, but first be re-referred to the Committee on [Appropriations]",7,0,2,0,9
1089127,752743,2018-05-14,Senate,"Placed on suspense file",7,0,0,0,7
1089128,744884,2018-04-25,Assembly,"Do pass as amended and be re-referred to the Committee on [Appropriations]",7,0,0,0,7
1089128,753825,2018-05-16,Assembly,"Do pass. To Consent Calendar",17,0,0,0,17
1089128,756283,2018-05-25,Assembly,"AB 2390 HARPER Consent Calendar Second Day Regular Session",70,0,8,0,78
1089129,751855,2018-05-08,Senate,"Do pass",2,1,4,0,7
1089131,714409,2018-03-01,Assembly,"Be adopted. To third reading",6,0,5,0,11
1089132,743746,2018-04-25,Assembly,"Do pass as amended and be re-referred to the Committee on [Appropriations]",8,4,1,0,13
1089132,756487,2018-05-25,Assembly,"Do pass as amended",12,4,1,0,17
1089132,758818,2018-05-31,Assembly,"AB 2537 CARRILLO Assembly Third Reading",54,24,0,0,78
1089132,768799,2018-06-27,Senate,"Do pass, but first be re-referred to the Committee on [Appropriations]",9,1,1,0,11
1089132,770520,2018-08-06,Senate,"Placed on suspense file",7,0,0,0,7
1089133,736129,2018-04-10,Assembly,"Do pass and be re-referred to the Committee on [Appropriations]",12,1,2,0,15
1089133,740882,2018-04-18,Assembly,"Do pass as amended",15,0,2,0,17
1089133,746121,2018-04-30,Assembly,"AB 2369 GONZALEZ FLETCHER Assembly Third Reading",74,0,4,0,78
1089133,762202,2018-06-12,Senate,"Do pass, but first be re-referred to the Committee on [Appropriations] with the recommendation: To Consent Calendar",9,0,0,0,9
1089133,770900,2018-08-06,Senate,"Consent Calendar AB2369 Gonzalez Fletcher",37,0,2,0,39
1089133,771164,2018-08-09,Assembly,"AB 2369 GONZALEZ FLETCHER Concurrence in Senate Amendments",77,0,3,0,80
1089135,736167,2018-04-10,Assembly,"Do pass as amended",9,0,1,0,10
1089135,741457,2018-04-19,Assembly,"AB 2376 STONE Assembly Third Reading",65,0,13,0,78
1089135,763179,2018-06-12,Senate,"Do pass and be ordered to the Consent Calendar",7,0,0,0,7
1089135,772402,2018-08-21,Senate,"Assembly 3rd Reading AB2376 Mark Stone By Galgiani",38,0,2,0,40
1089135,773012,2018-08-27,Assembly,"AB 2376 STONE Concurrence in Senate Amendments",78,0,2,0,80
1089140,737397,2018-04-11,Senate,"Do pass, but first be re-referred to the Committee on [Labor and Industrial Relations]",4,2,0,0,6
1089140,743808,2018-04-25,Senate,"Do pass, but first be re-referred to the Committee on [Appropriations]",4,1,0,0,5
1089140,749805,2018-05-07,Senate,"Placed on suspense file",6,0,1,0,7
1089140,756622,2018-05-25,Senate,"Do pass as amended",5,2,0,0,7
1089140,757600,2018-05-30,Senate,"Senate 3rd Reading SB1177 Portantino",25,10,4,0,39
1089140,764248,2018-06-18,Assembly,"Be re-referred to the Committee on [Public Safety]",7,0,4,0,11
1089140,768118,2018-06-26,Assembly,"Do pass and be re-referred to the Committee on [Appropriations]",5,2,0,0,7
1089140,771848,2018-08-16,Assembly,"Do pass",12,5,0,0,17
1089140,772797,2018-08-27,Assembly,"SB 1177 Portantino Senate Third Reading By SANTIAGO",47,30,3,0,80
1089140,773275,2018-08-29,Senate,"That the Assembly amendments be concurred in",5,2,0,0,7
1089140,773851,2018-08-30,Senate,"Unfinished Business SB1177 Portantino Concurrence",25,12,3,0,40
1089141,723584,2018-03-15,Senate,"Senate 3rd Reading SCR103 Fuller",37,0,2,0,39
1089141,745236,2018-04-26,Assembly,"Be adopted. To Consent Calendar",8,0,3,0,11
1089141,748694,2018-05-03,Assembly,"SCR 103 Fuller Consent Calendar Second Day Regular Session",71,0,7,0,78
1089144,750736,2018-05-08,Assembly,"Do pass",16,0,2,0,18
1089144,752138,2018-05-10,Assembly,"AB 2445 O'DONNELL Assembly Third Reading",70,0,8,0,78
1089144,765581,2018-06-18,Senate,"Do pass",9,0,0,0,9
1089144,769666,2018-07-02,Senate,"Assembly 3rd Reading AB2445 O'Donnell By Galgiani",37,0,2,0,39
1089145,736073,2018-04-10,Senate,"Do pass, but first be re-referred to the Committee on [Judiciary]",11,0,1,0,12
1089145,740895,2018-04-17,Senate,"Do pass, but first be re-referred to the Committee on [Appropriations] with the recommendation: To Consent Calendar",7,0,0,0,7
1089145,746247,2018-04-30,Senate,"Placed on suspense file",6,0,1,0,7
1089147,742893,2018-04-24,Assembly,"Do pass and be re-referred to the Committee on [Appropriations]",16,0,0,0,16
1089147,756486,2018-05-25,Assembly,"Do pass as amended",12,0,5,0,17
1089147,758644,2018-05-31,Assembly,"AB 2368 CALDERON Assembly Third Reading",78,0,0,0,78
1089148,725699,2018-03-20,Assembly,"Do pass",12,0,4,0,16
1089148,752067,2018-05-10,Assembly,"AB 2362 RUBIO Assembly Third Reading",64,0,14,0,78
1089148,769604,2018-07-02,Senate,"Do pass as amended",8,0,1,0,9
1089148,771437,2018-08-13,Senate,"Special Consent AB2362",37,0,3,0,40
1089148,772193,2018-08-20,Assembly,"AB 2362 RUBIO Concurrence in Senate Amendments",75,0,5,0,80
1089151,743712,2018-04-24,Assembly,"Do pass and be re-referred to the Committee on [Appropriations]",7,0,0,0,7
1089151,756204,2018-05-25,Assembly,"Do pass",13,3,1,0,17
1089151,757017,2018-05-29,Assembly,"AB 2501 CHU Assembly Third Reading",55,21,2,0,78
1089151,767371,2018-06-20,Senate,"Do pass as amended, but first amend, and re-refer to the Committee on [Appropriations]",5,2,0,0,7
1089151,770843,2018-08-06,Senate,"Placed on suspense file",7,0,0,0,7
1089151,772027,2018-08-16,Senate,"Do pass",5,2,0,0,7
1089151,773111,2018-08-28,Senate,"That the measure be returned to Senate Floor for consideration. Ordered to third reading",4,2,1,0,7
1089151,773721,2018-08-30,Senate,"Assembly 3rd Reading AB2501 Chu et al. By Hertzberg",26,13,1,0,40
1089151,774194,2018-08-31,Assembly,"With recommendation: That Senate amendments be concurred in",6,1,0,0,7
1089151,774195,2018-08-31,Assembly,"AB 2501 Chu Concurrence in Senate Amendments",54,22,4,0,80
1089153,744793,2018-04-25,Assembly,"Do pass as amended and be re-referred to the Committee on [Appropriations]",6,0,1,0,7
1089153,756538,2018-05-25,Assembly,"Do pass",13,1,3,0,17
1089153,757097,2018-05-29,Assembly,"AB 2488 O'DONNELL Assembly Third Reading",69,1,8,0,78
1089153,762925,2018-06-13,Senate,"Do pass, but first be re-referred to the Committee on [Appropriations]",7,0,0,0,7
1089153,769776,2018-07-05,Senate,"Assembly 3rd Reading AB2488 O'Donnell By Wilk",29,5,5,0,39
1089155,737199,2018-04-11,Assembly,"Do pass and be re-referred to the Committee on [Appropriations]",9,0,0,0,9
1089156,733168,2018-04-03,Assembly,"Do pass and be re-referred to the Committee on [Appropriations]",5,0,2,0,7
1089159,742168,2018-04-23,Assembly,"Do pass and be re-referred to the Committee on [Appropriations]",13,0,1,0,14
1089159,747902,2018-05-02,Assembly,"Do pass",17,0,0,0,17
1089159,757119,2018-05-29,Assembly,"AB 2392 SANTIAGO Assembly Third Reading",74,1,3,0,78
1089159,765202,2018-06-18,Senate,"Do pass as amended, but first amend, and re-refer to the Committee on [Judiciary]",9,0,0,0,9
1089159,772532,2018-08-23,Senate,"Assembly 3rd Reading AB2392 Santiago By Mitchell",37,0,3,0,40
1089159,772840,2018-08-27,Assembly,"AB 2392 SANTIAGO Concurrence in Senate Amendments",80,0,0,0,80
1089163,733298,2018-04-03,Senate,"Do pass, but first be re-referred to the Committee on [Appropriations]",4,0,1,0,5
1089163,744862,2018-04-26,Senate,"Senate 3rd Reading SB1153 Stern",36,0,3,0,39
1089163,762895,2018-06-13,Assembly,"Do pass and be re-referred to the Committee on [Appropriations]",7,0,0,0,7
1089163,768860,2018-06-27,Assembly,"Do pass. To Consent Calendar",16,0,1,0,17
1089163,769757,2018-07-05,Assembly,"SB 1153 Stern Consent Calendar Second Day Regular Session",69,0,11,0,80
1089164,739860,2018-04-17,Assembly,"Do pass as amended and be re-referred to the Committee on [Appropriations]",12,0,1,0,13
1089164,756555,2018-05-25,Assembly,"Do pass as amended",12,0,5,0,17
1089164,757789,2018-05-30,Assembly,"AB 2505 SANTIAGO Assembly Third Reading",71,0,7,0,78
1089164,768745,2018-06-27,Senate,"Do pass as amended, but first amend, and re-refer to the Committee on [Appropriations]",7,0,0,0,7
1089164,770500,2018-08-06,Senate,"Placed on suspense file",7,0,0,0,7
1089164,772010,2018-08-16,Senate,"Do pass as amended",7,0,0,0,7
1089164,772779,2018-08-27,Senate,"Assembly 3rd Reading AB2505 Santiago By Pan",39,0,1,0,40
1089164,773353,2018-08-29,Assembly,"AB 2505 SANTIAGO Concurrence in Senate Amendments",79,0,1,0,80
1089167,739833,2018-04-16,Assembly,"Do pass as amended and be re-referred to the Committee on [Public Safety]",6,4,0,0,10
1089168,734050,2018-04-03,Assembly,"Do pass and be re-referred to the Committee on [Appropriations]",11,1,1,0,13
1089168,756477,2018-05-25,Assembly,"Do pass as amended",12,3,2,0,17
1089168,757562,2018-05-30,Assembly,"AB 2477 RUBIO Assembly Third Reading",55,17,6,0,78
1089168,762833,2018-06-13,Senate,"Do pass, but first be re-referred to the Committee on [Appropriations]",7,0,0,0,7
1089168,769601,2018-07-02,Senate,"Placed on suspense file",7,0,0,0,7
1089168,771645,2018-08-16,Senate,"Do pass as amended",5,1,1,0,7
1089168,772421,2018-08-22,Senate,"Assembly 3rd Reading AB2477 Rubio et al. By Lara",29,9,2,0,40
1089168,772945,2018-08-27,Assembly,"AB 2477 RUBIO Concurrence in Senate Amendments",61,11,8,0,80
1089168,777522,2018-08-22,Senate,,5,9,2,0,16
1089169,747897,2018-05-02,Senate,"Do pass, but first be re-referred to the Committee on [Appropriations]",7,0,0,0,7
1089169,752941,2018-05-14,Senate,"Placed on suspense file",7,0,0,0,7
1089171,739692,2018-04-17,Assembly,"Do pass and be re-referred to the Committee on [Business and Professions]",7,0,0,0,7
1089171,742981,2018-04-24,Assembly,"Do pass as amended and be re-referred to the Committee on [Appropriations]",15,0,1,0,16
1089172,750486,2018-05-08,Assembly,"Do pass",13,3,2,0,18
1089172,751962,2018-05-10,Assembly,"AB 2450 QUIRK Assembly Third Reading",56,12,10,0,78
1089172,765351,2018-06-18,Senate,"Do pass",7,2,0,0,9
1089172,772079,2018-08-16,Senate,"Assembly 3rd Reading AB2450 Quirk By Hill",27,11,2,0,40
1089172,772491,2018-08-23,Assembly,"AB 2450 QUIRK Concurrence in Senate Amendments",62,15,3,0,80
1089174,733246,2018-04-03,Assembly,"Do pass. To Consent Calendar",7,0,0,0,7
1089174,738174,2018-04-12,Assembly,"AB 2495 MAYES Consent Calendar Second Day Regular Session",68,0,9,0,77
1089174,764896,2018-06-19,Senate,"Do pass",7,0,0,0,7
1089174,771278,2018-08-13,Senate,"Assembly 3rd Reading AB2495 Mayes et al. By Wiener",36,1,3,0,40
1089174,772252,2018-08-20,Assembly,"AB 2495 MAYES Concurrence in Senate Amendments",69,2,9,0,80
1089176,743158,2018-04-24,Assembly,"Do pass and be re-referred to the Committee on [Appropriations]",15,0,0,0,15
1089176,756460,2018-05-25,Assembly,"Do pass",14,2,1,0,17
1089176,757003,2018-05-29,Assembly,"AB 2472 WOOD Assembly Third Reading",68,8,2,0,78
1089176,766103,2018-06-20,Senate,"Do pass as amended, but first amend, and re-refer to the Committee on [Appropriations]",7,0,2,0,9
1089176,770549,2018-08-06,Senate,"Placed on suspense file",7,0,0,0,7
1089176,771657,2018-08-16,Senate,"Do pass as amended",5,1,1,0,7
1089176,772465,2018-08-22,Senate,"Assembly 3rd Reading AB2472 Wood et al. By Monning",27,10,3,0,40
1089176,772807,2018-08-27,Assembly,"AB 2472 WOOD Concurrence in Senate Amendments",62,16,2,0,80
1089178,736272,2018-04-10,Senate,"Do pass, but first be re-referred to the Committee on [Appropriations] with the recommendation: To Consent Calendar",12,0,0,0,12
1089178,742821,2018-04-23,Senate,"Placed on suspense file",7,0,0,0,7
1089179,740768,2018-04-18,Assembly,"Do pass and be re-referred to the Committee on [Natural Resources]",21,0,0,0,21
1089179,743172,2018-04-23,Assembly,"Do pass as amended and be re-referred to the Committee on [Appropriations]",10,0,0,0,10
1089179,756355,2018-05-25,Assembly,"Do pass",15,1,1,0,17
1089179,757100,2018-05-29,Assembly,"AB 2380 AGUIAR-CURRY Assembly Third Reading",77,0,1,0,78
1089179,762172,2018-06-12,Senate,"Do pass, but first be re-referred to the Committee on [Natural Resources and Water]",9,1,2,0,12
1089179,768109,2018-06-26,Senate,"Do pass as amended, but first amend, and re-refer to the Committee on [Appropriations]",9,0,0,0,9
1089179,770284,2018-08-06,Senate,"Placed on suspense file",7,0,0,0,7
1089179,771971,2018-08-16,Senate,"Do pass as amended",7,0,0,0,7
1089179,774186,2018-08-31,Senate,"Assembly 3rd Reading AB2380 Aguiar-Curry By Wiener",39,0,1,0,40
1089179,774187,2018-08-31,Assembly,"AB 2380 Aguiar-Curry Concurrence in Senate Amendments",78,0,2,0,80
1089180,736096,2018-04-10,Assembly,"Do pass as amended and be re-referred to the Committee on [Appropriations]",10,4,1,0,15
1089180,756401,2018-05-25,Assembly,"Do pass",12,4,1,0,17
1089180,757148,2018-05-29,Assembly,"AB 2499 ARAMBULA Assembly Third Reading",50,24,4,0,78
1089180,762837,2018-06-13,Senate,"Do pass as amended, but first amend, and re-refer to the Committee on [Appropriations]",7,0,2,0,9
1089180,769539,2018-07-02,Senate,"Do pass",7,0,0,0,7
1089180,772129,2018-08-20,Senate,"Assembly 3rd Reading AB2499 Arambula et al. By Pan",39,0,1,0,40
1089180,772499,2018-08-23,Assembly,"AB 2499 ARAMBULA Concurrence in Senate Amendments",70,0,10,0,80
1089182,737392,2018-04-10,Assembly,"Do pass and be re-referred to the Committee on [Privacy and Consumer Protection]",14,2,0,0,16
1089182,740684,2018-04-17,Assembly,"Do pass and be re-referred to the Committee on [Appropriations]",9,0,1,0,10
1089182,751350,2018-05-09,Assembly,"Do pass",11,1,5,0,17
1089182,752608,2018-05-14,Assembly,"AB 2402 LOW Assembly Third Reading",61,5,12,0,78
1089182,764834,2018-06-18,Senate,"Do pass as amended, but first amend, and re-refer to the Committee on [Judiciary]",8,1,0,0,9
1089182,768778,2018-06-26,Senate,"Do pass, but first be re-referred to the Committee on [Appropriations]",5,1,1,0,7
1089182,773154,2018-08-28,Senate,"Assembly 3rd Reading AB2402 Low By Hertzberg",29,9,2,0,40
1089182,773352,2018-08-29,Assembly,"AB 2402 LOW Concurrence in Senate Amendments",63,10,7,0,80
1089183,735458,2018-04-09,Senate,"Do pass, but first be re-referred to the Committee on [Appropriations] with the recommendation: To Consent Calendar",5,0,0,0,5
1089183,748899,2018-05-03,Senate,"Consent Calendar SB1165",38,0,1,0,39
1089183,766204,2018-06-20,Assembly,"Do pass and be re-referred to the Committee on [Appropriations] with recommendation: To Consent Calendar",6,0,1,0,7
1089183,771044,2018-08-08,Assembly,"Do pass. To Consent Calendar",17,0,0,0,17
1089183,771610,2018-08-16,Assembly,"SB 1165 Pan Consent Calendar Second Day Regular Session",76,0,4,0,80
1089183,772207,2018-08-20,Senate,"Unfinished Business SB1165 Pan Concurrence",39,0,1,0,40
1089184,725774,2018-03-20,Assembly,"Do pass",8,0,2,0,10
1089184,744913,2018-04-26,Assembly,"AB 2439 GARCIA, E. Assembly Third Reading",67,0,11,0,78
1089184,762211,2018-06-12,Senate,"Do pass",10,0,2,0,12
1089184,769790,2018-07-05,Senate,"Assembly 3rd Reading AB2439 Eduardo Garcia et al. By Wiener",35,0,4,0,39
1089184,770826,2018-08-06,Assembly,"AB 2439 GARCIA, E. Concurrence in Senate Amendments",65,0,15,0,80
1089186,733363,2018-04-03,Assembly,"Do pass as amended, and be re-referred to the Committee on [Appropriations] with recommendation: To Consent Calendar",10,0,0,0,10
1089186,737173,2018-04-11,Assembly,"Do pass. To Consent Calendar",15,0,2,0,17
1089186,741408,2018-04-19,Assembly,"AB 2373 ACOSTA Consent Calendar Second Day Regular Session",71,0,7,0,78
1089187,740490,2018-04-18,Assembly,"Do pass and be re-referred to the Committee on [Appropriations]",13,0,0,0,13
1089187,756431,2018-05-25,Assembly,"Do pass",16,0,1,0,17
1089187,757059,2018-05-29,Assembly,"AB 2395 CALDERON Assembly Third Reading",77,0,1,0,78
1089187,769254,2018-06-27,Senate,"Do pass as amended, but first amend, and re-refer to the Committee on [Appropriations]",12,0,1,0,13
1089187,770435,2018-08-06,Senate,"Placed on suspense file",7,0,0,0,7
1089187,771708,2018-08-16,Senate,"Do pass",7,0,0,0,7
1089187,773319,2018-08-29,Senate,"Assembly 3rd Reading AB2395 Calderon By Roth",39,0,1,0,40
1089187,773767,2018-08-30,Assembly,"AB 2395 CALDERON Concurrence in Senate Amendments",79,0,1,0,80
1089188,743647,2018-04-23,Senate,"Do pass, but first be re-referred to the Committee on [Appropriations]",3,1,1,0,5
1089188,757206,2018-05-29,Senate,"Senate 3rd Reading SB1166 Pan",27,10,2,0,39
1089188,766184,2018-06-20,Assembly,"Do pass and be re-referred to the Committee on [Appropriations]",5,1,1,0,7
1089188,771108,2018-08-08,Assembly,"Do pass",12,5,0,0,17
1089192,742923,2018-04-24,Senate,"Do pass, but first be re-referred to the Committee on [Appropriations] with the recommendation: To Consent Calendar",7,0,0,0,7
1089192,752031,2018-05-10,Senate,"Consent Calendar SB1163",38,0,1,0,39
1089192,762612,2018-06-12,Assembly,"Do pass and be re-referred to the Committee on [Appropriations]",6,0,1,0,7
1089192,771143,2018-08-08,Assembly,"Do pass. To Consent Calendar",17,0,0,0,17
1089192,773933,2018-08-30,Assembly,"SB 1163 Galgiani Senate Third Reading By CARRILLO",79,0,1,0,80
1089192,774144,2018-08-31,Senate,"Unfinished Business SB1163 Galgiani Concurrence",39,0,1,0,40
1089193,743252,2018-04-24,Senate,"Do pass, but first be re-referred to the Committee on [Appropriations]",7,0,0,0,7
1089193,750120,2018-05-07,Senate,"Placed on suspense file",6,0,1,0,7
1089195,742847,2018-04-24,Senate,"Do pass as amended",7,0,0,0,7
1089195,748856,2018-05-03,Senate,"Senate 3rd Reading SB1146 Stone",38,0,1,0,39
1089195,762717,2018-06-12,Assembly,"Do pass",2,5,0,0,7
1089195,762718,2018-06-12,Assembly,Reconsideration,7,0,0,0,7
1089196,743631,2018-04-24,Assembly,"Do pass and be re-referred to the Committee on [Appropriations]",13,1,1,0,15
1089199,743179,2018-04-24,Assembly,"Do pass and be re-referred to the Committee on [Appropriations]",12,2,1,0,15
1089199,756334,2018-05-25,Assembly,"Do pass",13,1,3,0,17
1089199,758778,2018-05-31,Assembly,"AB 2486 MCCARTY Assembly Third Reading",65,1,12,0,78
1089201,740092,2018-04-17,Assembly,"Do pass and be re-referred to the Committee on [Appropriations]",5,2,0,0,7
1089201,756475,2018-05-25,Assembly,"Do pass as amended",12,4,1,0,17
1089201,757713,2018-05-30,Assembly,"AB 2504 LOW Assembly Third Reading",53,22,3,0,78
1089201,765189,2018-06-19,Senate,"Do pass, but first be re-referred to the Committee on [Appropriations]",6,1,0,0,7
1089201,772269,2018-08-20,Senate,"Assembly 3rd Reading AB2504 Low By Galgiani",38,0,2,0,40
1089201,772480,2018-08-23,Assembly,"AB 2504 LOW Concurrence in Senate Amendments",65,0,15,0,80
1089203,736072,2018-04-10,Senate,"Do pass, but first be re-referred to the Committee on [Veterans Affairs]",12,0,0,0,12
1089203,743141,2018-04-24,Senate,"Do pass, but first be re-referred to the Committee on [Appropriations]",7,0,0,0,7
1089203,752908,2018-05-14,Senate,"Placed on suspense file",7,0,0,0,7
1089203,756253,2018-05-25,Senate,"Do pass",7,0,0,0,7
1089203,758544,2018-05-31,Senate,"Special Consent SB1179",39,0,0,0,39
1089204,733721,2018-04-03,Assembly,"Do pass as amended",13,0,0,0,13
1089204,743947,2018-04-25,Assembly,"Do pass. To Consent Calendar",17,0,0,0,17
1089204,748666,2018-05-03,Assembly,"AB 2391 HARPER Consent Calendar Second Day Regular Session",71,0,7,0,78
1089204,774547,2018-04-25,Assembly,,13,0,0,0,13
1089205,725445,2018-03-20,Assembly,"Do pass and be re-referred to the Committee on [Appropriations] with recommendation: To Consent Calendar",7,0,0,0,7
1089205,756678,2018-05-25,Assembly,"Do pass as amended",16,0,1,0,17
1089205,757532,2018-05-30,Assembly,"AB 2461 FLORA Assembly Third Reading",75,1,2,0,78
1089205,768328,2018-06-26,Senate,"Do pass, but first be re-referred to the Committee on [Appropriations]",7,0,0,0,7
1089205,770957,2018-08-06,Senate,"Placed on suspense file",7,0,0,0,7
1089205,772094,2018-08-16,Senate,"Do pass",7,0,0,0,7
1089205,772658,2018-08-24,Senate,"Special Consent AB2461",39,0,1,0,40
1089207,738244,2018-04-11,Assembly,"Do pass and be re-referred to the Committee on [Judiciary]",5,0,2,0,7
1089207,742997,2018-04-24,Assembly,"Do pass as amended and be re-referred to the Committee on [Appropriations]",8,0,2,0,10
1089208,738270,2018-04-11,Assembly,"Do pass and be re-referred to the Committee on [Natural Resources]",9,0,1,0,10
1089208,738882,2018-04-16,Assembly,"Do pass and be re-referred to the Committee on [Appropriations]",10,0,0,0,10
1089208,756606,2018-05-25,Assembly,"Do pass as amended",14,1,2,0,17
1089208,758811,2018-05-31,Assembly,"AB 2377 IRWIN Assembly Third Reading",72,0,6,0,78
1089208,765371,2018-06-19,Senate,"Do pass, but first be re-referred to the Committee on [Appropriations]",4,0,1,0,5
1089208,769633,2018-07-02,Senate,"Placed on suspense file",7,0,0,0,7
1089208,771994,2018-08-16,Senate,"Do pass as amended",5,0,2,0,7
1089208,773233,2018-08-28,Senate,"Assembly 3rd Reading AB2377 Irwin et al. By McGuire",39,0,1,0,40
1089208,773602,2018-08-29,Assembly,"AB 2377 IRWIN Concurrence in Senate Amendments",79,0,1,0,80
1089210,743723,2018-04-24,Assembly,"Do pass and be re-referred to the Committee on [Appropriations]",6,1,0,0,7
1089210,756765,2018-05-25,Assembly,"Do pass",16,0,1,0,17
1089210,757038,2018-05-29,Assembly,"AB 2407 TING Assembly Third Reading",77,1,0,0,78
1089211,738100,2018-04-11,Assembly,"Do pass and be re-referred to the Committee on [Appropriations]",7,0,2,0,9
1089212,736109,2018-04-10,Assembly,"Do pass and be re-referred to the Committee on [Appropriations]",11,1,3,0,15
1089212,756513,2018-05-25,Assembly,"Do pass as amended",13,2,2,0,17
1089212,757809,2018-05-30,Assembly,"AB 2534 LIMÓN Assembly Third Reading",58,15,5,0,78
1089212,768585,2018-06-26,Senate,"Do pass as amended, but first amend, and re-refer to the Committee on [Appropriations]",8,1,0,0,9
1089212,770295,2018-08-06,Senate,"Placed on suspense file",7,0,0,0,7
1089212,772014,2018-08-16,Senate,"Do pass as amended",7,0,0,0,7
1089212,772015,2018-08-16,Senate,"[08-16-2018] set for [First] hearing: Reconsideration of favorable vote granted",7,0,0,0,7
1089212,772016,2018-08-16,Senate,"Do pass as amended",5,1,1,0,7
1089212,773273,2018-08-29,Senate,"That the measure be returned to Senate Floor for consideration. Ordered to third reading",7,2,0,0,9
1089212,773885,2018-08-30,Senate,"Assembly 3rd Reading AB2534 Limón et al. By Jackson",27,9,4,0,40
1089212,773886,2018-08-30,Assembly,"AB 2534 LIMÓN Concurrence in Senate Amendments",58,21,1,0,80
1089214,739265,2018-04-16,Assembly,"Do pass as amended and be re-referred to the Committee on [Appropriations]",10,0,0,0,10
1089214,754087,2018-05-16,Assembly,"Do pass. To Consent Calendar",17,0,0,0,17
1089214,756361,2018-05-25,Assembly,"AB 2518 AGUIAR-CURRY Consent Calendar Second Day Regular Session",70,0,8,0,78
1089214,768201,2018-06-26,Senate,"Do pass as amended, but first amend, and re-refer to the Committee on [Appropriations]",9,0,0,0,9
1089214,770864,2018-08-06,Senate,"Placed on suspense file",7,0,0,0,7
1089214,771624,2018-08-16,Senate,"Do pass",7,0,0,0,7
1089214,773625,2018-08-29,Senate,"Assembly 3rd Reading AB2518 Aguiar-Curry By Hertzberg",39,0,1,0,40
1089214,773894,2018-08-30,Assembly,"AB 2518 AGUIAR-CURRY Concurrence in Senate Amendments",79,0,1,0,80
1089215,733176,2018-04-03,Assembly,"Do pass and be re-referred to the Committee on [Appropriations]",5,0,2,0,7
1089215,740723,2018-04-18,Assembly,"Do pass. To Consent Calendar",15,0,2,0,17
1089215,744836,2018-04-26,Assembly,"AB 2532 JONES-SAWYER Consent Calendar Second Day Regular Session",74,0,4,0,78
1089215,762141,2018-06-12,Senate,"Do pass, but first be re-referred to the Committee on [Appropriations]",7,0,0,0,7
1089215,772194,2018-08-20,Senate,"Assembly 3rd Reading AB2532 Jones-Sawyer By McGuire",39,0,1,0,40
1089217,742905,2018-04-24,Senate,"Do pass, but first be re-referred to the Committee on [Judiciary]",2,5,0,0,7
1089219,734387,2018-04-04,Assembly,"Do pass and be re-referred to the Committee on [Appropriations] with recommendation: To Consent Calendar",21,0,0,0,21
1089219,741218,2018-04-18,Assembly,"Do pass. To Consent Calendar",15,0,2,0,17
1089219,744931,2018-04-26,Assembly,"AB 2469 BERMAN Consent Calendar Second Day Regular Session",74,0,4,0,78
1089219,768264,2018-06-26,Senate,"Do pass as amended, but first amend, and re-refer to the Committee on [Appropriations]",13,0,0,0,13
1089219,771329,2018-08-13,Senate,"Assembly 3rd Reading AB2469 Berman By Wilk",36,0,4,0,40
1089219,773259,2018-08-28,Assembly,"With recommendation: That Senate amendments be concurred in",17,0,3,0,20
1089219,773672,2018-08-29,Assembly,"AB 2469 BERMAN Concurrence in Senate Amendments",79,0,1,0,80
1089220,743351,2018-04-23,Senate,"Do pass, but first be re-referred to the Committee on [Appropriations]",1,3,1,0,5
1089220,743352,2018-04-23,Senate,"[Second] hearing set for [04-23-2018]: Failed passage in Committee. Reconsideration granted",4,0,1,0,5
1089221,743031,2018-04-24,Senate,"Do pass, but first be re-referred to the Committee on [Appropriations]",7,0,0,0,7
1089221,752135,2018-05-10,Senate,"Senate 3rd Reading SB1160 Hueso",37,0,2,0,39
1089223,743914,2018-04-25,Assembly,"Do pass and be re-referred to the Committee on [Appropriations] with recommendation: To Consent Calendar",7,0,0,0,7
1089223,747919,2018-05-02,Assembly,"Do pass. To Consent Calendar",17,0,0,0,17
1089223,752011,2018-05-10,Assembly,"AB 2475 TING Consent Calendar Second Day Regular Session",73,0,5,0,78
1089224,740696,2018-04-18,Senate,"Do pass as amended, but first amend, and re-refer to the Committee on [Appropriations]",8,0,1,0,9
1089224,755281,2018-05-22,Senate,"Placed on suspense file",7,0,0,0,7
1089224,756266,2018-05-25,Senate,"Do pass as amended",6,0,1,0,7
1089224,757684,2018-05-30,Senate,"Senate 3rd Reading SB1156 Leyva",34,1,4,0,39
1089224,768149,2018-06-26,Assembly,"Do pass as amended and be re-referred to the Committee on [Appropriations]",11,3,1,0,15
1089224,771538,2018-08-16,Assembly,"Do pass",11,5,1,0,17
1089224,773423,2018-08-29,Assembly,"SB 1156 Leyva Senate Third Reading By WOOD",50,21,9,0,80
1089224,773748,2018-08-30,Senate,"Unfinished Business SB1156 Leyva Concurrence",26,8,6,0,40
1089228,743448,2018-04-24,Assembly,"Do pass as amended and be re-referred to the Committee on [Appropriations]",12,3,0,0,15
1089228,756316,2018-05-25,Assembly,"Do pass as amended",12,4,1,0,17
1089228,758798,2018-05-31,Assembly,"AB 2384 ARAMBULA Assembly Third Reading",58,17,3,0,78
1089228,768797,2018-06-27,Senate,"Do pass as amended, but first amend, and re-refer to the Committee on [Appropriations]",6,2,1,0,9
1089228,770279,2018-08-06,Senate,"Placed on suspense file",7,0,0,0,7
1089228,771794,2018-08-16,Senate,"Do pass",5,2,0,0,7
1089228,773175,2018-08-28,Senate,"Assembly 3rd Reading AB2384 Arambula By Beall",26,9,5,0,40
1089228,773414,2018-08-29,Assembly,"AB 2384 ARAMBULA Concurrence in Senate Amendments",68,6,6,0,80
1089230,743721,2018-04-24,Assembly,"Do pass and be re-referred to the Committee on [Appropriations]",7,0,0,0,7
1089230,756729,2018-05-25,Assembly,"Do pass as amended",16,0,1,0,17
1089230,757880,2018-05-30,Assembly,"AB 2474 QUIRK Assembly Third Reading",75,0,3,0,78
1089230,767278,2018-06-20,Senate,"Do pass, but first be re-referred to the Committee on [Appropriations]",7,0,0,0,7
1089230,770289,2018-08-06,Senate,"Placed on suspense file",7,0,0,0,7
1089230,772013,2018-08-16,Senate,"Do pass",7,0,0,0,7
1089230,772847,2018-08-27,Senate,"Assembly 3rd Reading AB2474 Quirk By Pan",39,0,1,0,40
1089230,773375,2018-08-29,Assembly,"AB 2474 QUIRK Concurrence in Senate Amendments",78,0,2,0,80
1089231,736003,2018-04-10,Assembly,"Do pass as amended and be re-referred to the Committee on [Accountability and Administrative Review]",8,5,2,0,15
1089231,756320,2018-05-25,Assembly,"Do pass",12,4,1,0,17
1089231,758717,2018-05-31,Assembly,"AB 2371 CARRILLO Assembly Third Reading",46,28,4,0,78
1089231,765016,2018-06-18,Senate,"Do pass as amended, but first amend, and re-refer to the Committee on [Natural Resources and Water]",7,1,1,0,9
1089231,768124,2018-06-26,Senate,"Do pass as amended, but first amend, and re-refer to the Committee on [Appropriations]",7,1,1,0,9
1089231,770443,2018-08-06,Senate,"Placed on suspense file",7,0,0,0,7
1089231,771643,2018-08-16,Senate,"Do pass as amended",5,1,1,0,7
1089231,772983,2018-08-27,Senate,"Assembly 3rd Reading AB2371 Carrillo et al. By Glazer",32,6,2,0,40
1089231,773481,2018-08-29,Assembly,"AB 2371 CARRILLO Concurrence in Senate Amendments",56,23,1,0,80
1089232,743701,2018-04-24,Assembly,"Do pass as amended and be re-referred to the Committee on [Appropriations]",7,0,0,0,7
1089232,756650,2018-05-25,Assembly,"Do pass as amended",12,0,5,0,17
1089232,757846,2018-05-30,Assembly,"AB 2538 RUBIO Assembly Third Reading",75,0,3,0,78
1089232,766886,2018-06-20,Senate,"Do pass, but first be re-referred to the Committee on [Appropriations]",5,1,1,0,7
1089232,770287,2018-08-06,Senate,"Placed on suspense file",7,0,0,0,7
1089232,771666,2018-08-16,Senate,"Do pass as amended",7,0,0,0,7
1089232,773357,2018-08-29,Senate,"Assembly 3rd Reading AB2538 Rubio et al. By Portantino",38,0,2,0,40
1089232,773723,2018-08-30,Assembly,"AB 2538 RUBIO Concurrence in Senate Amendments",80,0,0,0,80
1089236,736229,2018-04-10,Assembly,"Do pass and be re-referred to the Committee on [Water, Parks, and Wildlife]",4,2,1,0,7
1089238,738440,2018-04-11,Assembly,"Do pass and be re-referred to the Committee on [Appropriations] with recommendation: To Consent Calendar",7,0,0,0,7
1089238,744447,2018-04-25,Assembly,"Do pass. To Consent Calendar",17,0,0,0,17
1089238,748940,2018-05-03,Assembly,"AB 2449 ARAMBULA Consent Calendar Second Day Regular Session",71,0,7,0,78
1089238,760372,2018-06-06,Senate,"Do pass, but first be re-referred to the Committee on [Appropriations] with the recommendation: To Consent Calendar",6,0,0,0,6
1089238,769639,2018-07-02,Senate,"Consent Calendar AB2449",37,0,2,0,39
1089239,740673,2018-04-18,Senate,"Do pass, but first be re-referred to the Committee on [Appropriations]",7,1,1,0,9
1089239,757768,2018-05-30,Senate,"Senate 3rd Reading SB1152 Hernandez",26,13,0,0,39
1089239,768244,2018-06-26,Assembly,"Do pass as amended and be re-referred to the Committee on [Appropriations]",12,3,0,0,15
1089239,771475,2018-08-15,Assembly,"Do pass as amended",12,5,0,0,17
1089239,772922,2018-08-27,Assembly,"SB 1152 Hernandez Senate Third Reading By WOOD",48,26,6,0,80
1089239,773251,2018-08-28,Senate,"Unfinished Business SB1152 Hernandez et al. Concurrence",26,13,1,0,40
1089240,736865,2018-04-10,Assembly,"Do pass and be re-referred to the Committee on [Appropriations] with recommendation: To Consent Calendar",15,0,0,0,15
1089240,740775,2018-04-18,Assembly,"Do pass. To Consent Calendar",15,0,2,0,17
1089240,744889,2018-04-26,Assembly,"AB 2490 CHIU Consent Calendar Second Day Regular Session",74,0,4,0,78
1089240,760363,2018-06-06,Senate,"Do pass as amended, but first amend, and re-refer to the Committee on [Appropriations] with the recommendation: To Consent Calendar",8,0,1,0,9
1089240,768090,2018-06-25,Senate,"Placed on suspense file",7,0,0,0,7
1089240,771978,2018-08-16,Senate,"Do pass",7,0,0,0,7
1089240,772710,2018-08-24,Senate,"Special Consent AB2490",39,0,1,0,40
1089240,773406,2018-08-29,Assembly,"AB 2490 CHIU Concurrence in Senate Amendments",79,0,1,0,80
1089242,741115,2018-04-18,Senate,"Do pass, but first be re-referred to the Committee on [Judiciary]",2,0,5,0,7
1089244,743898,2018-04-24,Senate,"Do pass as amended, but first amend, and re-refer to the Committee on [Appropriations] with the recommendation: To Consent Calendar",11,0,2,0,13
1089244,754342,2018-05-17,Senate,"Consent Calendar SB1151",38,0,1,0,39
1089244,767851,2018-06-25,Assembly,"Do pass and be re-referred to the Committee on [Appropriations]",12,0,2,0,14
1089244,771576,2018-08-16,Assembly,"Do pass as amended",17,0,0,0,17
1089244,774048,2018-08-31,Senate,"Unfinished Business SB1151 Bates et al. Concurrence",39,0,1,0,40
1089244,774049,2018-08-31,Assembly,"SB 1151 Bates Senate Third Reading By CHÁVEZ",79,0,1,0,80
1089246,743118,2018-04-23,Assembly,"Do pass as amended and be re-referred to the Committee on [Appropriations]",10,0,0,0,10
1089246,756572,2018-05-25,Assembly,"Do pass",16,0,1,0,17
1089246,757111,2018-05-29,Assembly,"AB 2378 SALAS Assembly Third Reading",76,0,2,0,78
1089247,740363,2018-04-17,Assembly,"Do pass as amended and be re-referred to the Committee on [Appropriations]",7,0,0,0,7
1089247,756268,2018-05-25,Assembly,"Do pass",16,0,1,0,17
1089247,757708,2018-05-30,Assembly,"AB 2463 QUIRK-SILVA Assembly Third Reading",78,0,0,0,78
1089247,767881,2018-06-25,Senate,"Do pass, but first be re-referred to the Committee on [Appropriations]",9,0,0,0,9
1089248,725693,2018-03-20,Senate,"Do pass and be ordered to the Consent Calendar",11,0,2,0,13
1089248,738284,2018-04-12,Senate,"Senate 3rd Reading SB1172 Beall",38,0,1,0,39
1089248,767922,2018-06-25,Assembly,"Do pass and be re-referred to the Committee on [Appropriations]",8,4,2,0,14
1089248,771885,2018-08-16,Assembly,"Do pass",12,5,0,0,17
1089248,773929,2018-08-30,Assembly,"SB 1172 Beall Senate Third Reading By ARAMBULA",46,29,5,0,80
1089248,774072,2018-08-31,Senate,"Unfinished Business SB1172 Beall et al. Concurrence",25,13,2,0,40
1089250,743119,2018-04-24,Assembly,"Do pass and be re-referred to the Committee on [Appropriations]",5,2,0,0,7
1089250,756384,2018-05-25,Assembly,"Do pass as amended",12,4,1,0,17
1089250,758719,2018-05-31,Assembly,"AB 2382 GIPSON Assembly Third Reading",45,29,4,0,78
1089250,768332,2018-06-26,Senate,"Do pass as amended, but first amend, and re-refer to the Committee on [Appropriations]",5,2,0,0,7
1089250,770407,2018-08-06,Senate,"Placed on suspense file",7,0,0,0,7
1089251,743377,2018-04-24,Assembly,"Do pass and be re-referred to the Committee on [Appropriations] with recommendation: To Consent Calendar",15,0,0,0,15
1089252,738234,2018-04-11,Assembly,"Do pass as amended and be re-referred to the Committee on [Health]",6,0,1,0,7
1089252,743441,2018-04-24,Assembly,"Do pass and be re-referred to the Committee on [Appropriations] with recommendation: To Consent Calendar",15,0,0,0,15
1089254,740883,2018-04-18,Senate,"Do pass as amended, but first amend, and re-refer to the Committee on [Appropriations]",9,0,0,0,9
1089254,755261,2018-05-22,Senate,"Placed on suspense file",7,0,0,0,7
1089255,733234,2018-04-03,Assembly,"Do pass and be re-referred to the Committee on [Appropriations] with recommendation: To Consent Calendar",15,0,0,0,15
1089255,756552,2018-05-25,Assembly,"Do pass as amended",16,0,1,0,17
1089255,758660,2018-05-31,Assembly,"AB 2367 BERMAN Assembly Third Reading",78,0,0,0,78
1089255,769117,2018-06-27,Senate,"Do pass, but first be re-referred to the Committee on [Appropriations] with the recommendation: To Consent Calendar",9,0,0,0,9
1089255,770829,2018-08-06,Senate,"Placed on suspense file",7,0,0,0,7
1089256,734201,2018-04-04,Senate,"Do pass as amended, but first amend, and re-refer to the Committee on [Appropriations]",9,0,0,0,9
1089256,752774,2018-05-14,Senate,"Placed on suspense file",7,0,0,0,7
1089256,756578,2018-05-25,Senate,"Do pass",7,0,0,0,7
1089256,758673,2018-05-31,Senate,"Special Consent SB1148",39,0,0,0,39
1089256,764942,2018-06-19,Assembly,"Do pass as amended and be re-referred to the Committee on [Appropriations]",15,0,0,0,15
1089256,771809,2018-08-16,Assembly,"Do pass as amended",12,0,5,0,17
1089256,773452,2018-08-29,Assembly,"SB 1148 Pan Senate Third Reading By MAYES",80,0,0,0,80
1089256,773932,2018-08-30,Senate,"Unfinished Business SB1148 Pan Concurrence",39,0,1,0,40
1089258,747037,2018-04-30,Assembly,"Do pass as amended",7,2,1,0,10
1089258,752124,2018-05-10,Assembly,"AB 2425 BERMAN Assembly Third Reading",50,21,7,0,78
1089258,763174,2018-06-13,Senate,"Do pass, but first be re-referred to the Committee on [Appropriations]",5,1,1,0,7
1089258,773200,2018-08-28,Senate,"Assembly 3rd Reading AB2425 Berman By McGuire",26,11,3,0,40
1089258,773588,2018-08-29,Assembly,"AB 2425 BERMAN Concurrence in Senate Amendments",54,25,1,0,80
1089259,742169,2018-04-23,Assembly,"Do pass and be re-referred to the Committee on [Appropriations]",4,8,2,0,14
1089259,742170,2018-04-23,Assembly,Reconsideration,14,0,0,0,14
1089261,744103,2018-04-24,Assembly,"Do pass and be re-referred to the Committee on [Appropriations]",10,0,0,0,10
1089261,749809,2018-05-07,Assembly,"AB 2521 QUIRK-SILVA Assembly Third Reading",74,0,4,0,78
1089261,762286,2018-06-12,Senate,"Do pass and be ordered to the Consent Calendar",5,0,2,0,7
1089261,768052,2018-06-25,Senate,"Consent Calendar AB2521",36,0,3,0,39
1089262,737329,2018-04-11,Senate,"Do pass as amended",6,0,1,0,7
1089262,746636,2018-04-30,Senate,"Senate 3rd Reading SB1145 Leyva",37,0,2,0,39
1089262,762828,2018-06-13,Assembly,"Do pass",5,2,2,0,9
1089262,772850,2018-08-27,Assembly,"SB 1145 Leyva Senate Third Reading By RODRIGUEZ",58,18,4,0,80
1089262,773140,2018-08-28,Senate,"Unfinished Business SB1145 Leyva Concurrence",34,3,3,0,40
1089263,744037,2018-04-25,Assembly,"Do pass and be re-referred to the Committee on [Appropriations]",6,0,1,0,7
1089263,755711,2018-05-23,Assembly,"Do pass",15,0,2,0,17
1089263,757850,2018-05-30,Assembly,"AB 2540 MULLIN Assembly Third Reading",75,0,3,0,78
1089263,765924,2018-06-19,Senate,"Do pass, but first be re-referred to the Committee on [Appropriations]",5,0,0,0,5
1089263,772956,2018-08-27,Senate,"Assembly 3rd Reading AB2540 Mullin By Allen",38,0,2,0,40
1089265,744907,2018-04-25,Assembly,"Do pass as amended and be re-referred to the Committee on [Appropriations]",4,0,3,0,7
1089266,743255,2018-04-24,Assembly,"Do pass as amended and be re-referred to the Committee on [Appropriations]",11,4,0,0,15
1089266,756270,2018-05-25,Assembly,"Do pass as amended",12,4,1,0,17
1089266,757758,2018-05-30,Assembly,"AB 2427 WOOD Assembly Third Reading",50,23,5,0,78
1089266,769009,2018-06-27,Senate,"Do pass as amended, but first amend, and re-refer to the Committee on [Appropriations]",7,2,0,0,9
1089266,770412,2018-08-06,Senate,"Placed on suspense file",7,0,0,0,7
1089266,771693,2018-08-16,Senate,"Do pass",5,2,0,0,7
1089266,772586,2018-08-23,Senate,"Assembly 3rd Reading AB2427 Wood et al. By Pan",26,13,1,0,40
1089266,772895,2018-08-27,Assembly,"AB 2427 WOOD Concurrence in Senate Amendments",50,24,6,0,80
1089267,736202,2018-04-09,Assembly,"Do pass as amended and be re-referred to the Committee on [Appropriations]",7,1,2,0,10
1089270,744024,2018-04-25,Assembly,"Do pass as amended and be re-referred to the Committee on [Appropriations]",10,2,3,0,15
1089271,733169,2018-04-02,Assembly,"Do pass and be re-referred to the Committee on [Appropriations]",7,0,4,0,11
1089271,756186,2018-05-25,Assembly,"Do pass",11,3,3,0,17
1089271,758728,2018-05-31,Assembly,"AB 2500 KALRA Assembly Third Reading",27,30,21,0,78
1089272,733868,2018-04-03,Assembly,"Do pass and be re-referred to the Committee on [Judiciary]",12,0,1,0,13
1089272,736043,2018-04-10,Assembly,"Do pass and be re-referred to the Committee on [Appropriations] with recommendation: To Consent Calendar",10,0,0,0,10
1089274,736769,2018-04-10,Assembly,"Do pass and be re-referred to the Committee on [Appropriations]",15,0,0,0,15
1089274,740841,2018-04-18,Assembly,"Do pass. To Consent Calendar",15,0,2,0,17
1089274,744929,2018-04-26,Assembly,"AB 2516 EGGMAN Consent Calendar Second Day Regular Session",74,0,4,0,78
1089274,762199,2018-06-12,Senate,"Do pass as amended, but first amend, and re-refer to the Committee on [Appropriations]",9,0,0,0,9
1089274,771321,2018-08-13,Senate,"Do pass",6,0,1,0,7
1089274,772359,2018-08-21,Senate,"Assembly 3rd Reading AB2516 Eggman et al. By Nielsen",39,0,1,0,40
1089274,773127,2018-08-28,Assembly,"AB 2516 EGGMAN Concurrence in Senate Amendments",80,0,0,0,80
1089275,725472,2018-03-20,Assembly,"Do pass as amended and be re-referred to the Committee on [Appropriations]",15,0,0,0,15
1089275,756239,2018-05-25,Assembly,"Do pass",16,0,1,0,17
1089275,756957,2018-05-29,Assembly,"AB 2465 GALLAGHER Assembly Third Reading",76,0,2,0,78
1089275,768186,2018-06-26,Senate,"Do pass as amended, but first amend, and re-refer to the Committee on [Appropriations] with the recommendation: To Consent Calendar",9,0,0,0,9
1089275,770249,2018-08-06,Senate,"Placed on suspense file",7,0,0,0,7
1089276,738266,2018-04-11,Assembly,"Do pass as amended, and be re-referred to the Committee on [Natural Resources] with recommendation: To Consent Calendar",7,0,0,0,7
1089276,743169,2018-04-23,Assembly,"Do pass as amended and be re-referred to the Committee on [Appropriations]",10,0,0,0,10
1089276,756220,2018-05-25,Assembly,"Do pass",16,0,1,0,17
1089276,757757,2018-05-30,Assembly,"AB 2453 GARCIA, E. Assembly Third Reading",77,0,1,0,78
1089276,762962,2018-06-13,Senate,"Do pass, but first be re-referred to the Committee on [Environmental Quality] with the recommendation: To Consent Calendar",7,0,0,0,7
1089276,767176,2018-06-20,Senate,"Do pass as amended, but first amend, and re-refer to the Committee on [Appropriations] with the recommendation: To Consent Calendar",7,0,0,0,7
1089276,770781,2018-08-06,Senate,"Placed on suspense file",7,0,0,0,7
1089276,772077,2018-08-16,Senate,"Do pass as amended",7,0,0,0,7
1089276,773023,2018-08-27,Senate,"Assembly 3rd Reading AB2453 Eduardo Garcia et al. By Lara",39,0,1,0,40
1089276,773441,2018-08-29,Assembly,"AB 2453 GARCIA, E. Concurrence in Senate Amendments",80,0,0,0,80
1089278,733599,2018-04-03,Assembly,"Do pass as amended, and be re-referred to the Committee on [Appropriations] with recommendation: To Consent Calendar",15,0,0,0,15
1089279,747650,2018-05-01,Assembly,"Do pass as amended",8,1,1,0,10
1089279,758704,2018-05-31,Assembly,"AB 2511 CHAU Assembly Third Reading",56,16,6,0,78
1089279,769692,2018-07-03,Senate,"Do pass as amended, but first amend, and re-refer to the Committee on [Appropriations]",5,1,1,0,7
1089279,771336,2018-08-13,Senate,"Placed on suspense file",7,0,0,0,7
1089279,771884,2018-08-16,Senate,"Do pass",5,2,0,0,7
1089279,773660,2018-08-29,Senate,"Assembly 3rd Reading AB2511 Chau By Roth",27,10,3,0,40
1089279,773698,2018-08-30,Assembly,"AB 2511 CHAU Concurrence in Senate Amendments",64,12,4,0,80
1089281,740918,2018-04-18,Assembly,"Do pass and be re-referred to the Committee on [Appropriations]",14,0,1,0,15
1089282,744064,2018-04-25,Assembly,"Do pass and be re-referred to the Committee on [Appropriations]",7,0,0,0,7
1089285,738797,2018-04-16,Assembly,"Do pass and be re-referred to the Committee on [Appropriations]",14,0,0,0,14
1089286,738231,2018-04-11,Assembly,"Do pass as amended and be re-referred to the Committee on [Appropriations]",5,0,2,0,7
1089290,738892,2018-04-16,Assembly,"Do pass and be re-referred to the Committee on [Appropriations]",14,0,0,0,14
1089291,725508,2018-03-20,Assembly,"Be adopted. To Consent Calendar",10,0,0,0,10
1089291,727791,2018-03-22,Assembly,"HR 81 MCCARTY Consent Calendar Second Day Regular Session",69,0,8,0,77
1089293,743187,2018-04-23,Assembly,"Do pass as amended and be re-referred to the Committee on [Appropriations]",9,1,0,0,10
1089296,742269,2018-04-23,Assembly,"Do pass and be re-referred to the Committee on [Appropriations] with recommendation: To Consent Calendar",14,0,0,0,14
1089296,756653,2018-05-25,Assembly,"Do pass",16,0,1,0,17
1089296,757022,2018-05-29,Assembly,"AB 2433 SALAS Assembly Third Reading",78,0,0,0,78
1089299,738065,2018-04-11,Assembly,"Do pass and be re-referred to the Committee on [Appropriations]",2,5,0,0,7
1089300,743799,2018-04-25,Assembly,"Do pass and be re-referred to the Committee on [Judiciary]",5,2,0,0,7
1089300,750678,2018-05-08,Assembly,"Do pass as amended",7,3,0,0,10
1089300,758723,2018-05-31,Assembly,"AB 2364 BLOOM Assembly Third Reading",25,36,17,0,78
1089302,741654,2018-04-18,Assembly,"Do pass and be re-referred to the Committee on [Appropriations]",2,5,0,0,7
1089302,741655,2018-04-18,Assembly,Reconsideration,7,0,0,0,7
1089304,736710,2018-04-09,Assembly,"Do pass and be re-referred to the Committee on [Transportation]",10,0,0,0,10
1089304,742704,2018-04-23,Assembly,"Do pass and be re-referred to the Committee on [Appropriations]",14,0,0,0,14
1089304,756481,2018-05-25,Assembly,"Do pass as amended",14,0,3,0,17
1089304,758627,2018-05-31,Assembly,"AB 2381 CARRILLO Assembly Third Reading",62,11,5,0,78
1089304,767028,2018-06-20,Senate,"Do pass, but first be re-referred to the Committee on [Transportation and Housing]",7,0,0,0,7
1089304,768342,2018-06-26,Senate,"Do pass, but first be re-referred to the Committee on [Appropriations]",9,3,1,0,13
1089304,770828,2018-08-06,Senate,"Placed on suspense file",7,0,0,0,7
1089304,771993,2018-08-16,Senate,"Do pass",5,2,0,0,7
1089304,773509,2018-08-29,Senate,"Assembly 3rd Reading AB2381 Carrillo By Wieckowski",29,10,1,0,40
1089304,773823,2018-08-30,Assembly,"AB 2381 CARRILLO Concurrence in Senate Amendments",63,14,3,0,80
1089306,743219,2018-04-24,Assembly,"Do pass as amended and be re-referred to the Committee on [Appropriations]",12,3,0,0,15
1089306,756274,2018-05-25,Assembly,"Do pass",12,4,1,0,17
1089306,756977,2018-05-29,Assembly,"AB 2517 WOOD Assembly Third Reading",53,25,0,0,78
1089307,743211,2018-04-23,Senate,"Do pass, but first be re-referred to the Committee on [Appropriations]",3,0,2,0,5
1089307,752594,2018-05-14,Senate,"Placed on suspense file",7,0,0,0,7
1089307,756719,2018-05-25,Senate,"Do pass",6,0,1,0,7
1089307,756968,2018-05-29,Senate,"Senate 3rd Reading SB1144 Dodd",38,0,1,0,39
1089307,766263,2018-06-20,Assembly,"Do pass and be re-referred to the Committee on [Appropriations]",6,0,1,0,7
1089307,771821,2018-08-16,Assembly,"Do pass",17,0,0,0,17
1089307,772938,2018-08-27,Assembly,"SB 1144 Dodd Senate Third Reading By RODRIGUEZ",80,0,0,0,80
1089308,732666,2018-04-02,Assembly,"Do pass and be re-referred to the Committee on [Appropriations]",14,0,0,0,14
1089308,737351,2018-04-11,Assembly,"Do pass. To Consent Calendar",15,0,2,0,17
1089308,741439,2018-04-19,Assembly,"AB 2535 OBERNOLTE Consent Calendar Second Day Regular Session",71,0,7,0,78
1089308,765870,2018-06-19,Senate,"Do pass, but first be re-referred to the Committee on [Appropriations]",13,0,0,0,13
1089308,771279,2018-08-13,Senate,"Assembly 3rd Reading AB2535 Obernolte By Beall",37,0,3,0,40
1089309,725678,2018-03-20,Senate,"Do pass, but first be re-referred to the Committee on [Judiciary] with the recommendation: To Consent Calendar",11,0,2,0,13
1089309,751184,2018-05-08,Senate,"Do pass as amended, and be ordered to the Consent Calendar",7,0,0,0,7
1089309,754403,2018-05-17,Senate,"Consent Calendar SB1173 Vidak",38,0,1,0,39
1089309,763091,2018-06-13,Assembly,"Do pass. To Consent Calendar",7,0,0,0,7
1089309,764967,2018-06-19,Assembly,"Do pass. To Consent Calendar",10,0,0,0,10
1089309,767992,2018-06-25,Assembly,"SB 1173 Vidak Consent Calendar Second Day Regular Session",75,0,5,0,80
1089310,733317,2018-04-03,Assembly,"Do pass and be re-referred to the Committee on [Appropriations]",2,8,0,0,10
1089310,733318,2018-04-03,Assembly,Reconsideration,10,0,0,0,10
1089311,733116,2018-04-02,Assembly,"Be re-referred to the Committee on [Natural Resources]",6,0,5,0,11
1089311,743128,2018-04-23,Assembly,"Do pass as amended and be re-referred to the Committee on [Appropriations]",10,0,0,0,10
1089311,751398,2018-05-09,Assembly,"Do pass. To Consent Calendar",16,0,1,0,17
1089311,754268,2018-05-17,Assembly,"AB 2411 MCCARTY Consent Calendar Second Day Regular Session",73,0,5,0,78
1089311,760472,2018-06-06,Senate,"Do pass as amended, but first amend, and re-refer to the Committee on [Appropriations]",5,0,2,0,7
1089311,771192,2018-08-09,Senate,"Assembly 3rd Reading AB2411 McCarty et al. By Skinner",36,0,3,0,39
1089311,771247,2018-08-13,Assembly,"AB 2411 MCCARTY Concurrence in Senate Amendments",77,0,3,0,80
1089313,733268,2018-04-03,Senate,"Do pass",4,0,1,0,5
1089313,734304,2018-04-05,Senate,"Senate 3rd Reading SB1171 Stern",25,10,4,0,39
1089313,762816,2018-06-13,Assembly,"Do pass",5,2,0,0,7
1089313,769203,2018-06-28,Assembly,"SB 1171 Stern Senate Third Reading By BERMAN",53,23,4,0,80
1089314,739770,2018-04-17,Senate,"Do pass as amended, but first amend, and re-refer to the Committee on [Appropriations]",10,0,1,0,11
1089314,755316,2018-05-22,Senate,"Placed on suspense file",7,0,0,0,7
1089317,738242,2018-04-11,Assembly,"Do pass and be re-referred to the Committee on [Judiciary]",7,0,0,0,7
1089317,739685,2018-04-17,Assembly,"Do pass and be re-referred to the Committee on [Appropriations]",9,1,0,0,10
1089317,753834,2018-05-16,Assembly,"Do pass",12,4,1,0,17
1089317,754906,2018-05-21,Assembly,"AB 2496 GONZALEZ FLETCHER Assembly Third Reading",57,7,14,0,78
1089317,763045,2018-06-13,Senate,"Do pass, but first be re-referred to the Committee on [Judiciary]",5,0,0,0,5
1089317,769055,2018-06-26,Senate,"Do pass, but first be re-referred to the Committee on [Appropriations]",5,1,1,0,7
1089317,771162,2018-08-09,Senate,"Assembly 3rd Reading AB2496 Gonzalez Fletcher et al. By Skinner",28,4,7,0,39
1089318,743190,2018-04-23,Assembly,"Do pass as amended and be re-referred to the Committee on [Appropriations]",9,0,1,0,10
1089321,734227,2018-04-04,Assembly,"Do pass and be re-referred to the Committee on [Labor and Employment]",6,0,1,0,7
1089321,741716,2018-04-18,Assembly,"Do pass and be re-referred to the Committee on [Appropriations] with recommendation: To Consent Calendar",7,0,0,0,7
1089321,755658,2018-05-23,Assembly,"Do pass. To Consent Calendar",16,0,1,0,17
1089321,757024,2018-05-29,Assembly,"AB 2388 CHU Consent Calendar Second Day Regular Session",78,0,0,0,78
1089321,765250,2018-06-19,Senate,"Do pass, but first be re-referred to the Committee on [Judiciary]",5,0,0,0,5
1089321,771446,2018-08-13,Senate,"Special Consent AB2388",37,0,3,0,40
1089321,772273,2018-08-20,Assembly,"AB 2388 CHU Concurrence in Senate Amendments",80,0,0,0,80
1089321,777235,2018-08-13,Senate,,5,0,3,0,8
1089322,768640,2018-06-26,Senate,"Do pass, but first be re-referred to the Committee on [Appropriations] with the recommendation: To Consent Calendar",7,0,0,0,7
1089322,770819,2018-08-06,Senate,"Placed on suspense file",7,0,0,0,7
1089323,742115,2018-04-23,Assembly,"Do pass as amended and be re-referred to the Committee on [Appropriations]",13,1,0,0,14
1089323,756522,2018-05-25,Assembly,"Do pass as amended",15,0,2,0,17
1089323,757742,2018-05-30,Assembly,"AB 2363 FRIEDMAN Assembly Third Reading",77,0,1,0,78
1089323,765050,2018-06-19,Senate,"Do pass as amended, but first amend, and re-refer to the Committee on [Appropriations]",10,2,1,0,13
1089323,770439,2018-08-06,Senate,"Do pass as amended",5,1,1,0,7
1089323,771358,2018-08-13,Senate,"Assembly 3rd Reading AB2363 Friedman et al. By Wiener",28,7,5,0,40
1089323,772224,2018-08-20,Assembly,"AB 2363 FRIEDMAN Concurrence in Senate Amendments",78,0,2,0,80
1089325,737000,2018-04-10,Assembly,"Do pass and be re-referred to the Committee on [Appropriations] with recommendation: To Consent Calendar",7,0,0,0,7
1089325,744488,2018-04-25,Assembly,"Do pass. To Consent Calendar",17,0,0,0,17
1089325,748775,2018-05-03,Assembly,"AB 2541 SALAS Consent Calendar Second Day Regular Session",71,0,7,0,78
1089325,760462,2018-06-06,Senate,"Do pass, but first be re-referred to the Committee on [Appropriations] with the recommendation: To Consent Calendar",5,0,2,0,7
1089325,770523,2018-08-06,Senate,"Consent Calendar AB2541 Salas",37,0,2,0,39
1089326,737369,2018-04-11,Assembly,"Do pass and be re-referred to the Committee on [Privacy and Consumer Protection]",7,0,0,0,7
1089326,740869,2018-04-17,Assembly,"Do pass as amended and be re-referred to the Committee on [Appropriations]",6,1,3,0,10
1089327,744015,2018-04-25,Assembly,"Do pass and be re-referred to the Committee on [Appropriations]",7,0,0,0,7
1089327,751510,2018-05-09,Assembly,"Do pass. To Consent Calendar",16,0,1,0,17
1089327,754317,2018-05-17,Assembly,"AB 2396 BIGELOW Consent Calendar Second Day Regular Session",73,0,5,0,78
1089327,762429,2018-06-12,Senate,"Do pass, but first be re-referred to the Committee on [Appropriations] with the recommendation: To Consent Calendar",10,0,2,0,12
1089327,770869,2018-08-06,Senate,"Consent Calendar AB2396 Bigelow",37,0,2,0,39
1089329,736158,2018-04-10,Senate,"Do pass, but first be re-referred to the Committee on [Veterans Affairs] with the recommendation: To Consent Calendar",12,0,0,0,12
1089329,742895,2018-04-24,Senate,"Do pass, but first be re-referred to the Committee on [Appropriations]",7,0,0,0,7
1089329,750000,2018-05-07,Senate,"Placed on suspense file",6,0,1,0,7
1089329,756181,2018-05-25,Senate,"Do pass",7,0,0,0,7
1089329,758606,2018-05-31,Senate,"Special Consent SB1180",39,0,0,0,39
1089330,733272,2018-04-03,Assembly,"Do pass and be re-referred to the Committee on [Appropriations]",2,5,0,0,7
1089330,733273,2018-04-03,Assembly,Reconsideration,7,0,0,0,7
1089330,743005,2018-04-24,Assembly,"Do pass and be re-referred to the Committee on [Appropriations]",2,5,0,0,7
1089332,736068,2018-04-10,Assembly,"Do pass. To Consent Calendar",7,0,0,0,7
1089333,733274,2018-04-03,Assembly,"Do pass and be re-referred to the Committee on [Appropriations]",2,5,0,0,7
1089333,733275,2018-04-03,Assembly,Reconsideration,7,0,0,0,7
1089333,742977,2018-04-24,Assembly,"Do pass and be re-referred to the Committee on [Appropriations]",2,5,0,0,7
1089334,738784,2018-04-16,Assembly,"Do pass as amended and be re-referred to the Committee on [Appropriations]",7,3,0,0,10
1089334,755672,2018-05-23,Assembly,"Do pass",11,5,1,0,17
1089334,757125,2018-05-29,Assembly,"AB 2528 BLOOM Assembly Third Reading",42,32,4,0,78
1089334,768242,2018-06-26,Senate,"Do pass as amended, but first amend, and re-refer to the Committee on [Appropriations]",7,2,0,0,9
1089334,770497,2018-08-06,Senate,"Placed on suspense file",7,0,0,0,7
1089334,771698,2018-08-16,Senate,"Do pass",5,2,0,0,7
1089334,772436,2018-08-22,Senate,"Assembly 3rd Reading AB2528 Bloom et al. By Allen",23,12,5,0,40
1089334,772801,2018-08-27,Assembly,"AB 2528 BLOOM Concurrence in Senate Amendments",44,32,4,0,80
1089337,725614,2018-03-20,Assembly,"Do pass and be re-referred to the Committee on [Appropriations] with recommendation: To Consent Calendar",7,0,0,0,7
1089337,756641,2018-05-25,Assembly,"Do pass as amended",16,0,1,0,17
1089337,757521,2018-05-30,Assembly,"AB 2507 JONES-SAWYER Assembly Third Reading",75,0,3,0,78
1089337,768528,2018-06-26,Senate,"Do pass, but first be re-referred to the Committee on [Appropriations] with the recommendation: To Consent Calendar",7,0,0,0,7
1089337,770913,2018-08-06,Senate,"Placed on suspense file",7,0,0,0,7
1089337,772080,2018-08-16,Senate,"Do pass as amended",7,0,0,0,7
1089337,772430,2018-08-22,Senate,"Assembly 3rd Reading AB2507 Jones-Sawyer By Jackson",39,0,1,0,40
1089337,772865,2018-08-27,Assembly,"AB 2507 JONES-SAWYER Concurrence in Senate Amendments",80,0,0,0,80
1089340,726130,2018-03-19,Assembly,"Do pass and be re-referred to the Committee on [Appropriations]",10,0,0,0,10
1089340,733764,2018-04-04,Assembly,"Do pass. To Consent Calendar",15,0,2,0,17
1089340,738204,2018-04-12,Assembly,"AB 2400 KALRA Consent Calendar Second Day Regular Session",68,0,9,0,77
1089340,762714,2018-06-13,Senate,"Do pass as amended, but first amend, and re-refer to the Committee on [Appropriations]",7,0,0,0,7
1089340,769589,2018-07-02,Senate,"Do pass",7,0,0,0,7
1089340,771302,2018-08-13,Senate,"Special Consent AB2400",37,0,3,0,40
1089340,772226,2018-08-20,Assembly,"AB 2400 KALRA Concurrence in Senate Amendments",80,0,0,0,80
1089341,739925,2018-04-17,Assembly,"Do pass and be re-referred to the Committee on [Judiciary]",5,11,0,0,16
1089342,743177,2018-04-24,Senate,"Do pass, but first be re-referred to the Committee on [Appropriations] with the recommendation: To Consent Calendar",12,0,0,0,12
1089342,754293,2018-05-17,Senate,"Consent Calendar SB1162",38,0,1,0,39
1089342,768764,2018-06-27,Assembly,"Do pass and be re-referred to the Committee on [Appropriations] with recommendation: To Consent Calendar",7,0,0,0,7
1089342,771101,2018-08-08,Assembly,"Do pass",16,0,1,0,17
1089342,772641,2018-08-23,Assembly,"SB 1162 Pan Senate Third Reading By MCCARTY",77,0,3,0,80
1089344,738243,2018-04-11,Assembly,"Do pass as amended and be re-referred to the Committee on [Appropriations]",6,0,1,0,7
1089344,756430,2018-05-25,Assembly,"Do pass",13,2,2,0,17
1089344,757074,2018-05-29,Assembly,"AB 2514 THURMOND Assembly Third Reading",65,9,4,0,78
1089344,766242,2018-06-20,Senate,"Do pass as amended, but first amend, and re-refer to the Committee on [Appropriations]",7,0,0,0,7
1089344,770408,2018-08-06,Senate,"Placed on suspense file",7,0,0,0,7
1089344,771613,2018-08-16,Senate,"Do pass",6,1,0,0,7
1089344,772661,2018-08-24,Senate,"Assembly 3rd Reading AB2514 Thurmond et al. By Delgado",31,4,5,0,40
1089344,773561,2018-08-29,Assembly,"AB 2514 THURMOND Concurrence in Senate Amendments",69,8,3,0,80
1089345,734444,2018-04-04,Assembly,"Do pass as amended and be re-referred to the Committee on [Appropriations]",16,2,3,0,21
1089348,743892,2018-04-24,Assembly,"Do pass and be re-referred to the Committee on [Appropriations]",13,0,0,0,13
1089348,756589,2018-05-25,Assembly,"Do pass",16,0,1,0,17
1089348,757591,2018-05-30,Assembly,"AB 2479 VOEPEL Assembly Third Reading",77,0,1,0,78
1089348,768870,2018-06-27,Senate,"Do pass, but first be re-referred to the Committee on [Appropriations]",7,0,0,0,7
1089348,770547,2018-08-06,Senate,"Placed on suspense file",7,0,0,0,7
1089349,743040,2018-04-24,Assembly,"Do pass and be re-referred to the Committee on [Appropriations]",9,0,1,0,10
1089349,751342,2018-05-09,Assembly,"Do pass",16,0,1,0,17
1089349,752718,2018-05-14,Assembly,"AB 2413 CHIU Assembly Third Reading",75,0,3,0,78
1089349,762884,2018-06-12,Senate,"Do pass, but first be re-referred to the Committee on [Appropriations] with the recommendation: To Consent Calendar",7,0,0,0,7
1089349,770358,2018-08-06,Senate,"Consent Calendar AB2413 Chiu et al",37,0,2,0,39
1089349,771186,2018-08-09,Assembly,"AB 2413 CHIU Concurrence in Senate Amendments",77,0,3,0,80
1089350,735998,2018-04-09,Assembly,"Do pass as amended and be re-referred to the Committee on [Environmental Safety and Toxic Materials]",6,4,0,0,10
1089350,743714,2018-04-24,Assembly,"Do pass as amended",5,2,0,0,7
1089352,732646,2018-04-02,Senate,"Do pass, but first be re-referred to the Committee on [Appropriations]",6,2,1,0,9
1089352,746079,2018-04-30,Senate,"Senate 3rd Reading SB1159 Moorlach",24,10,5,0,39
1089353,751106,2018-05-09,Senate,"Do pass, but first be re-referred to the Committee on [Appropriations]",5,0,2,0,7
1089353,755320,2018-05-22,Senate,"Placed on suspense file",7,0,0,0,7
1089353,756194,2018-05-25,Senate,"Do pass as amended",7,0,0,0,7
1089353,757838,2018-05-30,Senate,"Senate 3rd Reading SB1182 Glazer et al",37,0,2,0,39
1089353,769714,2018-07-02,Assembly,"Do pass as amended and be re-referred to the Committee on [Appropriations]",9,0,1,0,10
1089354,751378,2018-05-09,Assembly,"Do pass",9,0,0,0,9
1089354,757126,2018-05-29,Assembly,"AB 2485 CHAU Assembly Third Reading",74,0,4,0,78
1089354,766094,2018-06-20,Senate,"Do pass as amended",7,0,0,0,7
1089354,771376,2018-08-13,Senate,"Special Consent AB2485",37,0,3,0,40
1089354,772188,2018-08-20,Assembly,"AB 2485 CHAU Concurrence in Senate Amendments",79,0,1,0,80
1089357,738799,2018-04-16,Assembly,"Do pass and be re-referred to the Committee on [Environmental Safety and Toxic Materials]",7,3,0,0,10
1089357,744049,2018-04-24,Assembly,"Do pass as amended and be re-referred to the Committee on [Appropriations]",5,2,0,0,7
1089357,756346,2018-05-25,Assembly,"Do pass as amended",12,4,1,0,17
1089357,757660,2018-05-30,Assembly,"AB 2447 REYES Assembly Third Reading",47,26,5,0,78
1089357,767132,2018-06-20,Senate,"Do pass as amended, but first amend, and re-refer to the Committee on [Appropriations]",5,2,0,0,7
1089357,773572,2018-08-29,Senate,"Assembly 3rd Reading AB2447 Reyes et al. By Lara",25,13,2,0,40
1089357,773865,2018-08-30,Assembly,"AB 2447 REYES Concurrence in Senate Amendments",42,30,8,0,80
1089360,733508,2018-04-03,Assembly,"Do pass. To Consent Calendar",10,0,0,0,10
1089360,735477,2018-04-09,Assembly,"AB 2426 MAIENSCHEIN Consent Calendar Second Day",72,0,5,0,77
1089360,763029,2018-06-12,Senate,"Do pass and be ordered to the Consent Calendar",7,0,0,0,7
1089360,767985,2018-06-25,Senate,"Consent Calendar AB2426",36,0,3,0,39
1089361,733447,2018-04-03,Assembly,"Do pass as amended and be re-referred to the Committee on [Appropriations]",13,0,3,0,16
1089361,744393,2018-04-25,Assembly,"Do pass. To Consent Calendar",17,0,0,0,17
1089361,758835,2018-05-31,Assembly,"AB 2423 HOLDEN Assembly Third Reading",77,0,1,0,78
1089361,768064,2018-06-25,Senate,"Do pass as amended, but first amend, and re-refer to the Committee on [Appropriations]",9,0,0,0,9
1089361,773593,2018-08-29,Senate,"Assembly 3rd Reading AB2423 Holden By Wieckowski",39,0,1,0,40
1089361,773702,2018-08-30,Assembly,"AB 2423 HOLDEN Concurrence in Senate Amendments",77,0,3,0,80
1089362,743222,2018-04-24,Assembly,"Do pass as amended and be re-referred to the Committee on [Appropriations]",15,0,0,0,15
1089364,744865,2018-04-25,Assembly,"Do pass and be re-referred to the Committee on [Appropriations]",2,5,0,0,7
1089365,734345,2018-04-04,Assembly,"Do pass and be re-referred to the Committee on [Appropriations]",21,0,0,0,21
1089365,740858,2018-04-18,Assembly,"Do pass. To Consent Calendar",15,0,2,0,17
1089365,744945,2018-04-26,Assembly,"AB 2452 AGUIAR-CURRY Consent Calendar Second Day Regular Session",74,0,4,0,78
1089365,768312,2018-06-26,Senate,"Do pass, but first be re-referred to the Committee on [Appropriations]",13,0,0,0,13
1089365,772385,2018-08-21,Senate,"Assembly 3rd Reading AB2452 Aguiar-Curry et al. By Dodd",39,0,1,0,40
1089365,773188,2018-08-28,Assembly,"With recommendation: That Senate amendments be concurred in",17,0,3,0,20
1089365,773483,2018-08-29,Assembly,"AB 2452 AGUIAR-CURRY Concurrence in Senate Amendments",80,0,0,0,80
1089367,739436,2018-04-16,Assembly,"Do pass and be re-referred to the Committee on [Appropriations]",4,7,3,0,14
1089367,739437,2018-04-16,Assembly,Reconsideration,14,0,0,0,14
1089368,743238,2018-04-24,Assembly,"Do pass as amended and be re-referred to the Committee on [Appropriations]",14,0,1,0,15
1089368,756453,2018-05-25,Assembly,"Do pass",14,1,2,0,17
1089368,756961,2018-05-29,Assembly,"AB 2502 WOOD Assembly Third Reading",73,0,5,0,78
1089369,738230,2018-04-11,Assembly,"Do pass and be re-referred to the Committee on [Water, Parks, and Wildlife] with recommendation: To Consent Calendar",10,0,0,0,10
1089369,743101,2018-04-24,Assembly,"Do pass and be re-referred to the Committee on [Appropriations]",15,0,0,0,15
1089369,756313,2018-05-25,Assembly,"Do pass as amended",16,0,1,0,17
1089369,757571,2018-05-30,Assembly,"AB 2470 GRAYSON Assembly Third Reading",76,0,2,0,78
1089369,762253,2018-06-12,Senate,"Do pass, but first be re-referred to the Committee on [Agriculture] with the recommendation: To Consent Calendar",9,0,0,0,9
1089369,764868,2018-06-19,Senate,"Do pass, but first be re-referred to the Committee on [Appropriations]",4,0,1,0,5
1089369,773486,2018-08-29,Senate,"Assembly 3rd Reading AB2470 Grayson et al. By Galgiani",39,0,1,0,40
1089369,773802,2018-08-30,Assembly,"With recommendation: That Senate amendments be concurred in",8,0,2,0,10
1089369,773986,2018-08-31,Assembly,"AB 2470 GRAYSON Concurrence in Senate Amendments",78,0,2,0,80
1089371,733927,2018-04-04,Assembly,"Do pass and be re-referred to the Committee on [Appropriations]",4,0,3,0,7
1089371,756640,2018-05-25,Assembly,"Do pass",16,0,1,0,17
1089371,757165,2018-05-29,Assembly,"AB 2415 CALDERON Assembly Third Reading",76,0,2,0,78
1089371,768032,2018-06-25,Senate,"Do pass, but first be re-referred to the Committee on [Appropriations]",4,1,0,0,5
1089371,770868,2018-08-06,Senate,"Placed on suspense file",7,0,0,0,7
1089371,771998,2018-08-16,Senate,"Do pass as amended",6,1,0,0,7
1089371,773017,2018-08-27,Senate,"Assembly 3rd Reading AB2415 Calderon By Moorlach",31,7,2,0,40
1089371,773547,2018-08-29,Assembly,"AB 2415 CALDERON Concurrence in Senate Amendments",79,1,0,0,80
1089374,733144,2018-04-02,Assembly,"Do pass and be re-referred to the Committee on [Revenue and Taxation] with recommendation: To Consent Calendar",11,0,0,0,11
1089374,743116,2018-04-23,Assembly,"Do pass and be re-referred to the Committee on [Appropriations]",10,0,0,0,10
1089374,756693,2018-05-25,Assembly,"Do pass",16,0,1,0,17
1089374,757060,2018-05-29,Assembly,"AB 2503 IRWIN Assembly Third Reading",77,0,1,0,78
1089374,766176,2018-06-19,Senate,"Do pass, but first be re-referred to the Committee on [Governance and Finance] with the recommendation: To Consent Calendar",7,0,0,0,7
1089374,769297,2018-06-27,Senate,"Do pass, but first be re-referred to the Committee on [Appropriations]",7,0,0,0,7
1089374,770945,2018-08-06,Senate,"Placed on suspense file",7,0,0,0,7
1089374,772071,2018-08-16,Senate,"Do pass",7,0,0,0,7
1089374,772729,2018-08-24,Senate,"Special Consent AB2503",39,0,1,0,40
1089377,740913,2018-04-17,Assembly,"Do pass and be re-referred to the Committee on [Revenue and Taxation]",14,0,1,0,15
1089377,753340,2018-05-14,Assembly,"Do pass as amended and be re-referred to the Committee on [Appropriations]",9,0,1,0,10
1089377,756324,2018-05-25,Assembly,"Do pass as amended",13,0,4,0,17
1089377,757767,2018-05-30,Assembly,"AB 2459 FRIEDMAN Assembly Third Reading",73,0,5,0,78
1089377,771070,2018-08-08,Senate,"Do pass, but first be re-referred to the Committee on [Appropriations]",6,0,1,0,7
1089377,771332,2018-08-13,Senate,"Placed on suspense file",7,0,0,0,7
1089377,774581,2018-05-14,Assembly,,14,0,1,0,15
1089378,744331,2018-04-25,Assembly,"Do pass and be re-referred to the Committee on [Appropriations]",9,0,1,0,10
1089378,751720,2018-05-09,Assembly,"Do pass. To Consent Calendar",16,0,1,0,17
1089378,754259,2018-05-17,Assembly,"AB 2468 ARAMBULA Consent Calendar Second Day Regular Session",73,0,5,0,78
1089378,765203,2018-06-19,Senate,"Do pass, but first be re-referred to the Committee on [Appropriations]",4,0,1,0,5
1089378,772417,2018-08-21,Senate,"Assembly 3rd Reading AB2468 Arambula By Cannella",38,1,1,0,40
1089378,772794,2018-08-27,Assembly,"AB 2468 ARAMBULA Concurrence in Senate Amendments",80,0,0,0,80
1089380,736500,2018-04-10,Assembly,"Do pass. To Consent Calendar",15,0,0,0,15
1089380,741459,2018-04-19,Assembly,"AB 2393 HEALTH Consent Calendar Second Day By WOOD",71,0,7,0,78
1089380,760711,2018-06-06,Senate,"Do pass and be ordered to the Consent Calendar",8,0,1,0,9
1089380,763554,2018-06-14,Senate,"Consent Calendar AB2393 HEALTH",37,0,2,0,39
1089380,767230,2018-06-21,Assembly,"AB 2393 HEALTH Concurrence in Senate Amendments By WOOD",74,0,6,0,80
1089381,733207,2018-04-03,Assembly,"Do pass as amended and be re-referred to the Committee on [Appropriations]",16,0,0,0,16
1089381,744397,2018-04-25,Assembly,"Do pass. To Consent Calendar",17,0,0,0,17
1089381,748933,2018-05-03,Assembly,"AB 2483 VOEPEL Consent Calendar Second Day Regular Session",71,0,7,0,78
1089383,733875,2018-04-04,Assembly,"Do pass and be re-referred to the Committee on [Appropriations] with recommendation: To Consent Calendar",5,0,2,0,7
1089383,756771,2018-05-25,Assembly,"Do pass",16,0,1,0,17
1089383,757782,2018-05-30,Assembly,"AB 2481 VOEPEL Assembly Third Reading",78,0,0,0,78
1089383,768056,2018-06-25,Senate,"Do pass, but first be re-referred to the Committee on [Appropriations]",5,0,0,0,5
1089383,770836,2018-08-06,Senate,"Placed on suspense file",7,0,0,0,7
1089384,740870,2018-04-18,Assembly,"Do pass and be re-referred to the Committee on [Appropriations] with recommendation: To Consent Calendar",21,0,0,0,21
1089384,755732,2018-05-23,Assembly,"Do pass. To Consent Calendar",16,0,1,0,17
1089384,757145,2018-05-29,Assembly,"AB 2451 AGUIAR-CURRY Consent Calendar Second Day Regular Session",78,0,0,0,78
1089385,736193,2018-04-10,Assembly,"Do pass as amended, and be re-referred to the Committee on [Appropriations] with recommendation: To Consent Calendar",10,0,0,0,10
1089385,744000,2018-04-25,Assembly,"Do pass. To Consent Calendar",17,0,0,0,17
1089385,748936,2018-05-03,Assembly,"AB 2531 GALLAGHER Consent Calendar Second Day Regular Session",71,0,7,0,78
1089385,762972,2018-06-12,Senate,"Do pass, but first be re-referred to the Committee on [Appropriations] with the recommendation: To Consent Calendar",7,0,0,0,7
1089385,767998,2018-06-25,Senate,"Placed on suspense file",7,0,0,0,7
1089385,771963,2018-08-16,Senate,"Do pass",7,0,0,0,7
1089385,773204,2018-08-28,Senate,"Assembly 3rd Reading AB2531 Gallagher By Moorlach",39,0,1,0,40
1089385,773568,2018-08-29,Assembly,"AB 2531 GALLAGHER Concurrence in Senate Amendments",79,0,1,0,80
1089387,733214,2018-04-03,Assembly,"Do pass and be re-referred to the Committee on [Appropriations]",15,0,0,0,15
1089387,756297,2018-05-25,Assembly,"Do pass",14,1,2,0,17
1089387,756999,2018-05-29,Assembly,"AB 2430 ARAMBULA Assembly Third Reading",74,0,4,0,78
1089387,762875,2018-06-13,Senate,"Do pass, but first be re-referred to the Committee on [Appropriations]",8,0,1,0,9
1089387,769609,2018-07-02,Senate,"Placed on suspense file",7,0,0,0,7
1089388,737116,2018-04-10,Assembly,"Do pass as amended and be re-referred to the Committee on [Appropriations]",9,2,5,0,16
1089388,747664,2018-05-02,Assembly,"Do pass",12,2,3,0,17
1089388,758828,2018-05-31,Assembly,"AB 2487 MCCARTY Assembly Third Reading",51,18,9,0,78
1089388,767842,2018-06-25,Senate,"Do pass, but first be re-referred to the Committee on [Appropriations]",8,0,1,0,9
1089388,772227,2018-08-20,Senate,"Assembly 3rd Reading AB2487 McCarty et al. By Stone",39,0,1,0,40
1089388,772577,2018-08-23,Assembly,"AB 2487 MCCARTY Concurrence in Senate Amendments",74,0,6,0,80
1089389,737444,2018-04-10,Assembly,"Do pass and be re-referred to the Committee on [Public Safety]",7,0,0,0,7
1089389,743114,2018-04-24,Assembly,"Do pass and be re-referred to the Committee on [Appropriations]",5,2,0,0,7
1089389,756311,2018-05-25,Assembly,"Do pass",12,4,1,0,17
1089389,757540,2018-05-30,Assembly,"AB 2448 GIPSON Assembly Third Reading",50,24,4,0,78
1089389,762834,2018-06-12,Senate,"Do pass, but first be re-referred to the Committee on [Public Safety]",6,0,1,0,7
1089389,768229,2018-06-26,Senate,"Do pass, but first be re-referred to the Committee on [Appropriations]",5,2,0,0,7
1089389,770344,2018-08-06,Senate,"Placed on suspense file",7,0,0,0,7
1089389,771790,2018-08-16,Senate,"Do pass as amended",5,1,1,0,7
1089389,772913,2018-08-27,Senate,"Assembly 3rd Reading AB2448 Gipson et al. By Mitchell",34,5,1,0,40
1089389,773381,2018-08-29,Assembly,"AB 2448 GIPSON Concurrence in Senate Amendments",59,21,0,0,80
1089391,736728,2018-04-09,Assembly,"Do pass as amended and be re-referred to the Committee on [Appropriations]",10,0,0,0,10
1089391,756485,2018-05-25,Assembly,"Do pass",16,0,1,0,17
1089391,757135,2018-05-29,Assembly,"AB 2441 FRAZIER Assembly Third Reading",78,0,0,0,78
1089391,768315,2018-06-26,Senate,"Do pass, but first be re-referred to the Committee on [Appropriations] with the recommendation: To Consent Calendar",9,0,0,0,9
1089391,770511,2018-08-06,Senate,"Placed on suspense file",7,0,0,0,7
1089391,771519,2018-08-16,Senate,"Do pass as amended",7,0,0,0,7
1089391,773186,2018-08-28,Senate,"Assembly 3rd Reading AB2441 Frazier et al. By Dodd",39,0,1,0,40
1089391,773783,2018-08-30,Assembly,"AB 2441 FRAZIER Concurrence in Senate Amendments",79,0,1,0,80
1089392,733262,2018-04-03,Assembly,"Do pass and be re-referred to the Committee on [Appropriations] with recommendation: To Consent Calendar",7,0,0,0,7
1089392,743957,2018-04-25,Assembly,"Do pass. To Consent Calendar",17,0,0,0,17
1089392,748704,2018-05-03,Assembly,"AB 2526 RUBIO Consent Calendar Second Day Regular Session",71,0,7,0,78
1089392,762132,2018-06-12,Senate,"Do pass, but first be re-referred to the Committee on [Appropriations]",7,0,0,0,7
1089392,771678,2018-08-16,Senate,"Assembly 3rd Reading AB2526 Rubio By McGuire",39,0,1,0,40
1089393,735488,2018-04-09,Assembly,"Do pass. To Consent Calendar",12,0,2,0,14
1089393,756483,2018-05-25,Assembly,"Do pass",16,0,1,0,17
1089393,757132,2018-05-29,Assembly,"AB 2473 BONTA Assembly Third Reading",78,0,0,0,78
1089393,762245,2018-06-12,Senate,"Do pass, but first be re-referred to the Committee on [Appropriations] with the recommendation: To Consent Calendar",12,0,1,0,13
1089393,767983,2018-06-25,Senate,"Placed on suspense file",7,0,0,0,7
1089393,771969,2018-08-16,Senate,"Do pass",7,0,0,0,7
1089393,773334,2018-08-29,Senate,"Assembly 3rd Reading AB2473 Bonta By Wieckowski",39,0,1,0,40
1089396,743887,2018-04-24,Assembly,"Do pass as amended",12,0,1,0,13
1089396,752053,2018-05-10,Assembly,"AB 2385 CUNNINGHAM Assembly Third Reading",71,0,7,0,78
1089396,762727,2018-06-13,Senate,"Do pass as amended",7,0,0,0,7
1089396,769763,2018-07-05,Senate,"Assembly 3rd Reading AB2385 Cunningham By Monning",35,0,4,0,39
1089396,771183,2018-08-09,Assembly,"AB 2385 CUNNINGHAM Concurrence in Senate Amendments",76,0,4,0,80
1090379,733174,2018-04-03,Assembly,"Do pass as amended and be re-referred to the Committee on [Appropriations]",8,2,0,0,10
1090379,740742,2018-04-18,Assembly,"Do pass",11,4,2,0,17
1090379,758674,2018-05-31,Assembly,"AB 2546 CHAU Assembly Third Reading",45,29,4,0,78
1090379,765036,2018-06-18,Senate,"Do pass, but first be re-referred to the Committee on [Judiciary]",6,3,0,0,9
1090379,768867,2018-06-26,Senate,"Do pass as amended, but first amend, and re-refer to the Committee on [Appropriations]",5,2,0,0,7
1090379,770533,2018-08-06,Senate,"Placed on suspense file",7,0,0,0,7
1090379,771642,2018-08-16,Senate,"Do pass as amended",5,2,0,0,7
1090379,772589,2018-08-23,Senate,"Assembly 3rd Reading AB2546 Chau By Allen",25,12,3,0,40
1090381,744242,2018-04-25,Assembly,"Do pass and be re-referred to the Committee on [Appropriations]",4,3,0,0,7
1090383,747753,2018-05-01,Assembly,"Do pass as amended",10,0,0,0,10
1090383,757191,2018-05-29,Assembly,"AB 2632 SANTIAGO Assembly Third Reading",78,0,0,0,78
1090383,769668,2018-07-02,Senate,"Do pass",8,0,1,0,9
1090383,773201,2018-08-28,Senate,"Assembly 3rd Reading AB2632 Santiago By Dodd",38,0,2,0,40
1090383,773433,2018-08-29,Assembly,"AB 2632 SANTIAGO Concurrence in Senate Amendments",78,0,2,0,80
1090385,743840,2018-04-24,Senate,"Do pass as amended, but first amend, and re-refer to the Committee on [Appropriations]",5,1,1,0,7
1090385,752729,2018-05-14,Senate,"Placed on suspense file",7,0,0,0,7
1090385,756670,2018-05-25,Senate,"Do pass",5,2,0,0,7
1090385,757631,2018-05-30,Senate,"Senate 3rd Reading SB1249 Galgiani",21,9,9,0,39
1090385,768216,2018-06-26,Assembly,"Do pass as amended and be re-referred to the Committee on [Appropriations]",9,0,1,0,10
1090385,771068,2018-08-08,Assembly,"Do pass",11,6,0,0,17
1090385,774137,2018-08-31,Senate,"Unfinished Business SB1249 Galgiani et al. Concurrence",39,0,1,0,40
1090385,774138,2018-08-31,Assembly,"SB 1249 Galgiani Senate Third Reading By KALRA",80,0,0,0,80
1090387,740917,2018-04-17,Assembly,"Do pass and be re-referred to the Committee on [Appropriations]",15,0,0,0,15
1090387,756245,2018-05-25,Assembly,"Do pass",15,1,1,0,17
1090387,757645,2018-05-30,Assembly,"AB 2579 BURKE Assembly Third Reading",77,1,0,0,78
1090387,766109,2018-06-20,Senate,"Do pass as amended, but first amend, and re-refer to the Committee on [Appropriations]",8,0,1,0,9
1090387,770510,2018-08-06,Senate,"Placed on suspense file",7,0,0,0,7
1090389,741431,2018-04-18,Assembly,"Do pass and be re-referred to the Committee on [Appropriations]",5,2,0,0,7
1090389,756559,2018-05-25,Assembly,"Do pass",12,4,1,0,17
1090390,737419,2018-04-10,Assembly,"Do pass and be re-referred to the Committee on [Appropriations]",15,0,1,0,16
1090390,744051,2018-04-25,Assembly,"Do pass",17,0,0,0,17
1090390,750111,2018-05-07,Assembly,"AB 2555 COOLEY Assembly Third Reading",68,0,10,0,78
1090390,767921,2018-06-25,Senate,"Do pass, but first be re-referred to the Committee on [Appropriations]",9,0,0,0,9
1090391,737541,2018-04-11,Senate,"Do pass as amended, but first amend, and re-refer to the Committee on [Appropriations]",6,0,0,0,6
1090391,746134,2018-04-30,Senate,"Placed on suspense file",6,0,1,0,7
1090391,756222,2018-05-25,Senate,"Do pass as amended",7,0,0,0,7
1090391,757701,2018-05-30,Senate,"Senate 3rd Reading SB1243 Portantino",36,0,3,0,39
1090393,747025,2018-05-01,Assembly,"Do pass. To Consent Calendar",10,0,0,0,10
1090393,750073,2018-05-07,Assembly,"AB 2664 HOLDEN Consent Calendar Second Day",72,0,6,0,78
1090393,762993,2018-06-12,Senate,"Do pass and be ordered to the Consent Calendar",7,0,0,0,7
1090393,774159,2018-08-31,Senate,"Assembly 3rd Reading AB2664 Holden By Monning",39,0,1,0,40
1090393,774160,2018-08-31,Assembly,"AB 2664 Holden Concurrence in Senate Amendments",80,0,0,0,80
1090394,743956,2018-04-24,Senate,"Do pass, but first be re-referred to the Committee on [Appropriations] with the recommendation: To Consent Calendar",7,0,0,0,7
1090394,749956,2018-05-07,Senate,"Placed on suspense file",6,0,1,0,7
1090394,756219,2018-05-25,Senate,"Do pass",7,0,0,0,7
1090394,758585,2018-05-31,Senate,"Special Consent SB1196",39,0,0,0,39
1090394,765074,2018-06-19,Assembly,"Do pass and be re-referred to the Committee on [Judiciary] with recommendation: To Consent Calendar",10,0,0,0,10
1090394,768287,2018-06-26,Assembly,"Do pass as amended, and be re-referred to the Committee on [Appropriations] with recommendation: To Consent Calendar",10,0,0,0,10
1090394,771052,2018-08-08,Assembly,"Do pass. To Consent Calendar",17,0,0,0,17
1090394,772994,2018-08-27,Assembly,"SB 1196 Jackson Senate Third Reading By CHAU",80,0,0,0,80
1090394,773162,2018-08-28,Senate,"Unfinished Business SB1196 Jackson Concurrence",39,0,1,0,40
1090397,739876,2018-04-17,Senate,"Do pass, but first be re-referred to the Committee on [Appropriations] with the recommendation: To Consent Calendar",7,0,0,0,7
1090397,746796,2018-04-30,Senate,"Placed on suspense file",6,0,1,0,7
1090397,756673,2018-05-25,Senate,"Do pass as amended",7,0,0,0,7
1090397,757774,2018-05-30,Senate,"Senate 3rd Reading SB1190 Skinner et al",37,0,2,0,39
1090397,768438,2018-06-26,Assembly,"Do pass and be re-referred to the Committee on [Appropriations]",7,0,0,0,7
1090398,737336,2018-04-10,Assembly,"Do pass and be re-referred to the Committee on [Appropriations] with recommendation: To Consent Calendar",7,0,0,0,7
1090399,740749,2018-04-17,Assembly,"Do pass and be re-referred to the Committee on [Appropriations]",14,1,0,0,15
1090399,756356,2018-05-25,Assembly,"Do pass as amended",13,3,1,0,17
1090399,757681,2018-05-30,Assembly,"AB 2565 CHIU Assembly Third Reading",59,15,4,0,78
1090399,766243,2018-06-20,Senate,"Do pass, but first be re-referred to the Committee on [Appropriations]",8,1,0,0,9
1090399,770368,2018-08-06,Senate,"Placed on suspense file",7,0,0,0,7
1090401,747794,2018-05-01,Assembly,"Do pass as amended",10,0,0,0,10
1090401,751927,2018-05-10,Assembly,"AB 2678 IRWIN Assembly Third Reading",71,0,7,0,78
1090401,766280,2018-06-19,Senate,"Do pass as amended, and be ordered to the Consent Calendar",7,0,0,0,7
1090402,738258,2018-04-11,Assembly,"Do pass as amended, and be re-referred to the Committee on [Appropriations] with recommendation: To Consent Calendar",7,0,0,0,7
1090402,747657,2018-05-02,Assembly,"Do pass. To Consent Calendar",17,0,0,0,17
1090402,752090,2018-05-10,Assembly,"AB 2622 DAHLE Consent Calendar Second Day Regular Session",73,0,5,0,78
1090402,760373,2018-06-06,Senate,"Do pass as amended, but first amend, and re-refer to the Committee on [Appropriations] with the recommendation: To Consent Calendar",6,0,0,0,6
1090402,771364,2018-08-13,Senate,"Assembly 3rd Reading AB2622 Dahle By Wilk",37,0,3,0,40
1090402,772189,2018-08-20,Assembly,"AB 2622 DAHLE Concurrence in Senate Amendments",80,0,0,0,80
1090403,725516,2018-03-20,Assembly,"Do pass and be re-referred to the Committee on [Appropriations]",6,0,1,0,7
1090403,737654,2018-04-11,Assembly,"Do pass. To Consent Calendar",15,0,2,0,17
1090403,741402,2018-04-19,Assembly,"AB 2660 QUIRK Consent Calendar Second Day Regular Session",71,0,7,0,78
1090405,737428,2018-04-11,Senate,"Do pass, but first be re-referred to the Committee on [Appropriations]",5,0,2,0,7
1090405,742228,2018-04-23,Senate,"Placed on suspense file",7,0,0,0,7
1090406,737174,2018-04-10,Assembly,"Do pass and be re-referred to the Committee on [Appropriations]",7,0,0,0,7
1090409,740770,2018-04-17,Assembly,"Do pass and be re-referred to the Committee on [Appropriations]",6,0,1,0,7
1090409,747836,2018-05-02,Assembly,"Do pass. To Consent Calendar",17,0,0,0,17
1090409,751972,2018-05-10,Assembly,"AB 2719 IRWIN Consent Calendar Second Day Regular Session",73,0,5,0,78
1090409,762825,2018-06-12,Senate,"Do pass, but first be re-referred to the Committee on [Appropriations] with the recommendation: To Consent Calendar",6,0,1,0,7
1090409,770308,2018-08-06,Senate,"Consent Calendar AB2719 Irwin",37,0,2,0,39
1090410,733883,2018-04-04,Senate,"Do pass, but first be re-referred to the Committee on [Judiciary] with the recommendation: To Consent Calendar",7,0,0,0,7
1090410,748067,2018-05-01,Senate,"Do pass and be ordered to the Consent Calendar",7,0,0,0,7
1090410,751978,2018-05-10,Senate,"Consent Calendar SB1183",38,0,1,0,39
1090410,764403,2018-06-18,Assembly,"Do pass",11,0,0,0,11
1090410,765968,2018-06-18,Assembly,"Do pass and be re-referred to the Committee on [Judiciary] with recommendation: To Consent Calendar",11,0,0,0,11
1090410,768346,2018-06-26,Assembly,"Do pass. To Consent Calendar",10,0,0,0,10
1090410,769629,2018-07-02,Assembly,"SB 1183 Morrell Consent Calendar Second Day Regular Session",77,0,3,0,80
1090411,732667,2018-04-02,Assembly,"Do pass and be re-referred to the Committee on [Appropriations]",13,0,1,0,14
1090411,737449,2018-04-11,Assembly,"Do pass. To Consent Calendar",15,0,2,0,17
1090411,741424,2018-04-19,Assembly,"AB 2544 LACKEY Consent Calendar Second Day Regular Session",71,0,7,0,78
1090411,769710,2018-07-03,Senate,"Do pass as amended, but first amend, and re-refer to the Committee on [Appropriations]",12,0,1,0,13
1090411,771404,2018-08-13,Senate,"Placed on suspense file",7,0,0,0,7
1090411,771917,2018-08-16,Senate,"Do pass",7,0,0,0,7
1090411,772264,2018-08-20,Senate,"Assembly 3rd Reading AB2544 Lackey et al. By Wiener Urgency Clause",38,1,1,0,40
1090411,772488,2018-08-23,Assembly,"AB 2544 LACKEY Concurrence - Urgency Added",78,0,2,0,80
1090413,743748,2018-04-25,Assembly,"Do pass as amended and be re-referred to the Committee on [Appropriations]",8,4,1,0,13
1090413,756626,2018-05-25,Assembly,"Do pass as amended",12,3,2,0,17
1090413,758803,2018-05-31,Assembly,"AB 2652 QUIRK Assembly Third Reading",56,15,7,0,78
1090413,769048,2018-06-27,Senate,"Do pass as amended, but first amend, and re-refer to the Committee on [Appropriations]",10,0,1,0,11
1090413,770507,2018-08-06,Senate,"Placed on suspense file",7,0,0,0,7
1090413,772076,2018-08-16,Senate,"Do pass as amended",7,0,0,0,7
1090413,772471,2018-08-22,Senate,"Assembly 3rd Reading AB2652 Quirk By Hueso",38,0,2,0,40
1090413,772960,2018-08-27,Assembly,"AB 2652 QUIRK Concurrence in Senate Amendments",70,1,9,0,80
1090414,742880,2018-04-24,Senate,"Do pass as amended, but first amend, and re-refer to the Committee on [Appropriations]",3,1,3,0,7
1090415,751341,2018-05-08,Senate,"Do pass as amended",7,0,0,0,7
1090415,757149,2018-05-29,Senate,"Senate 3rd Reading SB1244 Wieckowski",38,0,1,0,39
1090415,769715,2018-07-03,Assembly,"Do pass as amended. To Consent Calendar",10,0,0,0,10
1090415,771148,2018-08-09,Assembly,"SB 1244 Wieckowski Consent Calendar Second Day Regular Session",71,0,9,0,80
1090415,771296,2018-08-13,Senate,"Unfinished Business SB1244 Wieckowski Concurrence",36,0,4,0,40
1090417,737411,2018-04-11,Assembly,"Do pass and be re-referred to the Committee on [Appropriations]",7,0,0,0,7
1090417,744413,2018-04-25,Assembly,"Do pass. To Consent Calendar",17,0,0,0,17
1090417,748926,2018-05-03,Assembly,"AB 2592 BERMAN Consent Calendar Second Day Regular Session",71,0,7,0,78
1090417,760501,2018-06-06,Senate,"Do pass, but first be re-referred to the Committee on [Appropriations]",4,1,0,0,5
1090417,773220,2018-08-28,Senate,"Assembly 3rd Reading AB2592 Berman By Pan",32,3,5,0,40
1090417,773601,2018-08-29,Assembly,"AB 2592 BERMAN Concurrence in Senate Amendments",66,8,6,0,80
1090418,753829,2018-05-16,Senate,"Do pass, but first be re-referred to the Committee on [Appropriations]",2,3,2,0,7
1090418,753830,2018-05-16,Senate,"[05-16-2018] hearing: Motion to Reconsider. [Reconsideration Granted.]",7,0,0,0,7
1090419,736012,2018-04-09,Assembly,"Do pass and be re-referred to the Committee on [Appropriations] with recommendation: To Consent Calendar",7,0,3,0,10
1090419,740617,2018-04-18,Assembly,"Do pass. To Consent Calendar",15,0,2,0,17
1090419,744799,2018-04-26,Assembly,"AB 2646 GONZALEZ FLETCHER Consent Calendar Second Day Regular Session",74,0,4,0,78
1090419,762180,2018-06-12,Senate,"Do pass, but first be re-referred to the Committee on [Appropriations] with the recommendation: To Consent Calendar",9,0,0,0,9
1090419,770581,2018-08-06,Senate,"Consent Calendar AB2646 Gonzalez Fletcher Urgency Clause",37,0,2,0,39
1090421,733291,2018-04-03,Assembly,"Do pass as amended. To Consent Calendar",7,0,0,0,7
1090421,741400,2018-04-19,Assembly,"AB 2595 OBERNOLTE Assembly Third Reading",73,0,5,0,78
1090421,762143,2018-06-12,Senate,"Do pass as amended",7,0,0,0,7
1090421,771384,2018-08-13,Senate,"Special Consent AB2595",37,0,3,0,40
1090421,772161,2018-08-20,Assembly,"AB 2595 OBERNOLTE Concurrence in Senate Amendments",80,0,0,0,80
1090422,738245,2018-04-11,Assembly,"Do pass and be re-referred to the Committee on [Judiciary]",7,0,0,0,7
1090422,739531,2018-04-17,Assembly,"Do pass as amended and be re-referred to the Committee on [Appropriations]",10,0,0,0,10
1090422,753832,2018-05-16,Assembly,"Do pass. To Consent Calendar",17,0,0,0,17
1090422,757199,2018-05-29,Assembly,"AB 2732 GONZALEZ FLETCHER Assembly Third Reading",62,1,15,0,78
1090422,763025,2018-06-13,Senate,"Do pass as amended, but first amend, and re-refer to the Committee on [Judiciary]",4,1,0,0,5
1090422,768990,2018-06-26,Senate,"Do pass as amended, but first amend, and re-refer to the Committee on [Appropriations]",5,1,1,0,7
1090422,774231,2018-08-31,Senate,"Assembly 3rd Reading AB2732 Gonzalez Fletcher et al. By Leyva",24,8,8,0,40
1090422,774232,2018-08-31,Assembly,"AB 2732 Gonzalez Fletcher Concurrence in Senate Amendments",59,13,8,0,80
1090422,774584,2018-08-31,Senate,,5,8,8,0,21
1090423,735445,2018-04-09,Senate,"Do pass, but first be re-referred to the Committee on [Appropriations] with the recommendation: To Consent Calendar",5,0,0,0,5
1090423,742265,2018-04-23,Senate,"Consent Calendar SB1195",38,0,1,0,39
1090423,766138,2018-06-20,Assembly,"Do pass and be re-referred to the Committee on [Appropriations]",6,0,1,0,7
1090423,771141,2018-08-08,Assembly,"Do pass. To Consent Calendar",17,0,0,0,17
1090423,771672,2018-08-16,Assembly,"SB 1195 Portantino Consent Calendar Second Day Regular Session",76,0,4,0,80
1090425,742876,2018-04-23,Assembly,"Do pass and be re-referred to the Committee on [Appropriations] with recommendation: To Consent Calendar",10,0,0,0,10
1090427,726647,2018-03-21,Assembly,"Do pass and be re-referred to the Committee on [Appropriations]",6,0,1,0,7
1090427,740903,2018-04-18,Assembly,"Do pass. To Consent Calendar",15,0,2,0,17
1090427,744894,2018-04-26,Assembly,"AB 2543 EGGMAN Assembly Third Reading",74,0,4,0,78
1090427,762427,2018-06-12,Senate,"Do pass, but first be re-referred to the Committee on [Appropriations]",10,0,2,0,12
1090427,772409,2018-08-21,Senate,"Assembly 3rd Reading AB2543 Eggman et al. By Dodd",34,0,6,0,40
1090429,733157,2018-04-02,Assembly,"Do pass and be re-referred to the Committee on [Appropriations]",7,0,3,0,10
1090429,748357,2018-05-02,Assembly,"Do pass. To Consent Calendar",17,0,0,0,17
1090429,751902,2018-05-10,Assembly,"AB 2730 HARPER Consent Calendar Second Day Regular Session",73,0,5,0,78
1090429,769327,2018-06-27,Senate,"Do pass, but first be re-referred to the Committee on [Appropriations]",2,4,1,0,7
1090429,769328,2018-06-27,Senate,"[06-28-2018] hearing: Motion to Reconsider. [Reconsideration Granted.]",7,0,0,0,7
1090430,737417,2018-04-11,Senate,"Do pass as amended, but first amend, and re-refer to the Committee on [Appropriations]",6,0,0,0,6
1090430,745968,2018-04-30,Senate,"Placed on suspense file",6,0,1,0,7
1090432,734003,2018-04-03,Assembly,"Do pass and be re-referred to the Committee on [Appropriations]",13,0,0,0,13
1090432,741184,2018-04-18,Assembly,"Do pass. To Consent Calendar",15,0,2,0,17
1090432,744759,2018-04-26,Assembly,"AB 2554 BONTA Consent Calendar Second Day Regular Session",74,0,4,0,78
1090432,760323,2018-06-06,Senate,"Do pass, but first be re-referred to the Committee on [Appropriations]",6,0,0,0,6
1090432,771185,2018-08-09,Senate,"Assembly 3rd Reading AB2554 Bonta By Pan",36,0,3,0,39
1090435,740710,2018-04-18,Senate,"Do pass, but first be re-referred to the Committee on [Judiciary]",4,1,2,0,7
1090435,751127,2018-05-08,Senate,"Do pass as amended",4,1,2,0,7
1090435,758578,2018-05-31,Senate,"Senate 3rd Reading SB1235 Glazer",21,11,7,0,39
1090435,767839,2018-06-25,Assembly,"Do pass",9,0,2,0,11
1090435,772789,2018-08-27,Assembly,"Do pass",11,0,6,0,17
1090435,773981,2018-08-31,Senate,"That the Assembly amendments be concurred in",3,2,2,0,7
1090435,773982,2018-08-31,Senate,"Unfinished Business SB1235 Glazer Concurrence",28,6,6,0,40
1090435,773983,2018-08-31,Assembly,"SB 1235 Glazer Senate Third Reading By LIMÓN",72,3,5,0,80
1090436,744518,2018-04-24,Senate,"Do pass as amended, but first amend, and re-refer to the Committee on [Appropriations]",10,1,2,0,13
1090436,754946,2018-05-21,Senate,"Senate 3rd Reading SB1184 Pan",30,6,3,0,39
1090438,738181,2018-04-11,Assembly,"Do pass",9,0,0,0,9
1090438,742300,2018-04-23,Assembly,"AB 2600 FLORA Assembly Third Reading",72,2,4,0,78
1090438,766273,2018-06-20,Senate,"Do pass as amended",7,0,0,0,7
1090438,769786,2018-07-05,Senate,"Assembly 3rd Reading AB2600 Flora By Dodd",32,3,4,0,39
1090438,771178,2018-08-09,Assembly,"AB 2600 FLORA Concurrence in Senate Amendments",77,1,2,0,80
1090439,725480,2018-03-20,Senate,"Do pass, but first be re-referred to the Committee on [Appropriations] with the recommendation: To Consent Calendar",11,0,2,0,13
1090439,738887,2018-04-16,Senate,"Do pass",7,0,0,0,7
1090439,742340,2018-04-23,Senate,"Senate 3rd Reading SB1236 Monning",38,0,1,0,39
1090439,767918,2018-06-25,Assembly,"Do pass and be re-referred to the Committee on [Appropriations]",13,0,1,0,14
1090439,771109,2018-08-08,Assembly,"Do pass",14,3,0,0,17
1090439,772633,2018-08-23,Assembly,"SB 1236 Monning Senate Third Reading By STONE",73,3,4,0,80
1090439,772670,2018-08-24,Senate,"Unfinished Business SB1236 Monning Concurrence",39,0,1,0,40
1090440,753249,2018-05-14,Assembly,"Do pass as amended and be re-referred to the Committee on [Appropriations]",8,1,1,0,10
1090444,747035,2018-05-01,Assembly,"Do pass",10,0,0,0,10
1090444,748592,2018-05-03,Assembly,"AB 2642 LEVINE Assembly Third Reading",64,0,14,0,78
1090444,762973,2018-06-12,Senate,"Do pass and be ordered to the Consent Calendar",7,0,0,0,7
1090444,769538,2018-07-02,Senate,"Assembly 3rd Reading AB2642 Levine By Hertzberg",37,0,2,0,39
1090447,743308,2018-04-24,Senate,"Do pass, but first be re-referred to the Committee on [Appropriations]",9,0,0,0,9
1090447,756978,2018-05-29,Senate,"Senate 3rd Reading SB1261 Nielsen Urgency Clause",38,0,1,0,39
1090447,766155,2018-06-20,Assembly,"Do pass and be re-referred to the Committee on [Appropriations]",6,0,1,0,7
1090447,771512,2018-08-15,Assembly,"Do pass. To Consent Calendar",17,0,0,0,17
1090447,772603,2018-08-23,Assembly,"SB 1261 Nielsen Consent Calendar Second Day Regular Session",75,0,5,0,80
1090447,772682,2018-08-24,Senate,"Unfinished Business SB1261 Nielsen Urgency Clause Concurrence",39,0,1,0,40
1090450,745126,2018-04-25,Assembly,"Do pass and be re-referred to the Committee on [Appropriations]",6,0,1,0,7
1090450,756639,2018-05-25,Assembly,"Do pass",16,0,1,0,17
1090450,757607,2018-05-30,Assembly,"AB 2580 CUNNINGHAM Assembly Third Reading",78,0,0,0,78
1090450,768878,2018-06-27,Senate,"Do pass as amended, but first amend, and re-refer to the Committee on [Appropriations]",7,0,0,0,7
1090450,770859,2018-08-06,Senate,"Placed on suspense file",7,0,0,0,7
1090450,772020,2018-08-16,Senate,"Do pass",7,0,0,0,7
1090450,773132,2018-08-28,Senate,"Assembly 3rd Reading AB2580 Cunningham By Wieckowski",38,0,2,0,40
1090450,773690,2018-08-30,Assembly,"AB 2580 CUNNINGHAM Concurrence in Senate Amendments",80,0,0,0,80
1090450,774478,2018-04-25,Assembly,,0,0,1,0,1
1090451,744772,2018-04-25,Assembly,"Do pass and be re-referred to the Committee on [Appropriations]",7,0,0,0,7
1090452,737152,2018-04-10,Assembly,"Do pass and be re-referred to the Committee on [Appropriations]",11,2,2,0,15
1090455,742953,2018-04-23,Assembly,"Do pass as amended and be re-referred to the Committee on [Appropriations]",7,3,0,0,10
1090455,756751,2018-05-25,Assembly,"Do pass as amended and be re-referred to the Committee on [Rules]",10,5,2,0,17
1090458,727721,2018-03-21,Assembly,"Do pass and be re-referred to the Committee on [Appropriations]",7,0,0,0,7
1090458,756445,2018-05-25,Assembly,"Do pass as amended",12,0,5,0,17
1090458,758809,2018-05-31,Assembly,"AB 2639 BERMAN Assembly Third Reading",78,0,0,0,78
1090458,768869,2018-06-27,Senate,"Do pass, but first be re-referred to the Committee on [Appropriations] with the recommendation: To Consent Calendar",7,0,0,0,7
1090458,770367,2018-08-06,Senate,"Placed on suspense file",7,0,0,0,7
1090458,771648,2018-08-16,Senate,"Do pass as amended",7,0,0,0,7
1090458,772466,2018-08-22,Senate,"Assembly 3rd Reading AB2639 Berman et al. By Portantino",39,0,1,0,40
1090458,772852,2018-08-27,Assembly,"AB 2639 BERMAN Concurrence in Senate Amendments",80,0,0,0,80
1090459,726300,2018-03-21,Senate,"Do pass, but first be re-referred to the Committee on [Governance and Finance]",5,0,1,0,6
1090459,744052,2018-04-25,Senate,"Do pass, but first be re-referred to the Committee on [Appropriations]",6,1,0,0,7
1090459,750124,2018-05-07,Senate,"Placed on suspense file",6,0,1,0,7
1090459,756614,2018-05-25,Senate,"Do pass",7,0,0,0,7
1090459,757686,2018-05-30,Senate,"Senate 3rd Reading SB1225 Glazer et al. Urgency Clause",34,5,0,0,39
1090459,768962,2018-06-26,Assembly,"Do pass and be re-referred to the Committee on [Appropriations]",11,0,2,0,13
1090459,771828,2018-08-16,Assembly,"Do pass",12,3,2,0,17
1090461,740668,2018-04-17,Assembly,"Do pass and be re-referred to the Committee on [Appropriations]",15,0,0,0,15
1090461,743993,2018-04-25,Assembly,"Do pass. To Consent Calendar",17,0,0,0,17
1090461,748925,2018-05-03,Assembly,"AB 2679 O'DONNELL Consent Calendar Second Day Regular Session",71,0,7,0,78
1090461,766570,2018-06-20,Senate,"Do pass as amended, but first amend, and re-refer to the Committee on [Appropriations] with the recommendation: To Consent Calendar",8,0,1,0,9
1090461,771390,2018-08-13,Senate,"Do pass",6,0,1,0,7
1090461,773627,2018-08-29,Senate,"Assembly 3rd Reading AB2679 O'Donnell By Pan",39,0,1,0,40
1090461,773779,2018-08-30,Assembly,"AB 2679 O'DONNELL Concurrence in Senate Amendments",80,0,0,0,80
1090463,740342,2018-04-17,Senate,"Do pass, but first be re-referred to the Committee on [Appropriations]",5,1,1,0,7
1090463,746431,2018-04-30,Senate,"Placed on suspense file",6,0,1,0,7
1090463,756699,2018-05-25,Senate,"Do pass",5,1,1,0,7
1090463,757036,2018-05-29,Senate,"Senate 3rd Reading SB1200 Skinner",30,8,1,0,39
1090463,764895,2018-06-19,Assembly,"Do pass and be re-referred to the Committee on [Appropriations]",6,1,0,0,7
1090463,771062,2018-08-08,Assembly,"Do pass",12,5,0,0,17
1090463,774156,2018-08-31,Senate,"Unfinished Business SB1200 Skinner Concurrence",22,5,13,0,40
1090463,774157,2018-08-31,Assembly,"SB 1200 Skinner Senate Third Reading By GIPSON",64,1,15,0,80
1090464,737276,2018-04-11,Assembly,"Do pass as amended",8,1,0,0,9
1090464,749201,2018-05-03,Assembly,"AB 2598 QUIRK Assembly Third Reading",54,17,7,0,78
1090464,765974,2018-06-20,Senate,"Do pass",5,1,1,0,7
1090464,771220,2018-08-09,Senate,"Assembly 3rd Reading AB2598 Quirk By McGuire",24,10,5,0,39
1090464,772632,2018-08-23,Assembly,"AB 2598 QUIRK Concurrence in Senate Amendments",58,19,3,0,80
1090465,740699,2018-04-18,Senate,"Do pass, but first be re-referred to the Committee on [Natural Resources and Water]",7,0,0,0,7
1090465,743086,2018-04-24,Senate,"Do pass as amended, but first amend, and re-refer to the Committee on [Appropriations]",9,0,0,0,9
1090465,755311,2018-05-22,Senate,"Placed on suspense file",7,0,0,0,7
1090465,756234,2018-05-25,Senate,"Do pass",7,0,0,0,7
1090465,758532,2018-05-31,Senate,"Special Consent SB1263",39,0,0,0,39
1090465,768251,2018-06-26,Assembly,"Do pass and be re-referred to the Committee on [Environmental Safety and Toxic Materials]",15,0,0,0,15
1090465,768402,2018-06-26,Assembly,"Do pass as amended and be re-referred to the Committee on [Appropriations]",6,0,1,0,7
1090465,771551,2018-08-16,Assembly,"Do pass",17,0,0,0,17
1090465,772871,2018-08-27,Assembly,"SB 1263 Portantino Senate Third Reading By BLOOM",80,0,0,0,80
1090465,773159,2018-08-28,Senate,"Unfinished Business SB1263 Portantino Concurrence",39,0,1,0,40
1090467,739838,2018-04-17,Assembly,"Do pass and be re-referred to the Committee on [Appropriations] with recommendation: To Consent Calendar",7,0,0,0,7
1090467,748119,2018-05-02,Assembly,"Do pass. To Consent Calendar",17,0,0,0,17
1090467,752100,2018-05-10,Assembly,"AB 2720 WALDRON Consent Calendar Second Day Regular Session",73,0,5,0,78
1090467,765244,2018-06-19,Senate,"Do pass, but first be re-referred to the Committee on [Appropriations]",7,0,0,0,7
1090467,770275,2018-08-06,Senate,"Do pass as amended",6,1,0,0,7
1090467,772423,2018-08-21,Senate,"Assembly 3rd Reading AB2720 Waldron By Skinner",39,0,1,0,40
1090467,772839,2018-08-27,Assembly,"AB 2720 WALDRON Concurrence in Senate Amendments",80,0,0,0,80
1090468,742101,2018-04-23,Senate,"Do pass as amended, but first amend, and re-refer to the Committee on [Appropriations] with the recommendation: To Consent Calendar",9,0,0,0,9
1090468,757158,2018-05-29,Senate,"Consent Calendar SB1217",37,0,2,0,39
1090468,768296,2018-06-26,Assembly,"Do pass as amended and be re-referred to the Committee on [Appropriations]",18,0,1,0,19
1090468,771126,2018-08-08,Assembly,"Do pass. To Consent Calendar",17,0,0,0,17
1090468,771662,2018-08-16,Assembly,"SB 1217 Morrell Consent Calendar Second Day Regular Session",76,0,4,0,80
1090468,772218,2018-08-20,Senate,"Unfinished Business SB1217 Morrell Concurrence",39,0,1,0,40
1090469,743003,2018-04-24,Senate,"Do pass, but first be re-referred to the Committee on [Appropriations]",2,4,1,0,7
1090471,736149,2018-04-10,Assembly,"Do pass and be re-referred to the Committee on [Appropriations]",11,3,1,0,15
1090471,756710,2018-05-25,Assembly,"Do pass",12,4,1,0,17
1090471,757553,2018-05-30,Assembly,"AB 2718 FRIEDMAN Assembly Third Reading",55,20,3,0,78
1090471,762805,2018-06-13,Senate,"Do pass, but first be re-referred to the Committee on [Appropriations]",8,0,1,0,9
1090471,769652,2018-07-02,Senate,"Placed on suspense file",7,0,0,0,7
1090472,736160,2018-04-10,Assembly,"Do pass and be re-referred to the Committee on [Appropriations] with recommendation: To Consent Calendar",7,0,0,0,7
1090472,743729,2018-04-25,Assembly,"Do pass. To Consent Calendar",17,0,0,0,17
1090472,748723,2018-05-03,Assembly,"AB 2661 ARAMBULA Consent Calendar Second Day Regular Session",71,0,7,0,78
1090472,768205,2018-06-26,Senate,"Do pass, but first be re-referred to the Committee on [Appropriations] with the recommendation: To Consent Calendar",7,0,0,0,7
1090472,771282,2018-08-13,Senate,"Consent Calendar AB2661",37,0,3,0,40
1090475,743125,2018-04-23,Assembly,"Do pass as amended and be re-referred to the Committee on [Appropriations]",3,6,1,0,10
1090476,736315,2018-04-10,Assembly,"Do pass as amended and be re-referred to the Committee on [Appropriations]",5,0,2,0,7
1090476,756636,2018-05-25,Assembly,"Do pass as amended",12,0,5,0,17
1090476,758681,2018-05-31,Assembly,"AB 2606 FONG Assembly Third Reading",65,4,9,0,78
1090476,766962,2018-06-20,Senate,"Do pass as amended, but first amend, and re-refer to the Committee on [Appropriations]",7,0,0,0,7
1090476,770962,2018-08-06,Senate,"Placed on suspense file",7,0,0,0,7
1090477,736691,2018-04-10,Assembly,"Do pass as amended and be re-referred to the Committee on [Appropriations]",7,0,0,0,7
1090477,736692,2018-04-10,Assembly,"Do pass as amended and be re-referred to the Committee on [Appropriations]",7,0,0,0,7
1090479,742106,2018-04-23,Senate,"Do pass as amended, but first amend, and re-refer to the Committee on [Appropriations]",9,0,0,0,9
1090479,755372,2018-05-22,Senate,"Do pass",7,0,0,0,7
1090479,757040,2018-05-29,Senate,"Senate 3rd Reading SB1254 Stone",38,0,1,0,39
1090479,765077,2018-06-19,Assembly,"Do pass as amended and be re-referred to the Committee on [Health]",17,0,2,0,19
1090479,768268,2018-06-26,Assembly,"Do pass as amended and be re-referred to the Committee on [Appropriations]",15,0,0,0,15
1090479,771496,2018-08-15,Assembly,"Do pass. To Consent Calendar",17,0,0,0,17
1090479,772580,2018-08-23,Assembly,"SB 1254 Stone Consent Calendar Second Day Regular Session",75,0,5,0,80
1090479,772696,2018-08-24,Senate,"Unfinished Business SB1254 Stone Concurrence",39,0,1,0,40
1090480,740795,2018-04-18,Assembly,"Do pass and be re-referred to the Committee on [Appropriations]",9,0,0,0,9
1090480,748280,2018-05-02,Assembly,"Do pass. To Consent Calendar",17,0,0,0,17
1090480,751953,2018-05-10,Assembly,"AB 2654 QUIRK-SILVA Consent Calendar Second Day Regular Session",73,0,5,0,78
1090480,763015,2018-06-13,Senate,"Do pass as amended, but first amend, and re-refer to the Committee on [Appropriations]",7,0,0,0,7
1090480,771211,2018-08-09,Senate,"Assembly 3rd Reading AB2654 Quirk-Silva By Moorlach",36,0,3,0,39
1090480,771259,2018-08-13,Assembly,"AB 2654 QUIRK-SILVA Concurrence in Senate Amendments",78,0,2,0,80
1090481,733364,2018-04-02,Assembly,"Do pass as amended and be re-referred to the Committee on [Appropriations]",9,0,1,0,10
1090483,738199,2018-04-11,Assembly,"Do pass as amended and be re-referred to the Committee on [Health]",6,0,1,0,7
1090483,743271,2018-04-24,Assembly,"Do pass and be re-referred to the Committee on [Appropriations] with recommendation: To Consent Calendar",15,0,0,0,15
1090484,742911,2018-04-24,Assembly,"Do pass as amended and be re-referred to the Committee on [Appropriations]",8,4,3,0,15
1090484,756183,2018-05-25,Assembly,"Do pass as amended",13,1,3,0,17
1090484,757639,2018-05-30,Assembly,"AB 2545 GALLAGHER Assembly Third Reading",68,1,9,0,78
1090485,735495,2018-04-09,Assembly,"Do pass and be re-referred to the Committee on [Higher Education]",9,2,3,0,14
1090485,744461,2018-04-24,Assembly,"Do pass and be re-referred to the Committee on [Appropriations]",10,2,1,0,13
1090487,739690,2018-04-17,Assembly,"Do pass and be re-referred to the Committee on [Appropriations]",7,0,0,0,7
1090487,756422,2018-05-25,Assembly,"Do pass as amended",16,0,1,0,17
1090487,758789,2018-05-31,Assembly,"AB 2599 HOLDEN Assembly Third Reading",76,0,2,0,78
1090487,768154,2018-06-26,Senate,"Do pass, but first be re-referred to the Committee on [Appropriations] with the recommendation: To Consent Calendar",7,0,0,0,7
1090487,770574,2018-08-06,Senate,"Placed on suspense file",7,0,0,0,7
1090487,771788,2018-08-16,Senate,"Do pass",7,0,0,0,7
1090487,773411,2018-08-29,Senate,"Assembly 3rd Reading AB2599 Holden By Lara",39,0,1,0,40
1090488,733811,2018-04-03,Assembly,"Do pass as amended and be re-referred to the Committee on [Veterans Affairs]",13,0,0,0,13
1090488,743962,2018-04-24,Assembly,"Do pass and be re-referred to the Committee on [Appropriations]",10,0,0,0,10
1090488,756446,2018-05-25,Assembly,"Do pass",16,0,1,0,17
1090488,757662,2018-05-30,Assembly,"AB 2722 MEDINA Assembly Third Reading",78,0,0,0,78
1090488,762829,2018-06-13,Senate,"Do pass as amended, but first amend, and re-refer to the Committee on [Veterans Affairs] with the recommendation: To Consent Calendar",7,0,0,0,7
1090488,768146,2018-06-26,Senate,"Do pass, but first be re-referred to the Committee on [Appropriations] with the recommendation: To Consent Calendar",6,0,0,0,6
1090488,770572,2018-08-06,Senate,"Placed on suspense file",7,0,0,0,7
1090488,771683,2018-08-16,Senate,"Do pass",7,0,0,0,7
1090488,772693,2018-08-24,Senate,"Special Consent AB2722",39,0,1,0,40
1090488,773376,2018-08-29,Assembly,"AB 2722 MEDINA Concurrence in Senate Amendments",79,0,1,0,80
1090489,733735,2018-04-04,Senate,"Do pass as amended, but first amend, and re-refer to the Committee on [Judiciary]",8,0,1,0,9
1090489,743739,2018-04-24,Senate,"Do pass, but first be re-referred to the Committee on [Appropriations]",6,1,0,0,7
1090489,755274,2018-05-22,Senate,"Do pass",7,0,0,0,7
1090489,757072,2018-05-29,Senate,"Senate 3rd Reading SB1238 Roth",34,2,3,0,39
1090489,768194,2018-06-26,Assembly,"Do pass as amended and be re-referred to the Committee on [Appropriations]",8,4,3,0,15
1090491,739870,2018-04-16,Senate,"Do pass, but first be re-referred to the Committee on [Environmental Quality]",7,0,2,0,9
1090491,740854,2018-04-18,Senate,"Do pass, but first be re-referred to the Committee on [Governance and Finance]",7,0,0,0,7
1090491,743842,2018-04-25,Senate,"Do pass, but first be re-referred to the Committee on [Appropriations]",6,1,0,0,7
1090491,750128,2018-05-07,Senate,"Placed on suspense file",6,0,1,0,7
1090491,756383,2018-05-25,Senate,"Do pass as amended",7,0,0,0,7
1090491,757761,2018-05-30,Senate,"Senate 3rd Reading SB1260 Jackson",36,0,3,0,39
1090491,768131,2018-06-25,Assembly,"Do pass and be re-referred to the Committee on [Local Government]",10,0,0,0,10
1090491,768734,2018-06-27,Assembly,"Do pass as amended and be re-referred to the Committee on [Appropriations]",9,0,0,0,9
1090491,771812,2018-08-16,Assembly,"Do pass",15,0,2,0,17
1090491,774249,2018-08-31,Senate,"Unfinished Business SB1260 Jackson Concurrence",39,0,1,0,40
1090491,774250,2018-08-31,Assembly,"SB 1260 Jackson Senate Third Reading By AGUIAR-CURRY",80,0,0,0,80
1090492,751544,2018-05-09,Assembly,"Do pass",9,0,0,0,9
1090492,757861,2018-05-30,Assembly,"AB 2558 BROUGH Assembly Third Reading",73,2,3,0,78
1090492,766402,2018-06-20,Senate,"Do pass as amended",5,1,1,0,7
1090492,769804,2018-07-05,Senate,"Assembly 3rd Reading AB2558 Brough By Galgiani",17,8,14,0,39
1090492,769805,2018-07-05,Senate,"Assembly 3rd Reading AB2558 Brough By Galgiani Reconsider",35,0,4,0,39
1090492,773022,2018-08-27,Senate,"Assembly 3rd Reading AB2558 Brough By Galgiani",19,12,9,0,40
1090493,733143,2018-04-03,Senate,"Do pass, but first be re-referred to the Committee on [Judiciary]",5,1,1,0,7
1090493,740811,2018-04-17,Senate,"Do pass as amended, but first amend, and re-refer to the Committee on [Appropriations]",4,2,1,0,7
1090493,750010,2018-05-07,Senate,"Placed on suspense file",6,0,1,0,7
1090493,756261,2018-05-25,Senate,"Do pass as amended",5,2,0,0,7
1090493,758384,2018-05-31,Senate,"Senate 3rd Reading SB1186 Hill",21,15,3,0,39
1090493,764925,2018-06-19,Assembly,"Do pass and be re-referred to the Committee on [Privacy and Consumer Protection]",5,2,0,0,7
1090493,768341,2018-06-26,Assembly,"Do pass and be re-referred to the Committee on [Appropriations]",7,3,0,0,10
1090495,737517,2018-04-11,Assembly,"Do pass as amended and be re-referred to the Committee on [Appropriations]",6,0,1,0,7
1090495,748172,2018-05-02,Assembly,"Do pass. To Consent Calendar",17,0,0,0,17
1090495,757444,2018-05-29,Assembly,"AB 2689 GRAY Assembly Third Reading",77,0,1,0,78
1090495,765601,2018-06-19,Senate,"Do pass, but first be re-referred to the Committee on [Appropriations]",5,0,0,0,5
1090495,772318,2018-08-20,Senate,"Assembly 3rd Reading AB2689 Gray By Stern",39,0,1,0,40
1090496,733760,2018-04-02,Assembly,"Do pass as amended and be re-referred to the Committee on [Appropriations]",8,1,1,0,10
1090497,740503,2018-04-18,Senate,"Do pass, but first be re-referred to the Committee on [Appropriations]",8,1,0,0,9
1090497,754939,2018-05-21,Senate,"Senate 3rd Reading SB1245 Leyva",28,10,1,0,39
1090497,765208,2018-06-19,Assembly,"Do pass and be re-referred to the Committee on [Appropriations]",12,3,0,0,15
1090497,768812,2018-06-27,Assembly,"Do pass",12,4,1,0,17
1090497,772246,2018-08-20,Assembly,"SB 1245 Leyva Senate Third Reading By LIMÓN",54,23,3,0,80
1090499,737279,2018-04-10,Assembly,"Do pass and be re-referred to the Committee on [Appropriations]",10,0,0,0,10
1090500,733233,2018-04-03,Assembly,"Do pass",6,0,1,0,7
1090500,735601,2018-04-09,Assembly,"AB 2669 JONES-SAWYER Assembly Third Reading",72,0,5,0,77
1090500,762235,2018-06-12,Senate,"Do pass as amended",5,0,2,0,7
1090500,769799,2018-07-05,Senate,"Assembly 3rd Reading AB2669 Jones-Sawyer By Wiener",35,0,4,0,39
1090500,770357,2018-08-06,Assembly,"AB 2669 JONES-SAWYER Concurrence in Senate Amendments",77,0,3,0,80
1090503,733923,2018-04-03,Assembly,"Do pass and be re-referred to the Committee on [Appropriations]",13,0,0,0,13
1090504,737310,2018-04-11,Senate,"Do pass, but first be re-referred to the Committee on [Appropriations]",8,1,0,0,9
1090504,755366,2018-05-22,Senate,"Placed on suspense file",7,0,0,0,7
1090504,756643,2018-05-25,Senate,"Do pass",5,2,0,0,7
1090504,757067,2018-05-29,Senate,"Senate 3rd Reading SB1255 Hernandez et al",28,10,1,0,39
1090504,768335,2018-06-26,Assembly,"Do pass and be re-referred to the Committee on [Appropriations]",13,2,0,0,15
1090505,733580,2018-04-03,Assembly,"Do pass and be re-referred to the Committee on [Appropriations]",2,5,0,0,7
1090505,733581,2018-04-03,Assembly,Reconsideration,7,0,0,0,7
1090505,743223,2018-04-24,Assembly,"Do pass and be re-referred to the Committee on [Appropriations]",2,5,0,0,7
1090507,740118,2018-04-17,Assembly,"Do pass as amended and be re-referred to the Committee on [Appropriations]",8,1,1,0,10
1090507,747804,2018-05-02,Assembly,"Do pass",12,5,0,0,17
1090507,752106,2018-05-10,Assembly,"AB 2636 GARCIA, E. Assembly Third Reading",49,22,7,0,78
1090507,762963,2018-06-12,Senate,"Do pass, but first be re-referred to the Committee on [Environmental Quality]",4,1,2,0,7
1090511,743063,2018-04-24,Senate,"Do pass, but first be re-referred to the Committee on [Appropriations] with the recommendation: To Consent Calendar",7,0,0,0,7
1090511,749920,2018-05-07,Senate,"Placed on suspense file",6,0,1,0,7
1090512,739887,2018-04-17,Assembly,"Do pass and be re-referred to the Committee on [Appropriations]",16,0,0,0,16
1090512,748203,2018-05-02,Assembly,"Do pass. To Consent Calendar",17,0,0,0,17
1090512,752141,2018-05-10,Assembly,"AB 2603 CUNNINGHAM Consent Calendar Second Day Regular Session",73,0,5,0,78
1090513,751402,2018-05-09,Senate,"Do pass as amended, but first amend, and re-refer to the Committee on [Appropriations]",5,0,2,0,7
1090513,755340,2018-05-22,Senate,"Placed on suspense file",7,0,0,0,7
1090515,742891,2018-04-24,Assembly,"Do pass and be re-referred to the Committee on [Appropriations]",15,1,0,0,16
1090515,756336,2018-05-25,Assembly,"Do pass",13,1,3,0,17
1090515,757729,2018-05-30,Assembly,"AB 2682 BURKE Assembly Third Reading",78,0,0,0,78
1090521,739757,2018-04-17,Senate,"Do pass, but first be re-referred to the Committee on [Appropriations]",4,0,1,0,5
1090521,750083,2018-05-07,Senate,"Senate 3rd Reading SB1239 Hertzberg",37,0,2,0,39
1090521,768758,2018-06-27,Assembly,"Do pass as amended and be re-referred to the Committee on [Appropriations]",6,1,0,0,7
1090521,771085,2018-08-08,Assembly,"Do pass",17,0,0,0,17
1090521,772929,2018-08-27,Assembly,"SB 1239 Hertzberg Senate Third Reading By MULLIN",78,0,2,0,80
1090521,773253,2018-08-28,Senate,"Unfinished Business SB1239 Hertzberg Concurrence",39,0,1,0,40
1090522,735741,2018-04-09,Assembly,"Do pass and be re-referred to the Committee on [Water, Parks, and Wildlife]",12,0,2,0,14
1090522,743573,2018-04-24,Assembly,"Do pass and be re-referred to the Committee on [Appropriations]",15,0,0,0,15
1090522,756563,2018-05-25,Assembly,"Do pass",16,0,1,0,17
1090522,757576,2018-05-30,Assembly,"AB 2615 CARRILLO Assembly Third Reading",77,0,1,0,78
1090522,762251,2018-06-12,Senate,"Do pass, but first be re-referred to the Committee on [Appropriations] with the recommendation: To Consent Calendar",12,0,1,0,13
1090522,767852,2018-06-25,Senate,"Placed on suspense file",7,0,0,0,7
1090522,771660,2018-08-16,Senate,"Do pass as amended",7,0,0,0,7
1090522,772967,2018-08-27,Senate,"Assembly 3rd Reading AB2615 Carrillo et al. By Galgiani",39,0,1,0,40
1090522,773300,2018-08-29,Assembly,"AB 2615 CARRILLO Concurrence in Senate Amendments",78,0,2,0,80
1090524,736151,2018-04-10,Assembly,"Do pass and be re-referred to the Committee on [Transportation] with recommendation: To Consent Calendar",7,0,0,0,7
1090524,742268,2018-04-23,Assembly,"Do pass and be re-referred to the Committee on [Appropriations] with recommendation: To Consent Calendar",14,0,0,0,14
1090524,751785,2018-05-09,Assembly,"Do pass. To Consent Calendar",16,0,1,0,17
1090524,754308,2018-05-17,Assembly,"AB 2685 LACKEY Consent Calendar Second Day Regular Session",73,0,5,0,78
1090524,765851,2018-06-19,Senate,"Do pass, but first be re-referred to the Committee on [Appropriations] with the recommendation: To Consent Calendar",7,0,0,0,7
1090524,773260,2018-08-28,Senate,"Assembly 3rd Reading AB2685 Lackey By Vidak",39,0,1,0,40
1090524,773663,2018-08-29,Assembly,"AB 2685 LACKEY Concurrence in Senate Amendments",79,0,1,0,80
1090528,739806,2018-04-17,Assembly,"Do pass and be re-referred to the Committee on [Education]",13,0,0,0,13
1090529,738193,2018-04-11,Assembly,"Do pass as amended and be re-referred to the Committee on [Appropriations]",6,0,1,0,7
1090529,747820,2018-05-02,Assembly,"Do pass. To Consent Calendar",17,0,0,0,17
1090529,752022,2018-05-10,Assembly,"AB 2735 O'DONNELL Consent Calendar Second Day Regular Session",73,0,5,0,78
1090529,760341,2018-06-06,Senate,"Do pass as amended, but first amend, and re-refer to the Committee on [Appropriations]",6,0,0,0,6
1090529,772142,2018-08-20,Senate,"Assembly 3rd Reading AB2735 O'Donnell et al. By Hueso",39,0,1,0,40
1090529,772583,2018-08-23,Assembly,"AB 2735 O'DONNELL Concurrence in Senate Amendments",78,0,2,0,80
1090530,727743,2018-03-21,Assembly,"Do pass and be re-referred to the Committee on [Appropriations]",6,1,0,0,7
1090530,756580,2018-05-25,Assembly,"Do pass",12,3,2,0,17
1090530,757732,2018-05-30,Assembly,"AB 2601 WEBER Assembly Third Reading",54,18,6,0,78
1090530,766160,2018-06-20,Senate,"Do pass as amended, but first amend, and re-refer to the Committee on [Appropriations]",7,0,0,0,7
1090530,770539,2018-08-06,Senate,"Placed on suspense file",7,0,0,0,7
1090530,771731,2018-08-16,Senate,"Do pass",5,2,0,0,7
1090530,772361,2018-08-21,Senate,"Assembly 3rd Reading AB2601 Weber et al. By Leyva",27,10,3,0,40
1090530,772836,2018-08-27,Assembly,"AB 2601 WEBER Concurrence in Senate Amendments",57,16,7,0,80
1090530,774569,2018-08-21,Senate,"Assembly 3rd Reading AB2601 Weber et al. By Leyolspan=""2""> ?",5,10,3,0,18
1090532,740521,2018-04-18,Senate,"Do pass, but first be re-referred to the Committee on [Judiciary]",7,0,0,0,7
1090532,743849,2018-04-24,Senate,"Do pass as amended, but first amend, and re-refer to the Committee on [Appropriations]",7,0,0,0,7
1090532,754936,2018-05-21,Senate,"Senate 3rd Reading SB1201 Jackson",39,0,0,0,39
1090532,764295,2018-06-18,Assembly,"Do pass and be re-referred to the Committee on [Appropriations]",11,0,0,0,11
1090532,766056,2018-06-18,Assembly,"Do pass and be re-referred to the Committee on [Privacy and Consumer Protection] with recommendation: To Consent Calendar",11,0,0,0,11
1090532,768345,2018-06-26,Assembly,"Do pass and be re-referred to the Committee on [Appropriations]",10,0,0,0,10
1090532,771138,2018-08-08,Assembly,"Do pass. To Consent Calendar",17,0,0,0,17
1090532,771947,2018-08-16,Assembly,"SB 1201 Jackson Consent Calendar Second Day Regular Session",76,0,4,0,80
1090536,740070,2018-04-17,Assembly,"Do pass as amended and be re-referred to the Committee on [Appropriations]",7,0,0,0,7
1090536,756255,2018-05-25,Assembly,"Do pass as amended",16,0,1,0,17
1090536,758820,2018-05-31,Assembly,"AB 2596 COOLEY Assembly Third Reading",78,0,0,0,78
1090536,767966,2018-06-25,Senate,"Do pass, but first be re-referred to the Committee on [Appropriations]",9,0,0,0,9
1090536,770870,2018-08-06,Senate,"Placed on suspense file",7,0,0,0,7
1090536,772030,2018-08-16,Senate,"Do pass as amended",7,0,0,0,7
1090536,772574,2018-08-23,Senate,"Assembly 3rd Reading AB2596 Cooley et al. By Hill",39,0,1,0,40
1090536,773174,2018-08-28,Assembly,"AB 2596 COOLEY Concurrence in Senate Amendments",78,0,2,0,80
1090537,733683,2018-04-02,Assembly,"Do pass as amended and be re-referred to the Committee on [Appropriations]",8,0,2,0,10
1090537,756509,2018-05-25,Assembly,"Do pass",13,3,1,0,17
1090537,757084,2018-05-29,Assembly,"AB 2577 GRAY Assembly Third Reading",64,11,3,0,78
1090537,771072,2018-08-08,Senate,"Do pass, but first be re-referred to the Committee on [Appropriations]",5,1,1,0,7
1090537,771363,2018-08-13,Senate,"Placed on suspense file",7,0,0,0,7
1090538,743042,2018-04-24,Assembly,"Do pass as amended and be re-referred to the Committee on [Appropriations]",11,1,3,0,15
1090538,756616,2018-05-25,Assembly,"Do pass as amended",11,2,4,0,17
1090538,758800,2018-05-31,Assembly,"AB 2649 ARAMBULA Assembly Third Reading",51,18,9,0,78
1090538,768198,2018-06-26,Senate,"Do pass as amended, but first amend, and re-refer to the Committee on [Appropriations]",7,0,2,0,9
1090538,770352,2018-08-06,Senate,"Placed on suspense file",7,0,0,0,7
1090538,771734,2018-08-16,Senate,"Do pass",7,0,0,0,7
1090540,744066,2018-04-25,Senate,"Do pass as amended, but first amend, and re-refer to the Committee on [Appropriations]",9,0,0,0,9
1090540,752682,2018-05-14,Senate,"Placed on suspense file",7,0,0,0,7
1090540,756438,2018-05-25,Senate,"Do pass",7,0,0,0,7
1090540,758482,2018-05-31,Senate,"Special Consent SB1264",39,0,0,0,39
1090540,764817,2018-06-19,Assembly,"Do pass and be re-referred to the Committee on [Appropriations]",12,1,2,0,15
1090541,741001,2018-04-18,Assembly,"Do pass and be re-referred to the Committee on [Appropriations]",5,1,1,0,7
1090541,756545,2018-05-25,Assembly,"Do pass",12,0,5,0,17
1090541,757805,2018-05-30,Assembly,"AB 2628 RODRIGUEZ Assembly Third Reading",57,10,11,0,78
1090544,751413,2018-05-09,Senate,"Do pass and be ordered to the Consent Calendar",6,0,1,0,7
1090544,754191,2018-05-17,Senate,"Consent Calendar SB1251",38,0,1,0,39
1090544,763533,2018-06-14,Assembly,"Be re-referred to the Committee on [Insurance]",7,0,4,0,11
1090544,766227,2018-06-20,Assembly,"Do pass and be re-referred to the Committee on [Appropriations]",10,1,2,0,13
1090544,771509,2018-08-15,Assembly,"Do pass",12,5,0,0,17
1090544,772483,2018-08-23,Assembly,"SB 1251 McGuire Senate Third Reading By DALY",63,15,2,0,80
1090544,772856,2018-08-27,Senate,"That the Assembly amendments be concurred in",4,0,1,0,5
1090544,773149,2018-08-28,Senate,"Unfinished Business SB1251 McGuire Concurrence",33,5,2,0,40
1090546,740877,2018-04-18,Senate,"Do pass, but first be re-referred to the Committee on [Judiciary]",4,1,1,0,6
1090546,743994,2018-04-24,Senate,"Do pass as amended, but first amend, and re-refer to the Committee on [Appropriations]",3,2,2,0,7
1090546,743995,2018-04-24,Senate,"[First] hearing set for [04-25-2018]: Failed passage in Committee. Reconsideration granted",7,0,0,0,7
1090549,736150,2018-04-10,Assembly,"Do pass as amended and be re-referred to the Committee on [Appropriations]",9,0,1,0,10
1090549,744149,2018-04-25,Assembly,"Do pass. To Consent Calendar",17,0,0,0,17
1090549,752062,2018-05-10,Assembly,"AB 2684 BLOOM Assembly Third Reading",69,0,9,0,78
1090549,768859,2018-06-26,Senate,"Do pass, but first be re-referred to the Committee on [Appropriations]",6,1,0,0,7
1090549,770254,2018-08-06,Senate,"Placed on suspense file",7,0,0,0,7
1090549,771915,2018-08-16,Senate,"Do pass",6,0,1,0,7
1090549,773446,2018-08-29,Senate,"Assembly 3rd Reading AB2684 Bloom et al. By Wieckowski",35,2,3,0,40
1090549,773913,2018-08-30,Assembly,"AB 2684 BLOOM Concurrence in Senate Amendments",73,0,7,0,80
1090550,743381,2018-04-24,Senate,"Do pass, but first be re-referred to the Committee on [Appropriations] with the recommendation: To Consent Calendar",7,0,0,0,7
1090550,750174,2018-05-07,Senate,"Placed on suspense file",6,0,1,0,7
1090551,733150,2018-04-03,Assembly,"Do pass and be re-referred to the Committee on [Arts, Entertainment, Sports, Tourism, and Internet Media]",10,0,0,0,10
1090551,739638,2018-04-17,Assembly,"Do pass and be re-referred to the Committee on [Appropriations]",7,0,0,0,7
1090553,743675,2018-04-23,Senate,"Do pass, but first be re-referred to the Committee on [Appropriations]",1,3,1,0,5
1090553,743676,2018-04-23,Senate,"[Second] hearing set for [04-23-2018]: Failed passage in Committee. Reconsideration granted",4,0,1,0,5
1090554,734427,2018-04-05,Assembly,"Be re-referred to the Committee on [Transportation]",8,0,3,0,11
1090554,742172,2018-04-23,Assembly,"Do pass and be re-referred to the Committee on [Appropriations]",14,0,0,0,14
1090554,751812,2018-05-09,Assembly,"Do pass. To Consent Calendar",16,0,1,0,17
1090554,754316,2018-05-17,Assembly,"AB 2564 RODRIGUEZ Consent Calendar Second Day Regular Session",73,0,5,0,78
1090554,760481,2018-06-06,Senate,"Do pass as amended, but first amend, and re-refer to the Committee on [Judiciary]",5,0,2,0,7
1090554,765971,2018-06-19,Senate,"Do pass, but first be re-referred to the Committee on [Appropriations]",7,0,0,0,7
1090554,771405,2018-08-13,Senate,"Assembly 3rd Reading AB2564 Rodriguez et al. By Allen",36,0,4,0,40
1090554,772292,2018-08-20,Assembly,"AB 2564 RODRIGUEZ Concurrence in Senate Amendments",78,0,2,0,80
1090555,737161,2018-04-11,Assembly,"Do pass as amended and be re-referred to the Committee on [Appropriations]",6,1,0,0,7
1090555,756429,2018-05-25,Assembly,"Do pass as amended",12,3,2,0,17
1090555,757683,2018-05-30,Assembly,"AB 2588 CHU Assembly Third Reading",52,19,7,0,78
1090555,768246,2018-06-26,Senate,"Do pass, but first be re-referred to the Committee on [Appropriations]",8,3,2,0,13
1090555,770545,2018-08-06,Senate,"Placed on suspense file",7,0,0,0,7
1090555,771703,2018-08-16,Senate,"Do pass",5,2,0,0,7
1090555,772235,2018-08-20,Senate,"Assembly 3rd Reading AB2588 Chu By Leyva",26,10,4,0,40
1090557,733401,2018-04-03,Assembly,"Do pass as amended and be re-referred to the Committee on [Appropriations]",10,0,0,0,10
1090558,733733,2018-04-02,Assembly,"Do pass and be re-referred to the Committee on [Appropriations] with recommendation: To Consent Calendar",11,0,0,0,11
1090558,737427,2018-04-11,Assembly,"Do pass. To Consent Calendar",15,0,2,0,17
1090558,741456,2018-04-19,Assembly,"AB 2557 MAIENSCHEIN Consent Calendar Second Day Regular Session",71,0,7,0,78
1090558,760667,2018-06-06,Senate,"Do pass as amended, but first amend, and re-refer to the Committee on [Judiciary]",6,0,1,0,7
1090558,769010,2018-06-26,Senate,"Do pass, but first be re-referred to the Committee on [Appropriations] with the recommendation: To Consent Calendar",7,0,0,0,7
1090558,771280,2018-08-13,Senate,"Special Consent AB2557",37,0,3,0,40
1090558,772150,2018-08-20,Assembly,"AB 2557 MAIENSCHEIN Concurrence in Senate Amendments",80,0,0,0,80
1090561,733692,2018-04-03,Senate,"Do pass as amended, but first amend, and re-refer to the Committee on [Public Safety] with the recommendation: To Consent Calendar",6,0,1,0,7
1090561,745942,2018-04-30,Senate,"Consent Calendar SB1208 JUD. (Jackson)",36,0,3,0,39
1090561,762577,2018-06-12,Assembly,"Do pass as amended, and be re-referred to the Committee on [Appropriations] with recommendation: To Consent Calendar",9,0,1,0,10
1090561,769155,2018-06-27,Assembly,"Do pass. To Consent Calendar",16,0,1,0,17
1090561,769765,2018-07-05,Assembly,"SB 1208 JUD. Consent Calendar Second Day Regular Session",69,0,11,0,80
1090561,771215,2018-08-09,Senate,"Unfinished Business SB1208 JUD. (Jackson) Concurrence",37,0,2,0,39
1090563,743103,2018-04-24,Senate,"Do pass, but first be re-referred to the Committee on [Appropriations]",7,0,0,0,7
1090563,749841,2018-05-07,Senate,"Placed on suspense file",6,0,1,0,7
1090563,756262,2018-05-25,Senate,"Do pass",7,0,0,0,7
1090563,758555,2018-05-31,Senate,"Special Consent SB1242",39,0,0,0,39
1090565,751167,2018-05-09,Senate,"Do pass, but first be re-referred to the Committee on [Appropriations]",5,0,2,0,7
1090565,755332,2018-05-22,Senate,"Placed on suspense file",7,0,0,0,7
1090568,736009,2018-04-10,Assembly,"Do pass as amended and be re-referred to the Committee on [Appropriations]",5,2,0,0,7
1090569,740798,2018-04-17,Assembly,"Do pass and be re-referred to the Committee on [Appropriations] with recommendation: To Consent Calendar",15,0,0,0,15
1090569,756379,2018-05-25,Assembly,"Do pass as amended",12,0,5,0,17
1090569,758786,2018-05-31,Assembly,"AB 2593 GRAYSON Assembly Third Reading",66,0,12,0,78
1090569,768884,2018-06-27,Senate,"Do pass as amended, but first amend, and re-refer to the Committee on [Appropriations]",9,0,0,0,9
1090569,771361,2018-08-13,Senate,"Placed on suspense file",7,0,0,0,7
1090569,771771,2018-08-16,Senate,"Do pass",7,0,0,0,7
1090569,772356,2018-08-21,Senate,"Assembly 3rd Reading AB2593 Grayson et al. By Nielsen",39,0,1,0,40
1090569,772935,2018-08-27,Assembly,"With recommendation: That Senate amendments be concurred in",12,0,3,0,15
1090569,773410,2018-08-29,Assembly,"AB 2593 GRAYSON Concurrence in Senate Amendments",79,0,1,0,80
1090572,740635,2018-04-18,Assembly,"Do pass as amended and be re-referred to the Committee on [Appropriations]",21,0,0,0,21
1090572,756584,2018-05-25,Assembly,"Do pass",16,0,1,0,17
1090572,758705,2018-05-31,Assembly,"AB 2573 LOW Assembly Third Reading",78,0,0,0,78
1090572,768162,2018-06-26,Senate,"Do pass, but first be re-referred to the Committee on [Appropriations]",13,0,0,0,13
1090572,770830,2018-08-06,Senate,"Placed on suspense file",7,0,0,0,7
1090572,772070,2018-08-16,Senate,"Do pass",7,0,0,0,7
1090572,772380,2018-08-21,Senate,"Assembly 3rd Reading AB2573 Low By Dodd",39,0,1,0,40
1090574,743750,2018-04-24,Senate,"Do pass, but first be re-referred to the Committee on [Appropriations] with the recommendation: To Consent Calendar",11,0,2,0,13
1090574,749861,2018-05-07,Senate,"Do pass",6,0,1,0,7
1090574,754905,2018-05-21,Senate,"Senate 3rd Reading SB1262 Newman",38,0,1,0,39
1090574,767913,2018-06-25,Assembly,"Do pass and be re-referred to the Committee on [Appropriations]",13,0,1,0,14
1090574,771494,2018-08-15,Assembly,"Do pass. To Consent Calendar",17,0,0,0,17
1090574,772548,2018-08-23,Assembly,"SB 1262 Beall Consent Calendar Second Day Regular Session",75,0,5,0,80
1090574,772671,2018-08-24,Senate,"Unfinished Business SB1262 Beall Concurrence",39,0,1,0,40
1090576,737445,2018-04-10,Assembly,"Do pass as amended, and be re-referred to the Committee on [Education] with recommendation: To Consent Calendar",7,0,0,0,7
1090576,744826,2018-04-25,Assembly,"Do pass as amended and be re-referred to the Committee on [Appropriations]",7,0,0,0,7
1090576,756370,2018-05-25,Assembly,"Do pass",16,0,1,0,17
1090576,758672,2018-05-31,Assembly,"AB 2626 MULLIN Assembly Third Reading",78,0,0,0,78
1090576,766011,2018-06-20,Senate,"Do pass, but first be re-referred to the Committee on [Human Services] with the recommendation: To Consent Calendar",7,0,0,0,7
1090576,768881,2018-06-26,Senate,"Do pass, but first be re-referred to the Committee on [Appropriations] with the recommendation: To Consent Calendar",6,0,1,0,7
1090576,770518,2018-08-06,Senate,"Placed on suspense file",7,0,0,0,7
1090576,771713,2018-08-16,Senate,"Do pass",7,0,0,0,7
1090576,772663,2018-08-24,Senate,"Special Consent AB2626",39,0,1,0,40
1090576,773317,2018-08-29,Assembly,"AB 2626 MULLIN Concurrence in Senate Amendments",79,0,1,0,80
1090576,777357,2018-08-24,Senate,,7,0,1,0,8
1090578,733672,2018-04-03,Senate,"Do pass as amended, but first amend, and re-refer to the Committee on [Appropriations]",10,0,1,0,11
1090578,752139,2018-05-10,Senate,"Senate 3rd Reading SB1205 Hill",36,0,3,0,39
1090578,763427,2018-06-14,Assembly,"Be re-referred to the Committee on [Governmental Organization]",7,0,4,0,11
1090578,769280,2018-06-28,Assembly,"Do pass and be re-referred to the Committee on [Appropriations]",21,0,0,0,21
1090578,771840,2018-08-16,Assembly,"Do pass",17,0,0,0,17
1090578,773083,2018-08-28,Assembly,"SB 1205 Hill Senate Third Reading By BONTA",80,0,0,0,80
1090578,773813,2018-08-30,Senate,"That the Assembly amendments be concurred in",13,0,0,0,13
1090578,773979,2018-08-31,Senate,"Unfinished Business SB1205 Hill Concurrence",39,0,1,0,40
1090580,743833,2018-04-24,Assembly,"Do pass as amended and be re-referred to the Committee on [Appropriations]",7,0,0,0,7
1090580,755673,2018-05-23,Assembly,"Do pass",16,0,1,0,17
1090580,757013,2018-05-29,Assembly,"AB 2605 GIPSON Assembly Third Reading",78,0,0,0,78
1090580,762853,2018-06-12,Senate,"Do pass, but first be re-referred to the Committee on [Appropriations]",6,0,1,0,7
1090580,772844,2018-08-27,Senate,"Do pass, but first be re-referred to the Committee on [Appropriations]",4,0,1,0,5
1090580,774205,2018-08-31,Assembly,"With recommendation: That Senate amendments be concurred in",7,0,0,0,7
1090580,774206,2018-08-31,Senate,"Assembly 3rd Reading AB2605 Gipson et al. By Lara Urgency Clause",38,1,1,0,40
1090580,774207,2018-08-31,Assembly,"AB 2605 Gipson Concurrence - Urgency Added",80,0,0,0,80
1090582,733225,2018-04-03,Assembly,"Do pass as amended and be re-referred to the Committee on [Judiciary]",10,0,0,0,10
1090582,750620,2018-05-08,Assembly,"Do pass as amended",10,0,0,0,10
1090582,756258,2018-05-25,Assembly,"Do pass",16,0,1,0,17
1090582,757644,2018-05-30,Assembly,"AB 2658 CALDERON Assembly Third Reading",76,0,2,0,78
1090582,768291,2018-06-26,Senate,"Do pass, but first be re-referred to the Committee on [Appropriations]",13,0,0,0,13
1090582,770566,2018-08-06,Senate,"Placed on suspense file",7,0,0,0,7
1090582,771841,2018-08-16,Senate,"Do pass as amended",7,0,0,0,7
1090582,772523,2018-08-23,Senate,"Assembly 3rd Reading AB2658 Calderon et al. By Hertzberg",39,0,1,0,40
1090582,772882,2018-08-27,Assembly,"AB 2658 CALDERON Concurrence in Senate Amendments",78,0,2,0,80
1090585,740477,2018-04-18,Senate,"Do pass, but first be re-referred to the Committee on [Public Safety]",8,0,1,0,9
1090585,754892,2018-05-21,Senate,"Senate 3rd Reading SB1192 Monning",32,7,0,0,39
1090585,765327,2018-06-19,Assembly,"Do pass and be re-referred to the Committee on [Appropriations]",12,0,3,0,15
1090585,768970,2018-06-27,Assembly,"Do pass",12,4,1,0,17
1090585,771701,2018-08-16,Assembly,"SB 1192 Monning Senate Third Reading By MCCARTY",46,26,8,0,80
1090585,772407,2018-08-21,Senate,"Unfinished Business SB1192 Monning Concurrence",29,9,2,0,40
1090586,744192,2018-04-24,Assembly,"Do pass and be re-referred to the Committee on [Appropriations]",13,0,0,0,13
1090586,756736,2018-05-25,Assembly,"Do pass as amended",16,0,1,0,17
1090586,758666,2018-05-31,Assembly,"AB 2597 ARAMBULA Assembly Third Reading",77,0,1,0,78
1090586,769068,2018-06-27,Senate,"Do pass, but first be re-referred to the Committee on [Appropriations] with the recommendation: To Consent Calendar",7,0,0,0,7
1090586,770562,2018-08-06,Senate,"Placed on suspense file",7,0,0,0,7
1090588,737429,2018-04-10,Assembly,"Do pass and be re-referred to the Committee on [Appropriations] with recommendation: To Consent Calendar",7,0,0,0,7
1090588,756594,2018-05-25,Assembly,"Do pass",16,0,1,0,17
1090588,757810,2018-05-30,Assembly,"AB 2602 MCCARTY Assembly Third Reading",78,0,0,0,78
1090588,762787,2018-06-12,Senate,"Do pass, but first be re-referred to the Committee on [Appropriations]",6,0,1,0,7
1090588,768002,2018-06-25,Senate,"Placed on suspense file",7,0,0,0,7
1090588,771983,2018-08-16,Senate,"Do pass as amended",7,0,0,0,7
1090588,772531,2018-08-23,Senate,"Assembly 3rd Reading AB2602 McCarty By Galgiani",39,0,1,0,40
1090588,772778,2018-08-27,Assembly,"AB 2602 MCCARTY Concurrence in Senate Amendments",78,0,2,0,80
1090589,741442,2018-04-18,Assembly,"Do pass and be re-referred to the Committee on [Appropriations]",7,0,0,0,7
1090589,751842,2018-05-09,Assembly,"Do pass as amended. To Consent Calendar",16,0,1,0,17
1090589,754314,2018-05-17,Assembly,"AB 2610 AGUIAR-CURRY Consent Calendar Second Day Regular Session",73,0,5,0,78
1090589,763132,2018-06-13,Senate,"Do pass, but first be re-referred to the Committee on [Appropriations] with the recommendation: To Consent Calendar",5,0,0,0,5
1090589,769637,2018-07-02,Senate,"Consent Calendar AB2610",37,0,2,0,39
1090590,744119,2018-04-25,Senate,"Do pass, but first be re-referred to the Committee on [Appropriations]",5,0,0,0,5
1090590,750122,2018-05-07,Senate,"Placed on suspense file",6,0,1,0,7
1090590,756704,2018-05-25,Senate,"Do pass",7,0,0,0,7
1090590,758626,2018-05-31,Senate,"Special Consent SB1223",39,0,0,0,39
1090590,767240,2018-06-20,Assembly,"Do pass and be re-referred to the Committee on [Appropriations]",7,0,0,0,7
1090590,771827,2018-08-16,Assembly,"Do pass",17,0,0,0,17
1090590,773013,2018-08-27,Assembly,"SB 1223 Galgiani Senate Third Reading By CERVANTES",80,0,0,0,80
1090590,773231,2018-08-28,Senate,"Unfinished Business SB1223 Galgiani et al. Concurrence",39,0,1,0,40
1090592,733280,2018-04-03,Senate,"Do pass, but first be re-referred to the Committee on [Appropriations] with the recommendation: To Consent Calendar",6,0,1,0,7
1090592,742175,2018-04-23,Senate,"Placed on suspense file",7,0,0,0,7
1090593,743258,2018-04-23,Senate,"Do pass, but first be re-referred to the Committee on [Appropriations] with the recommendation: To Consent Calendar",4,0,1,0,5
1090593,752020,2018-05-10,Senate,"Consent Calendar SB1207",38,0,1,0,39
1090594,740748,2018-04-17,Assembly,"Do pass as amended and be re-referred to the Committee on [Appropriations]",10,0,0,0,10
1090596,740801,2018-04-18,Senate,"Do pass, but first be re-referred to the Committee on [Public Safety]",9,0,0,0,9
1090596,742959,2018-04-24,Senate,"Do pass as amended, but first amend, and re-refer to the Committee on [Appropriations]",7,0,0,0,7
1090596,755318,2018-05-22,Senate,"Placed on suspense file",7,0,0,0,7
1090596,756284,2018-05-25,Senate,"Do pass",7,0,0,0,7
1090596,758396,2018-05-31,Senate,"Special Consent SB1228",39,0,0,0,39
1090596,764842,2018-06-19,Assembly,"Do pass and be re-referred to the Committee on [Public Safety]",15,0,0,0,15
1090596,768203,2018-06-26,Assembly,"Do pass as amended and be re-referred to the Committee on [Appropriations]",7,0,0,0,7
1090596,771609,2018-08-16,Assembly,"Do pass as amended",12,0,5,0,17
1090596,773745,2018-08-30,Assembly,"SB 1228 Lara Senate Third Reading By BLOOM",80,0,0,0,80
1090596,774092,2018-08-31,Senate,"Unfinished Business SB1228 Lara Concurrence",39,0,1,0,40
1090598,743818,2018-04-25,Senate,"Do pass, but first be re-referred to the Committee on [Appropriations]",9,0,0,0,9
1090598,755334,2018-05-22,Senate,"Placed on suspense file",7,0,0,0,7
1090598,756330,2018-05-25,Senate,"Do pass as amended",7,0,0,0,7
1090598,758584,2018-05-31,Senate,"Senate 3rd Reading SB1206 De León et al. Urgency Clause",37,2,0,0,39
1090600,751410,2018-05-09,Senate,"Do pass as amended",6,0,1,0,7
1090600,754952,2018-05-21,Senate,"Senate 3rd Reading SB1202 Stone",39,0,0,0,39
1090600,766758,2018-06-20,Assembly,"Do pass",8,0,1,0,9
1090600,772095,2018-08-16,Assembly,"SB 1202 Stone Senate Third Reading By MAYES",78,0,2,0,80
1090601,747042,2018-05-01,Senate,"Do pass as amended",13,0,0,0,13
1090601,752635,2018-05-14,Senate,"Placed on suspense file",7,0,0,0,7
1090601,756727,2018-05-25,Senate,"Do pass",7,0,0,0,7
1090601,758599,2018-05-31,Senate,"Special Consent SB1226",39,0,0,0,39
1090601,766346,2018-06-20,Assembly,"Do pass and be re-referred to the Committee on [Appropriations]",7,0,0,0,7
1090601,771574,2018-08-16,Assembly,"Do pass",17,0,0,0,17
1090601,774090,2018-08-31,Assembly,"SB 1226 Bates Senate Third Reading By GLORIA",77,1,2,0,80
1090602,742761,2018-04-23,Assembly,"Do pass and be re-referred to the Committee on [Appropriations] with recommendation: To Consent Calendar",14,0,0,0,14
1090602,747795,2018-05-02,Assembly,"Do pass. To Consent Calendar",17,0,0,0,17
1090602,751924,2018-05-10,Assembly,"AB 2656 CHEN Consent Calendar Second Day Regular Session",73,0,5,0,78
1090602,764976,2018-06-18,Senate,"Do pass, but first be re-referred to the Committee on [Appropriations]",9,0,0,0,9
1090602,771720,2018-08-16,Senate,"Assembly 3rd Reading AB2656 Chen By Fuller",39,0,1,0,40
1090602,772236,2018-08-20,Assembly,"AB 2656 CHEN Concurrence in Senate Amendments",80,0,0,0,80
1090604,743143,2018-04-23,Assembly,"Do pass and be re-referred to the Committee on [Appropriations]",7,3,0,0,10
1090606,733312,2018-04-03,Assembly,"Do pass and be re-referred to the Committee on [Appropriations] with recommendation: To Consent Calendar",15,0,0,0,15
1090606,737433,2018-04-11,Assembly,"Do pass. To Consent Calendar",15,0,2,0,17
1090606,741462,2018-04-19,Assembly,"AB 2561 FLORA Consent Calendar Second Day Regular Session",71,0,7,0,78
1090606,760548,2018-06-06,Senate,"Do pass, but first be re-referred to the Committee on [Appropriations] with the recommendation: To Consent Calendar",8,0,1,0,9
1090606,769580,2018-07-02,Senate,"Consent Calendar AB2561",37,0,2,0,39
1090608,739880,2018-04-17,Assembly,"Do pass as amended and be re-referred to the Committee on [Appropriations]",15,0,1,0,16
1090608,756302,2018-05-25,Assembly,"Do pass as amended",13,2,2,0,17
1090608,758720,2018-05-31,Assembly,"AB 2641 WOOD Assembly Third Reading",54,15,9,0,78
1090608,767886,2018-06-25,Senate,"Do pass as amended, but first amend, and re-refer to the Committee on [Appropriations]",5,2,2,0,9
1090608,770366,2018-08-06,Senate,"Placed on suspense file",7,0,0,0,7
1090609,743904,2018-04-25,Assembly,"Do pass and be re-referred to the Committee on [Appropriations] with recommendation: To Consent Calendar",7,0,0,0,7
1090609,755719,2018-05-23,Assembly,"Do pass. To Consent Calendar",16,0,1,0,17
1090609,757187,2018-05-29,Assembly,"AB 2552 BERMAN Consent Calendar Second Day Regular Session",78,0,0,0,78
1090609,764998,2018-06-19,Senate,"Do pass, but first be re-referred to the Committee on [Appropriations]",5,0,0,0,5
1090609,769648,2018-07-02,Senate,"Placed on suspense file",7,0,0,0,7
1090609,771959,2018-08-16,Senate,"Do pass as amended",7,0,0,0,7
1090609,772559,2018-08-23,Senate,"Assembly 3rd Reading AB2552 Berman By Stern",39,0,1,0,40
1090609,772973,2018-08-27,Assembly,"AB 2552 BERMAN Concurrence in Senate Amendments",71,4,5,0,80
1090610,744847,2018-04-25,Assembly,"Do pass as amended and be re-referred to the Committee on [Appropriations]",4,1,2,0,7
1090610,756531,2018-05-25,Assembly,"Do pass",12,2,3,0,17
1090610,758755,2018-05-31,Assembly,"AB 2657 WEBER Assembly Third Reading",54,13,11,0,78
1090610,768864,2018-06-27,Senate,"Do pass as amended, but first amend, and re-refer to the Committee on [Appropriations]",6,1,0,0,7
1090610,770496,2018-08-06,Senate,"Placed on suspense file",7,0,0,0,7
1090610,771785,2018-08-16,Senate,"Do pass as amended",6,0,1,0,7
1090610,773478,2018-08-29,Senate,"Assembly 3rd Reading AB2657 Weber By Wilk",38,0,2,0,40
1090610,773787,2018-08-30,Assembly,"AB 2657 WEBER Concurrence in Senate Amendments",76,2,2,0,80
1090612,738869,2018-04-16,Assembly,"Do pass and be re-referred to the Committee on [Appropriations]",14,0,0,0,14
1090612,751773,2018-05-09,Assembly,"Do pass. To Consent Calendar",16,0,1,0,17
1090612,754198,2018-05-17,Assembly,"AB 2629 EGGMAN Consent Calendar Second Day Regular Session",73,0,5,0,78
1090612,765058,2018-06-19,Senate,"Do pass, but first be re-referred to the Committee on [Appropriations]",12,1,0,0,13
1090612,770950,2018-08-06,Senate,"Placed on suspense file",7,0,0,0,7
1090612,772086,2018-08-16,Senate,"Do pass as amended",6,0,1,0,7
1090612,773449,2018-08-29,Senate,"Assembly 3rd Reading AB2629 Eggman et al. By Galgiani",35,2,3,0,40
1090612,773930,2018-08-30,Assembly,"AB 2629 EGGMAN Concurrence in Senate Amendments",80,0,0,0,80
1090613,736924,2018-04-10,Senate,"Do pass, but first be re-referred to the Committee on [Appropriations] with the recommendation: To Consent Calendar",7,0,0,0,7
1090613,742617,2018-04-23,Senate,"Placed on suspense file",7,0,0,0,7
1090613,756737,2018-05-25,Senate,"Do pass as amended",7,0,0,0,7
1090613,757519,2018-05-30,Senate,"Senate 3rd Reading SB1198 Wilk et al",37,0,2,0,39
1090613,765537,2018-06-19,Assembly,"Do pass and be re-referred to the Committee on [Appropriations] with recommendation: To Consent Calendar",7,0,0,0,7
1090616,732644,2018-04-02,Assembly,"Do pass and be re-referred to the Committee on [Accountability and Administrative Review] with recommendation: To Consent Calendar",14,0,0,0,14
1090616,744710,2018-04-25,Assembly,"Do pass and be re-referred to the Committee on [Appropriations] with recommendation: To Consent Calendar",7,0,0,0,7
1090616,751124,2018-05-09,Assembly,"Do pass. To Consent Calendar",16,0,1,0,17
1090616,754232,2018-05-17,Assembly,"AB 2734 FRAZIER Consent Calendar Second Day Regular Session",73,0,5,0,78
1090616,762229,2018-06-12,Senate,"Do pass, but first be re-referred to the Committee on [Governmental Organization] with the recommendation: To Consent Calendar",12,0,1,0,13
1090616,768326,2018-06-26,Senate,"Do pass, but first be re-referred to the Committee on [Appropriations] with the recommendation: To Consent Calendar",13,0,0,0,13
1090616,771326,2018-08-13,Senate,"Consent Calendar AB2734",37,0,3,0,40
1090617,751838,2018-05-09,Assembly,"Do pass. To Consent Calendar",7,0,0,0,7
1090617,754210,2018-05-17,Assembly,"AB 2559 TING Consent Calendar Second Day",73,0,5,0,78
1090620,743175,2018-04-23,Assembly,"Do pass as amended and be re-referred to the Committee on [Appropriations]",10,0,0,0,10
1090620,756575,2018-05-25,Assembly,"Do pass as amended",16,0,1,0,17
1090620,757537,2018-05-30,Assembly,"AB 2551 WOOD Assembly Third Reading",76,0,2,0,78
1090620,768272,2018-06-26,Senate,"Do pass as amended, but first amend, and re-refer to the Committee on [Appropriations] with the recommendation: To Consent Calendar",9,0,0,0,9
1090620,770409,2018-08-06,Senate,"Placed on suspense file",7,0,0,0,7
1090620,771900,2018-08-16,Senate,"Do pass as amended",7,0,0,0,7
1090620,773451,2018-08-29,Senate,"Assembly 3rd Reading AB2551 Wood et al. By Cannella",39,0,1,0,40
1090620,773830,2018-08-30,Assembly,"AB 2551 WOOD Concurrence in Senate Amendments",80,0,0,0,80
1090621,737252,2018-04-11,Senate,"Do pass, but first be re-referred to the Committee on [Appropriations]",1,2,2,0,5
1090621,737253,2018-04-11,Senate,"[First] hearing set for [04-11-2018]: Failed passage in Committee. Reconsideration granted",5,0,0,0,5
1090622,740456,2018-04-17,Assembly,"Do pass and be re-referred to the Committee on [Appropriations]",15,0,1,0,16
1090622,747685,2018-05-02,Assembly,"Do pass",16,0,1,0,17
1090622,752054,2018-05-10,Assembly,"AB 2721 QUIRK Assembly Third Reading",67,0,11,0,78
1090622,761604,2018-06-11,Senate,"Do pass, but first be re-referred to the Committee on [Appropriations]",7,0,2,0,9
1090622,772257,2018-08-20,Senate,"Assembly 3rd Reading AB2721 Quirk By Wiener",33,5,2,0,40
1090624,743961,2018-04-25,Senate,"Do pass as amended, but first amend, and re-refer to the Committee on [Rules] with the recommendation: To Consent Calendar",6,0,0,0,6
1090624,752766,2018-05-14,Senate,"Placed on suspense file",7,0,0,0,7
1090624,756244,2018-05-25,Senate,"Do pass as amended",7,0,0,0,7
1090624,757705,2018-05-30,Senate,"Senate 3rd Reading SB1203 Bates",37,0,2,0,39
1090624,768960,2018-06-27,Assembly,"Do pass as amended, and be re-referred to the Committee on [Appropriations] with recommendation: To Consent Calendar",7,0,0,0,7
1090625,736140,2018-04-09,Assembly,"Do pass and be re-referred to the Committee on [Appropriations]",8,2,0,0,10
1090625,740864,2018-04-18,Assembly,"Do pass",10,5,2,0,17
1090625,742310,2018-04-23,Assembly,"AB 2549 STONE Assembly Third Reading",48,25,5,0,78
1090626,739679,2018-04-17,Assembly,"Do pass as amended and be re-referred to the Committee on [Appropriations]",7,0,0,0,7
1090626,756741,2018-05-25,Assembly,"Do pass",16,0,1,0,17
1090626,757734,2018-05-30,Assembly,"AB 2687 QUIRK-SILVA Assembly Third Reading",78,0,0,0,78
1090626,767835,2018-06-25,Senate,"Do pass, but first be re-referred to the Committee on [Appropriations] with the recommendation: To Consent Calendar",9,0,0,0,9
1090626,771263,2018-08-13,Senate,"Consent Calendar AB2687",37,0,3,0,40
1090626,772159,2018-08-20,Assembly,"AB 2687 QUIRK-SILVA Concurrence in Senate Amendments",80,0,0,0,80
1090628,736277,2018-04-10,Senate,"Do pass, but first be re-referred to the Committee on [Appropriations] with the recommendation: To Consent Calendar",7,0,0,0,7
1090628,742389,2018-04-23,Senate,"Do pass",7,0,0,0,7
1090628,744775,2018-04-26,Senate,"Senate 3rd Reading SB1232 Bradford",35,0,4,0,39
1090628,762436,2018-06-12,Assembly,"Do pass and be re-referred to the Committee on [Appropriations] with recommendation: To Consent Calendar",7,0,0,0,7
1090628,769063,2018-06-27,Assembly,"Do pass. To Consent Calendar",16,0,1,0,17
1090628,771906,2018-08-16,Assembly,"SB 1232 Bradford Senate Third Reading By GARCIA, E",78,0,2,0,80
1090628,772285,2018-08-20,Senate,"Unfinished Business SB1232 Bradford Concurrence",39,0,1,0,40
1090630,733243,2018-04-03,Senate,"Do pass as amended, but first amend, and re-refer to the Committee on [Appropriations] with the recommendation: To Consent Calendar",6,0,1,0,7
1090630,742236,2018-04-23,Senate,"Consent Calendar SB1191",38,0,1,0,39
1090630,764943,2018-06-19,Assembly,"Do pass and be re-referred to the Committee on [Public Safety]",6,0,1,0,7
1090630,768197,2018-06-26,Assembly,"Do pass and be re-referred to the Committee on [Appropriations] with recommendation: To Consent Calendar",7,0,0,0,7
1090630,771476,2018-08-15,Assembly,"Do pass. To Consent Calendar",17,0,0,0,17
1090630,773807,2018-08-30,Assembly,"SB 1191 Hueso Senate Third Reading By KALRA",80,0,0,0,80
1090630,774093,2018-08-31,Senate,"Unfinished Business SB1191 Hueso et al. Concurrence",39,0,1,0,40
1090633,744705,2018-04-25,Assembly,"Do pass as amended and be re-referred to the Committee on [Appropriations]",7,0,0,0,7
1090634,744363,2018-04-24,Senate,"Do pass, but first be re-referred to the Committee on [Appropriations] with the recommendation: To Consent Calendar",11,0,2,0,13
1090634,750144,2018-05-07,Senate,"Placed on suspense file",6,0,1,0,7
1090634,756684,2018-05-25,Senate,"Do pass",7,0,0,0,7
1090634,758711,2018-05-31,Senate,"Special Consent SB1189",39,0,0,0,39
1090635,738308,2018-04-11,Assembly,"Do pass. To Consent Calendar",7,0,0,0,7
1090635,742109,2018-04-23,Assembly,"AB 2644 REYES Consent Calendar Second Day Regular Session",75,0,3,0,78
1090635,762217,2018-06-12,Senate,"Do pass, but first be re-referred to the Committee on [Education]",10,0,2,0,12
1090635,768693,2018-06-27,Senate,"Do pass and be ordered to the Consent Calendar",7,0,0,0,7
1090635,769800,2018-07-05,Senate,"Consent Calendar AB2644 Reyes et al",35,0,4,0,39
1090637,736080,2018-04-10,Assembly,"Do pass as amended and be re-referred to the Committee on [Appropriations]",14,0,1,0,15
1090637,756421,2018-05-25,Assembly,"Do pass as amended",13,0,4,0,17
1090637,758784,2018-05-31,Assembly,"AB 2674 AGUIAR-CURRY Assembly Third Reading",74,0,4,0,78
1090637,768794,2018-06-27,Senate,"Do pass, but first be re-referred to the Committee on [Appropriations]",9,0,0,0,9
1090637,770265,2018-08-06,Senate,"Placed on suspense file",7,0,0,0,7
1090637,771799,2018-08-16,Senate,"Do pass as amended",7,0,0,0,7
1090637,772459,2018-08-22,Senate,"Assembly 3rd Reading AB2674 Aguiar-Curry By Stern",39,0,1,0,40
1090637,772941,2018-08-27,Assembly,"AB 2674 AGUIAR-CURRY Concurrence in Senate Amendments",80,0,0,0,80
1090638,744076,2018-04-25,Assembly,"Do pass as amended and be re-referred to the Committee on [Appropriations]",6,1,0,0,7
1090638,756225,2018-05-25,Assembly,"Do pass",12,4,1,0,17
1090638,757883,2018-05-30,Assembly,"AB 2562 MULLIN Assembly Third Reading",54,24,0,0,78
1090638,768191,2018-06-26,Senate,"Do pass, but first be re-referred to the Committee on [Appropriations]",9,3,1,0,13
1090638,770269,2018-08-06,Senate,"Placed on suspense file",7,0,0,0,7
1090638,771825,2018-08-16,Senate,"Do pass as amended",5,2,0,0,7
1090638,772868,2018-08-27,Senate,"Assembly 3rd Reading AB2562 Mullin et al. By Wiener",27,12,1,0,40
1090638,773380,2018-08-29,Assembly,"AB 2562 MULLIN Concurrence in Senate Amendments",57,23,0,0,80
1090639,743772,2018-04-24,Senate,"Do pass as amended, but first amend, and re-refer to the Committee on [Appropriations]",11,0,2,0,13
1090639,754270,2018-05-17,Senate,"Senate 3rd Reading SB1227 Skinner",37,1,1,0,39
1090639,762958,2018-06-13,Assembly,"Do pass and be re-referred to the Committee on [Local Government]",7,0,0,0,7
1090639,766274,2018-06-20,Assembly,"Do pass and be re-referred to the Committee on [Appropriations]",7,0,2,0,9
1090639,768798,2018-06-27,Assembly,"Do pass. To Consent Calendar",16,0,1,0,17
1090639,769760,2018-07-05,Assembly,"SB 1227 Skinner Consent Calendar Second Day Regular Session",69,0,11,0,80
1090639,772849,2018-08-27,Assembly,"SB 1227 Skinner Senate Third Reading By KAMLAGER-DOVE",78,2,0,0,80
1090639,773198,2018-08-28,Senate,"Unfinished Business SB1227 Skinner Concurrence",39,0,1,0,40
1090641,737162,2018-04-10,Senate,"Do pass, but first be re-referred to the Committee on [Appropriations]",7,0,0,0,7
1090641,742131,2018-04-23,Senate,"Placed on suspense file",7,0,0,0,7
1090642,743194,2018-04-24,Assembly,"Do pass and be re-referred to the Committee on [Appropriations]",9,5,1,0,15
1090642,756544,2018-05-25,Assembly,"Do pass as amended",12,4,1,0,17
1090642,758678,2018-05-31,Assembly,"AB 2627 KALRA Assembly Third Reading",42,34,2,0,78
1090642,768270,2018-06-26,Senate,"Do pass as amended, but first amend, and re-refer to the Committee on [Appropriations]",6,2,1,0,9
1090642,771408,2018-08-13,Senate,"Placed on suspense file",7,0,0,0,7
1090643,736241,2018-04-10,Assembly,"Do pass and be re-referred to the Committee on [Appropriations]",7,0,0,0,7
1090645,733864,2018-04-04,Assembly,"Do pass. To Consent Calendar",13,0,0,0,13
1090645,738235,2018-04-12,Assembly,"AB 2587 LEVINE Consent Calendar Second Day Regular Session",68,0,9,0,77
1090645,762771,2018-06-13,Senate,"Do pass and be ordered to the Consent Calendar",5,0,0,0,5
1090645,767973,2018-06-25,Senate,"Consent Calendar AB2587",36,0,3,0,39
1090646,747681,2018-05-02,Senate,"Do pass as amended, but first amend, and re-refer to the Committee on [Appropriations]",7,0,0,0,7
1090646,755323,2018-05-22,Senate,"Placed on suspense file",7,0,0,0,7
1090646,756390,2018-05-25,Senate,"Do pass as amended",7,0,0,0,7
1090646,757499,2018-05-30,Senate,"Senate 3rd Reading SB1214 Portantino",36,0,3,0,39
1090646,769676,2018-07-02,Assembly,"Do pass and be re-referred to the Committee on [Appropriations]",9,0,1,0,10
1090647,743149,2018-04-24,Assembly,"Do pass as amended and be re-referred to the Committee on [Appropriations]",11,1,3,0,15
1090649,738357,2018-04-11,Assembly,"Do pass as amended, and be re-referred to the Committee on [Appropriations] with recommendation: To Consent Calendar",7,0,0,0,7
1090649,756566,2018-05-25,Assembly,"Do pass",16,0,1,0,17
1090649,757803,2018-05-30,Assembly,"AB 2547 MCCARTY Assembly Third Reading",78,0,0,0,78
1090649,766151,2018-06-20,Senate,"Do pass, but first be re-referred to the Committee on [Appropriations] with the recommendation: To Consent Calendar",7,0,0,0,7
1090649,769653,2018-07-02,Senate,"Placed on suspense file",7,0,0,0,7
1090649,771907,2018-08-16,Senate,"Do pass as amended",7,0,0,0,7
1090649,773213,2018-08-28,Senate,"Assembly 3rd Reading AB2547 McCarty By Pan",39,0,1,0,40
1090649,773424,2018-08-29,Assembly,"AB 2547 MCCARTY Concurrence in Senate Amendments",80,0,0,0,80
1090651,736112,2018-04-10,Assembly,"Do pass and be re-referred to the Committee on [Appropriations]",12,1,2,0,15
1090651,756506,2018-05-25,Assembly,"Do pass",13,3,1,0,17
1090651,758807,2018-05-31,Assembly,"AB 2614 CARRILLO Assembly Third Reading",64,13,1,0,78
1090651,768222,2018-06-26,Senate,"Do pass as amended, but first amend, and re-refer to the Committee on [Appropriations]",7,1,1,0,9
1090651,770262,2018-08-06,Senate,"Placed on suspense file",7,0,0,0,7
1090651,771627,2018-08-16,Senate,"Do pass as amended",7,0,0,0,7
1090651,772811,2018-08-27,Senate,"Assembly 3rd Reading AB2614 Carrillo et al. By Hertzberg",34,4,2,0,40
1090651,773511,2018-08-29,Assembly,"AB 2614 CARRILLO Concurrence in Senate Amendments",72,1,7,0,80
1090653,736255,2018-04-10,Senate,"Do pass as amended, but first amend, and re-refer to the Committee on [Appropriations] with the recommendation: To Consent Calendar",13,0,0,0,13
1090653,746023,2018-04-30,Senate,"Consent Calendar SB1259 Nielsen",36,0,3,0,39
1090653,761725,2018-06-11,Assembly,"Do pass and be re-referred to the Committee on [Appropriations] with recommendation: To Consent Calendar",14,0,0,0,14
1090653,768748,2018-06-27,Assembly,"Do pass. To Consent Calendar",16,0,1,0,17
1090653,769762,2018-07-05,Assembly,"SB 1259 Nielsen Consent Calendar Second Day Regular Session",69,0,11,0,80
1090654,725442,2018-03-20,Senate,"Do pass, but first be re-referred to the Committee on [Appropriations]",4,2,1,0,7
1090654,738891,2018-04-16,Senate,"Placed on suspense file",7,0,0,0,7
1090654,756716,2018-05-25,Senate,"Do pass as amended",5,2,0,0,7
1090654,757522,2018-05-30,Senate,"Senate 3rd Reading SB1187 Beall",26,11,2,0,39
1090654,765030,2018-06-19,Assembly,"Do pass and be re-referred to the Committee on [Appropriations]",6,0,1,0,7
1090654,771481,2018-08-15,Assembly,"Do pass",12,5,0,0,17
1090654,773043,2018-08-27,Assembly,"SB 1187 Beall Senate Third Reading By JONES-SAWYER",54,22,4,0,80
1090654,773129,2018-08-28,Senate,"Unfinished Business SB1187 Beall Concurrence",27,12,1,0,40
1090655,737246,2018-04-10,Assembly,"Do pass and be re-referred to the Committee on [Business and Professions]",15,0,0,0,15
1090655,743483,2018-04-24,Assembly,"Do pass as amended and be re-referred to the Committee on [Appropriations]",16,0,0,0,16
1090655,753892,2018-05-16,Assembly,"Do pass. To Consent Calendar",17,0,0,0,17
1090655,756179,2018-05-25,Assembly,"AB 2576 AGUIAR-CURRY Consent Calendar Second Day Regular Session",70,0,8,0,78
1090655,766325,2018-06-20,Senate,"Do pass, but first be re-referred to the Committee on [Business, Professions and Economic Development]",9,0,0,0,9
1090655,767994,2018-06-25,Senate,"Do pass as amended, but first amend, and re-refer to the Committee on [Appropriations]",9,0,0,0,9
1090655,770542,2018-08-06,Senate,"Placed on suspense file",7,0,0,0,7
1090655,772054,2018-08-16,Senate,"Do pass as amended",7,0,0,0,7
1090655,773227,2018-08-28,Senate,"Assembly 3rd Reading AB2576 Aguiar-Curry et al. By Jackson",38,0,2,0,40
1090655,773524,2018-08-29,Assembly,"AB 2576 AGUIAR-CURRY Concurrence in Senate Amendments",77,0,3,0,80
1090657,744792,2018-04-25,Assembly,"Do pass and be re-referred to the Committee on [Appropriations]",5,0,2,0,7
1090657,751334,2018-05-09,Assembly,"Do pass",11,5,1,0,17
1090657,758771,2018-05-31,Assembly,"AB 2570 NAZARIAN Assembly Third Reading",47,25,6,0,78
1090657,767062,2018-06-20,Senate,"Do pass, but first be re-referred to the Committee on [Education]",5,2,0,0,7
1090657,768938,2018-06-27,Senate,"Do pass as amended, but first amend, and re-refer to the Committee on [Appropriations]",5,1,1,0,7
1090657,770375,2018-08-06,Senate,"Placed on suspense file",7,0,0,0,7
1090659,740792,2018-04-18,Assembly,"Do pass and be re-referred to the Committee on [Appropriations] with recommendation: To Consent Calendar",13,0,0,0,13
1090659,747817,2018-05-02,Assembly,"Do pass. To Consent Calendar",17,0,0,0,17
1090659,752094,2018-05-10,Assembly,"AB 2594 FRIEDMAN Consent Calendar Second Day Regular Session",73,0,5,0,78
1090659,769179,2018-06-27,Senate,"Do pass as amended, but first amend, and re-refer to the Committee on [Appropriations]",12,0,1,0,13
1090659,771281,2018-08-13,Senate,"Assembly 3rd Reading AB2594 Friedman By Gaines Urgency Clause",37,0,3,0,40
1090659,772157,2018-08-20,Assembly,"AB 2594 FRIEDMAN Concurrence - Urgency Added",80,0,0,0,80
1090660,736682,2018-04-10,Senate,"Do pass as amended, but first amend, and re-refer to the Committee on [Appropriations] with the recommendation: To Consent Calendar",7,0,0,0,7
1090660,748869,2018-05-03,Senate,"Consent Calendar SB1199",38,0,1,0,39
1090660,762103,2018-06-12,Assembly,"Do pass and be re-referred to the Committee on [Appropriations]",7,0,0,0,7
1090660,769148,2018-06-27,Assembly,"Do pass. To Consent Calendar",16,0,1,0,17
1090660,769806,2018-07-05,Assembly,"SB 1199 Wilk Consent Calendar Second Day Regular Session",69,0,11,0,80
1090660,771175,2018-08-09,Senate,"Unfinished Business SB1199 Wilk et al. Concurrence",37,0,2,0,39
1090662,747833,2018-05-01,Senate,"Do pass as amended, but first amend, and re-refer to the Committee on [Appropriations]",5,1,1,0,7
1090662,752775,2018-05-14,Senate,"Placed on suspense file",7,0,0,0,7
1090662,756713,2018-05-25,Senate,"Do pass as amended",5,2,0,0,7
1090662,757863,2018-05-30,Senate,"Senate 3rd Reading SB1194 Lara",25,12,2,0,39
1090662,765118,2018-06-19,Assembly,"Do pass as amended and be re-referred to the Committee on [Privacy and Consumer Protection]",8,1,1,0,10
1090662,769740,2018-07-03,Assembly,"Do pass as amended",7,2,1,0,10
1090662,773181,2018-08-28,Assembly,"SB 1194 Lara Senate Third Reading By STONE",56,24,0,0,80
1090662,773529,2018-08-29,Senate,"Unfinished Business SB1194 Lara Concurrence",27,12,1,0,40
1090663,743111,2018-04-24,Assembly,"Do pass and be re-referred to the Committee on [Appropriations]",11,4,1,0,16
1090663,756682,2018-05-25,Assembly,"Do pass",12,3,2,0,17
1090663,758736,2018-05-31,Assembly,"AB 2608 STONE Assembly Third Reading",54,24,0,0,78
1090663,764941,2018-06-18,Senate,"Do pass as amended, but first amend, and re-refer to the Committee on [Health]",6,0,3,0,9
1090663,768733,2018-06-27,Senate,"Do pass, but first be re-referred to the Committee on [Appropriations]",6,2,1,0,9
1090663,772418,2018-08-21,Senate,"Assembly 3rd Reading AB2608 Mark Stone et al. By Beall",32,4,4,0,40
1090663,772822,2018-08-27,Assembly,"AB 2608 STONE Concurrence in Senate Amendments",61,13,6,0,80
1090666,737331,2018-04-11,Senate,"Do pass as amended, but first amend, and re-refer to the Committee on [Appropriations]",5,0,0,0,5
1090666,748847,2018-05-03,Senate,"Senate 3rd Reading SB1252 Pan",35,0,4,0,39
1090666,767084,2018-06-20,Assembly,"Do pass and be re-referred to the Committee on [Appropriations]",5,0,2,0,7
1090666,771087,2018-08-08,Assembly,"Do pass",15,0,2,0,17
1090666,772493,2018-08-23,Assembly,"SB 1252 Pan Senate Third Reading By THURMOND",74,0,6,0,80
1090667,743315,2018-04-24,Senate,"Do pass as amended, but first amend, and re-refer to the Committee on [Appropriations]",5,1,1,0,7
1090667,752925,2018-05-14,Senate,"Placed on suspense file",7,0,0,0,7
1090667,756192,2018-05-25,Senate,"Do pass as amended",5,1,1,0,7
1090667,757525,2018-05-30,Senate,"Senate 3rd Reading SB1266 Portantino",29,3,7,0,39
1090668,740840,2018-04-18,Assembly,"Do pass and be re-referred to the Committee on [Local Government]",12,3,6,0,21
1090668,744939,2018-04-25,Assembly,"Do pass and be re-referred to the Committee on [Appropriations]",6,2,1,0,9
1090668,756510,2018-05-25,Assembly,"Do pass as amended",12,4,1,0,17
1090668,758675,2018-05-31,Assembly,"AB 2681 NAZARIAN Assembly Third Reading",51,26,1,0,78
1090668,765112,2018-06-19,Senate,"Do pass as amended, but first amend, and re-refer to the Committee on [Governmental Organization]",10,3,0,0,13
1090668,766187,2018-06-19,Senate,"Do pass, but first be re-referred to the Committee on [Governmental Organization]",10,3,0,0,13
1090668,768247,2018-06-26,Senate,"Do pass as amended, but first amend, and re-refer to the Committee on [Appropriations]",10,2,1,0,13
1090668,770309,2018-08-06,Senate,"Placed on suspense file",7,0,0,0,7
1090668,771839,2018-08-16,Senate,"Do pass as amended",5,2,0,0,7
1090668,772435,2018-08-22,Senate,"Assembly 3rd Reading AB2681 Nazarian et al. By Beall",28,10,2,0,40
1090668,772961,2018-08-27,Assembly,"AB 2681 NAZARIAN Concurrence in Senate Amendments",55,23,2,0,80
1090671,740472,2018-04-16,Assembly,"Do pass as amended and be re-referred to the Committee on [Appropriations]",5,4,1,0,10
1090672,743836,2018-04-25,Assembly,"Do pass and be re-referred to the Committee on [Appropriations]",5,1,1,0,7
1090672,755720,2018-05-23,Assembly,"Do pass",9,4,4,0,17
1090672,757185,2018-05-29,Assembly,"AB 2729 MURATSUCHI Assembly Third Reading",50,25,3,0,78
1090672,768349,2018-06-26,Senate,"Do pass, but first be re-referred to the Committee on [Appropriations]",10,2,1,0,13
1090674,740899,2018-04-18,Senate,"Do pass, but first be re-referred to the Committee on [Insurance]",9,0,0,0,9
1090674,744763,2018-04-25,Senate,"Do pass as amended, but first amend, and re-refer to the Committee on [Appropriations] with the recommendation: To Consent Calendar",11,0,2,0,13
1090674,757053,2018-05-29,Senate,"Senate 3rd Reading SB1248 Gaines et al",38,0,1,0,39
1090674,765054,2018-06-19,Assembly,"Do pass and be re-referred to the Committee on [Insurance]",6,0,1,0,7
1090674,769270,2018-06-28,Assembly,"Do pass and be re-referred to the Committee on [Appropriations]",8,0,5,0,13
1090674,771507,2018-08-15,Assembly,"Do pass. To Consent Calendar",17,0,0,0,17
1090674,772511,2018-08-23,Assembly,"SB 1248 Gaines Consent Calendar Second Day Regular Session",75,0,5,0,80
1090674,772662,2018-08-24,Senate,"Unfinished Business SB1248 Gaines et al. Concurrence",39,0,1,0,40
1090675,740690,2018-04-18,Senate,"Do pass, but first be re-referred to the Committee on [Governance and Finance]",6,1,0,0,7
1090675,743909,2018-04-25,Senate,"Do pass as amended, but first amend, and re-refer to the Committee on [Appropriations]",5,0,2,0,7
1090675,753088,2018-05-14,Senate,"Placed on suspense file",7,0,0,0,7
1090675,756618,2018-05-25,Senate,"Do pass",5,2,0,0,7
1090675,757153,2018-05-29,Senate,"Senate 3rd Reading SB1215 Hertzberg",30,8,1,0,39
1090675,768400,2018-06-26,Assembly,"Do pass and be re-referred to the Committee on [Local Government]",6,0,1,0,7
1090675,768789,2018-06-27,Assembly,"Do pass as amended and be re-referred to the Committee on [Appropriations]",8,1,0,0,9
1090675,771520,2018-08-16,Assembly,"Do pass as amended",13,0,4,0,17
1090675,773840,2018-08-30,Assembly,"SB 1215 Hertzberg Senate Third Reading By FRIEDMAN",54,23,3,0,80
1090675,774139,2018-08-31,Senate,"Unfinished Business SB1215 Hertzberg Concurrence",29,10,1,0,40
1090676,738227,2018-04-11,Assembly,"Do pass and be re-referred to the Committee on [Appropriations]",7,0,0,0,7
1090676,756315,2018-05-25,Assembly,"Do pass",15,0,2,0,17
1090676,757744,2018-05-30,Assembly,"AB 2635 WEBER Assembly Third Reading",76,0,2,0,78
1090678,733430,2018-04-02,Assembly,"Do pass as amended and be re-referred to the Committee on [Appropriations]",8,0,2,0,10
1090678,756496,2018-05-25,Assembly,"Do pass",16,0,1,0,17
1090678,757551,2018-05-30,Assembly,"AB 2663 FRIEDMAN Assembly Third Reading",77,0,1,0,78
1090678,771074,2018-08-08,Senate,"Do pass, but first be re-referred to the Committee on [Appropriations]",7,0,0,0,7
1090678,771367,2018-08-13,Senate,"Placed on suspense file",7,0,0,0,7
1090678,771769,2018-08-16,Senate,"Do pass as amended",7,0,0,0,7
1090678,772375,2018-08-21,Senate,"Assembly 3rd Reading AB2663 Friedman et al. By Wilk",38,0,2,0,40
1090678,772988,2018-08-27,Assembly,"AB 2663 FRIEDMAN Concurrence in Senate Amendments",79,0,1,0,80
1090679,746933,2018-05-01,Senate,"Do pass as amended, but first amend, and re-refer to the Committee on [Governance and Finance]",13,0,0,0,13
1090679,751331,2018-05-09,Senate,"Do pass, but first be re-referred to the Committee on [Appropriations]",6,0,1,0,7
1090679,755292,2018-05-22,Senate,"Placed on suspense file",7,0,0,0,7
1090680,736165,2018-04-10,Assembly,"Do pass as amended and be re-referred to the Committee on [Appropriations]",7,0,0,0,7
1090680,744007,2018-04-25,Assembly,"Do pass. To Consent Calendar",17,0,0,0,17
1090680,748960,2018-05-03,Assembly,"AB 2620 TING Consent Calendar Second Day Regular Session",71,0,7,0,78
1090680,769128,2018-06-26,Senate,"Do pass as amended",7,0,0,0,7
1090680,771438,2018-08-13,Senate,"Special Consent AB2620",37,0,3,0,40
1090680,772522,2018-08-23,Assembly,"Do pass",10,0,0,0,10
1090680,772672,2018-08-23,Assembly,"With recommendation: That Senate amendments be concurred in",10,0,0,0,10
1090680,772907,2018-08-27,Assembly,"AB 2620 TING Concurrence in Senate Amendments",80,0,0,0,80
1090682,751074,2018-05-08,Assembly,"Do pass",1,1,8,0,10
1090683,740017,2018-04-17,Assembly,"Do pass as amended and be re-referred to the Committee on [Appropriations]",7,3,0,0,10
1090686,739817,2018-04-17,Assembly,"Do pass and be re-referred to the Committee on [Appropriations] with recommendation: To Consent Calendar",7,0,0,0,7
1090686,756488,2018-05-25,Assembly,"Do pass as amended",16,0,1,0,17
1090686,757526,2018-05-30,Assembly,"AB 2568 REYES Assembly Third Reading",76,0,2,0,78
1090686,764947,2018-06-19,Senate,"Do pass, but first be re-referred to the Committee on [Appropriations] with the recommendation: To Consent Calendar",7,0,0,0,7
1090686,770277,2018-08-06,Senate,"Placed on suspense file",7,0,0,0,7
1090686,771694,2018-08-16,Senate,"Do pass",7,0,0,0,7
1090686,772145,2018-08-20,Senate,"Assembly 3rd Reading AB2568 Reyes et al. By Roth",39,0,1,0,40
1090687,742132,2018-04-23,Assembly,"Do pass",11,1,2,0,14
1090687,746120,2018-04-30,Assembly,"AB 2548 FRIEDMAN Assembly Third Reading",55,18,5,0,78
1090687,762255,2018-06-12,Senate,"Do pass, but first be re-referred to the Committee on [Environmental Quality]",9,2,2,0,13
1090687,767127,2018-06-20,Senate,"Do pass as amended",5,2,0,0,7
1090687,769810,2018-07-05,Senate,"Assembly 3rd Reading AB2548 Friedman By Allen",25,10,4,0,39
1090687,770803,2018-08-06,Assembly,"AB 2548 FRIEDMAN Concurrence in Senate Amendments",54,16,10,0,80
1090688,733197,2018-04-03,Assembly,"Do pass as amended, and be re-referred to the Committee on [Appropriations] with recommendation: To Consent Calendar",10,0,0,0,10
1090688,756554,2018-05-25,Assembly,"Do pass",16,0,1,0,17
1090688,757821,2018-05-30,Assembly,"AB 2676 GIPSON Assembly Third Reading",76,1,1,0,78
1090688,768061,2018-06-25,Senate,"Do pass, but first be re-referred to the Committee on [Appropriations]",9,0,0,0,9
1090688,770503,2018-08-06,Senate,"Do pass",7,0,0,0,7
1090688,771283,2018-08-13,Senate,"Assembly 3rd Reading AB2676 Gipson By Galgiani",36,0,4,0,40
1090692,751217,2018-05-09,Senate,"Do pass as amended, but first amend, and re-refer to the Committee on [Appropriations]",6,0,1,0,7
1090692,757157,2018-05-29,Senate,"Senate 3rd Reading SB1246 Gaines",38,0,1,0,39
1090692,769725,2018-07-02,Assembly,"Do pass",9,0,1,0,10
1090692,771952,2018-08-16,Assembly,"SB 1246 Gaines Senate Third Reading By KILEY",77,0,3,0,80
1090692,772289,2018-08-20,Senate,"Unfinished Business SB1246 Gaines Concurrence",39,0,1,0,40
1090694,743202,2018-04-24,Assembly,"Do pass and be re-referred to the Committee on [Appropriations]",11,2,2,0,15
1090694,751827,2018-05-09,Assembly,"Do pass",11,5,1,0,17
1090694,752801,2018-05-14,Assembly,"AB 2640 WOOD Assembly Third Reading",56,20,2,0,78
1090694,762316,2018-06-12,Senate,"Do pass as amended, but first amend, and re-refer to the Committee on [Appropriations]",7,1,1,0,9
1090694,773500,2018-08-29,Senate,"Assembly 3rd Reading AB2640 Wood By McGuire",27,11,2,0,40
1090694,773941,2018-08-30,Assembly,"AB 2640 WOOD Concurrence in Senate Amendments",60,19,1,0,80
1090695,737383,2018-04-11,Assembly,"Do pass and be re-referred to the Committee on [Appropriations]",9,0,0,0,9
1090695,756763,2018-05-25,Assembly,"Do pass",16,0,1,0,17
1090695,757851,2018-05-30,Assembly,"AB 2578 CHIU Assembly Third Reading",78,0,0,0,78
1090695,766297,2018-06-20,Senate,"Do pass, but first be re-referred to the Committee on [Appropriations]",6,1,0,0,7
1090695,770863,2018-08-06,Senate,"Placed on suspense file",7,0,0,0,7
1090696,746834,2018-05-01,Senate,"Do pass",4,0,1,0,5
1090696,754359,2018-05-17,Senate,"Senate 3rd Reading SB1250 Bradford et al",31,2,6,0,39
1090696,769044,2018-06-27,Assembly,"Do pass",6,1,0,0,7
1090696,773849,2018-08-30,Assembly,"SB 1250 Bradford Senate Third Reading By BURKE",66,7,7,0,80
1090699,739841,2018-04-17,Assembly,"Do pass. To Consent Calendar",7,0,0,0,7
1090699,742271,2018-04-23,Assembly,"AB 2589 BIGELOW Consent Calendar Second Day Regular Session",75,0,3,0,78
1090699,762246,2018-06-12,Senate,"Do pass and be ordered to the Consent Calendar",7,0,0,0,7
1090699,767974,2018-06-25,Senate,"Consent Calendar AB2589 Bigelow",36,0,3,0,39
1090700,725493,2018-03-20,Assembly,"Do pass as amended and be re-referred to the Committee on [Appropriations]",7,0,0,0,7
1090700,733944,2018-04-04,Assembly,"Do pass",15,0,2,0,17
1090700,738248,2018-04-12,Assembly,"AB 2550 WEBER Assembly Third Reading",70,0,7,0,77
1090700,753368,2018-05-15,Senate,"Do pass, but first be re-referred to the Committee on [Appropriations] with the recommendation: To Consent Calendar",7,0,0,0,7
1090700,769562,2018-07-02,Senate,"Consent Calendar AB2550",37,0,2,0,39
1090700,770578,2018-08-06,Assembly,"AB 2550 WEBER Concurrence in Senate Amendments",77,0,3,0,80
1090702,736474,2018-04-10,Assembly,"Do pass as amended and be re-referred to the Committee on [Judiciary]",4,2,1,0,7
1090703,751830,2018-05-09,Assembly,"Do pass. To Consent Calendar",7,0,0,0,7
1090703,754205,2018-05-17,Assembly,"AB 2665 SALAS Consent Calendar Second Day Regular Session",73,0,5,0,78
1090703,769726,2018-07-03,Senate,"Do pass",4,0,1,0,5
1090703,771435,2018-08-13,Senate,"Special Consent AB2665",37,0,3,0,40
1090704,739866,2018-04-17,Senate,"Do pass, but first be re-referred to the Committee on [Appropriations]",7,0,0,0,7
1090704,746543,2018-04-30,Senate,"Placed on suspense file",6,0,1,0,7
1090706,754944,2018-05-21,Assembly,"Do pass and be re-referred to the Committee on [Appropriations]",9,0,2,0,11
1090706,755708,2018-05-23,Assembly,"Do pass. To Consent Calendar",16,0,1,0,17
1090706,757120,2018-05-29,Assembly,"AB 2667 COOLEY Consent Calendar Second Day Regular Session",78,0,0,0,78
1090706,768354,2018-06-26,Senate,"Do pass, but first be re-referred to the Committee on [Appropriations] with the recommendation: To Consent Calendar",13,0,0,0,13
1090706,770918,2018-08-06,Senate,"Placed on suspense file",7,0,0,0,7
1090706,772050,2018-08-16,Senate,"Do pass",7,0,0,0,7
1090706,772717,2018-08-24,Senate,"Special Consent AB2667",39,0,1,0,40
1090707,740677,2018-04-17,Senate,"Do pass, but first be re-referred to the Committee on [Judiciary]",8,2,3,0,13
1090707,751875,2018-05-08,Senate,"Do pass as amended",4,2,1,0,7
1090707,757574,2018-05-30,Senate,"Senate 3rd Reading SB1265 Wieckowski",25,12,2,0,39
1090707,766180,2018-06-20,Assembly,"Do pass as amended and be re-referred to the Committee on [Judiciary]",5,2,0,0,7
1090707,769698,2018-07-03,Assembly,"Do pass as amended",7,3,0,0,10
1090707,773101,2018-08-28,Assembly,"SB 1265 Wieckowski Senate Third Reading By KALRA",46,27,7,0,80
1090707,773650,2018-08-29,Senate,"Unfinished Business SB1265 Wieckowski Concurrence",27,11,2,0,40
1090710,748833,2018-05-02,Assembly,"Do pass. To Consent Calendar",13,0,0,0,13
1090710,752069,2018-05-10,Assembly,"AB 2634 CHAU Consent Calendar Second Day Regular Session",73,0,5,0,78
1090710,769206,2018-06-27,Senate,"Do pass as amended",12,0,1,0,13
1090710,772914,2018-08-27,Senate,"Assembly 3rd Reading AB2634 Chau By Glazer",39,0,1,0,40
1090710,773320,2018-08-29,Assembly,"AB 2634 CHAU Concurrence in Senate Amendments",79,0,1,0,80
1090711,743905,2018-04-25,Senate,"Do pass as amended, but first amend, and re-refer to the Committee on [Appropriations]",6,0,1,0,7
1090711,753152,2018-05-14,Senate,"Placed on suspense file",7,0,0,0,7
1090712,751403,2018-05-09,Senate,"Do pass as amended, but first amend, and re-refer to the Committee on [Appropriations]",5,0,2,0,7
1090712,755358,2018-05-22,Senate,"Placed on suspense file",7,0,0,0,7
1090788,744148,2018-04-25,Assembly,"Do pass and be re-referred to the Committee on [Appropriations] with recommendation: To Consent Calendar",7,0,0,0,7
1090788,756611,2018-05-25,Assembly,"Do pass",16,0,1,0,17
1090788,757822,2018-05-30,Assembly,"AB 2707 MULLIN Assembly Third Reading",78,0,0,0,78
1090788,764880,2018-06-19,Senate,"Do pass as amended, but first amend, and re-refer to the Committee on [Appropriations]",5,0,0,0,5
1090788,770939,2018-08-06,Senate,"Placed on suspense file",7,0,0,0,7
1090788,771914,2018-08-16,Senate,"Do pass as amended",7,0,0,0,7
1090788,772952,2018-08-27,Senate,"Assembly 3rd Reading AB2707 Mullin By Stern",39,0,1,0,40
1090788,774239,2018-08-31,Assembly,"AB 2707 MULLIN Concurrence in Senate Amendments",79,0,1,0,80
1090791,736164,2018-04-10,Assembly,"Do pass and be re-referred to the Committee on [Appropriations] with recommendation: To Consent Calendar",7,0,0,0,7
1090791,756681,2018-05-25,Assembly,"Do pass as amended",16,0,1,0,17
1090802,743852,2018-04-24,Assembly,"Do pass and be re-referred to the Committee on [Appropriations]",9,0,1,0,10
1090805,744011,2018-04-25,Assembly,"Do pass as amended and be re-referred to the Committee on [Appropriations]",15,0,0,0,15
1090805,756553,2018-05-25,Assembly,"Do pass as amended",12,0,5,0,17
1090805,758847,2018-05-31,Assembly,"AB 2693 QUIRK Assembly Third Reading",48,24,6,0,78
1090805,768964,2018-06-27,Senate,"Do pass as amended, but first amend, and re-refer to the Committee on [Appropriations]",8,2,1,0,11
1090805,770807,2018-08-06,Senate,"Placed on suspense file",7,0,0,0,7
1090809,750718,2018-05-07,Assembly,"Do pass as amended and be re-referred to the Committee on [Appropriations]",8,1,1,0,10
1090812,724623,2018-03-19,Assembly,"Be adopted as amended",8,0,3,0,11
1090812,742362,2018-04-23,Senate,"Special Consent ACR175",38,0,1,0,39
1090816,740771,2018-04-18,Assembly,"Do pass and be re-referred to the Committee on [Appropriations]",5,2,2,0,9
1090828,743069,2018-04-24,Assembly,"Do pass and be re-referred to the Committee on [Appropriations]",14,1,0,0,15
1090828,756272,2018-05-25,Assembly,"Do pass as amended",16,0,1,0,17
1090828,758825,2018-05-31,Assembly,"AB 2697 GALLAGHER Assembly Third Reading",77,0,1,0,78
1090828,768185,2018-06-26,Senate,"Do pass, but first be re-referred to the Committee on [Appropriations]",9,0,0,0,9
1090828,771345,2018-08-13,Senate,"Placed on suspense file",7,0,0,0,7
1090828,771728,2018-08-16,Senate,"Do pass",7,0,0,0,7
1090828,772870,2018-08-27,Senate,"Assembly 3rd Reading AB2697 Gallagher By Galgiani",39,0,1,0,40
1090828,773534,2018-08-29,Assembly,"AB 2697 GALLAGHER Concurrence in Senate Amendments",79,0,1,0,80
1090828,774967,2018-08-27,Senate,,7,0,1,0,8
1090832,742944,2018-04-24,Assembly,"Do pass as amended and be re-referred to the Committee on [Appropriations]",10,0,0,0,10
1090832,751129,2018-05-09,Assembly,"Do pass. To Consent Calendar",16,0,1,0,17
1090832,754291,2018-05-17,Assembly,"AB 2694 RUBIO Consent Calendar Second Day Regular Session",73,0,5,0,78
1090832,762979,2018-06-12,Senate,"Do pass as amended, but first amend, and re-refer to the Committee on [Appropriations] with the recommendation: To Consent Calendar",7,0,0,0,7
1090832,770931,2018-08-06,Senate,"Consent Calendar AB2694 Rubio",37,0,2,0,39
1090832,771200,2018-08-09,Assembly,"AB 2694 RUBIO Concurrence in Senate Amendments",77,0,3,0,80
1090835,740765,2018-04-18,Assembly,"Do pass and be re-referred to the Committee on [Judiciary]",5,1,1,0,7
1090835,742929,2018-04-24,Assembly,"Do pass as amended and be re-referred to the Committee on [Appropriations]",8,0,2,0,10
1090835,756480,2018-05-25,Assembly,"Do pass",14,0,3,0,17
1090835,757560,2018-05-30,Assembly,"AB 2713 RODRIGUEZ Assembly Third Reading",72,0,6,0,78
1090835,761670,2018-06-11,Senate,"Do pass, but first be re-referred to the Committee on [Judiciary]",5,0,0,0,5
1090835,769111,2018-06-26,Senate,"Do pass, but first be re-referred to the Committee on [Appropriations]",7,0,0,0,7
1090835,770942,2018-08-06,Senate,"Placed on suspense file",7,0,0,0,7
1090835,772074,2018-08-16,Senate,"Do pass",7,0,0,0,7
1090835,772357,2018-08-21,Senate,"Assembly 3rd Reading AB2713 Rodriguez By Leyva",39,0,1,0,40
1090839,744685,2018-04-24,Assembly,"Do pass as amended, and be re-referred to the Committee on [Appropriations] with recommendation: To Consent Calendar",7,0,0,0,7
1090842,736376,2018-04-10,Assembly,"Do pass as amended",7,0,0,0,7
1090842,742126,2018-04-23,Assembly,"AB 2710 OBERNOLTE Assembly Third Reading",74,0,4,0,78
1090842,768439,2018-06-26,Senate,"Do pass",7,0,0,0,7
1090842,769758,2018-07-05,Senate,"Assembly 3rd Reading AB2710 Obernolte By Jackson",35,0,4,0,39
1090842,770865,2018-08-06,Assembly,"AB 2710 OBERNOLTE Concurrence in Senate Amendments",77,0,3,0,80
1090847,738387,2018-04-11,Assembly,"Do pass as amended and be re-referred to the Committee on [Health]",7,0,0,0,7
1090847,743210,2018-04-24,Assembly,"Do pass and be re-referred to the Committee on [Appropriations]",15,0,0,0,15
1090847,756471,2018-05-25,Assembly,"Do pass",16,0,1,0,17
1090847,757781,2018-05-30,Assembly,"AB 2691 JONES-SAWYER Assembly Third Reading",76,0,2,0,78
1090847,766284,2018-06-20,Senate,"Do pass, but first be re-referred to the Committee on [Appropriations] with the recommendation: To Consent Calendar",7,0,0,0,7
1090847,769651,2018-07-02,Senate,"Placed on suspense file",7,0,0,0,7
1090847,771927,2018-08-16,Senate,"Do pass as amended",7,0,0,0,7
1090847,772625,2018-08-23,Senate,"Assembly 3rd Reading AB2691 Jones-Sawyer By Beall",38,0,2,0,40
1090847,772900,2018-08-27,Assembly,"AB 2691 JONES-SAWYER Concurrence in Senate Amendments",80,0,0,0,80
1090857,734451,2018-04-05,Assembly,"Be re-referred to the Committee on [Revenue and Taxation]",8,0,3,0,11
1090857,753306,2018-05-14,Assembly,"Do pass as amended and be re-referred to the Committee on [Appropriations]",8,1,1,0,10
1090861,738276,2018-04-11,Assembly,"Do pass and be re-referred to the Committee on [Appropriations]",6,0,1,0,7
1090861,756623,2018-05-25,Assembly,"Do pass",16,0,1,0,17
1090861,758685,2018-05-31,Assembly,"AB 2704 O'DONNELL Assembly Third Reading",78,0,0,0,78
1090861,766276,2018-06-20,Senate,"Do pass, but first be re-referred to the Committee on [Appropriations] with the recommendation: To Consent Calendar",7,0,0,0,7
1090861,769575,2018-07-02,Senate,"Placed on suspense file",7,0,0,0,7
1090866,733309,2018-04-03,Assembly,"Do pass and be re-referred to the Committee on [Appropriations]",5,1,1,0,7
1090869,739862,2018-04-17,Assembly,"Do pass and be re-referred to the Committee on [Appropriations]",16,0,0,0,16
1090869,751098,2018-05-09,Assembly,"Do pass. To Consent Calendar",16,0,1,0,17
1090869,754351,2018-05-17,Assembly,"AB 2717 LACKEY Consent Calendar Second Day Regular Session",73,0,5,0,78
1090869,768179,2018-06-26,Senate,"Do pass",7,0,0,0,7
1090869,769782,2018-07-05,Senate,"Assembly 3rd Reading AB2717 Lackey By Hill",35,0,4,0,39
1090869,770551,2018-08-06,Assembly,"AB 2717 LACKEY Concurrence in Senate Amendments",77,0,3,0,80
1090873,733879,2018-04-04,Assembly,"Do pass and be re-referred to the Committee on [Appropriations]",5,0,2,0,7
1090873,741195,2018-04-18,Assembly,"Do pass",15,0,2,0,17
1090873,742197,2018-04-23,Assembly,"AB 2696 RODRIGUEZ Assembly Third Reading",71,0,7,0,78
1090873,768003,2018-06-25,Senate,"Do pass, but first be re-referred to the Committee on [Appropriations]",3,2,0,0,5
1090873,772411,2018-08-21,Senate,"Assembly 3rd Reading AB2696 Rodriguez By Pan",28,10,2,0,40
1090873,773313,2018-08-29,Assembly,"With recommendation: That Senate amendments be concurred in",5,0,2,0,7
1090873,773704,2018-08-30,Assembly,"AB 2696 RODRIGUEZ Concurrence in Senate Amendments",63,16,1,0,80
1090883,737364,2018-04-10,Assembly,"Do pass and be re-referred to the Committee on [Education]",7,0,0,0,7
1090883,744967,2018-04-25,Assembly,"Do pass as amended and be re-referred to the Committee on [Appropriations]",7,0,0,0,7
1090883,755848,2018-05-23,Assembly,"Do pass",16,0,1,0,17
1090883,757208,2018-05-29,Assembly,"AB 2698 RUBIO Assembly Third Reading",78,0,0,0,78
1090883,763057,2018-06-13,Senate,"Do pass, but first be re-referred to the Committee on [Human Services]",7,0,0,0,7
1090883,768987,2018-06-26,Senate,"Do pass, but first be re-referred to the Committee on [Appropriations]",6,0,1,0,7
1090883,770936,2018-08-06,Senate,"Placed on suspense file",7,0,0,0,7
1090883,771931,2018-08-16,Senate,"Do pass",7,0,0,0,7
1090883,773596,2018-08-29,Senate,"Assembly 3rd Reading AB2698 Rubio et al. By Leyva",39,0,1,0,40
1090883,773707,2018-08-30,Assembly,"AB 2698 RUBIO Concurrence in Senate Amendments",80,0,0,0,80
1090887,733209,2018-04-03,Assembly,"Do pass and be re-referred to the Committee on [Appropriations]",16,0,0,0,16
1090887,737436,2018-04-11,Assembly,"Do pass. To Consent Calendar",15,0,2,0,17
1090887,741467,2018-04-19,Assembly,"AB 2705 HOLDEN Consent Calendar Second Day Regular Session",71,0,7,0,78
1090887,762089,2018-06-11,Senate,"Do pass, but first be re-referred to the Committee on [Appropriations]",8,0,1,0,9
1090887,771284,2018-08-13,Senate,"Assembly 3rd Reading AB2705 Holden By Hill",37,0,3,0,40
1090887,772275,2018-08-20,Assembly,"AB 2705 HOLDEN Concurrence in Senate Amendments",80,0,0,0,80
1090894,739149,2018-04-16,Assembly,"Do pass and be re-referred to the Committee on [Appropriations]",4,9,1,0,14
1090894,739150,2018-04-16,Assembly,Reconsideration,14,0,0,0,14
1090901,742930,2018-04-24,Assembly,"Do pass and be re-referred to the Committee on [Appropriations]",8,0,2,0,10
1092011,739800,2018-04-17,Assembly,"Do pass and be re-referred to the Committee on [Judiciary]",10,3,0,0,13
1092011,743052,2018-04-24,Assembly,"Do pass as amended and be re-referred to the Committee on [Appropriations]",9,0,1,0,10
1092011,756604,2018-05-25,Assembly,"Do pass as amended",15,1,1,0,17
1092011,758622,2018-05-31,Assembly,"AB 2747 HOLDEN Assembly Third Reading",71,0,7,0,78
1092011,766162,2018-06-20,Senate,"Do pass, but first be re-referred to the Committee on [Judiciary]",6,1,0,0,7
1092011,769007,2018-06-26,Senate,"Do pass as amended, but first amend, and re-refer to the Committee on [Appropriations]",6,1,0,0,7
1092011,770276,2018-08-06,Senate,"Placed on suspense file",7,0,0,0,7
1092015,741113,2018-04-17,Assembly,"Do pass and be re-referred to the Committee on [Elections and Redistricting]",10,0,0,0,10
1092015,743990,2018-04-25,Assembly,"Do pass as amended and be re-referred to the Committee on [Appropriations]",7,0,0,0,7
1092015,756757,2018-05-25,Assembly,"Do pass as amended",16,0,1,0,17
1092015,758805,2018-05-31,Assembly,"AB 2748 CHAU Assembly Third Reading",78,0,0,0,78
1092015,765090,2018-06-19,Senate,"Do pass, but first be re-referred to the Committee on [Governmental Organization]",5,0,0,0,5
1092015,768187,2018-06-26,Senate,"Do pass, but first be re-referred to the Committee on [Appropriations]",13,0,0,0,13
1092015,770512,2018-08-06,Senate,"Placed on suspense file",7,0,0,0,7
1092015,772011,2018-08-16,Senate,"Do pass",7,0,0,0,7
1092021,727687,2018-03-21,Assembly,"Do pass as amended and be re-referred to the Committee on [Appropriations]",5,1,1,0,7
1092021,756191,2018-05-25,Assembly,"Do pass",12,3,2,0,17
1092021,757709,2018-05-30,Assembly,"AB 2772 MEDINA Assembly Third Reading",54,19,5,0,78
1092021,768861,2018-06-27,Senate,"Do pass, but first be re-referred to the Committee on [Appropriations]",5,0,2,0,7
1092021,770348,2018-08-06,Senate,"Placed on suspense file",7,0,0,0,7
1092021,771763,2018-08-16,Senate,"Do pass as amended",5,2,0,0,7
1092021,773440,2018-08-29,Senate,"Assembly 3rd Reading AB2772 Medina et al. By Mitchell",31,6,3,0,40
1092021,773737,2018-08-30,Assembly,"AB 2772 MEDINA Concurrence in Senate Amendments",63,12,5,0,80
1092032,740746,2018-04-17,Assembly,"Do pass and be re-referred to the Committee on [Accountability and Administrative Review] with recommendation: To Consent Calendar",10,0,0,0,10
1092032,744025,2018-04-25,Assembly,"Do pass and be re-referred to the Committee on [Appropriations]",7,0,0,0,7
1092032,756686,2018-05-25,Assembly,"Do pass as amended",16,0,1,0,17
1092032,758797,2018-05-31,Assembly,"AB 2749 BONTA Assembly Third Reading",78,0,0,0,78
1092032,768661,2018-06-26,Senate,"Do pass, but first be re-referred to the Committee on [Appropriations] with the recommendation: To Consent Calendar",13,0,0,0,13
1092032,770914,2018-08-06,Senate,"Placed on suspense file",7,0,0,0,7
1092032,772092,2018-08-16,Senate,"Do pass as amended",7,0,0,0,7
1092032,773258,2018-08-28,Senate,"Assembly 3rd Reading AB2749 Bonta By Stern",39,0,1,0,40
1092032,773342,2018-08-29,Assembly,"AB 2749 BONTA Concurrence in Senate Amendments",80,0,0,0,80
1092043,743976,2018-04-24,Assembly,"Do pass as amended and be re-referred to the Committee on [Appropriations]",11,0,2,0,13
1092043,756610,2018-05-25,Assembly,"Do pass",12,3,2,0,17
1092043,758697,2018-05-31,Assembly,"AB 2771 EGGMAN Third Reading Urgency",58,12,8,0,78
1092043,766279,2018-06-20,Senate,"Do pass, but first be re-referred to the Committee on [Governance and Finance]",7,0,0,0,7
1092043,769288,2018-06-27,Senate,"Do pass as amended, but first amend, and re-refer to the Committee on [Appropriations]",5,1,1,0,7
1092043,770897,2018-08-06,Senate,"Placed on suspense file",7,0,0,0,7
1092043,772012,2018-08-16,Senate,"Do pass as amended",5,1,1,0,7
1092051,741154,2018-04-17,Assembly,"Do pass as amended and be re-referred to the Committee on [Appropriations]",9,0,1,0,10
1092051,751702,2018-05-09,Assembly,"Do pass. To Consent Calendar",16,0,1,0,17
1092051,754382,2018-05-17,Assembly,"AB 2769 COOPER Consent Calendar Second Day Regular Session",73,0,5,0,78
1092051,762337,2018-06-12,Senate,"Do pass as amended, but first amend, and re-refer to the Committee on [Judiciary]",9,1,2,0,12
1092051,768958,2018-06-26,Senate,"Do pass as amended, but first amend, and re-refer to the Committee on [Appropriations]",5,2,0,0,7
1092051,771403,2018-08-13,Senate,"Placed on suspense file",7,0,0,0,7
1092051,771946,2018-08-16,Senate,"Do pass",5,2,0,0,7
1092051,774247,2018-08-31,Senate,"Assembly 3rd Reading AB2769 Cooper et al. By Hueso",26,12,2,0,40
1092051,774248,2018-08-31,Assembly,"AB 2769 Cooper Concurrence in Senate Amendments",75,0,5,0,80
1092063,736337,2018-04-10,Assembly,"Do pass and be re-referred to the Committee on [Appropriations]",8,2,0,0,10
1092063,756675,2018-05-25,Assembly,"Do pass",13,3,1,0,17
1092063,757602,2018-05-30,Assembly,"AB 2757 REYES Assembly Third Reading",52,23,3,0,78
1092063,766529,2018-06-19,Senate,"Do pass as amended, but first amend, and re-refer to the Committee on [Appropriations]",5,1,1,0,7
1092063,770371,2018-08-06,Senate,"Placed on suspense file",7,0,0,0,7
1092071,747851,2018-05-02,Assembly,"Do pass. To Consent Calendar",20,0,1,0,21
1092071,751952,2018-05-10,Assembly,"AB 2739 GRAY Consent Calendar Second Day Regular Session",73,0,5,0,78
1092071,768281,2018-06-26,Senate,"Do pass and be ordered to the Consent Calendar",13,0,0,0,13
1092078,736425,2018-04-09,Assembly,"Do pass as amended and be re-referred to the Committee on [Appropriations]",8,0,2,0,10
1092083,736187,2018-04-09,Assembly,"Do pass and be re-referred to the Committee on [Appropriations] with recommendation: To Consent Calendar",7,0,3,0,10
1092083,756539,2018-05-25,Assembly,"Do pass",16,0,1,0,17
1092083,757589,2018-05-30,Assembly,"AB 2766 BERMAN Third Reading Urgency",78,0,0,0,78
1092083,766873,2018-06-20,Senate,"Do pass, but first be re-referred to the Committee on [Appropriations]",6,0,1,0,7
1092083,770544,2018-08-06,Senate,"Placed on suspense file",7,0,0,0,7
1092091,737300,2018-04-10,Assembly,"Do pass and be re-referred to the Committee on [Health]",14,0,2,0,16
1092091,740797,2018-04-17,Assembly,"Do pass and be re-referred to the Committee on [Appropriations]",12,0,3,0,15
1092091,748362,2018-05-02,Assembly,"Do pass",15,0,2,0,17
1092091,750018,2018-05-07,Assembly,"AB 2741 BURKE Assembly Third Reading",58,0,20,0,78
1092091,761729,2018-06-11,Senate,"Do pass as amended, but first amend, and re-refer to the Committee on [Rules]",4,1,4,0,9
1092091,761730,2018-06-11,Senate,"[First] hearing set for [06-11-2018]: Failed passage in Committee. Reconsideration granted",8,0,1,0,9
1092095,737287,2018-04-10,Assembly,"Do pass and be re-referred to the Committee on [Health]",14,1,1,0,16
1092095,740547,2018-04-17,Assembly,"Do pass as amended, and be re-referred to the Committee on [Appropriations] with recommendation: To Consent Calendar",15,0,0,0,15
1092095,753756,2018-05-16,Assembly,"Do pass",17,0,0,0,17
1092095,754923,2018-05-21,Assembly,"AB 2760 WOOD Assembly Third Reading",70,0,8,0,78
1092095,765010,2018-06-18,Senate,"Do pass as amended, but first amend, and re-refer to the Committee on [Appropriations]",8,0,1,0,9
1092095,772133,2018-08-20,Senate,"Assembly 3rd Reading AB2760 Wood By Hernandez",38,0,2,0,40
1092095,772544,2018-08-23,Assembly,"AB 2760 WOOD Concurrence in Senate Amendments",78,0,2,0,80
1092104,743288,2018-04-24,Assembly,"Do pass and be re-referred to the Committee on [Appropriations] with recommendation: To Consent Calendar",15,0,0,0,15
1092104,747904,2018-05-02,Assembly,"Do pass. To Consent Calendar",17,0,0,0,17
1092104,752079,2018-05-10,Assembly,"AB 2750 OBERNOLTE Consent Calendar Second Day Regular Session",73,0,5,0,78
1092104,763048,2018-06-13,Senate,"Do pass, but first be re-referred to the Committee on [Appropriations] with the recommendation: To Consent Calendar",8,0,1,0,9
1092104,769571,2018-07-02,Senate,"Consent Calendar AB2750",37,0,2,0,39
1092108,742947,2018-04-24,Assembly,"Do pass and be re-referred to the Committee on [Appropriations]",4,0,3,0,7
1092113,737451,2018-04-11,Assembly,"Do pass and be re-referred to the Committee on [Appropriations]",5,0,2,0,7
1092113,744390,2018-04-25,Assembly,"Do pass",14,0,3,0,17
1092113,746032,2018-04-30,Assembly,"AB 2764 CHAU Assembly Third Reading",70,0,8,0,78
1092113,762274,2018-06-12,Senate,"Do pass, but first be re-referred to the Committee on [Appropriations]",9,0,3,0,12
1092113,771189,2018-08-09,Senate,"Assembly 3rd Reading AB2764 Chau By Wiener",36,0,3,0,39
1092118,750761,2018-05-07,Assembly,"Do pass as amended and be re-referred to the Committee on [Appropriations]",9,0,1,0,10
1092118,756314,2018-05-25,Assembly,"AB 2746 GARCIA, E. Assembly Third Reading",71,0,7,0,78
1092118,769267,2018-06-27,Senate,"Do pass",7,0,0,0,7
1092118,771350,2018-08-13,Senate,"Special Consent AB2746",37,0,3,0,40
1092118,772214,2018-08-20,Assembly,"AB 2746 GARCIA, E. Concurrence in Senate Amendments",80,0,0,0,80
1092146,741707,2018-04-18,Assembly,"Do pass and be re-referred to the Committee on [Appropriations]",5,2,0,0,7
1092146,756561,2018-05-25,Assembly,"Do pass as amended",12,4,1,0,17
1092146,758659,2018-05-31,Assembly,"AB 2751 STONE Assembly Third Reading",53,25,0,0,78
1092146,765206,2018-06-19,Senate,"Do pass, but first be re-referred to the Committee on [Appropriations]",4,1,0,0,5
1092146,769643,2018-07-02,Senate,"Placed on suspense file",7,0,0,0,7
1092146,771964,2018-08-16,Senate,"Do pass as amended",5,2,0,0,7
1092146,772699,2018-08-24,Senate,"Assembly 3rd Reading AB2751 Mark Stone By Monning",22,12,6,0,40
1092146,773322,2018-08-29,Assembly,"AB 2751 STONE Concurrence in Senate Amendments",47,28,5,0,80
1092152,746805,2018-05-01,Assembly,"Do pass. To Consent Calendar",10,0,0,0,10
1092152,749994,2018-05-07,Assembly,"AB 2770 IRWIN Consent Calendar Second Day Regular Session",72,0,6,0,78
1092152,762790,2018-06-12,Senate,"Do pass and be ordered to the Consent Calendar",7,0,0,0,7
1092152,767975,2018-06-25,Senate,"Consent Calendar AB2770",36,0,3,0,39
1092158,739794,2018-04-17,Assembly,"Do pass. To Consent Calendar",7,0,0,0,7
1092158,742231,2018-04-23,Assembly,"AB 2774 LIMÓN Consent Calendar Second Day Regular Session",75,0,3,0,78
1092158,762247,2018-06-12,Senate,"Do pass and be ordered to the Consent Calendar",7,0,0,0,7
1092158,768011,2018-06-25,Senate,"Consent Calendar AB2774",36,0,3,0,39
1092158,773377,2018-08-29,Assembly,"AB 2774 LIMÓN Concurrence in Senate Amendments",79,0,1,0,80
1092161,743925,2018-04-25,Assembly,"Do pass and be re-referred to the Committee on [Local Government]",7,0,0,0,7
1092161,744706,2018-04-25,Assembly,"Do pass and be re-referred to the Committee on [Appropriations]",8,0,1,0,9
1092161,751379,2018-05-09,Assembly,"Do pass. To Consent Calendar",16,0,1,0,17
1092161,754311,2018-05-17,Assembly,"AB 2753 FRIEDMAN Consent Calendar Second Day Regular Session",73,0,5,0,78
1092161,762134,2018-06-12,Senate,"Do pass, but first be re-referred to the Committee on [Governance and Finance] with the recommendation: To Consent Calendar",12,0,1,0,13
1092161,769232,2018-06-27,Senate,"Do pass, but first be re-referred to the Committee on [Appropriations] with the recommendation: To Consent Calendar",7,0,0,0,7
1092161,772916,2018-08-27,Senate,"Assembly 3rd Reading AB2753 Friedman By Skinner",38,0,2,0,40
1092161,773538,2018-08-29,Assembly,"AB 2753 FRIEDMAN Concurrence in Senate Amendments",79,0,1,0,80
1092166,745158,2018-04-26,Assembly,"Do pass as amended",5,0,2,0,7
1092166,752183,2018-05-10,Assembly,"AB 2762 CARRILLO Assembly Third Reading",70,0,8,0,78
1092166,766095,2018-06-20,Senate,"Do pass as amended, but first amend, and re-refer to the Committee on [Veterans Affairs]",7,0,0,0,7
1092166,768126,2018-06-26,Senate,"Do pass",6,0,0,0,6
1092166,773224,2018-08-28,Senate,"Assembly 3rd Reading AB2762 Carrillo et al. By Beall",38,0,2,0,40
1092166,773771,2018-08-30,Assembly,"With recommendation: That Senate amendments be concurred in",5,0,2,0,7
1092166,774174,2018-08-31,Assembly,"AB 2762 CARRILLO Concurrence in Senate Amendments",78,0,2,0,80
1092171,733288,2018-04-03,Assembly,"Do pass and be re-referred to the Committee on [Environmental Safety and Toxic Materials]",15,0,0,0,15
1092171,736231,2018-04-10,Assembly,"Do pass and be re-referred to the Committee on [Appropriations]",7,0,0,0,7
1092171,756409,2018-05-25,Assembly,"Do pass",15,1,1,0,17
1092171,757550,2018-05-30,Assembly,"AB 2775 KALRA Assembly Third Reading",76,0,2,0,78
1092171,767050,2018-06-20,Senate,"Do pass, but first be re-referred to the Committee on [Health] with the recommendation: To Consent Calendar",7,0,0,0,7
1092171,768899,2018-06-27,Senate,"Do pass, but first be re-referred to the Committee on [Appropriations] with the recommendation: To Consent Calendar",9,0,0,0,9
1092171,770293,2018-08-06,Senate,"Placed on suspense file",7,0,0,0,7
1092171,771623,2018-08-16,Senate,"Do pass",7,0,0,0,7
1092171,773205,2018-08-28,Senate,"Assembly 3rd Reading AB2775 Kalra et al. By Lara",39,0,1,0,40
1092177,737251,2018-04-10,Assembly,"Do pass as amended and be re-referred to the Committee on [Aging and Long-Term Care]",7,0,0,0,7
1092177,740675,2018-04-17,Assembly,"Do pass and be re-referred to the Committee on [Appropriations]",6,0,1,0,7
1092187,736930,2018-04-10,Assembly,"Do pass and be re-referred to the Committee on [Appropriations]",15,0,0,0,15
1092187,740853,2018-04-18,Assembly,"Do pass. To Consent Calendar",15,0,2,0,17
1092187,744821,2018-04-26,Assembly,"AB 2745 CARRILLO Consent Calendar Second Day Regular Session",74,0,4,0,78
1092187,762283,2018-06-12,Senate,"Do pass, but first be re-referred to the Committee on [Appropriations] with the recommendation: To Consent Calendar",9,0,0,0,9
1092187,770968,2018-08-06,Senate,"Consent Calendar AB2745 Carrillo et al",37,0,2,0,39
1092187,772315,2018-08-20,Assembly,"AB 2745 CARRILLO Concurrence in Senate Amendments",80,0,0,0,80
1092194,738209,2018-04-11,Assembly,"Do pass and be re-referred to the Committee on [Appropriations]",6,0,1,0,7
1092194,756411,2018-05-25,Assembly,"Do pass",16,0,1,0,17
1092194,757568,2018-05-30,Assembly,"AB 2763 O'DONNELL Assembly Third Reading",78,0,0,0,78
1092205,743136,2018-04-24,Assembly,"Do pass and be re-referred to the Committee on [Appropriations]",15,0,1,0,16
1092205,756742,2018-05-25,Assembly,"Do pass",16,0,1,0,17
1092205,757524,2018-05-30,Assembly,"AB 3144 B. & P. Assembly Third Reading By LOW",78,0,0,0,78
1092205,767949,2018-06-25,Senate,"Do pass, but first be re-referred to the Committee on [Appropriations]",9,0,0,0,9
1092205,770963,2018-08-06,Senate,"Placed on suspense file",7,0,0,0,7
1092205,772008,2018-08-16,Senate,"Do pass",7,0,0,0,7
1092205,772783,2018-08-27,Senate,"Assembly 3rd Reading AB3144 Low By Hill",39,0,1,0,40
1092205,773266,2018-08-29,Assembly,"With recommendation: That Senate amendments be concurred in",15,0,4,0,19
1092205,773691,2018-08-30,Assembly,"AB 3144 LOW Concurrence in Senate Amendments",80,0,0,0,80
1092207,743845,2018-04-25,Senate,"Do pass, but first be re-referred to the Committee on [Appropriations]",8,0,1,0,9
1092207,754914,2018-05-21,Senate,"Senate 3rd Reading SB1423 Hernandez et al",34,2,3,0,39
1092207,765224,2018-06-19,Assembly,"Do pass and be re-referred to the Committee on [Appropriations]",13,2,0,0,15
1092207,771508,2018-08-15,Assembly,"Do pass",13,4,0,0,17
1092207,772513,2018-08-23,Assembly,"SB 1423 Hernandez Senate Third Reading By CHU",67,7,6,0,80
1092209,751433,2018-05-09,Assembly,"Do pass as amended. To Consent Calendar",6,0,1,0,7
1092209,756423,2018-05-25,Assembly,"AB 3223 GRAYSON Consent Calendar Second Day Regular Session",70,0,8,0,78
1092209,762703,2018-06-13,Senate,"Do pass and be ordered to the Consent Calendar",7,0,0,0,7
1092209,768038,2018-06-25,Senate,"Consent Calendar AB3223",36,0,3,0,39
1092211,739034,2018-04-16,Senate,"Do pass as amended, but first amend, and re-refer to the Committee on [Appropriations]",9,0,0,0,9
1092211,754926,2018-05-21,Senate,"Senate 3rd Reading SB1451 Fuller",39,0,0,0,39
1092211,768163,2018-06-26,Assembly,"Do pass as amended and be re-referred to the Committee on [Appropriations]",19,0,0,0,19
1092211,771485,2018-08-15,Assembly,"Do pass. To Consent Calendar",17,0,0,0,17
1092211,772576,2018-08-23,Assembly,"SB 1451 Fuller Consent Calendar Second Day Regular Session",75,0,5,0,80
1092211,772655,2018-08-24,Senate,"Unfinished Business SB1451 Fuller Concurrence",39,0,1,0,40
1092212,736079,2018-04-10,Assembly,"Do pass and be re-referred to the Committee on [Appropriations]",9,3,3,0,15
1092212,756645,2018-05-25,Assembly,"Do pass",12,4,1,0,17
1092212,757836,2018-05-30,Assembly,"AB 3206 FRIEDMAN Assembly Third Reading",54,23,1,0,78
1092212,768331,2018-06-26,Senate,"Do pass as amended, but first amend, and re-refer to the Committee on [Appropriations]",7,2,0,0,9
1092212,770816,2018-08-06,Senate,"Placed on suspense file",7,0,0,0,7
1092214,743901,2018-04-25,Assembly,"Do pass as amended and be re-referred to the Committee on [Appropriations]",7,0,0,0,7
1092214,756705,2018-05-25,Assembly,"Do pass",16,0,1,0,17
1092214,757860,2018-05-30,Assembly,"AB 2887 AGUIAR-CURRY Assembly Third Reading",78,0,0,0,78
1092214,765088,2018-06-19,Senate,"Do pass, but first be re-referred to the Committee on [Appropriations] with the recommendation: To Consent Calendar",12,0,1,0,13
1092214,770519,2018-08-06,Senate,"Placed on suspense file",7,0,0,0,7
1092214,772004,2018-08-16,Senate,"Do pass as amended",7,0,0,0,7
1092214,773430,2018-08-29,Senate,"Assembly 3rd Reading AB2887 Aguiar-Curry et al. By Lara",39,0,1,0,40
1092214,773923,2018-08-30,Assembly,"AB 2887 AGUIAR-CURRY Concurrence in Senate Amendments",80,0,0,0,80
1092215,751113,2018-05-09,Senate,"Do pass as amended, but first amend, and re-refer to the Committee on [Appropriations]",5,0,2,0,7
1092215,755365,2018-05-22,Senate,"Placed on suspense file",7,0,0,0,7
1092216,739920,2018-04-17,Assembly,"Do pass and be re-referred to the Committee on [Appropriations] with recommendation: To Consent Calendar",7,0,0,0,7
1092216,747952,2018-05-02,Assembly,"Do pass. To Consent Calendar",17,0,0,0,17
1092216,752010,2018-05-10,Assembly,"AB 2952 STONE Consent Calendar Second Day Regular Session",73,0,5,0,78
1092216,765313,2018-06-19,Senate,"Do pass, but first be re-referred to the Committee on [Appropriations] with the recommendation: To Consent Calendar",7,0,0,0,7
1092216,772921,2018-08-27,Senate,"Assembly 3rd Reading AB2952 Mark Stone By Stern",38,0,2,0,40
1092216,773517,2018-08-29,Assembly,"AB 2952 STONE Concurrence in Senate Amendments",79,0,1,0,80
1092217,736143,2018-04-10,Assembly,"Do pass and be re-referred to the Committee on [Appropriations] with recommendation: To Consent Calendar",7,0,0,0,7
1092217,744408,2018-04-25,Assembly,"Do pass. To Consent Calendar",17,0,0,0,17
1092217,748887,2018-05-03,Assembly,"AB 3078 GALLAGHER Consent Calendar Second Day Regular Session",71,0,7,0,78
1092217,762230,2018-06-12,Senate,"Do pass, but first be re-referred to the Committee on [Appropriations] with the recommendation: To Consent Calendar",7,0,0,0,7
1092217,769576,2018-07-02,Senate,"Consent Calendar AB3078",37,0,2,0,39
1092218,740707,2018-04-18,Assembly,"Do pass as amended and be re-referred to the Committee on [Appropriations]",21,0,0,0,21
1092218,753844,2018-05-16,Assembly,"Do pass",17,0,0,0,17
1092218,754971,2018-05-21,Assembly,"AB 3168 RUBIO Assembly Third Reading",72,0,6,0,78
1092218,762227,2018-06-12,Senate,"Do pass as amended, but first amend, and re-refer to the Committee on [Appropriations]",12,0,1,0,13
1092218,770910,2018-08-06,Senate,"Placed on suspense file",7,0,0,0,7
1092218,771727,2018-08-16,Senate,"Do pass",6,0,1,0,7
1092218,773576,2018-08-29,Senate,"Assembly 3rd Reading AB3168 Rubio By Galgiani",39,0,1,0,40
1092218,773712,2018-08-30,Assembly,"AB 3168 RUBIO Concurrence in Senate Amendments",78,0,2,0,80
1092219,733989,2018-04-04,Senate,"Do pass, but first be re-referred to the Committee on [Appropriations] with the recommendation: To Consent Calendar",6,0,0,0,6
1092219,738878,2018-04-16,Senate,"Placed on suspense file",7,0,0,0,7
1092219,756319,2018-05-25,Senate,"Do pass",7,0,0,0,7
1092219,758593,2018-05-31,Senate,"Special Consent SB1321",39,0,0,0,39
1092219,768711,2018-06-27,Assembly,"Do pass and be re-referred to the Committee on [Appropriations] with recommendation: To Consent Calendar",7,0,0,0,7
1092219,771824,2018-08-16,Assembly,"Do pass",17,0,0,0,17
1092219,773951,2018-08-30,Assembly,"SB 1321 Monning Senate Third Reading By CUNNINGHAM",79,0,1,0,80
1092220,744020,2018-04-24,Assembly,"Do pass and be re-referred to the Committee on [Appropriations]",9,3,1,0,13
1092220,756333,2018-05-25,Assembly,"Do pass as amended",12,4,1,0,17
1092220,757723,2018-05-30,Assembly,"AB 2819 HOLDEN Assembly Third Reading",52,24,2,0,78
1092220,768976,2018-06-27,Senate,"Do pass as amended, but first amend, and re-refer to the Committee on [Appropriations]",5,2,0,0,7
1092220,772413,2018-08-21,Senate,"Assembly 3rd Reading AB2819 Holden By Bradford",26,10,4,0,40
1092220,772985,2018-08-27,Assembly,"AB 2819 HOLDEN Concurrence in Senate Amendments",51,26,3,0,80
1092221,751200,2018-05-09,Senate,"Do pass, but first be re-referred to the Committee on [Appropriations]",6,0,1,0,7
1092221,755246,2018-05-22,Senate,"Placed on suspense file",7,0,0,0,7
1092222,743115,2018-04-24,Senate,"Do pass, but first be re-referred to the Committee on [Energy, Utilities and Communications]",6,1,0,0,7
1092222,743985,2018-04-25,Senate,"Do pass as amended, but first amend, and re-refer to the Committee on [Appropriations]",10,0,1,0,11
1092222,753140,2018-05-14,Senate,"Placed on suspense file",7,0,0,0,7
1092222,756724,2018-05-25,Senate,"Do pass",6,1,0,0,7
1092222,757198,2018-05-29,Senate,"Senate 3rd Reading SB1474 Hill",34,4,1,0,39
1092222,765950,2018-06-20,Assembly,"Do pass and be re-referred to the Committee on [Public Safety]",10,1,2,0,13
1092222,768239,2018-06-26,Assembly,"Do pass as amended and be re-referred to the Committee on [Appropriations]",7,0,0,0,7
1092222,771813,2018-08-16,Assembly,"Do pass",17,0,0,0,17
1092222,773950,2018-08-30,Assembly,"SB 1474 Hill Senate Third Reading By LACKEY",80,0,0,0,80
1092222,774045,2018-08-31,Senate,"Unfinished Business SB1474 Hill Concurrence",38,1,1,0,40
1092223,733567,2018-04-03,Assembly,"Do pass and be re-referred to the Committee on [Judiciary] with recommendation: To Consent Calendar",7,0,0,0,7
1092223,736064,2018-04-10,Assembly,"Do pass and be re-referred to the Committee on [Appropriations] with recommendation: To Consent Calendar",10,0,0,0,10
1092223,744464,2018-04-25,Assembly,"Do pass. To Consent Calendar",17,0,0,0,17
1092223,748811,2018-05-03,Assembly,"AB 3112 GRAYSON Consent Calendar Second Day Regular Session",71,0,7,0,78
1092223,762238,2018-06-12,Senate,"Do pass, but first be re-referred to the Committee on [Judiciary] with the recommendation: To Consent Calendar",7,0,0,0,7
1092223,766348,2018-06-19,Senate,"Do pass, but first be re-referred to the Committee on [Appropriations] with the recommendation: To Consent Calendar",7,0,0,0,7
1092223,770395,2018-08-06,Senate,"Placed on suspense file",7,0,0,0,7
1092223,772002,2018-08-16,Senate,"Do pass as amended",7,0,0,0,7
1092223,773039,2018-08-27,Senate,"Assembly 3rd Reading AB3112 Grayson By Skinner",39,0,1,0,40
1092223,773390,2018-08-29,Assembly,"AB 3112 GRAYSON Concurrence in Senate Amendments",79,0,1,0,80
1092224,721756,2018-03-12,Senate,"Senate 3rd Reading SR83 Leyva et al",37,0,2,0,39
1092225,736126,2018-04-10,Assembly,"Do pass as amended and be re-referred to the Committee on [Appropriations]",14,0,1,0,15
1092225,756590,2018-05-25,Assembly,"Do pass as amended",16,0,1,0,17
1092225,757814,2018-05-30,Assembly,"AB 2805 BIGELOW Assembly Third Reading",74,1,3,0,78
1092225,768278,2018-06-26,Senate,"Do pass as amended, but first amend, and re-refer to the Committee on [Appropriations]",8,0,1,0,9
1092225,770965,2018-08-06,Senate,"Placed on suspense file",7,0,0,0,7
1092225,772040,2018-08-16,Senate,"Do pass",6,0,1,0,7
1092226,743931,2018-04-24,Assembly,"Do pass and be re-referred to the Committee on [Appropriations]",5,2,0,0,7
1092227,725768,2018-03-20,Assembly,"Do pass",8,0,2,0,10
1092227,734771,2018-04-05,Assembly,"AB 2870 EGGMAN Assembly Third Reading",69,0,8,0,77
1092227,762521,2018-06-12,Senate,"Do pass and be ordered to the Consent Calendar",5,0,2,0,7
1092227,768070,2018-06-25,Senate,"Consent Calendar AB2870",36,0,3,0,39
1092228,740120,2018-04-17,Assembly,"Do pass and be re-referred to the Committee on [Appropriations]",15,0,1,0,16
1092228,756206,2018-05-25,Assembly,"Do pass",14,2,1,0,17
1092228,757796,2018-05-30,Assembly,"AB 3061 GLORIA Assembly Third Reading",67,9,2,0,78
1092228,768172,2018-06-26,Senate,"Do pass as amended, but first amend, and re-refer to the Committee on [Appropriations]",12,0,1,0,13
1092228,771340,2018-08-13,Senate,"Placed on suspense file",7,0,0,0,7
1092228,771939,2018-08-16,Senate,"Do pass as amended",7,0,0,0,7
1092228,773542,2018-08-29,Assembly,"With recommendation: That Senate amendments be concurred in",14,0,0,0,14
1092228,773543,2018-08-29,Senate,"Assembly 3rd Reading AB3061 Gloria et al. By Hueso",37,2,1,0,40
1092228,773947,2018-08-30,Assembly,"AB 3061 GLORIA Concurrence in Senate Amendments",79,0,1,0,80
1092229,737503,2018-04-11,Senate,"Do pass, but first be re-referred to the Committee on [Public Safety]",4,1,0,0,5
1092229,743447,2018-04-24,Senate,"Do pass, but first be re-referred to the Committee on [Appropriations]",5,2,0,0,7
1092229,758432,2018-05-31,Senate,"Senate 3rd Reading SB1412 Bradford",21,14,4,0,39
1092229,768862,2018-06-27,Assembly,"Do pass and be re-referred to the Committee on [Appropriations]",5,2,0,0,7
1092229,771046,2018-08-08,Assembly,"Do pass",12,5,0,0,17
1092229,773781,2018-08-30,Assembly,"SB 1412 Bradford Senate Third Reading By THURMOND",45,31,4,0,80
1092229,774024,2018-08-31,Senate,"Unfinished Business SB1412 Bradford Concurrence",26,13,1,0,40
1092231,740533,2018-04-18,Assembly,"Do pass and be re-referred to the Committee on [Public Safety]",6,3,0,0,9
1092231,743082,2018-04-24,Assembly,"Do pass and be re-referred to the Committee on [Appropriations]",5,2,0,0,7
1092231,755699,2018-05-23,Assembly,"Do pass",11,5,1,0,17
1092231,757115,2018-05-29,Assembly,"AB 3131 GLORIA Assembly Third Reading Amend By GLORIA Set #1",49,26,3,0,78
1092231,758676,2018-05-31,Assembly,"AB 3131 GLORIA Assembly Third Reading",41,34,3,0,78
1092231,765138,2018-06-19,Senate,"Do pass, but first be re-referred to the Committee on [Governance and Finance]",5,2,0,0,7
1092231,769256,2018-06-27,Senate,"Do pass as amended, but first amend, and re-refer to the Committee on [Appropriations]",5,1,1,0,7
1092231,773498,2018-08-29,Senate,"Assembly 3rd Reading AB3131 Gloria et al. By Hill",22,16,2,0,40
1092231,773827,2018-08-30,Assembly,"AB 3131 GLORIA Concurrence in Senate Amendments",42,36,2,0,80
1092231,774592,2018-08-29,Senate,tr>,5,16,2,0,23
1092232,738447,2018-04-11,Assembly,"Do pass as amended and be re-referred to the Committee on [Environmental Safety and Toxic Materials]",6,0,1,0,7
1092232,743724,2018-04-24,Assembly,"Do pass as amended and be re-referred to the Committee on [Appropriations]",5,0,2,0,7
1092232,756567,2018-05-25,Assembly,"Do pass",13,2,2,0,17
1092232,758696,2018-05-31,Assembly,"AB 2816 MURATSUCHI Assembly Third Reading",62,8,8,0,78
1092232,767122,2018-06-20,Senate,"Do pass, but first be re-referred to the Committee on [Education]",6,1,0,0,7
1092232,768966,2018-06-27,Senate,"Do pass, but first be re-referred to the Committee on [Appropriations]",7,0,0,0,7
1092232,770522,2018-08-06,Senate,"Placed on suspense file",7,0,0,0,7
1092232,771710,2018-08-16,Senate,"Do pass as amended",5,1,1,0,7
1092232,772554,2018-08-23,Senate,"Assembly 3rd Reading AB2816 Muratsuchi et al. By Pan",34,3,3,0,40
1092232,772793,2018-08-27,Assembly,"AB 2816 MURATSUCHI Concurrence in Senate Amendments",65,9,6,0,80
1092233,736087,2018-04-10,Assembly,"Do pass as amended and be re-referred to the Committee on [Revenue and Taxation]",13,0,2,0,15
1092233,743043,2018-04-23,Assembly,"Do pass as amended and be re-referred to the Committee on [Appropriations]",9,1,0,0,10
1092234,736190,2018-04-09,Assembly,"Do pass as amended and be re-referred to the Committee on [Utilities and Energy]",7,3,0,0,10
1092234,744035,2018-04-25,Assembly,"Do pass as amended and be re-referred to the Committee on [Appropriations]",8,5,2,0,15
1092234,756667,2018-05-25,Assembly,"Do pass",11,4,2,0,17
1092234,758671,2018-05-31,Assembly,"AB 3232 FRIEDMAN Assembly Third Reading",55,23,0,0,78
1092234,764892,2018-06-19,Senate,"Do pass, but first be re-referred to the Committee on [Environmental Quality]",10,1,0,0,11
1092234,767103,2018-06-20,Senate,"Do pass, but first be re-referred to the Committee on [Appropriations]",5,2,0,0,7
1092234,770304,2018-08-06,Senate,"Placed on suspense file",7,0,0,0,7
1092234,771608,2018-08-16,Senate,"Do pass",5,2,0,0,7
1092234,772366,2018-08-21,Senate,"Assembly 3rd Reading AB3232 Friedman et al. By Stern",31,6,3,0,40
1092234,772804,2018-08-27,Assembly,"AB 3232 FRIEDMAN Concurrence Vote: Final Form",49,26,5,0,80
1092236,744021,2018-04-25,Senate,"Do pass as amended, but first amend, and re-refer to the Committee on [Appropriations]",9,1,1,0,11
1092236,755321,2018-05-22,Senate,"Placed on suspense file",7,0,0,0,7
1092236,756280,2018-05-25,Senate,"Do pass",5,2,0,0,7
1092236,757052,2018-05-29,Senate,"Senate 3rd Reading SB1347 Stern",28,10,1,0,39
1092236,769064,2018-06-27,Assembly,"Do pass as amended and be re-referred to the Committee on [Appropriations]",15,0,0,0,15
1092237,735834,2018-04-09,Senate,"Do pass and be ordered to the Consent Calendar",5,0,0,0,5
1092237,742739,2018-04-23,Senate,"Consent Calendar SB1270 Vidak",38,0,1,0,39
1092237,766352,2018-06-20,Assembly,"Do pass. To Consent Calendar",6,0,1,0,7
1092237,769277,2018-06-28,Assembly,"SB 1270 Vidak Consent Calendar Second Day Regular Session",75,0,5,0,80
1092242,742857,2018-04-24,Assembly,"Do pass as amended and be re-referred to the Committee on [Appropriations]",15,0,0,0,15
1092243,743706,2018-04-24,Senate,"Do pass, but first be re-referred to the Committee on [Appropriations] with the recommendation: To Consent Calendar",11,0,2,0,13
1092243,750112,2018-05-07,Senate,"Placed on suspense file",6,0,1,0,7
1092243,756702,2018-05-25,Senate,"Do pass",7,0,0,0,7
1092243,758706,2018-05-31,Senate,"Special Consent SB1455",39,0,0,0,39
1092243,767848,2018-06-25,Assembly,"Do pass and be re-referred to the Committee on [Appropriations] with recommendation: To Consent Calendar",13,0,1,0,14
1092243,771801,2018-08-16,Assembly,"Do pass as amended",12,0,5,0,17
1092243,774141,2018-08-31,Senate,"Unfinished Business SB1455 Stern Concurrence",39,0,1,0,40
1092243,774142,2018-08-31,Assembly,"SB 1455 Stern Senate Third Reading By MURATSUCHI",80,0,0,0,80
1092244,733818,2018-04-04,Senate,"Do pass, but first be re-referred to the Committee on [Appropriations]",9,0,0,0,9
1092244,746193,2018-04-30,Senate,"Senate 3rd Reading SB1280 Roth",36,0,3,0,39
1092244,762528,2018-06-12,Assembly,"Do pass and be re-referred to the Committee on [Appropriations]",13,0,2,0,15
1092244,769051,2018-06-27,Assembly,"Do pass. To Consent Calendar",16,0,1,0,17
1092244,769770,2018-07-05,Assembly,"SB 1280 Roth Consent Calendar Second Day Regular Session",69,0,11,0,80
1092245,741173,2018-04-18,Assembly,"Do pass and be re-referred to the Committee on [Appropriations]",5,0,2,0,7
1092245,756582,2018-05-25,Assembly,"Do pass",14,1,2,0,17
1092245,757592,2018-05-30,Assembly,"AB 3145 SALAS Assembly Third Reading",74,1,3,0,78
1092245,767979,2018-06-25,Senate,"Do pass, but first be re-referred to the Committee on [Labor and Industrial Relations]",5,0,0,0,5
1092245,769019,2018-06-27,Senate,"Do pass, but first be re-referred to the Committee on [Appropriations]",5,0,0,0,5
1092245,770926,2018-08-06,Senate,"Placed on suspense file",7,0,0,0,7
1092245,772037,2018-08-16,Senate,"Do pass",7,0,0,0,7
1092245,772400,2018-08-21,Senate,"Assembly 3rd Reading AB3145 Salas By Wiener",39,0,1,0,40
1092245,772925,2018-08-27,Assembly,"AB 3145 SALAS Concurrence in Senate Amendments",79,0,1,0,80
1092246,737273,2018-04-11,Senate,"Do pass and be ordered to the Consent Calendar",6,0,1,0,7
1092246,742090,2018-04-23,Senate,"Consent Calendar SB1323 Hernandez et al. Urgency Clause",38,0,1,0,39
1092246,763017,2018-06-13,Assembly,"Do pass. To Consent Calendar",7,0,2,0,9
1092246,767233,2018-06-21,Assembly,"SB 1323 Hernandez Consent Calendar Second Day Regular Session",75,0,5,0,80
1092247,736584,2018-04-10,Senate,"Do pass, but first be re-referred to the Committee on [Appropriations] with the recommendation: To Consent Calendar",6,0,1,0,7
1092247,742446,2018-04-23,Senate,"Placed on suspense file",7,0,0,0,7
1092247,756202,2018-05-25,Senate,"Do pass as amended",7,0,0,0,7
1092247,757862,2018-05-30,Senate,"Senate 3rd Reading SB1446 Glazer",37,0,2,0,39
1092247,769035,2018-06-26,Assembly,"Do pass and be re-referred to the Committee on [Appropriations]",7,0,0,0,7
1092247,771814,2018-08-16,Assembly,"Do pass",17,0,0,0,17
1092247,773953,2018-08-30,Assembly,"SB 1446 Glazer Senate Third Reading By BAKER",80,0,0,0,80
1092248,733704,2018-04-04,Assembly,"Do pass",6,0,1,0,7
1092248,738198,2018-04-12,Assembly,"AB 2800 CHU Assembly Third Reading",69,0,8,0,77
1092248,751606,2018-05-09,Senate,"Do pass and be ordered to the Consent Calendar",6,0,0,0,6
1092248,754277,2018-05-17,Senate,"Consent Calendar AB2800",38,0,1,0,39
1092250,743983,2018-04-25,Senate,"Do pass as amended, but first amend, and re-refer to the Committee on [Appropriations]",8,0,1,0,9
1092250,755330,2018-05-22,Senate,"Placed on suspense file",7,0,0,0,7
1092251,751428,2018-05-09,Assembly,"Do pass",3,1,3,0,7
1092253,743192,2018-04-24,Senate,"Do pass, but first be re-referred to the Committee on [Appropriations]",9,1,2,0,12
1092253,756952,2018-05-29,Senate,"Senate 3rd Reading SB1283 Bradford",34,4,1,0,39
1092253,769279,2018-06-28,Assembly,"Do pass as amended and be re-referred to the Committee on [Appropriations]",21,0,0,0,21
1092253,771133,2018-08-08,Assembly,"Do pass. To Consent Calendar",17,0,0,0,17
1092253,773049,2018-08-27,Assembly,"SB 1283 Bradford Senate Third Reading By BERMAN",80,0,0,0,80
1092253,773216,2018-08-28,Senate,"Unfinished Business SB1283 Bradford Concurrence",38,1,1,0,40
1092254,736186,2018-04-10,Assembly,"Do pass and be re-referred to the Committee on [Appropriations]",3,5,2,0,10
1092255,733957,2018-04-04,Assembly,"Do pass and be re-referred to the Committee on [Appropriations]",5,0,2,0,7
1092255,741219,2018-04-18,Assembly,"Do pass",10,5,2,0,17
1092255,749051,2018-05-03,Assembly,"AB 2970 COOPER Assembly Third Reading Amend By COOPER Set #1",52,18,8,0,78
1092255,752080,2018-05-10,Assembly,"AB 2970 COOPER Assembly Third Reading",50,21,7,0,78
1092255,761727,2018-06-11,Senate,"Do pass, but first be re-referred to the Committee on [Judiciary]",3,2,0,0,5
1092257,739845,2018-04-17,Assembly,"Do pass and be re-referred to the Committee on [Appropriations] with recommendation: To Consent Calendar",7,0,0,0,7
1092257,751804,2018-05-09,Assembly,"Do pass. To Consent Calendar",16,0,1,0,17
1092257,754197,2018-05-17,Assembly,"AB 2783 O'DONNELL Consent Calendar Second Day Regular Session",73,0,5,0,78
1092257,762241,2018-06-12,Senate,"Do pass, but first be re-referred to the Committee on [Appropriations]",7,0,0,0,7
1092257,769662,2018-07-02,Senate,"Placed on suspense file",7,0,0,0,7
1092257,771908,2018-08-16,Senate,"Do pass",7,0,0,0,7
1092257,772910,2018-08-27,Senate,"Assembly 3rd Reading AB2783 O'Donnell By Bates",39,0,1,0,40
1092257,773664,2018-08-29,Assembly,"AB 2783 O'DONNELL Concurrence in Senate Amendments",79,0,1,0,80
1092260,743022,2018-04-24,Senate,"Do pass, but first be re-referred to the Committee on [Appropriations] with the recommendation: To Consent Calendar",7,0,0,0,7
1092260,750481,2018-05-07,Senate,"Placed on suspense file",6,0,1,0,7
1092262,740850,2018-04-18,Senate,"Do pass, but first be re-referred to the Committee on [Appropriations]",9,0,0,0,9
1092262,753043,2018-05-14,Senate,"Placed on suspense file",7,0,0,0,7
1092262,756291,2018-05-25,Senate,"Do pass as amended",7,0,0,0,7
1092262,757857,2018-05-30,Senate,"Senate 3rd Reading SB1292 Hueso",36,0,3,0,39
1092262,764985,2018-06-19,Assembly,"Do pass and be re-referred to the Committee on [Appropriations] with recommendation: To Consent Calendar",15,0,0,0,15
1092262,771557,2018-08-16,Assembly,"Do pass",17,0,0,0,17
1092262,773742,2018-08-30,Assembly,"SB 1292 Hueso Senate Third Reading By KALRA",79,0,1,0,80
1092262,774026,2018-08-31,Senate,"Unfinished Business SB1292 Hueso Concurrence",39,0,1,0,40
1092263,751183,2018-05-08,Senate,"Do pass as amended",5,1,1,0,7
1092263,755275,2018-05-22,Senate,"Placed on suspense file",7,0,0,0,7
1092263,756232,2018-05-25,Senate,"Do pass as amended",5,2,0,0,7
1092263,757777,2018-05-30,Senate,"Senate 3rd Reading SB1424 Pan",25,11,3,0,39
1092263,764921,2018-06-19,Assembly,"Do pass and be re-referred to the Committee on [Arts, Entertainment, Sports, Tourism, and Internet Media]",8,2,0,0,10
1092263,768211,2018-06-26,Assembly,"Do pass and be re-referred to the Committee on [Appropriations]",5,2,0,0,7
1092263,771069,2018-08-08,Assembly,"Do pass",12,5,0,0,17
1092263,772571,2018-08-23,Assembly,"SB 1424 Pan Senate Third Reading Amend By CHAU Set #1",53,23,4,0,80
1092263,772827,2018-08-27,Assembly,"SB 1424 Pan Senate Third Reading By CHAU",52,26,2,0,80
1092263,773150,2018-08-28,Senate,"Unfinished Business SB1424 Pan Concurrence",25,11,4,0,40
1092265,750711,2018-05-07,Assembly,"Do pass and be re-referred to the Committee on [Appropriations]",10,0,0,0,10
1092266,737494,2018-04-11,Senate,"Do pass as amended, but first amend, and re-refer to the Committee on [Judiciary]",6,0,0,0,6
1092268,742323,2018-04-23,Assembly,"Do pass and be re-referred to the Committee on [Appropriations]",13,0,1,0,14
1092269,738833,2018-04-16,Assembly,"Do pass and be re-referred to the Committee on [Appropriations]",10,0,0,0,10
1092269,743740,2018-04-25,Assembly,"Do pass. To Consent Calendar",17,0,0,0,17
1092269,750039,2018-05-07,Assembly,"AB 3036 COOLEY Assembly Third Reading",74,0,4,0,78
1092269,760398,2018-06-06,Senate,"Do pass, but first be re-referred to the Committee on [Appropriations]",5,0,2,0,7
1092269,772908,2018-08-27,Senate,"Assembly 3rd Reading AB3036 Cooley By Nielsen",39,0,1,0,40
1092269,773341,2018-08-29,Assembly,"AB 3036 COOLEY Concurrence in Senate Amendments",79,0,1,0,80
1092270,743699,2018-04-25,Senate,"Do pass, but first be re-referred to the Committee on [Appropriations]",4,0,1,0,5
1092270,749972,2018-05-07,Senate,"Placed on suspense file",6,0,1,0,7
1092270,756238,2018-05-25,Senate,"Do pass",7,0,0,0,7
1092270,758569,2018-05-31,Senate,"Special Consent SB1470",39,0,0,0,39
1092270,768822,2018-06-27,Assembly,"Do pass and be re-referred to the Committee on [Appropriations]",7,0,0,0,7
1092271,740265,2018-04-17,Assembly,"Do pass. To Consent Calendar",7,0,0,0,7
1092271,742354,2018-04-23,Assembly,"AB 3091 WEBER Consent Calendar Second Day Regular Session",75,0,3,0,78
1092273,743749,2018-04-24,Assembly,"Do pass and be re-referred to the Committee on [Appropriations] with recommendation: To Consent Calendar",7,0,0,0,7
1092273,754003,2018-05-16,Assembly,"Do pass. To Consent Calendar",17,0,0,0,17
1092273,756348,2018-05-25,Assembly,"AB 2821 MAYES Consent Calendar Second Day Regular Session",70,0,8,0,78
1092273,766157,2018-06-20,Senate,"Do pass, but first be re-referred to the Committee on [Human Services]",8,0,1,0,9
1092273,768972,2018-06-26,Senate,"Do pass, but first be re-referred to the Committee on [Appropriations]",6,0,1,0,7
1092273,771323,2018-08-13,Senate,"Assembly 3rd Reading AB2821 Mayes By Roth",36,0,4,0,40
1092273,772165,2018-08-20,Assembly,"AB 2821 MAYES Concurrence in Senate Amendments",80,0,0,0,80
1092275,751257,2018-05-09,Assembly,"Do pass as amended",6,0,1,0,7
1092275,754931,2018-05-21,Assembly,"AB 3086 KILEY Assembly Third Reading",74,0,4,0,78
1092275,762870,2018-06-13,Senate,"Do pass and be ordered to the Consent Calendar",7,0,0,0,7
1092275,772190,2018-08-20,Senate,"Assembly 3rd Reading AB3086 Kiley By Galgiani",39,0,1,0,40
1092275,772503,2018-08-23,Assembly,"AB 3086 KILEY Concurrence in Senate Amendments",76,0,4,0,80
1092276,747886,2018-05-02,Senate,"Do pass",4,1,2,0,7
1092277,750521,2018-05-07,Assembly,"Do pass and be re-referred to the Committee on [Housing and Community Development]",9,1,0,0,10
1092277,751323,2018-05-09,Assembly,"Do pass as amended and be re-referred to the Committee on [Appropriations]",7,0,0,0,7
1092278,734547,2018-04-04,Assembly,"Do pass and be re-referred to the Committee on [Appropriations]",5,1,1,0,7
1092278,756542,2018-05-25,Assembly,"Do pass",12,4,1,0,17
1092278,757743,2018-05-30,Assembly,"AB 2963 KALRA Assembly Third Reading",41,30,7,0,78
1092278,765975,2018-06-20,Senate,"Do pass, but first be re-referred to the Committee on [Labor and Industrial Relations]",7,2,0,0,9
1092278,768932,2018-06-27,Senate,"Do pass, but first be re-referred to the Committee on [Appropriations]",4,1,0,0,5
1092278,770540,2018-08-06,Senate,"Placed on suspense file",7,0,0,0,7
1092278,771641,2018-08-16,Senate,"Do pass",5,2,0,0,7
1092278,773189,2018-08-28,Senate,"Assembly 3rd Reading AB2963 Kalra et al. By De León",23,13,4,0,40
1092278,773891,2018-08-30,Assembly,"AB 2963 KALRA Concurrence in Senate Amendments",43,31,6,0,80
1092279,743151,2018-04-24,Senate,"Do pass, but first be re-referred to the Committee on [Appropriations]",12,0,0,0,12
1092279,754993,2018-05-21,Senate,"Senate 3rd Reading SB1293 Lara",38,0,1,0,39
1092279,769073,2018-06-27,Assembly,"Do pass and be re-referred to the Committee on [Appropriations]",7,0,0,0,7
1092279,771124,2018-08-08,Assembly,"Do pass. To Consent Calendar",17,0,0,0,17
1092279,772845,2018-08-27,Assembly,"SB 1293 Lara Senate Third Reading By GONZALEZ FLETCHER",80,0,0,0,80
1092279,773157,2018-08-28,Senate,"Unfinished Business SB1293 Lara et al. Concurrence",39,0,1,0,40
1092280,751046,2018-05-08,Assembly,"Do pass",8,0,2,0,10
1092280,752673,2018-05-14,Assembly,"AB 3019 REYES Assembly Third Reading",58,9,11,0,78
1092280,762971,2018-06-12,Senate,"Do pass",5,1,1,0,7
1092280,772746,2018-08-24,Senate,"Assembly 3rd Reading AB3019 Reyes et al. By Jackson",36,0,4,0,40
1092281,743989,2018-04-25,Assembly,"Do pass as amended and be re-referred to the Committee on [Local Government]",7,0,0,0,7
1092281,751281,2018-05-09,Assembly,"Do pass",8,1,0,0,9
1092281,758788,2018-05-31,Assembly,"AB 3194 DALY Assembly Third Reading",70,4,4,0,78
1092281,765193,2018-06-19,Senate,"Do pass as amended, but first amend, and re-refer to the Committee on [Governance and Finance]",13,0,0,0,13
1092281,769226,2018-06-27,Senate,"Do pass and be ordered to the Consent Calendar",7,0,0,0,7
1092281,771180,2018-08-09,Senate,"Assembly 3rd Reading AB3194 Daly By Skinner",36,0,3,0,39
1092281,771372,2018-08-13,Assembly,"AB 3194 DALY Concurrence in Senate Amendments",73,0,7,0,80
1092282,740753,2018-04-17,Assembly,"Do pass and be re-referred to the Committee on [Human Services]",5,0,2,0,7
1092282,744027,2018-04-24,Assembly,"Do pass and be re-referred to the Committee on [Appropriations] with recommendation: To Consent Calendar",7,0,0,0,7
1092282,755721,2018-05-23,Assembly,"Do pass. To Consent Calendar",16,0,1,0,17
1092282,757176,2018-05-29,Assembly,"AB 3098 FRIEDMAN Consent Calendar Second Day Regular Session",78,0,0,0,78
1092282,762773,2018-06-12,Senate,"Do pass as amended, but first amend, and re-refer to the Committee on [Appropriations]",6,0,1,0,7
1092282,772814,2018-08-27,Senate,"Assembly 3rd Reading AB3098 Friedman By Wiener",39,0,1,0,40
1092282,773499,2018-08-29,Assembly,"AB 3098 FRIEDMAN Concurrence in Senate Amendments",80,0,0,0,80
1092283,738886,2018-04-16,Assembly,"Do pass. To Consent Calendar",14,0,0,0,14
1092283,742195,2018-04-23,Assembly,"AB 3077 CABALLERO Consent Calendar Second Day Regular Session",75,0,3,0,78
1092283,753455,2018-05-15,Senate,"Do pass and be ordered to the Consent Calendar",11,0,2,0,13
1092283,773183,2018-08-28,Senate,"Assembly 3rd Reading AB3077 Caballero By Mitchell",39,0,1,0,40
1092283,773456,2018-08-29,Assembly,"AB 3077 CABALLERO Concurrence in Senate Amendments",80,0,0,0,80
1092285,750608,2018-05-07,Assembly,"Do pass as amended and be re-referred to the Committee on [Appropriations]",8,0,2,0,10
1092286,740857,2018-04-17,Assembly,"Do pass and be re-referred to the Committee on [Appropriations]",11,4,0,0,15
1092286,756596,2018-05-25,Assembly,"Do pass",12,4,1,0,17
1092286,758687,2018-05-31,Assembly,"AB 2843 GLORIA Assembly Third Reading",49,25,4,0,78
1092287,742259,2018-04-23,Assembly,"Do pass",14,0,0,0,14
1092287,754932,2018-05-21,Assembly,"AB 2955 FRIEDMAN Assembly Third Reading",74,0,4,0,78
1092287,762239,2018-06-12,Senate,"Do pass",12,0,1,0,13
1092287,771391,2018-08-13,Senate,"Assembly 3rd Reading AB2955 Friedman et al. By Portantino",37,0,3,0,40
1092287,772153,2018-08-20,Assembly,"AB 2955 FRIEDMAN Concurrence in Senate Amendments",78,0,2,0,80
1092289,743162,2018-04-23,Assembly,"Do pass as amended and be re-referred to the Committee on [Appropriations]",10,0,0,0,10
1092289,755724,2018-05-23,Assembly,"Do pass",16,0,1,0,17
1092289,756712,2018-05-25,Assembly,"AB 2849 STONE Assembly Third Reading",71,0,7,0,78
1092289,768166,2018-06-26,Senate,"Do pass as amended, but first amend, and re-refer to the Committee on [Appropriations] with the recommendation: To Consent Calendar",9,0,0,0,9
1092289,771324,2018-08-13,Senate,"Consent Calendar AB2849",37,0,3,0,40
1092289,772172,2018-08-20,Assembly,"AB 2849 STONE Concurrence in Senate Amendments",80,0,0,0,80
1092290,743870,2018-04-24,Assembly,"Do pass",5,1,1,0,7
1092290,746137,2018-04-30,Assembly,"AB 3224 THURMOND Assembly Third Reading",54,22,2,0,78
1092290,762770,2018-06-12,Senate,"Do pass",5,0,2,0,7
1092290,769556,2018-07-02,Senate,"Assembly 3rd Reading AB3224 Thurmond By Leyva",26,11,2,0,39
1092290,770400,2018-08-06,Assembly,"AB 3224 THURMOND Concurrence in Senate Amendments",56,20,4,0,80
1092292,733295,2018-04-03,Assembly,"Do pass as amended, and be re-referred to the Committee on [Appropriations] with recommendation: To Consent Calendar",7,0,0,0,7
1092292,740724,2018-04-18,Assembly,"Do pass. To Consent Calendar",15,0,2,0,17
1092292,744800,2018-04-26,Assembly,"AB 2801 SALAS Consent Calendar Second Day Regular Session",74,0,4,0,78
1092292,762152,2018-06-12,Senate,"Do pass as amended, but first amend, and re-refer to the Committee on [Appropriations] with the recommendation: To Consent Calendar",7,0,0,0,7
1092292,771285,2018-08-13,Senate,"Special Consent AB2801",37,0,3,0,40
1092292,772137,2018-08-20,Assembly,"AB 2801 SALAS Concurrence in Senate Amendments",80,0,0,0,80
1092294,738222,2018-04-11,Assembly,"Do pass and be re-referred to the Committee on [Appropriations]",5,0,2,0,7
1092294,756529,2018-05-25,Assembly,"Do pass",13,1,3,0,17
1092294,758621,2018-05-31,Assembly,"AB 2808 MURATSUCHI Assembly Third Reading",70,3,5,0,78
1092294,768827,2018-06-27,Senate,"Do pass, but first be re-referred to the Committee on [Appropriations]",7,0,0,0,7
1092294,770528,2018-08-06,Senate,"Placed on suspense file",7,0,0,0,7
1092294,771760,2018-08-16,Senate,"Do pass as amended",7,0,0,0,7
1092294,773250,2018-08-28,Senate,"Assembly 3rd Reading AB2808 Muratsuchi et al. By Portantino",39,0,1,0,40
1092295,737440,2018-04-11,Assembly,"Do pass as amended and be re-referred to the Committee on [Education]",7,0,0,0,7
1092295,744833,2018-04-25,Assembly,"Do pass and be re-referred to the Committee on [Appropriations]",6,1,0,0,7
1092296,733509,2018-04-02,Assembly,"Do pass as amended and be re-referred to the Committee on [Appropriations]",8,1,1,0,10
1092297,743920,2018-04-24,Assembly,"Do pass and be re-referred to the Committee on [Appropriations]",7,0,0,0,7
1092298,737209,2018-04-11,Senate,"Do pass as amended, but first amend, and re-refer to the Committee on [Appropriations]",9,0,0,0,9
1092298,755338,2018-05-22,Senate,"Placed on suspense file",7,0,0,0,7
1092298,756201,2018-05-25,Senate,"Do pass",7,0,0,0,7
1092298,758602,2018-05-31,Senate,"Special Consent SB1268",39,0,0,0,39
1092298,768259,2018-06-26,Assembly,"Do pass and be re-referred to the Committee on [Appropriations]",15,0,0,0,15
1092300,740825,2018-04-18,Assembly,"Do pass and be re-referred to the Committee on [Appropriations] with recommendation: To Consent Calendar",21,0,0,0,21
1092300,748321,2018-05-02,Assembly,"Do pass. To Consent Calendar",17,0,0,0,17
1092300,752093,2018-05-10,Assembly,"AB 3164 FONG Consent Calendar Second Day Regular Session",73,0,5,0,78
1092301,743982,2018-04-24,Assembly,"Do pass and be re-referred to the Committee on [Appropriations]",13,0,0,0,13
1092301,753709,2018-05-16,Assembly,"Do pass. To Consent Calendar",17,0,0,0,17
1092301,756341,2018-05-25,Assembly,"AB 2894 GLORIA Consent Calendar Second Day Regular Session",70,0,8,0,78
1092301,762744,2018-06-13,Senate,"Do pass, but first be re-referred to the Committee on [Veterans Affairs] with the recommendation: To Consent Calendar",7,0,0,0,7
1092301,768423,2018-06-26,Senate,"Do pass, but first be re-referred to the Committee on [Appropriations] with the recommendation: To Consent Calendar",6,0,0,0,6
1092301,772478,2018-08-22,Senate,"Assembly 3rd Reading AB2894 Gloria By Roth",39,0,1,0,40
1092302,736219,2018-04-10,Senate,"Do pass, but first be re-referred to the Committee on [Public Employment and Retirement] with the recommendation: To Consent Calendar",7,0,0,0,7
1092302,742968,2018-04-23,Senate,"Do pass, but first be re-referred to the Committee on [Appropriations] with the recommendation: To Consent Calendar",4,0,1,0,5
1092302,752910,2018-05-14,Senate,"Placed on suspense file",7,0,0,0,7
1092302,756717,2018-05-25,Senate,"Do pass",7,0,0,0,7
1092302,758491,2018-05-31,Senate,"Special Consent SB1312",39,0,0,0,39
1092302,766248,2018-06-20,Assembly,"Do pass and be re-referred to the Committee on [Veterans Affairs]",6,0,1,0,7
1092302,768723,2018-06-26,Assembly,"Do pass and be re-referred to the Committee on [Appropriations]",9,0,1,0,10
1092302,771604,2018-08-16,Assembly,"Do pass",17,0,0,0,17
1092302,772924,2018-08-27,Assembly,"SB 1312 Jackson Senate Third Reading By GLORIA",80,0,0,0,80
1092302,773256,2018-08-28,Senate,"Unfinished Business SB1312 Jackson et al. Concurrence",39,0,1,0,40
1092303,740871,2018-04-18,Assembly,"Do pass and be re-referred to the Committee on [Appropriations]",6,0,1,0,7
1092303,748369,2018-05-02,Assembly,"Do pass. To Consent Calendar",17,0,0,0,17
1092303,751930,2018-05-10,Assembly,"AB 2886 DALY Consent Calendar Second Day Regular Session",73,0,5,0,78
1092303,762067,2018-06-11,Senate,"Do pass, but first be re-referred to the Committee on [Judiciary]",3,2,0,0,5
1092303,769120,2018-06-26,Senate,"Do pass, but first be re-referred to the Committee on [Appropriations]",5,2,0,0,7
1092303,770929,2018-08-06,Senate,"Placed on suspense file",7,0,0,0,7
1092303,772047,2018-08-16,Senate,"Do pass",5,2,0,0,7
1092303,772391,2018-08-21,Senate,"Assembly 3rd Reading AB2886 Daly By Pan",28,11,1,0,40
1092304,736022,2018-04-10,Assembly,"Do pass and be re-referred to the Committee on [Privacy and Consumer Protection]",12,0,3,0,15
1092304,747734,2018-05-01,Assembly,"Do pass",7,3,0,0,10
1092304,758707,2018-05-31,Assembly,"AB 2935 CHAU Assembly Third Reading",57,15,6,0,78
1092305,710280,2018-02-26,Senate,"Senate 3rd Reading SR84 De León et al",29,3,7,0,39
1092306,740861,2018-04-17,Assembly,"Do pass as amended and be re-referred to the Committee on [Appropriations]",11,3,1,0,15
1092307,751279,2018-05-08,Senate,"Do pass and be ordered to the Consent Calendar",7,0,0,0,7
1092307,754287,2018-05-17,Senate,"Consent Calendar SB1436",38,0,1,0,39
1092307,762125,2018-06-12,Assembly,"Do pass. To Consent Calendar",9,0,1,0,10
1092307,764288,2018-06-18,Assembly,"SB 1436 Portantino Consent Calendar Second Day Regular Session",80,0,0,0,80
1092307,769544,2018-07-02,Senate,"Unfinished Business SB1436 Portantino Concurrence",37,0,2,0,39
1092308,747033,2018-05-01,Assembly,"Do pass. To Consent Calendar",10,0,0,0,10
1092308,750081,2018-05-07,Assembly,"AB 2780 BLOOM Consent Calendar Second Day Regular Session",72,0,6,0,78
1092308,765973,2018-06-19,Senate,"Do pass and be ordered to the Consent Calendar",7,0,0,0,7
1092308,769655,2018-07-02,Senate,"Consent Calendar AB2780",37,0,2,0,39
1092308,770776,2018-08-06,Assembly,"AB 2780 BLOOM Concurrence in Senate Amendments",76,0,4,0,80
1092309,736091,2018-04-09,Assembly,"Do pass",7,3,0,0,10
1092310,739864,2018-04-16,Senate,"Do pass as amended, but first amend, and re-refer to the Committee on [Appropriations]",9,0,0,0,9
1092310,755362,2018-05-22,Senate,"Placed on suspense file",7,0,0,0,7
1092310,756301,2018-05-25,Senate,"Do pass",7,0,0,0,7
1092310,757685,2018-05-30,Senate,"Senate 3rd Reading SB1309 McGuire et al",38,0,1,0,39
1092310,768115,2018-06-26,Assembly,"Do pass as amended and be re-referred to the Committee on [Appropriations]",15,0,0,0,15
1092310,771922,2018-08-16,Assembly,"Do pass",16,0,1,0,17
1092310,773158,2018-08-28,Assembly,"SB 1309 McGuire Senate Third Reading By DAHLE",76,0,4,0,80
1092310,773674,2018-08-29,Senate,"Unfinished Business SB1309 McGuire et al. Concurrence",38,1,1,0,40
1092311,740193,2018-04-16,Assembly,"Do pass and be re-referred to the Committee on [Privacy and Consumer Protection]",6,3,2,0,11
1092311,740800,2018-04-17,Assembly,"Do pass as amended and be re-referred to the Committee on [Appropriations]",7,3,0,0,10
1092311,756447,2018-05-25,Assembly,"Do pass",12,4,1,0,17
1092311,757634,2018-05-30,Assembly,"AB 3010 LIMÓN Assembly Third Reading",42,29,7,0,78
1092312,740104,2018-04-17,Assembly,"Do pass as amended, and be re-referred to the Committee on [Appropriations] with recommendation: To Consent Calendar",7,0,0,0,7
1092312,751394,2018-05-09,Assembly,"Do pass. To Consent Calendar",16,0,1,0,17
1092312,754243,2018-05-17,Assembly,"AB 3173 IRWIN Consent Calendar Second Day Regular Session",73,0,5,0,78
1092312,768374,2018-06-26,Senate,"Do pass as amended, but first amend, and re-refer to the Committee on [Appropriations] with the recommendation: To Consent Calendar",7,0,0,0,7
1092316,748480,2018-05-01,Senate,"Do pass as amended, but first amend, and re-refer to the Committee on [Appropriations]",6,1,0,0,7
1092316,755357,2018-05-22,Senate,"Placed on suspense file",7,0,0,0,7
1092316,756332,2018-05-25,Senate,"Do pass",5,1,1,0,7
1092316,757629,2018-05-30,Senate,"Senate 3rd Reading SB1453 McGuire",34,4,1,0,39
1092316,769724,2018-07-03,Assembly,"Do pass as amended",10,0,0,0,10
1092316,772140,2018-08-20,Assembly,"SB 1453 McGuire Senate Third Reading By WOOD",79,0,1,0,80
1092316,772477,2018-08-22,Senate,"Unfinished Business SB1453 McGuire Concurrence",37,2,1,0,40
1092317,737182,2018-04-10,Assembly,"Do pass and be re-referred to the Committee on [Appropriations]",10,1,5,0,16
1092317,744042,2018-04-25,Assembly,"Do pass",13,2,2,0,17
1092317,745924,2018-04-30,Assembly,"AB 2789 WOOD Assembly Third Reading",61,2,15,0,78
1092317,765048,2018-06-18,Senate,"Do pass as amended, but first amend, and re-refer to the Committee on [Appropriations]",7,1,1,0,9
1092317,772355,2018-08-21,Senate,"Assembly 3rd Reading AB2789 Wood By Hill",37,1,2,0,40
1092317,772904,2018-08-27,Assembly,"AB 2789 WOOD Concurrence in Senate Amendments",70,3,7,0,80
1092319,740757,2018-04-17,Assembly,"Do pass and be re-referred to the Committee on [Appropriations]",10,0,0,0,10
1092319,756638,2018-05-25,Assembly,"Do pass",16,0,1,0,17
1092319,757828,2018-05-30,Assembly,"AB 3193 CHAU Assembly Third Reading",78,0,0,0,78
1092319,768460,2018-06-26,Senate,"Do pass, but first be re-referred to the Committee on [Appropriations]",4,3,6,0,13
1092320,727931,2018-03-21,Assembly,"Do pass and be re-referred to the Committee on [Appropriations]",2,0,5,0,7
1092323,744079,2018-04-25,Assembly,"Do pass and be re-referred to the Committee on [Appropriations]",2,5,0,0,7
1092324,740526,2018-04-18,Assembly,"Do pass and be re-referred to the Committee on [Appropriations]",13,0,0,0,13
1092324,753810,2018-05-16,Assembly,"Do pass. To Consent Calendar",17,0,0,0,17
1092324,756288,2018-05-25,Assembly,"AB 2927 NAZARIAN Consent Calendar Second Day Regular Session",70,0,8,0,78
1092324,769227,2018-06-27,Senate,"Do pass, but first be re-referred to the Committee on [Appropriations] with the recommendation: To Consent Calendar",12,0,1,0,13
1092324,771335,2018-08-13,Senate,"Consent Calendar AB2927",37,0,3,0,40
1092324,772132,2018-08-20,Assembly,"AB 2927 NAZARIAN Concurrence in Senate Amendments",79,0,1,0,80
1092325,740264,2018-04-17,Assembly,"Do pass and be re-referred to the Committee on [Appropriations]",5,0,2,0,7
1092325,756777,2018-05-25,Assembly,"Do pass",15,0,2,0,17
1092325,757886,2018-05-30,Assembly,"AB 2823 NAZARIAN Assembly Third Reading",67,3,8,0,78
1092325,765013,2018-06-19,Senate,"Do pass as amended, but first amend, and re-refer to the Committee on [Appropriations]",5,0,2,0,7
1092325,770966,2018-08-06,Senate,"Placed on suspense file",7,0,0,0,7
1092326,743171,2018-04-24,Assembly,"Do pass and be re-referred to the Committee on [Appropriations] with recommendation: To Consent Calendar",15,0,0,0,15
1092326,756399,2018-05-25,Assembly,"Do pass as amended",16,0,1,0,17
1092326,757538,2018-05-30,Assembly,"AB 2893 WALDRON Assembly Third Reading",78,0,0,0,78
1092326,768928,2018-06-27,Senate,"Do pass as amended, but first amend, and re-refer to the Committee on [Appropriations] with the recommendation: To Consent Calendar",9,0,0,0,9
1092326,771287,2018-08-13,Senate,"Consent Calendar AB2893",37,0,3,0,40
1092326,772164,2018-08-20,Assembly,"AB 2893 WALDRON Concurrence in Senate Amendments",80,0,0,0,80
1092327,743027,2018-04-24,Senate,"Do pass, but first be re-referred to the Committee on [Appropriations]",9,0,0,0,9
1092327,749959,2018-05-07,Senate,"Placed on suspense file",6,0,1,0,7
1092329,739919,2018-04-17,Senate,"Do pass, but first be re-referred to the Committee on [Appropriations]",11,0,0,0,11
1092329,757665,2018-05-30,Senate,"Senate 3rd Reading SB1358 Hueso",37,0,2,0,39
1092329,769077,2018-06-27,Assembly,"Do pass as amended and be re-referred to the Committee on [Appropriations]",15,0,0,0,15
1092329,771059,2018-08-08,Assembly,"Do pass. To Consent Calendar",17,0,0,0,17
1092329,773769,2018-08-30,Assembly,"SB 1358 Hueso Senate Third Reading By HOLDEN",80,0,0,0,80
1092329,774226,2018-08-31,Senate,"Unfinished Business SB1358 Hueso Concurrence",39,0,1,0,40
1092330,738240,2018-04-11,Assembly,"Do pass and be re-referred to the Committee on [Jobs, Economic Development, and the Economy]",7,0,0,0,7
1092330,739630,2018-04-17,Assembly,"Do pass and be re-referred to the Committee on [Appropriations]",7,0,0,0,7
1092331,746940,2018-04-30,Assembly,"Do pass as amended and be re-referred to the Committee on [Housing and Community Development]",10,0,0,0,10
1092331,751162,2018-05-09,Assembly,"Do pass and be re-referred to the Committee on [Appropriations]",7,0,0,0,7
1092333,740662,2018-04-17,Assembly,"Do pass and be re-referred to the Committee on [Appropriations]",11,3,1,0,15
1092334,738409,2018-04-11,Assembly,"Do pass and be re-referred to the Committee on [Appropriations]",10,0,0,0,10
1092334,756654,2018-05-25,Assembly,"Do pass as amended",15,1,1,0,17
1092334,757711,2018-05-30,Assembly,"AB 3021 LEVINE Assembly Third Reading",72,2,4,0,78
1092334,765039,2018-06-19,Senate,"Do pass, but first be re-referred to the Committee on [Public Safety]",3,1,1,0,5
1092334,769647,2018-07-02,Senate,"Placed on suspense file",7,0,0,0,7
1092336,733277,2018-04-03,Senate,"Do pass, but first be re-referred to the Committee on [Appropriations]",6,0,1,0,7
1092336,738876,2018-04-16,Senate,"Placed on suspense file",7,0,0,0,7
1092336,756187,2018-05-25,Senate,"Do pass",7,0,0,0,7
1092336,758543,2018-05-31,Senate,"Special Consent SB1281",39,0,0,0,39
1092336,768133,2018-06-26,Assembly,"Do pass and be re-referred to the Committee on [Appropriations]",6,0,1,0,7
1092336,771054,2018-08-08,Assembly,"Do pass. To Consent Calendar",17,0,0,0,17
1092336,772899,2018-08-27,Assembly,"SB 1281 Stern Senate Third Reading By CARRILLO",78,0,2,0,80
1092336,773244,2018-08-28,Senate,"Unfinished Business SB1281 Stern Concurrence",38,0,2,0,40
1092338,744875,2018-04-25,Assembly,"Do pass and be re-referred to the Committee on [Appropriations] with recommendation: To Consent Calendar",7,0,0,0,7
1092338,753812,2018-05-16,Assembly,"Do pass. To Consent Calendar",17,0,0,0,17
1092338,756375,2018-05-25,Assembly,"AB 3058 O'DONNELL Consent Calendar Second Day Regular Session",70,0,8,0,78
1092338,762827,2018-06-13,Senate,"Do pass, but first be re-referred to the Committee on [Appropriations] with the recommendation: To Consent Calendar",7,0,0,0,7
1092338,770501,2018-08-06,Senate,"Consent Calendar AB3058 O'Donnell",37,0,2,0,39
1092339,743286,2018-04-23,Senate,"Do pass",1,3,1,0,5
1092339,743287,2018-04-23,Senate,"[First] hearing set for [04-23-2018]: Failed passage in Committee. Reconsideration granted",4,0,1,0,5
1092340,736984,2018-04-09,Assembly,"Do pass and be re-referred to the Committee on [Housing and Community Development]",3,3,4,0,10
1092341,744888,2018-04-25,Assembly,"Do pass and be re-referred to the Committee on [Appropriations]",6,2,1,0,9
1092341,751756,2018-05-09,Assembly,"Do pass",11,5,1,0,17
1092341,752787,2018-05-14,Assembly,"AB 2982 GLORIA Assembly Third Reading",54,20,4,0,78
1092341,762236,2018-06-12,Senate,"Do pass, but first be re-referred to the Committee on [Appropriations]",12,0,1,0,13
1092341,771216,2018-08-09,Senate,"Assembly 3rd Reading AB2982 Gloria By Bates",36,0,3,0,39
1092342,742928,2018-04-24,Senate,"Do pass, but first be re-referred to the Committee on [Appropriations]",9,0,0,0,9
1092342,752924,2018-05-14,Senate,"Placed on suspense file",7,0,0,0,7
1092342,756725,2018-05-25,Senate,"Do pass",7,0,0,0,7
1092342,757202,2018-05-29,Senate,"Senate 3rd Reading SB1367 Atkins et al",36,2,1,0,39
1092342,768106,2018-06-25,Assembly,"Do pass as amended and be re-referred to the Committee on [Appropriations]",10,0,0,0,10
1092342,771820,2018-08-16,Assembly,"Do pass",17,0,0,0,17
1092342,773061,2018-08-28,Assembly,"SB 1367 Atkins Senate Third Reading By GLORIA",80,0,0,0,80
1092342,773360,2018-08-29,Senate,"Unfinished Business SB1367 Atkins et al. Concurrence",37,2,1,0,40
1092343,733956,2018-04-04,Senate,"Do pass, but first be re-referred to the Committee on [Public Safety]",6,0,1,0,7
1092343,739689,2018-04-17,Senate,"Do pass, but first be re-referred to the Committee on [Appropriations] with the recommendation: To Consent Calendar",7,0,0,0,7
1092343,746505,2018-04-30,Senate,"Placed on suspense file",6,0,1,0,7
1092343,756236,2018-05-25,Senate,"Do pass as amended",7,0,0,0,7
1092343,757763,2018-05-30,Senate,"Senate 3rd Reading SB1272 Galgiani et al",37,0,2,0,39
1092343,765121,2018-06-19,Assembly,"Do pass and be re-referred to the Committee on [Revenue and Taxation]",7,0,0,0,7
1092343,768319,2018-06-25,Assembly,"Do pass as amended and be re-referred to the Committee on [Appropriations]",8,0,2,0,10
1092343,771774,2018-08-16,Assembly,"Do pass as amended",12,0,5,0,17
1092343,773801,2018-08-30,Assembly,"SB 1272 Galgiani Senate Third Reading By ARAMBULA",79,0,1,0,80
1092343,774106,2018-08-31,Senate,"Unfinished Business SB1272 Galgiani et al. Concurrence",39,0,1,0,40
1092343,777599,2018-04-04,Senate,,0,0,1,0,1
1092344,736180,2018-04-10,Assembly,"Do pass and be re-referred to the Committee on [Appropriations]",14,0,1,0,15
1092344,751701,2018-05-09,Assembly,"Do pass. To Consent Calendar",16,0,1,0,17
1092344,754373,2018-05-17,Assembly,"AB 3192 O'DONNELL Consent Calendar Second Day Regular Session",73,0,5,0,78
1092344,760436,2018-06-06,Senate,"Do pass, but first be re-referred to the Committee on [Education] with the recommendation: To Consent Calendar",8,0,1,0,9
1092344,763001,2018-06-13,Senate,"Do pass, but first be re-referred to the Committee on [Appropriations] with the recommendation: To Consent Calendar",7,0,0,0,7
1092344,770378,2018-08-06,Senate,"Placed on suspense file",7,0,0,0,7
1092344,772017,2018-08-16,Senate,"Do pass as amended",7,0,0,0,7
1092344,773257,2018-08-28,Senate,"Assembly 3rd Reading AB3192 O'Donnell et al. By Roth",38,0,2,0,40
1092344,773670,2018-08-29,Assembly,"AB 3192 O'DONNELL Concurrence in Senate Amendments",80,0,0,0,80
1092345,743105,2018-04-24,Assembly,"Do pass and be re-referred to the Committee on [Privacy and Consumer Protection]",9,0,1,0,10
1092345,747674,2018-05-01,Assembly,"Do pass as amended",9,0,1,0,10
1092345,755730,2018-05-23,Assembly,"Do pass",13,3,1,0,17
1092345,756715,2018-05-25,Assembly,"AB 2873 LOW Assembly Third Reading",60,4,14,0,78
1092345,765827,2018-06-19,Senate,"Do pass, but first be re-referred to the Committee on [Judiciary]",13,0,0,0,13
1092345,768712,2018-06-26,Senate,"Do pass as amended, but first amend, and re-refer to the Committee on [Appropriations]",7,0,0,0,7
1092345,773623,2018-08-29,Senate,"Assembly 3rd Reading AB2873 Low By Hertzberg",39,0,1,0,40
1092345,773773,2018-08-30,Assembly,"AB 2873 LOW Concurrence in Senate Amendments",76,1,3,0,80
1092347,739621,2018-04-17,Senate,"Do pass, but first be re-referred to the Committee on [Appropriations]",5,2,0,0,7
1092347,755363,2018-05-22,Senate,"Placed on suspense file",7,0,0,0,7
1092347,756329,2018-05-25,Senate,"Do pass as amended",5,2,0,0,7
1092347,757624,2018-05-30,Senate,"Senate 3rd Reading SB1421 Skinner et al",25,11,3,0,39
1092347,768283,2018-06-26,Assembly,"Do pass and be re-referred to the Committee on [Appropriations]",5,2,0,0,7
1092347,771849,2018-08-16,Assembly,"Do pass as amended",12,0,5,0,17
1092347,774059,2018-08-31,Senate,"Unfinished Business SB1421 Skinner et al. Concurrence",25,11,4,0,40
1092347,774060,2018-08-31,Assembly,"SB 1421 Skinner Senate Third Reading By TING",44,30,6,0,80
1092348,736044,2018-04-10,Senate,"Do pass as amended, but first amend, and re-refer to the Committee on [Appropriations]",13,0,0,0,13
1092348,750024,2018-05-07,Senate,"Placed on suspense file",6,0,1,0,7
1092348,756711,2018-05-25,Senate,"Do pass",7,0,0,0,7
1092348,758725,2018-05-31,Senate,"Special Consent SB1397",39,0,0,0,39
1092348,765120,2018-06-19,Assembly,"Do pass and be re-referred to the Committee on [Judiciary]",15,1,3,0,19
1092348,768339,2018-06-26,Assembly,"Do pass and be re-referred to the Committee on [Appropriations]",10,0,0,0,10
1092348,771830,2018-08-16,Assembly,"Do pass",16,1,0,0,17
1092348,773102,2018-08-28,Assembly,"SB 1397 Hill Senate Third Reading By BERMAN",79,1,0,0,80
1092349,738779,2018-04-16,Senate,"Do pass, but first be re-referred to the Committee on [Appropriations]",7,1,1,0,9
1092349,751996,2018-05-10,Senate,"Senate 3rd Reading SB1442 Wiener et al",33,4,2,0,39
1092349,765006,2018-06-19,Assembly,"Do pass as amended and be re-referred to the Committee on [Appropriations]",16,1,2,0,19
1092349,771477,2018-08-15,Assembly,"Do pass",14,3,0,0,17
1092349,774097,2018-08-31,Senate,"Unfinished Business SB1442 Wiener et al. Concurrence",39,0,1,0,40
1092349,774098,2018-08-31,Assembly,"SB 1442 Wiener Senate Third Reading By CUNNINGHAM",70,8,2,0,80
1092350,739709,2018-04-17,Assembly,"Do pass and be re-referred to the Committee on [Appropriations] with recommendation: To Consent Calendar",16,0,0,0,16
1092350,751814,2018-05-09,Assembly,"Do pass. To Consent Calendar",16,0,1,0,17
1092350,754374,2018-05-17,Assembly,"AB 2884 IRWIN Consent Calendar Second Day Regular Session",73,0,5,0,78
1092350,766319,2018-06-20,Senate,"Do pass, but first be re-referred to the Committee on [Business, Professions and Economic Development]",7,0,0,0,7
1092350,767834,2018-06-25,Senate,"Do pass as amended, but first amend, and re-refer to the Committee on [Appropriations]",9,0,0,0,9
1092350,772295,2018-08-20,Senate,"Assembly 3rd Reading AB2884 Irwin By Hill",39,0,1,0,40
1092350,772613,2018-08-23,Assembly,"AB 2884 IRWIN Concurrence in Senate Amendments",78,0,2,0,80
1092351,742839,2018-04-23,Senate,"Do pass, but first be re-referred to the Committee on [Appropriations]",7,0,2,0,9
1092351,755310,2018-05-22,Senate,"Placed on suspense file",7,0,0,0,7
1092351,756307,2018-05-25,Senate,"Do pass as amended",5,2,0,0,7
1092351,757585,2018-05-30,Senate,"Senate 3rd Reading SB1448 Hill",29,3,7,0,39
1092351,765198,2018-06-19,Assembly,"Do pass and be re-referred to the Committee on [Appropriations]",16,1,2,0,19
1092351,771808,2018-08-16,Assembly,"Do pass",14,3,0,0,17
1092351,774244,2018-08-31,Senate,"Unfinished Business SB1448 Hill et al. Concurrence",34,3,3,0,40
1092351,774245,2018-08-31,Assembly,"SB 1448 Hill Senate Third Reading By LOW",69,4,7,0,80
1092352,751320,2018-05-09,Assembly,"Do pass as amended",7,0,0,0,7
1092352,754916,2018-05-21,Assembly,"AB 2913 WOOD Assembly Third Reading",74,0,4,0,78
1092352,769753,2018-07-03,Senate,"Do pass as amended",13,0,0,0,13
1092352,773007,2018-08-27,Senate,"Assembly 3rd Reading AB2913 Wood By Wiener",38,0,2,0,40
1092352,773391,2018-08-29,Assembly,"AB 2913 WOOD Concurrence in Senate Amendments",79,0,1,0,80
1092353,751557,2018-05-09,Assembly,"Do pass. To Consent Calendar",9,0,0,0,9
1092353,754315,2018-05-17,Assembly,"AB 2898 GLORIA Consent Calendar Second Day Regular Session",73,0,5,0,78
1092353,768616,2018-06-26,Senate,"Do pass",13,0,0,0,13
1092353,771288,2018-08-13,Senate,"Assembly 3rd Reading AB2898 Gloria By McGuire",37,0,3,0,40
1092353,772219,2018-08-20,Assembly,"AB 2898 GLORIA Concurrence in Senate Amendments",80,0,0,0,80
1092354,742933,2018-04-24,Senate,"Do pass, but first be re-referred to the Committee on [Appropriations] with the recommendation: To Consent Calendar",7,0,0,0,7
1092354,754338,2018-05-17,Senate,"Consent Calendar SB1435",38,0,1,0,39
1092354,768839,2018-06-26,Assembly,"Do pass and be re-referred to the Committee on [Appropriations]",9,0,1,0,10
1092354,771128,2018-08-08,Assembly,"Do pass. To Consent Calendar",17,0,0,0,17
1092354,771951,2018-08-16,Assembly,"SB 1435 Dodd Consent Calendar Second Day Regular Session",76,0,4,0,80
1092354,772302,2018-08-20,Senate,"Unfinished Business SB1435 Dodd Concurrence",39,0,1,0,40
1092357,740488,2018-04-17,Assembly,"Do pass as amended, and be re-referred to the Committee on [Appropriations] with recommendation: To Consent Calendar",15,0,0,0,15
1092357,751345,2018-05-09,Assembly,"Do pass as amended",16,0,1,0,17
1092357,756380,2018-05-25,Assembly,"AB 3162 FRIEDMAN Assembly Third Reading",71,0,7,0,78
1092357,762753,2018-06-13,Senate,"Do pass as amended, but first amend, and re-refer to the Committee on [Appropriations]",8,0,1,0,9
1092357,772782,2018-08-27,Senate,"Assembly 3rd Reading AB3162 Friedman et al. By Bates",39,0,1,0,40
1092357,773455,2018-08-29,Assembly,"AB 3162 FRIEDMAN Concurrence in Senate Amendments",79,1,0,0,80
1092360,751284,2018-05-09,Assembly,"Do pass as amended",6,0,1,0,7
1092360,755701,2018-05-23,Assembly,"Do pass. To Consent Calendar",16,0,1,0,17
1092360,757028,2018-05-29,Assembly,"AB 3149 LIMÓN Consent Calendar Second Day Regular Session",78,0,0,0,78
1092360,768727,2018-06-27,Senate,"Do pass, but first be re-referred to the Committee on [Appropriations] with the recommendation: To Consent Calendar",7,0,0,0,7
1092361,732670,2018-04-02,Assembly,"Do pass and be re-referred to the Committee on [Appropriations] with recommendation: To Consent Calendar",14,0,0,0,14
1092361,740821,2018-04-18,Assembly,"Do pass. To Consent Calendar",15,0,2,0,17
1092361,744857,2018-04-26,Assembly,"AB 3163 FRAZIER Consent Calendar Second Day Regular Session",74,0,4,0,78
1092361,765154,2018-06-19,Senate,"Do pass, but first be re-referred to the Committee on [Appropriations] with the recommendation: To Consent Calendar",12,0,1,0,13
1092361,771457,2018-08-14,Senate,"That the measure be returned to Senate Floor for consideration. Ordered to third reading",12,1,0,0,13
1092361,772389,2018-08-21,Senate,"Assembly 3rd Reading AB3163 Frazier et al. By Wieckowski Urgency Clause",33,4,3,0,40
1092361,773024,2018-08-27,Assembly,"AB 3163 FRAZIER Concurrence - Urgency Added",67,8,5,0,80
1092362,739706,2018-04-17,Assembly,"Do pass and be re-referred to the Committee on [Appropriations]",1,4,2,0,7
1092365,740030,2018-04-17,Assembly,"Do pass and be re-referred to the Committee on [Appropriations]",13,0,0,0,13
1092365,756435,2018-05-25,Assembly,"Do pass as amended",16,0,1,0,17
1092365,757604,2018-05-30,Assembly,"AB 3089 THURMOND Assembly Third Reading",76,0,2,0,78
1092365,766052,2018-06-20,Senate,"Do pass, but first be re-referred to the Committee on [Appropriations] with the recommendation: To Consent Calendar",7,0,0,0,7
1092365,769620,2018-07-02,Senate,"Placed on suspense file",7,0,0,0,7
1092365,771684,2018-08-16,Senate,"Do pass as amended",7,0,0,0,7
1092365,773651,2018-08-29,Senate,"Assembly 3rd Reading AB3089 Thurmond et al. By Beall Urgency Clause",26,0,14,0,40
1092365,773652,2018-08-29,Senate,"Assembly 3rd Reading AB3089 Thurmond et al. By Beall Reconsider",38,0,2,0,40
1092365,774154,2018-08-31,Senate,"Assembly 3rd Reading AB3089 Thurmond et al. By Beall Urgency Clause",36,0,4,0,40
1092365,774155,2018-08-31,Assembly,"AB 3089 Thurmond Concurrence - Urgency Added",78,0,2,0,80
1092366,743397,2018-04-24,Senate,"Do pass as amended, but first amend, and re-refer to the Committee on [Appropriations]",7,2,0,0,9
1092366,755360,2018-05-22,Senate,"Placed on suspense file",7,0,0,0,7
1092367,739673,2018-04-17,Senate,"Do pass as amended, but first amend, and re-refer to the Committee on [Appropriations]",4,0,1,0,5
1092367,748818,2018-05-03,Senate,"Senate 3rd Reading SB1459 Cannella et al",37,0,2,0,39
1092367,768825,2018-06-27,Assembly,"Do pass and be re-referred to the Committee on [Appropriations]",8,1,1,0,10
1092367,771142,2018-08-08,Assembly,"Do pass",13,4,0,0,17
1092367,773279,2018-08-29,Assembly,"Do pass",18,1,0,0,19
1092367,774065,2018-08-31,Senate,"That the Assembly amendments be concurred in",8,0,1,0,9
1092367,774066,2018-08-31,Senate,"Unfinished Business SB1459 Cannella et al. Urgency Clause Concurrence",33,4,3,0,40
1092367,774067,2018-08-31,Assembly,"SB 1459 Cannella Third Reading Urgency By WOOD",73,1,6,0,80
1092368,743977,2018-04-25,Assembly,"Do pass and be re-referred to the Committee on [Appropriations]",2,7,1,0,10
1092371,736016,2018-04-10,Senate,"Do pass as amended, but first amend, and re-refer to the Committee on [Appropriations]",4,1,2,0,7
1092371,752736,2018-05-14,Senate,"Placed on suspense file",7,0,0,0,7
1092373,725876,2018-03-20,Assembly,"Do pass. To Consent Calendar",7,0,0,0,7
1092373,733066,2018-04-02,Assembly,"AB 2901 E.S. & T.M. Consent Calendar Second Day Regular Session",73,0,4,0,77
1092373,753760,2018-05-16,Senate,"Do pass and be ordered to the Consent Calendar",7,0,0,0,7
1092373,757405,2018-05-29,Senate,"Consent Calendar AB2901 E.S. & T.M. (Quirk)",37,0,2,0,39
1092374,745270,2018-04-25,Senate,"Do pass as amended, but first amend, and re-refer to the Committee on [Appropriations]",8,2,3,0,13
1092374,755305,2018-05-22,Senate,"Placed on suspense file",7,0,0,0,7
1092376,733817,2018-04-03,Assembly,"Do pass as amended and be re-referred to the Committee on [Appropriations]",13,0,0,0,13
1092376,756484,2018-05-25,Assembly,"Do pass as amended",12,0,5,0,17
1092376,758740,2018-05-31,Assembly,"AB 2785 RUBIO Assembly Third Reading",77,1,0,0,78
1092376,768831,2018-06-27,Senate,"Do pass as amended, but first amend, and re-refer to the Committee on [Appropriations]",7,0,0,0,7
1092376,770498,2018-08-06,Senate,"Placed on suspense file",7,0,0,0,7
1092376,771621,2018-08-16,Senate,"Do pass as amended",7,0,0,0,7
1092376,772448,2018-08-22,Senate,"Assembly 3rd Reading AB2785 Rubio et al. By Delgado",39,0,1,0,40
1092376,772775,2018-08-27,Assembly,"AB 2785 RUBIO Concurrence in Senate Amendments",80,0,0,0,80
1092377,747027,2018-04-30,Assembly,"Do pass as amended and be re-referred to the Committee on [Appropriations]",9,0,1,0,10
1092378,738953,2018-04-16,Assembly,"Do pass and be re-referred to the Committee on [Environmental Safety and Toxic Materials]",13,0,1,0,14
1092379,736204,2018-04-10,Assembly,"Do pass as amended and be re-referred to the Committee on [Appropriations]",6,0,1,0,7
1092379,743757,2018-04-25,Assembly,"Do pass. To Consent Calendar",17,0,0,0,17
1092379,748691,2018-05-03,Assembly,"AB 3014 QUIRK Consent Calendar Second Day Regular Session",71,0,7,0,78
1092380,743133,2018-04-24,Senate,"Do pass as amended, but first amend, and re-refer to the Committee on [Appropriations]",12,0,0,0,12
1092380,752903,2018-05-14,Senate,"Placed on suspense file",7,0,0,0,7
1092380,756718,2018-05-25,Senate,"Do pass as amended",7,0,0,0,7
1092380,758731,2018-05-31,Senate,"Senate 3rd Reading SB1396 Galgiani",38,0,1,0,39
1092380,765196,2018-06-19,Assembly,"Do pass as amended and be re-referred to the Committee on [Appropriations]",8,2,0,0,10
1092381,737390,2018-04-10,Assembly,"Do pass and be re-referred to the Committee on [Judiciary]",7,0,0,0,7
1092381,739632,2018-04-17,Assembly,"Do pass and be re-referred to the Committee on [Appropriations] with recommendation: To Consent Calendar",10,0,0,0,10
1092381,756726,2018-05-25,Assembly,"Do pass as amended",16,0,1,0,17
1092381,757889,2018-05-30,Assembly,"AB 3176 WALDRON Assembly Third Reading",77,0,1,0,78
1092381,769013,2018-06-26,Senate,"Do pass, but first be re-referred to the Committee on [Appropriations] with the recommendation: To Consent Calendar",7,0,0,0,7
1092381,770930,2018-08-06,Senate,"Placed on suspense file",7,0,0,0,7
1092381,772052,2018-08-16,Senate,"Do pass as amended",7,0,0,0,7
1092381,772467,2018-08-22,Senate,"Assembly 3rd Reading AB3176 Waldron et al. By Jackson",39,0,1,0,40
1092381,772468,2018-08-22,Senate,"Assembly 3rd Reading AB3176 Waldron et al. By Jackson Reconsider",39,0,1,0,40
1092381,773209,2018-08-28,Senate,"Assembly 3rd Reading AB3176 Waldron et al. By Jackson",39,0,1,0,40
1092381,773385,2018-08-29,Assembly,"AB 3176 WALDRON Concurrence in Senate Amendments",80,0,0,0,80
1092382,733926,2018-04-04,Assembly,"Do pass and be re-referred to the Committee on [Business and Professions]",5,0,2,0,7
1092382,742862,2018-04-24,Assembly,"Do pass as amended and be re-referred to the Committee on [Appropriations]",10,0,6,0,16
1092382,756501,2018-05-25,Assembly,"Do pass as amended",12,0,5,0,17
1092382,758708,2018-05-31,Assembly,"AB 3110 MULLIN Assembly Third Reading",60,11,7,0,78
1092382,767905,2018-06-25,Senate,"Do pass, but first be re-referred to the Committee on [Appropriations]",6,2,1,0,9
1092382,771330,2018-08-13,Senate,"Placed on suspense file",7,0,0,0,7
1092383,743196,2018-04-24,Assembly,"Do pass",6,1,0,0,7
1092384,732599,2018-04-02,Assembly,"Do pass",13,0,1,0,14
1092384,734463,2018-04-05,Assembly,"AB 2806 OBERNOLTE Assembly Third Reading",62,0,15,0,77
1092385,741425,2018-04-18,Assembly,"Do pass and be re-referred to the Committee on [Appropriations]",7,0,0,0,7
1092385,743848,2018-04-25,Assembly,"Do pass. To Consent Calendar",17,0,0,0,17
1092385,748717,2018-05-03,Assembly,"AB 3231 GRAY Consent Calendar Second Day Regular Session",71,0,7,0,78
1092385,768981,2018-06-26,Senate,"Do pass, but first be re-referred to the Committee on [Labor and Industrial Relations]",5,2,0,0,7
1092385,768982,2018-06-27,Senate,"Do pass as amended, but first amend, and re-refer to the Committee on [Appropriations]",4,1,0,0,5
1092385,772408,2018-08-21,Senate,"Assembly 3rd Reading AB3231 Gray By Cannella",28,11,1,0,40
1092385,773277,2018-08-29,Assembly,"With recommendation: That Senate amendments be concurred in",6,1,0,0,7
1092385,773873,2018-08-30,Assembly,"AB 3231 GRAY Concurrence in Senate Amendments",62,16,2,0,80
1092388,737439,2018-04-11,Assembly,"Do pass as amended and be re-referred to the Committee on [Local Government]",7,0,0,0,7
1092388,744912,2018-04-25,Assembly,"Do pass and be re-referred to the Committee on [Appropriations]",8,0,1,0,9
1092388,751483,2018-05-09,Assembly,"Do pass. To Consent Calendar",16,0,1,0,17
1092388,754201,2018-05-17,Assembly,"AB 2880 HARPER Consent Calendar Second Day Regular Session",73,0,5,0,78
1092388,764806,2018-06-19,Senate,"Do pass, but first be re-referred to the Committee on [Appropriations] with the recommendation: To Consent Calendar",5,0,0,0,5
1092388,771399,2018-08-13,Senate,"Consent Calendar AB2880",37,0,3,0,40
1092388,772616,2018-08-23,Assembly,"AB 2880 HARPER Concurrence in Senate Amendments",78,0,2,0,80
1092390,740914,2018-04-18,Senate,"Do pass as amended, but first amend, and re-refer to the Committee on [Appropriations]",5,0,2,0,7
1092390,755356,2018-05-22,Senate,"Placed on suspense file",7,0,0,0,7
1092390,756260,2018-05-25,Senate,"Do pass",7,0,0,0,7
1092390,758700,2018-05-31,Senate,"Special Consent SB1422",39,0,0,0,39
1092390,768347,2018-06-26,Assembly,"Do pass and be re-referred to the Committee on [Appropriations]",6,0,1,0,7
1092390,771681,2018-08-16,Assembly,"Do pass",15,0,2,0,17
1092390,773925,2018-08-30,Assembly,"SB 1422 Portantino Senate Third Reading By QUIRK",74,1,5,0,80
1092390,774085,2018-08-31,Senate,"Unfinished Business SB1422 Portantino Concurrence",34,2,4,0,40
1092391,739822,2018-04-16,Senate,"Do pass, but first be re-referred to the Committee on [Public Safety]",7,2,0,0,9
1092391,743045,2018-04-24,Senate,"Do pass, but first be re-referred to the Committee on [Appropriations]",5,2,0,0,7
1092391,755285,2018-05-22,Senate,"Placed on suspense file",7,0,0,0,7
1092391,756231,2018-05-25,Senate,"Do pass as amended",5,2,0,0,7
1092391,757731,2018-05-30,Senate,"Senate 3rd Reading SB1487 Stern",27,7,5,0,39
1092391,768137,2018-06-26,Assembly,"Do pass and be re-referred to the Committee on [Judiciary]",9,5,1,0,15
1092391,769182,2018-06-28,Assembly,"Do pass as amended and be re-referred to the Committee on [Appropriations]",8,2,0,0,10
1092391,771585,2018-08-16,Assembly,"Do pass",12,5,0,0,17
1092391,774196,2018-08-31,Senate,"Unfinished Business SB1487 Stern Concurrence",27,11,2,0,40
1092391,774197,2018-08-31,Assembly,"SB 1487 Stern Senate Third Reading By KALRA",55,20,5,0,80
1092393,735542,2018-04-09,Assembly,"Do pass. To Consent Calendar",12,0,2,0,14
1092393,738881,2018-04-16,Assembly,"AB 3124 BLOOM Consent Calendar Second Day",73,0,4,0,77
1092393,753334,2018-05-15,Senate,"Do pass and be ordered to the Consent Calendar",11,0,2,0,13
1092393,754955,2018-05-21,Senate,"Consent Calendar AB3124",39,0,0,0,39
1092394,744039,2018-04-25,Assembly,"Do pass and be re-referred to the Committee on [Appropriations]",9,0,1,0,10
1092395,727782,2018-03-21,Assembly,"Do pass as amended, and be re-referred to the Committee on [Appropriations] with recommendation: To Consent Calendar",6,0,1,0,7
1092395,740694,2018-04-18,Assembly,"Do pass. To Consent Calendar",15,0,2,0,17
1092395,744731,2018-04-26,Assembly,"AB 3043 BERMAN Consent Calendar Second Day Regular Session",74,0,4,0,78
1092395,760315,2018-06-06,Senate,"Do pass, but first be re-referred to the Committee on [Appropriations]",6,0,0,0,6
1092395,767920,2018-06-25,Senate,"Placed on suspense file",7,0,0,0,7
1092395,771752,2018-08-16,Senate,"Do pass as amended",7,0,0,0,7
1092395,772966,2018-08-27,Senate,"Assembly 3rd Reading AB3043 Berman By McGuire",39,0,1,0,40
1092395,773476,2018-08-29,Assembly,"AB 3043 BERMAN Concurrence in Senate Amendments",78,0,2,0,80
1092397,737362,2018-04-10,Assembly,"Do pass as amended and be re-referred to the Committee on [Appropriations]",7,0,0,0,7
1092397,756368,2018-05-25,Assembly,"Do pass as amended",12,0,5,0,17
1092397,757784,2018-05-30,Assembly,"AB 3200 KALRA Assembly Third Reading",74,0,4,0,78
1092397,768923,2018-06-26,Senate,"Do pass, but first be re-referred to the Committee on [Appropriations] with the recommendation: To Consent Calendar",6,0,1,0,7
1092399,736310,2018-04-10,Assembly,"Do pass and be re-referred to the Committee on [Revenue and Taxation]",4,2,1,0,7
1092399,747009,2018-04-30,Assembly,"Do pass as amended and be re-referred to the Committee on [Appropriations]",6,2,2,0,10
1092399,756613,2018-05-25,Assembly,"Do pass as amended",12,4,1,0,17
1092400,737555,2018-04-10,Assembly,"Do pass as amended, and be re-referred to the Committee on [Judiciary] with recommendation: To Consent Calendar",7,0,0,0,7
1092400,743085,2018-04-24,Assembly,"Do pass and be re-referred to the Committee on [Appropriations] with recommendation: To Consent Calendar",10,0,0,0,10
1092400,756583,2018-05-25,Assembly,"Do pass",16,0,1,0,17
1092400,757815,2018-05-30,Assembly,"AB 3076 REYES Assembly Third Reading",77,0,1,0,78
1092400,765938,2018-06-19,Senate,"Do pass, but first be re-referred to the Committee on [Appropriations] with the recommendation: To Consent Calendar",7,0,0,0,7
1092400,769588,2018-07-02,Senate,"Placed on suspense file",7,0,0,0,7
1092401,740818,2018-04-18,Assembly,"Do pass and be re-referred to the Committee on [Appropriations] with recommendation: To Consent Calendar",9,0,0,0,9
1092401,756632,2018-05-25,Assembly,"Do pass",16,0,1,0,17
1092401,757823,2018-05-30,Assembly,"AB 3137 RODRIGUEZ Assembly Third Reading",77,0,1,0,78
1092401,768329,2018-06-26,Senate,"Do pass, but first be re-referred to the Committee on [Appropriations] with the recommendation: To Consent Calendar",13,0,0,0,13
1092401,770919,2018-08-06,Senate,"Placed on suspense file",7,0,0,0,7
1092401,772089,2018-08-16,Senate,"Do pass as amended",7,0,0,0,7
1092401,773417,2018-08-29,Senate,"Assembly 3rd Reading AB3137 Rodriguez By Leyva",39,0,1,0,40
1092401,773911,2018-08-30,Assembly,"AB 3137 RODRIGUEZ Concurrence in Senate Amendments",80,0,0,0,80
1092402,747013,2018-05-01,Assembly,"Do pass as amended. To Consent Calendar",10,0,0,0,10
1092402,752788,2018-05-14,Assembly,"AB 2847 RUBIO Assembly Third Reading",77,0,1,0,78
1092402,762970,2018-06-12,Senate,"Do pass as amended, and be ordered to the Consent Calendar",7,0,0,0,7
1092402,768005,2018-06-25,Senate,"Consent Calendar AB2847",36,0,3,0,39
1092402,769536,2018-07-02,Assembly,"AB 2847 RUBIO Concurrence in Senate Amendments",77,0,3,0,80
1092405,742946,2018-04-23,Senate,"Do pass as amended, but first amend, and re-refer to the Committee on [Appropriations]",4,0,1,0,5
1092405,749983,2018-05-07,Senate,"Placed on suspense file",6,0,1,0,7
1092405,756215,2018-05-25,Senate,"Do pass as amended",7,0,0,0,7
1092405,757677,2018-05-30,Senate,"Senate 3rd Reading SB1413 Nielsen",38,0,1,0,39
1092405,766009,2018-06-20,Assembly,"Do pass as amended and be re-referred to the Committee on [Appropriations]",6,0,1,0,7
1092405,771544,2018-08-16,Assembly,"Do pass",17,0,0,0,17
1092405,774182,2018-08-31,Senate,"Unfinished Business SB1413 Nielsen et al. Concurrence",39,0,1,0,40
1092405,774183,2018-08-31,Assembly,"SB 1413 Nielsen Senate Third Reading By GONZALEZ FLETCHER",80,0,0,0,80
1092408,770975,2018-08-07,Senate,"Do pass, but first be re-referred to the Committee on [Appropriations]",6,0,1,0,7
1092408,771241,2018-08-13,Senate,"Placed on suspense file",7,0,0,0,7
1092409,741186,2018-04-18,Assembly,"Do pass and be re-referred to the Committee on [Appropriations]",5,1,1,0,7
1092409,756518,2018-05-25,Assembly,"Do pass",12,4,1,0,17
1092409,757791,2018-05-30,Assembly,"AB 2868 SANTIAGO Assembly Third Reading",50,27,1,0,78
1092410,743163,2018-04-24,Assembly,"Do pass as amended and be re-referred to the Committee on [Appropriations]",15,0,0,0,15
1092410,751105,2018-05-09,Assembly,"Do pass. To Consent Calendar",16,0,1,0,17
1092410,754261,2018-05-17,Assembly,"AB 3032 FRAZIER Consent Calendar Second Day Regular Session",73,0,5,0,78
1092410,768953,2018-06-27,Senate,"Do pass, but first be re-referred to the Committee on [Appropriations]",9,0,0,0,9
1092410,772501,2018-08-23,Senate,"Assembly 3rd Reading AB3032 Frazier By Leyva",39,0,1,0,40
1092410,773518,2018-08-29,Assembly,"AB 3032 FRAZIER Concurrence in Senate Amendments",80,0,0,0,80
1092410,774545,2018-08-23,Senate,,9,0,1,0,10
1092411,744336,2018-04-24,Assembly,"Do pass and be re-referred to the Committee on [Appropriations]",7,0,0,0,7
1092411,756624,2018-05-25,Assembly,"Do pass as amended",16,0,1,0,17
1092411,757825,2018-05-30,Assembly,"AB 3006 STONE Assembly Third Reading",77,0,1,0,78
1092412,742266,2018-04-23,Senate,"Do pass, but first be re-referred to the Committee on [Appropriations]",8,1,0,0,9
1092412,755314,2018-05-22,Senate,"Placed on suspense file",7,0,0,0,7
1092412,756601,2018-05-25,Senate,"Do pass as amended",5,2,0,0,7
1092412,757816,2018-05-30,Senate,"Senate 3rd Reading SB1465 Hill et al",28,8,3,0,39
1092412,768173,2018-06-26,Assembly,"Do pass as amended and be re-referred to the Committee on [Appropriations]",17,0,2,0,19
1092412,771740,2018-08-16,Assembly,"Do pass as amended",12,0,5,0,17
1092412,773896,2018-08-30,Assembly,"SB 1465 Hill Senate Third Reading By EGGMAN",79,0,1,0,80
1092412,774051,2018-08-31,Senate,"Unfinished Business SB1465 Hill et al. Concurrence",32,6,2,0,40
1092414,734017,2018-04-04,Senate,"Do pass, but first be re-referred to the Committee on [Appropriations] with the recommendation: To Consent Calendar",6,0,0,0,6
1092414,738903,2018-04-16,Senate,"Placed on suspense file",7,0,0,0,7
1092416,740676,2018-04-17,Assembly,"Do pass and be re-referred to the Committee on [Appropriations]",11,4,0,0,15
1092416,756369,2018-05-25,Assembly,"Do pass as amended",12,4,1,0,17
1092416,757599,2018-05-30,Assembly,"AB 2965 ARAMBULA Assembly Third Reading",47,25,6,0,78
1092416,765966,2018-06-20,Senate,"Do pass, but first be re-referred to the Committee on [Appropriations]",7,1,1,0,9
1092416,770580,2018-08-06,Senate,"Placed on suspense file",7,0,0,0,7
1092417,733186,2018-04-03,Senate,"Do pass, but first be re-referred to the Committee on [Public Safety]",4,0,1,0,5
1092417,742934,2018-04-24,Senate,"Do pass, but first be re-referred to the Committee on [Appropriations]",7,0,0,0,7
1092417,752624,2018-05-14,Senate,"Placed on suspense file",7,0,0,0,7
1092417,756182,2018-05-25,Senate,"Do pass as amended",7,0,0,0,7
1092417,757690,2018-05-30,Senate,"Senate 3rd Reading SB1409 Wilk et al",37,0,2,0,39
1092417,765123,2018-06-19,Assembly,"Do pass and be re-referred to the Committee on [Agriculture]",7,0,0,0,7
1092417,768877,2018-06-27,Assembly,"Do pass and be re-referred to the Committee on [Appropriations]",9,0,1,0,10
1092417,771845,2018-08-16,Assembly,"Do pass",17,0,0,0,17
1092417,774015,2018-08-31,Senate,"Unfinished Business SB1409 Wilk et al. Concurrence",39,0,1,0,40
1092417,774016,2018-08-31,Assembly,"SB 1409 Wilk Senate Third Reading By CABALLERO",75,1,4,0,80
1092418,733192,2018-04-03,Assembly,"Do pass and be re-referred to the Committee on [Judiciary]",8,2,0,0,10
1092418,736063,2018-04-10,Assembly,"Do pass",8,1,1,0,10
1092418,741340,2018-04-19,Assembly,"AB 2943 LOW Assembly Third Reading",50,18,10,0,78
1092418,762940,2018-06-12,Senate,"Do pass, but first be re-referred to the Committee on [Appropriations]",5,2,0,0,7
1092418,771590,2018-08-16,Senate,"Assembly 3rd Reading AB2943 Low et al. By Wiener",25,11,4,0,40
1092418,774574,2018-04-03,Assembly,?,0,2,0,0,2
1092419,740483,2018-04-18,Senate,"[First] hearing set for [04-18-2018]: Failed passage in Committee. Reconsideration granted",7,0,0,0,7
1092419,740484,2018-04-18,Senate,"Do pass, but first be re-referred to the Committee on [Governance and Finance]",2,5,0,0,7
1092421,738916,2018-04-16,Assembly,"Do pass as amended and be re-referred to the Committee on [Local Government]",7,0,3,0,10
1092421,744895,2018-04-25,Assembly,"Do pass and be re-referred to the Committee on [Appropriations]",7,0,2,0,9
1092421,756322,2018-05-25,Assembly,"Do pass",12,2,3,0,17
1092421,757587,2018-05-30,Assembly,"AB 2911 FRIEDMAN Assembly Third Reading",56,16,6,0,78
1092421,768336,2018-06-26,Senate,"Do pass, but first be re-referred to the Committee on [Governance and Finance]",7,2,0,0,9
1092421,769211,2018-06-27,Senate,"Do pass as amended, but first amend, and re-refer to the Committee on [Appropriations]",7,0,0,0,7
1092421,771261,2018-08-13,Senate,"Placed on suspense file",7,0,0,0,7
1092421,771954,2018-08-16,Senate,"Do pass",5,2,0,0,7
1092421,773520,2018-08-29,Senate,"Assembly 3rd Reading AB2911 Friedman By Cannella",29,8,3,0,40
1092421,774027,2018-08-31,Assembly,"AB 2911 FRIEDMAN Concurrence in Senate Amendments",61,15,4,0,80
1092422,739908,2018-04-17,Assembly,"Do pass and be re-referred to the Committee on [Appropriations]",11,0,2,0,13
1092423,736110,2018-04-09,Assembly,"Do pass as amended and be re-referred to the Committee on [Appropriations]",8,0,2,0,10
1092423,743918,2018-04-25,Assembly,"Do pass. To Consent Calendar",17,0,0,0,17
1092423,748763,2018-05-03,Assembly,"AB 2944 JONES-SAWYER Consent Calendar Second Day Regular Session",71,0,7,0,78
1092423,762849,2018-06-13,Senate,"Do pass as amended, but first amend, and re-refer to the Committee on [Appropriations]",7,0,0,0,7
1092423,769546,2018-07-02,Senate,"Do pass",7,0,0,0,7
1092423,771305,2018-08-13,Senate,"Special Consent AB2944",37,0,3,0,40
1092423,772181,2018-08-20,Assembly,"AB 2944 JONES-SAWYER Concurrence in Senate Amendments",79,0,1,0,80
1092424,740731,2018-04-17,Assembly,"Do pass and be re-referred to the Committee on [Banking and Finance]",7,3,0,0,10
1092424,742239,2018-04-23,Assembly,"Do pass and be re-referred to the Committee on [Appropriations]",8,2,1,0,11
1092424,756745,2018-05-25,Assembly,"Do pass",12,4,1,0,17
1092424,758733,2018-05-31,Assembly,"AB 3207 LIMÓN Assembly Third Reading",48,26,4,0,78
1092424,769309,2018-06-27,Senate,"Do pass as amended, but first amend, and re-refer to the Committee on [Appropriations]",5,1,1,0,7
1092424,770846,2018-08-06,Senate,"Placed on suspense file",7,0,0,0,7
1092425,742217,2018-04-23,Senate,"Do pass as amended, but first amend, and re-refer to the Committee on [Appropriations]",9,0,0,0,9
1092425,755304,2018-05-22,Senate,"Placed on suspense file",7,0,0,0,7
1092425,756634,2018-05-25,Senate,"Do pass",7,0,0,0,7
1092425,757102,2018-05-29,Senate,"Senate 3rd Reading SB1483 Hill",38,0,1,0,39
1092425,768395,2018-06-26,Assembly,"Do pass and be re-referred to the Committee on [Appropriations]",19,0,0,0,19
1092425,771806,2018-08-16,Assembly,"Do pass as amended",17,0,0,0,17
1092425,773798,2018-08-30,Assembly,"SB 1483 Hill Senate Third Reading By LOW",80,0,0,0,80
1092425,773994,2018-08-31,Senate,"Unfinished Business SB1483 Hill et al. Concurrence",39,0,1,0,40
1092426,753815,2018-05-16,Senate,"Do pass, but first be re-referred to the Committee on [Appropriations]",1,3,3,0,7
1092426,753816,2018-05-16,Senate,"[05-16-2018] hearing: Motion to Reconsider. [Reconsideration Granted.]",7,0,0,0,7
1092427,743109,2018-04-24,Senate,"Do pass, but first be re-referred to the Committee on [Appropriations]",6,1,0,0,7
1092427,752709,2018-05-14,Senate,"Placed on suspense file",7,0,0,0,7
1092427,756364,2018-05-25,Senate,"Do pass as amended",5,2,0,0,7
1092427,757503,2018-05-30,Senate,"Senate 3rd Reading SB1437 Skinner et al",26,11,2,0,39
1092427,768258,2018-06-26,Assembly,"Do pass and be re-referred to the Committee on [Appropriations]",5,2,0,0,7
1092427,771768,2018-08-16,Assembly,"Do pass as amended",12,1,4,0,17
1092427,773403,2018-08-29,Assembly,"SB 1437 Skinner Senate Third Reading By MEDINA",42,36,2,0,80
1092427,773744,2018-08-30,Senate,"Unfinished Business SB1437 Skinner et al. Concurrence",27,10,3,0,40
1092428,739708,2018-04-17,Assembly,"Do pass and be re-referred to the Committee on [Appropriations]",16,0,0,0,16
1092428,751096,2018-05-09,Assembly,"Do pass. To Consent Calendar",16,0,1,0,17
1092428,754278,2018-05-17,Assembly,"AB 2929 QUIRK Consent Calendar Second Day Regular Session",73,0,5,0,78
1092430,727676,2018-03-21,Assembly,"Do pass as amended and be re-referred to the Committee on [Veterans Affairs]",6,0,1,0,7
1092430,737422,2018-04-10,Assembly,"Do pass and be re-referred to the Committee on [Appropriations]",10,0,0,0,10
1092430,743719,2018-04-25,Assembly,"Do pass. To Consent Calendar",17,0,0,0,17
1092430,748566,2018-05-03,Assembly,"AB 2949 GLORIA Consent Calendar Second Day Regular Session",71,0,7,0,78
1092430,760325,2018-06-06,Senate,"Do pass as amended, but first amend, and re-refer to the Committee on [Veterans Affairs] with the recommendation: To Consent Calendar",6,0,0,0,6
1092430,768157,2018-06-26,Senate,"Do pass, but first be re-referred to the Committee on [Appropriations] with the recommendation: To Consent Calendar",6,0,0,0,6
1092430,771289,2018-08-13,Senate,"Consent Calendar AB2949",37,0,3,0,40
1092430,772196,2018-08-20,Assembly,"AB 2949 GLORIA Concurrence in Senate Amendments",80,0,0,0,80
1092431,743146,2018-04-24,Assembly,"Do pass as amended and be re-referred to the Committee on [Appropriations]",15,0,1,0,16
1092431,756507,2018-05-25,Assembly,"Do pass",16,0,1,0,17
1092431,757798,2018-05-30,Assembly,"AB 3142 B. & P. Assembly Third Reading By LOW",77,0,1,0,78
1092431,767995,2018-06-25,Senate,"Do pass, but first be re-referred to the Committee on [Appropriations]",9,0,0,0,9
1092431,770853,2018-08-06,Senate,"Placed on suspense file",7,0,0,0,7
1092431,772001,2018-08-16,Senate,"Do pass",7,0,0,0,7
1092431,772931,2018-08-27,Senate,"Assembly 3rd Reading AB3142 Low et al. By Hill",38,0,2,0,40
1092431,773545,2018-08-29,Assembly,"AB 3142 LOW Concurrence in Senate Amendments",80,0,0,0,80
1092432,742200,2018-04-23,Senate,"Do pass, but first be re-referred to the Committee on [Appropriations]",9,0,0,0,9
1092432,755344,2018-05-22,Senate,"Placed on suspense file",7,0,0,0,7
1092432,756658,2018-05-25,Senate,"Do pass",7,0,0,0,7
1092432,757112,2018-05-29,Senate,"Senate 3rd Reading SB1481 Hill",38,0,1,0,39
1092432,765114,2018-06-19,Assembly,"Do pass and be re-referred to the Committee on [Environmental Safety and Toxic Materials]",17,0,2,0,19
1092432,768373,2018-06-26,Assembly,"Do pass and be re-referred to the Committee on [Appropriations]",6,0,1,0,7
1092432,771804,2018-08-16,Assembly,"Do pass as amended",12,0,5,0,17
1092432,773901,2018-08-30,Assembly,"SB 1481 Hill Senate Third Reading By LOW",80,0,0,0,80
1092432,773984,2018-08-31,Senate,"Unfinished Business SB1481 Hill et al. Concurrence",39,0,1,0,40
1092434,736145,2018-04-10,Senate,"Do pass, but first be re-referred to the Committee on [Judiciary] with the recommendation: To Consent Calendar",6,0,1,0,7
1092434,743741,2018-04-24,Senate,"Do pass, but first be re-referred to the Committee on [Appropriations] with the recommendation: To Consent Calendar",7,0,0,0,7
1092434,754245,2018-05-17,Senate,"Consent Calendar SB1274",38,0,1,0,39
1092434,762147,2018-06-12,Assembly,"Do pass and be re-referred to the Committee on [Privacy and Consumer Protection] with recommendation: To Consent Calendar",7,0,0,0,7
1092434,765180,2018-06-19,Assembly,"Do pass as amended, and be re-referred to the Committee on [Appropriations] with recommendation: To Consent Calendar",10,0,0,0,10
1092434,771065,2018-08-08,Assembly,"Do pass. To Consent Calendar",17,0,0,0,17
1092434,772536,2018-08-23,Assembly,"SB 1274 McGuire Senate Third Reading By RUBIO",79,0,1,0,80
1092434,772697,2018-08-24,Senate,"Unfinished Business SB1274 McGuire Concurrence",39,0,1,0,40
1092436,751819,2018-05-09,Assembly,"Do pass. To Consent Calendar",7,0,0,0,7
1092436,754199,2018-05-17,Assembly,"AB 2835 CALDERON Consent Calendar Second Day Regular Session",73,0,5,0,78
1092436,760474,2018-06-06,Senate,"Do pass and be ordered to the Consent Calendar",5,0,0,0,5
1092436,763628,2018-06-14,Senate,"Consent Calendar AB2835",37,0,2,0,39
1092438,743853,2018-04-25,Assembly,"Do pass and be re-referred to the Committee on [Appropriations] with recommendation: To Consent Calendar",7,0,0,0,7
1092438,756750,2018-05-25,Assembly,"Do pass",15,1,1,0,17
1092438,757776,2018-05-30,Assembly,"AB 3179 SALAS Assembly Third Reading",75,0,3,0,78
1092438,768502,2018-06-26,Senate,"Do pass, but first be re-referred to the Committee on [Appropriations] with the recommendation: To Consent Calendar",13,0,0,0,13
1092438,770770,2018-08-06,Senate,"Placed on suspense file",7,0,0,0,7
1092438,772058,2018-08-16,Senate,"Do pass",7,0,0,0,7
1092438,773000,2018-08-27,Senate,"Assembly 3rd Reading AB3179 Salas et al. By Nielsen",38,0,2,0,40
1092439,741700,2018-04-18,Assembly,"Do pass and be re-referred to the Committee on [Appropriations]",7,0,0,0,7
1092440,744153,2018-04-25,Assembly,"Do pass and be re-referred to the Committee on [Appropriations]",2,5,0,0,7
1092441,740868,2018-04-17,Assembly,"Do pass and be re-referred to the Committee on [Appropriations] with recommendation: To Consent Calendar",15,0,0,0,15
1092441,756609,2018-05-25,Assembly,"Do pass",16,0,1,0,17
1092441,757824,2018-05-30,Assembly,"AB 2976 QUIRK Assembly Third Reading",78,0,0,0,78
1092441,768707,2018-06-27,Senate,"Do pass as amended, but first amend, and re-refer to the Committee on [Appropriations] with the recommendation: To Consent Calendar",9,0,0,0,9
1092441,771414,2018-08-13,Senate,"Placed on suspense file",7,0,0,0,7
1092445,742965,2018-04-24,Assembly,"Do pass and be re-referred to the Committee on [Appropriations]",6,9,0,0,15
1092445,742966,2018-04-24,Assembly,Reconsideration,15,0,0,0,15
1092446,738192,2018-04-11,Assembly,"Do pass and be re-referred to the Committee on [Appropriations]",5,0,2,0,7
1092446,756498,2018-05-25,Assembly,"Do pass as amended",12,3,2,0,17
1092446,757720,2018-05-30,Assembly,"AB 3167 O'DONNELL Assembly Third Reading",50,21,7,0,78
1092446,768759,2018-06-27,Senate,"Do pass, but first be re-referred to the Committee on [Appropriations]",5,2,0,0,7
1092446,770353,2018-08-06,Senate,"Placed on suspense file",7,0,0,0,7
1092447,733175,2018-04-02,Assembly,"Do pass and be re-referred to the Committee on [Appropriations] with recommendation: To Consent Calendar",11,0,0,0,11
1092447,737442,2018-04-11,Assembly,"Do pass. To Consent Calendar",15,0,2,0,17
1092447,741463,2018-04-19,Assembly,"AB 2862 LIMÓN Consent Calendar Second Day Regular Session",71,0,7,0,78
1092447,766299,2018-06-20,Senate,"Do pass, but first be re-referred to the Committee on [Appropriations] with the recommendation: To Consent Calendar",7,0,0,0,7
1092447,771306,2018-08-13,Senate,"Consent Calendar AB2862",37,0,3,0,40
1092447,772534,2018-08-23,Assembly,"AB 2862 LIMÓN Concurrence in Senate Amendments",79,0,1,0,80
1092448,742922,2018-04-24,Senate,"Do pass as amended, but first amend, and re-refer to the Committee on [Appropriations]",10,0,2,0,12
1092448,752912,2018-05-14,Senate,"Placed on suspense file",7,0,0,0,7
1092449,743890,2018-04-25,Assembly,"Do pass and be re-referred to the Committee on [Local Government]",6,1,0,0,7
1092449,744686,2018-04-25,Assembly,"Do pass as amended and be re-referred to the Committee on [Appropriations]",6,2,1,0,9
1092449,756282,2018-05-25,Assembly,"Do pass as amended",12,1,4,0,17
1092449,757652,2018-05-30,Assembly,"AB 2890 TING Assembly Third Reading",53,17,8,0,78
1092449,765188,2018-06-19,Senate,"Do pass, but first be re-referred to the Committee on [Governance and Finance]",10,2,1,0,13
1092449,769190,2018-06-27,Senate,"Do pass as amended, but first amend, and re-refer to the Committee on [Appropriations]",5,1,1,0,7
1092449,770286,2018-08-06,Senate,"Placed on suspense file",7,0,0,0,7
1092450,742303,2018-04-23,Senate,"Do pass, but first be re-referred to the Committee on [Appropriations]",9,0,0,0,9
1092450,755258,2018-05-22,Senate,"Placed on suspense file",7,0,0,0,7
1092450,756671,2018-05-25,Senate,"Do pass",7,0,0,0,7
1092450,757116,2018-05-29,Senate,"Senate 3rd Reading SB1447 Hernandez et al",37,1,1,0,39
1092450,768299,2018-06-26,Assembly,"Do pass as amended and be re-referred to the Committee on [Appropriations]",19,0,0,0,19
1092450,771584,2018-08-16,Assembly,"Do pass as amended",12,0,5,0,17
1092450,773782,2018-08-30,Assembly,"SB 1447 Hernandez Senate Third Reading By BONTA",74,0,6,0,80
1092450,774006,2018-08-31,Senate,"Unfinished Business SB1447 Hernandez et al. Concurrence",37,1,2,0,40
1092451,742190,2018-04-23,Senate,"Do pass, but first be re-referred to the Committee on [Appropriations]",8,1,0,0,9
1092451,752816,2018-05-14,Senate,"Placed on suspense file",7,0,0,0,7
1092451,756756,2018-05-25,Senate,"Do pass",5,2,0,0,7
1092451,757133,2018-05-29,Senate,"Senate 3rd Reading SB1294 Bradford",28,9,2,0,39
1092451,768161,2018-06-26,Assembly,"Do pass and be re-referred to the Committee on [Appropriations]",13,5,1,0,19
1092451,771639,2018-08-16,Assembly,"Do pass",12,4,1,0,17
1092451,774190,2018-08-31,Senate,"Unfinished Business SB1294 Bradford et al. Concurrence",28,10,2,0,40
1092451,774191,2018-08-31,Assembly,"SB 1294 Bradford Senate Third Reading By COOLEY",60,16,4,0,80
1092453,734593,2018-04-05,Assembly,"Be re-referred to the Committee on [Public Employees, Retirement, and Social Security]",8,0,3,0,11
1092453,740729,2018-04-18,Assembly,"Do pass and be re-referred to the Committee on [Appropriations]",5,1,1,0,7
1092453,756500,2018-05-25,Assembly,"Do pass as amended",12,3,2,0,17
1092453,757808,2018-05-30,Assembly,"AB 2830 REYES Assembly Third Reading",52,23,3,0,78
1092453,761678,2018-06-11,Senate,"Do pass as amended, but first amend, and re-refer to the Committee on [Human Services]",4,0,1,0,5
1092453,769030,2018-06-26,Senate,"Do pass, but first be re-referred to the Committee on [Appropriations]",5,0,2,0,7
1092453,770933,2018-08-06,Senate,"Placed on suspense file",7,0,0,0,7
1092453,772051,2018-08-16,Senate,"Do pass",5,2,0,0,7
1092453,772260,2018-08-20,Senate,"Assembly 3rd Reading AB2830 Reyes By Wiener",27,11,2,0,40
1092453,772591,2018-08-23,Assembly,"AB 2830 REYES Concurrence in Senate Amendments",55,9,16,0,80
1092454,743725,2018-04-25,Assembly,"Do pass and be re-referred to the Committee on [Appropriations]",6,0,1,0,7
1092455,739967,2018-04-16,Assembly,"Do pass and be re-referred to the Committee on [Appropriations]",7,2,2,0,11
1092456,750755,2018-05-08,Assembly,"Do pass as amended",9,0,1,0,10
1092456,754395,2018-05-17,Assembly,"AB 3109 STONE Assembly Third Reading",70,0,8,0,78
1092456,769730,2018-07-03,Senate,"Do pass and be ordered to the Consent Calendar",7,0,0,0,7
1092456,771419,2018-08-13,Senate,"Consent Calendar AB3109",37,0,3,0,40
1092456,772267,2018-08-20,Assembly,"AB 3109 STONE Concurrence in Senate Amendments",80,0,0,0,80
1092457,740741,2018-04-17,Assembly,"Do pass and be re-referred to the Committee on [Appropriations] with recommendation: To Consent Calendar",10,0,0,0,10
1092458,744492,2018-04-25,Assembly,"Do pass as amended and be re-referred to the Committee on [Appropriations]",14,0,1,0,15
1092458,753898,2018-05-16,Assembly,"Do pass. To Consent Calendar",17,0,0,0,17
1092458,756226,2018-05-25,Assembly,"AB 3187 GRAYSON Consent Calendar Second Day Regular Session",70,0,8,0,78
1092458,764802,2018-06-19,Senate,"Do pass, but first be re-referred to the Committee on [Appropriations]",11,0,0,0,11
1092458,770575,2018-08-06,Senate,"Placed on suspense file",7,0,0,0,7
1092458,772044,2018-08-16,Senate,"Do pass as amended",7,0,0,0,7
1092458,772869,2018-08-27,Senate,"Assembly 3rd Reading AB3187 Grayson et al. By Hueso",39,0,1,0,40
1092458,773549,2018-08-29,Assembly,"AB 3187 GRAYSON Concurrence in Senate Amendments",80,0,0,0,80
1092459,751368,2018-05-09,Assembly,"Do pass as amended. To Consent Calendar",6,0,1,0,7
1092459,756252,2018-05-25,Assembly,"AB 2826 FRIEDMAN Consent Calendar Second Day",70,0,8,0,78
1092459,762728,2018-06-13,Senate,"Do pass as amended, and be ordered to the Consent Calendar",7,0,0,0,7
1092459,772928,2018-08-27,Senate,"Assembly 3rd Reading AB2826 Friedman By Bradford",39,0,1,0,40
1092459,773560,2018-08-29,Assembly,"AB 2826 FRIEDMAN Concurrence in Senate Amendments",80,0,0,0,80
1092462,739797,2018-04-17,Senate,"Do pass, but first be re-referred to the Committee on [Appropriations]",3,1,1,0,5
1092462,746092,2018-04-30,Senate,"Placed on suspense file",6,0,1,0,7
1092464,739824,2018-04-17,Assembly,"Do pass and be re-referred to the Committee on [Appropriations]",12,3,1,0,16
1092464,751332,2018-05-09,Assembly,"Do pass",11,5,1,0,17
1092464,754350,2018-05-17,Assembly,"AB 2980 GIPSON Assembly Third Reading",48,21,9,0,78
1092464,767925,2018-06-25,Senate,"Do pass, but first be re-referred to the Committee on [Appropriations]",8,1,0,0,9
1092464,772353,2018-08-21,Senate,"Assembly 3rd Reading AB2980 Gipson By Portantino",29,9,2,0,40
1092464,772354,2018-08-21,Senate,"Assembly 3rd Reading AB2980 Gipson By Portantino Reconsider",39,0,1,0,40
1092464,773207,2018-08-28,Senate,"Assembly 3rd Reading AB2980 Gipson By Portantino",28,10,2,0,40
1092464,773599,2018-08-29,Assembly,"AB 2980 GIPSON Concurrence in Senate Amendments",54,22,4,0,80
1092465,743166,2018-04-23,Assembly,"Do pass and be re-referred to the Committee on [Appropriations]",7,3,0,0,10
1092465,756655,2018-05-25,Assembly,"Do pass as amended",12,4,1,0,17
1092465,758691,2018-05-31,Assembly,"AB 3146 HOLDEN Assembly Third Reading",30,35,13,0,78
1092466,735747,2018-04-09,Assembly,"Do pass and be re-referred to the Committee on [Appropriations]",13,0,1,0,14
1092468,740372,2018-04-16,Assembly,"Do pass as amended and be re-referred to the Committee on [Local Government]",8,0,2,0,10
1092468,744896,2018-04-25,Assembly,"Do pass and be re-referred to the Committee on [Appropriations]",7,0,2,0,9
1092468,751692,2018-05-09,Assembly,"Do pass",12,0,5,0,17
1092468,752693,2018-05-14,Assembly,"AB 3160 GRAYSON Assembly Third Reading",58,2,18,0,78
1092469,742884,2018-04-24,Assembly,"Do pass",4,0,3,0,7
1092469,754911,2018-05-21,Assembly,"AB 2888 TING Assembly Third Reading",48,25,5,0,78
1092469,765195,2018-06-19,Senate,"Do pass, but first be re-referred to the Committee on [Appropriations]",5,2,0,0,7
1092469,769590,2018-07-02,Senate,"Placed on suspense file",7,0,0,0,7
1092469,771899,2018-08-16,Senate,"Do pass",5,2,0,0,7
1092469,773226,2018-08-28,Senate,"Assembly 3rd Reading AB2888 Ting et al. By Skinner",25,12,3,0,40
1092470,743167,2018-04-24,Assembly,"Do pass as amended and be re-referred to the Committee on [Appropriations]",11,4,0,0,15
1092471,739828,2018-04-17,Assembly,"Do pass and be re-referred to the Committee on [Appropriations]",5,2,0,0,7
1092471,756439,2018-05-25,Assembly,"Do pass",12,4,1,0,17
1092471,757619,2018-05-30,Assembly,"AB 2845 BONTA Assembly Third Reading",46,29,3,0,78
1092471,768221,2018-06-26,Senate,"Do pass, but first be re-referred to the Committee on [Appropriations]",4,2,1,0,7
1092471,770847,2018-08-06,Senate,"Placed on suspense file",7,0,0,0,7
1092471,772087,2018-08-16,Senate,"Do pass as amended",5,2,0,0,7
1092471,773355,2018-08-29,Senate,"Assembly 3rd Reading AB2845 Bonta By Pan",25,12,3,0,40
1092471,773730,2018-08-30,Assembly,"AB 2845 BONTA Concurrence in Senate Amendments",45,30,5,0,80
1092472,750737,2018-05-08,Assembly,"Do pass as amended",16,0,2,0,18
1092472,754965,2018-05-21,Assembly,"AB 3069 COOPER Assembly Third Reading",69,0,9,0,78
1092472,767906,2018-06-25,Senate,"Do pass as amended",9,0,0,0,9
1092472,771157,2018-08-09,Senate,"Assembly 3rd Reading AB3069 Cooper By McGuire",35,0,4,0,39
1092472,771158,2018-08-09,Senate,"Assembly 3rd Reading AB3069 Cooper By McGuire Reconsider",35,0,4,0,39
1092472,771159,2018-08-09,Senate,"Assembly 3rd Reading AB3069 Cooper By McGuire",33,1,5,0,39
1092472,771300,2018-08-13,Assembly,"AB 3069 COOPER Concurrence in Senate Amendments",73,1,6,0,80
1092473,739608,2018-04-17,Assembly,"Do pass and be re-referred to the Committee on [Revenue and Taxation]",7,0,0,0,7
1092473,753278,2018-05-14,Assembly,"Do pass and be re-referred to the Committee on [Appropriations]",8,1,1,0,10
1092474,743137,2018-04-24,Assembly,"Do pass and be re-referred to the Committee on [Appropriations]",15,0,1,0,16
1092474,751797,2018-05-09,Assembly,"Do pass. To Consent Calendar",16,0,1,0,17
1092474,754195,2018-05-17,Assembly,"AB 3143 B. & P. Consent Calendar Second Day Regular Session",73,0,5,0,78
1092474,767900,2018-06-25,Senate,"Do pass, but first be re-referred to the Committee on [Appropriations]",8,0,1,0,9
1092474,770917,2018-08-06,Senate,"Placed on suspense file",7,0,0,0,7
1092474,772091,2018-08-16,Senate,"Do pass",7,0,0,0,7
1092474,772791,2018-08-27,Senate,"Assembly 3rd Reading AB3143 Low et al. By Hill",39,0,1,0,40
1092474,773267,2018-08-29,Assembly,"With recommendation: That Senate amendments be concurred in",15,0,4,0,19
1092474,773683,2018-08-30,Assembly,"AB 3143 LOW Concurrence in Senate Amendments",80,0,0,0,80
1092476,741261,2018-04-17,Assembly,"Do pass and be re-referred to the Committee on [Appropriations]",13,1,1,0,15
1092477,739890,2018-04-17,Assembly,"Do pass and be re-referred to the Committee on [Appropriations]",13,0,0,0,13
1092477,747621,2018-05-02,Assembly,"Do pass. To Consent Calendar",17,0,0,0,17
1092477,752001,2018-05-10,Assembly,"AB 3101 CARRILLO Consent Calendar Second Day Regular Session",73,0,5,0,78
1092477,760355,2018-06-06,Senate,"Do pass, but first be re-referred to the Committee on [Appropriations]",6,0,0,0,6
1092477,767854,2018-06-25,Senate,"Placed on suspense file",7,0,0,0,7
1092477,771632,2018-08-16,Senate,"Do pass as amended",7,0,0,0,7
1092477,773581,2018-08-29,Senate,"Assembly 3rd Reading AB3101 Carrillo By Lara",39,0,1,0,40
1092477,773861,2018-08-30,Assembly,"AB 3101 CARRILLO Concurrence in Senate Amendments",80,0,0,0,80
1092478,743970,2018-04-24,Senate,"Do pass, but first be re-referred to the Committee on [Labor and Industrial Relations]",4,2,1,0,7
1092478,743971,2018-04-24,Senate,"[04-25-2018] set for [First] hearing: Reconsideration of favorable vote granted",7,0,0,0,7
1092478,743972,2018-04-24,Senate,"Do pass, but first be re-referred to the Committee on [Labor and Industrial Relations]",5,2,0,0,7
1092478,743973,2018-04-25,Senate,"Do pass, but first be re-referred to the Committee on [Appropriations]",4,1,0,0,5
1092478,750027,2018-05-07,Senate,"Placed on suspense file",6,0,1,0,7
1092478,756376,2018-05-25,Senate,"Do pass as amended",5,2,0,0,7
1092478,757586,2018-05-30,Senate,"Senate 3rd Reading SB1402 Lara et al",24,12,3,0,39
1092478,767123,2018-06-20,Assembly,"Do pass and be re-referred to the Committee on [Judiciary]",5,2,0,0,7
1092478,768141,2018-06-26,Assembly,"Do pass and be re-referred to the Committee on [Appropriations]",7,2,1,0,10
1092478,771592,2018-08-16,Assembly,"Do pass as amended",12,5,0,0,17
1092478,773834,2018-08-30,Assembly,"SB 1402 Lara Senate Third Reading By GONZALEZ FLETCHER",53,26,1,0,80
1092478,774029,2018-08-31,Senate,"Unfinished Business SB1402 Lara et al. Concurrence",26,12,2,0,40
1092479,733203,2018-04-03,Senate,"Do pass, but first be re-referred to the Committee on [Appropriations]",5,1,1,0,7
1092479,742076,2018-04-23,Senate,"Placed on suspense file",7,0,0,0,7
1092479,756374,2018-05-25,Senate,"Do pass as amended",5,2,0,0,7
1092479,757654,2018-05-30,Senate,"Senate 3rd Reading SB1391 Lara et al",23,15,1,0,39
1092479,768300,2018-06-26,Assembly,"Do pass and be re-referred to the Committee on [Appropriations]",5,2,0,0,7
1092479,771617,2018-08-16,Assembly,"Do pass as amended",12,0,5,0,17
1092479,773474,2018-08-29,Assembly,"SB 1391 Lara Senate Third Reading By CHIU",41,23,16,0,80
1092479,773876,2018-08-30,Senate,"Unfinished Business SB1391 Lara et al. Concurrence",23,15,2,0,40
1092480,733792,2018-04-04,Assembly,"Do pass and be re-referred to the Committee on [Judiciary]",12,0,1,0,13
1092480,739769,2018-04-17,Assembly,"Do pass as amended and be re-referred to the Committee on [Appropriations]",10,0,0,0,10
1092480,756402,2018-05-25,Assembly,"Do pass",15,1,1,0,17
1092480,757528,2018-05-30,Assembly,"AB 2802 FRIEDMAN Assembly Third Reading",74,3,1,0,78
1092480,768924,2018-06-26,Senate,"Do pass, but first be re-referred to the Committee on [Insurance]",7,0,0,0,7
1092480,769258,2018-06-27,Senate,"Do pass as amended, but first amend, and re-refer to the Committee on [Appropriations]",12,0,1,0,13
1092480,770382,2018-08-06,Senate,"Placed on suspense file",7,0,0,0,7
1092480,771858,2018-08-16,Senate,"Do pass",7,0,0,0,7
1092480,773202,2018-08-28,Senate,"Assembly 3rd Reading AB2802 Friedman By Jackson",39,0,1,0,40
1092480,773551,2018-08-29,Assembly,"AB 2802 FRIEDMAN Concurrence in Senate Amendments",77,2,1,0,80
1092484,743954,2018-04-25,Senate,"Do pass, but first be re-referred to the Committee on [Appropriations]",8,0,1,0,9
1092484,755361,2018-05-22,Senate,"Placed on suspense file",7,0,0,0,7
1092485,743189,2018-04-24,Assembly,"Do pass as amended and be re-referred to the Committee on [Appropriations]",16,0,0,0,16
1092485,751399,2018-05-09,Assembly,"Do pass. To Consent Calendar",16,0,1,0,17
1092485,754352,2018-05-17,Assembly,"AB 2994 HOLDEN Consent Calendar Second Day Regular Session",73,0,5,0,78
1092485,765172,2018-06-19,Senate,"Do pass as amended, but first amend, and re-refer to the Committee on [Appropriations] with the recommendation: To Consent Calendar",12,0,1,0,13
1092485,770848,2018-08-06,Senate,"Do pass",7,0,0,0,7
1092485,772732,2018-08-24,Senate,"Assembly 3rd Reading AB2994 Holden By Portantino",39,0,1,0,40
1092485,773508,2018-08-29,Assembly,"AB 2994 HOLDEN Concurrence in Senate Amendments",78,0,2,0,80
1092486,740929,2018-04-17,Assembly,"Do pass and be re-referred to the Committee on [Governmental Organization]",10,0,0,0,10
1092486,740930,2018-04-18,Assembly,"Do pass and be re-referred to the Committee on [Appropriations]",21,0,0,0,21
1092486,756458,2018-05-25,Assembly,"Do pass",16,0,1,0,17
1092486,757792,2018-05-30,Assembly,"AB 2813 IRWIN Assembly Third Reading",78,0,0,0,78
1092486,768323,2018-06-26,Senate,"Do pass, but first be re-referred to the Committee on [Appropriations]",13,0,0,0,13
1092486,770940,2018-08-06,Senate,"Placed on suspense file",7,0,0,0,7
1092486,772034,2018-08-16,Senate,"Do pass",7,0,0,0,7
1092486,772645,2018-08-24,Senate,"Special Consent AB2813",39,0,1,0,40
1092486,773537,2018-08-29,Assembly,"AB 2813 IRWIN Concurrence in Senate Amendments",79,0,1,0,80
1092487,739854,2018-04-17,Assembly,"Do pass and be re-referred to the Committee on [Appropriations]",9,4,0,0,13
1092487,756349,2018-05-25,Assembly,"Do pass",12,3,2,0,17
1092487,757772,2018-05-30,Assembly,"AB 3186 MEDINA Assembly Third Reading",56,21,1,0,78
1092487,768691,2018-06-27,Senate,"Do pass, but first be re-referred to the Committee on [Appropriations]",6,1,0,0,7
1092487,770282,2018-08-06,Senate,"Placed on suspense file",7,0,0,0,7
1092487,771702,2018-08-16,Senate,"Do pass",5,2,0,0,7
1092487,772864,2018-08-27,Senate,"Assembly 3rd Reading AB3186 Medina By McGuire",29,10,1,0,40
1092489,733372,2018-04-03,Senate,"Do pass, but first be re-referred to the Committee on [Judiciary]",4,0,1,0,5
1092489,740654,2018-04-17,Senate,"Do pass, but first be re-referred to the Committee on [Public Safety]",5,2,0,0,7
1092489,753054,2018-05-14,Senate,"Placed on suspense file",7,0,0,0,7
1092489,756721,2018-05-25,Senate,"Do pass",5,2,0,0,7
1092489,758739,2018-05-31,Senate,"Senate 3rd Reading SB1394 Newman",24,13,2,0,39
1092491,740786,2018-04-18,Senate,"Do pass as amended, but first amend, and re-refer to the Committee on [Appropriations]",5,0,2,0,7
1092491,755301,2018-05-22,Senate,"Placed on suspense file",7,0,0,0,7
1092491,756228,2018-05-25,Senate,"Do pass",5,2,0,0,7
1092491,757622,2018-05-30,Senate,"Senate 3rd Reading SB1335 Allen et al",22,13,4,0,39
1092491,768286,2018-06-25,Assembly,"Do pass as amended and be re-referred to the Committee on [Appropriations]",7,3,0,0,10
1092491,771603,2018-08-16,Assembly,"Do pass as amended",12,0,5,0,17
1092491,772688,2018-08-24,Assembly,"SB 1335 Allen Senate Third Reading By BLOOM Amendment Set #1",45,24,11,0,80
1092491,773969,2018-08-31,Senate,"That the Assembly amendments be concurred in",5,2,0,0,7
1092491,774145,2018-08-31,Senate,"Unfinished Business SB1335 Allen et al. Concurrence",25,13,2,0,40
1092491,774146,2018-08-31,Assembly,"SB 1335 Allen Senate Third Reading By BLOOM",52,26,2,0,80
1092493,741038,2018-04-18,Assembly,"Do pass and be re-referred to the Committee on [Appropriations]",13,0,0,0,13
1092494,738864,2018-04-16,Assembly,"Do pass and be re-referred to the Committee on [Appropriations]",10,0,0,0,10
1092494,744004,2018-04-25,Assembly,"Do pass. To Consent Calendar",17,0,0,0,17
1092494,748962,2018-05-03,Assembly,"AB 3133 BERMAN Consent Calendar Second Day Regular Session",71,0,7,0,78
1092494,762385,2018-06-12,Senate,"Do pass as amended, but first amend, and re-refer to the Committee on [Appropriations]",9,0,0,0,9
1092494,771208,2018-08-09,Senate,"Assembly 3rd Reading AB3133 Berman By Monning",36,0,3,0,39
1092494,771402,2018-08-13,Assembly,"AB 3133 BERMAN Concurrence in Senate Amendments",77,1,2,0,80
1092495,736206,2018-04-09,Assembly,"Do pass as amended and be re-referred to the Committee on [Appropriations]",8,0,2,0,10
1092495,743881,2018-04-25,Assembly,"Do pass. To Consent Calendar",17,0,0,0,17
1092495,748852,2018-05-03,Assembly,"AB 3122 GALLAGHER Consent Calendar Second Day Regular Session",71,0,7,0,78
1092495,763247,2018-06-13,Senate,"Do pass, but first be re-referred to the Committee on [Appropriations] with the recommendation: To Consent Calendar",7,0,0,0,7
1092495,769570,2018-07-02,Senate,"Consent Calendar AB3122",37,0,2,0,39
1092497,741084,2018-04-18,Senate,"Do pass as amended, but first amend, and re-refer to the Committee on [Appropriations]",6,1,0,0,7
1092497,750440,2018-05-07,Senate,"Placed on suspense file",6,0,1,0,7
1092498,737927,2018-04-11,Assembly,"Do pass and be re-referred to the Committee on [Housing and Community Development]",9,0,0,0,9
1092498,743720,2018-04-25,Assembly,"Do pass and be re-referred to the Committee on [Appropriations]",7,0,0,0,7
1092498,751355,2018-05-09,Assembly,"Do pass. To Consent Calendar",16,0,1,0,17
1092498,754267,2018-05-17,Assembly,"AB 2973 GRAY Consent Calendar Second Day Regular Session",73,0,5,0,78
1092498,769219,2018-06-27,Senate,"Do pass as amended, but first amend, and re-refer to the Committee on [Appropriations]",7,0,0,0,7
1092498,773584,2018-08-29,Senate,"Assembly 3rd Reading AB2973 Gray By Galgiani",39,0,1,0,40
1092498,774193,2018-08-31,Assembly,"AB 2973 GRAY Concurrence in Senate Amendments",80,0,0,0,80
1092499,753379,2018-05-14,Assembly,"Do pass as amended and be re-referred to the Committee on [Appropriations]",8,0,2,0,10
1092501,743910,2018-04-25,Assembly,"Do pass and be re-referred to the Committee on [Appropriations]",2,5,0,0,7
1092504,737175,2018-04-10,Assembly,"Do pass and be re-referred to the Committee on [Judiciary]",9,0,1,0,10
1092504,739843,2018-04-17,Assembly,"Do pass and be re-referred to the Committee on [Appropriations]",9,0,1,0,10
1092504,747839,2018-05-02,Assembly,"Do pass. To Consent Calendar",17,0,0,0,17
1092504,752068,2018-05-10,Assembly,"AB 3212 IRWIN Consent Calendar Second Day Regular Session",73,0,5,0,78
1092504,762073,2018-06-12,Senate,"Do pass, but first be re-referred to the Committee on [Judiciary]",5,0,2,0,7
1092504,768875,2018-06-26,Senate,"Do pass, but first be re-referred to the Committee on [Appropriations] with the recommendation: To Consent Calendar",7,0,0,0,7
1092504,772796,2018-08-27,Senate,"Assembly 3rd Reading AB3212 Irwin et al. By Roth",39,0,1,0,40
1092504,773324,2018-08-29,Assembly,"AB 3212 IRWIN Concurrence in Senate Amendments",79,0,1,0,80
1092507,743759,2018-04-25,Assembly,"Do pass as amended and be re-referred to the Committee on [Appropriations]",6,1,0,0,7
1092507,756549,2018-05-25,Assembly,"Do pass as amended",12,4,1,0,17
1092507,757802,2018-05-30,Assembly,"AB 3085 CALDERON Assembly Third Reading",55,22,1,0,78
1092507,768996,2018-06-26,Senate,"Do pass, but first be re-referred to the Committee on [Appropriations]",6,0,1,0,7
1092507,770414,2018-08-06,Senate,"Placed on suspense file",7,0,0,0,7
1092507,772028,2018-08-16,Senate,"Do pass as amended",5,1,1,0,7
1092507,772620,2018-08-23,Senate,"Assembly 3rd Reading AB3085 Calderon By Delgado",32,6,2,0,40
1092507,772780,2018-08-27,Assembly,"AB 3085 CALDERON Concurrence in Senate Amendments",59,19,2,0,80
1092509,739466,2018-04-17,Senate,"Do pass, but first be re-referred to the Committee on [Appropriations] with the recommendation: To Consent Calendar",7,0,0,0,7
1092509,748860,2018-05-03,Senate,"Consent Calendar SB1331",38,0,1,0,39
1092509,762111,2018-06-12,Assembly,"Do pass and be re-referred to the Committee on [Appropriations] with recommendation: To Consent Calendar",7,0,0,0,7
1092509,768885,2018-06-27,Assembly,"Do pass. To Consent Calendar",16,0,1,0,17
1092509,769781,2018-07-05,Assembly,"SB 1331 Jackson Consent Calendar Second Day Regular Session",69,0,11,0,80
1092510,740876,2018-04-18,Assembly,"Do pass and be re-referred to the Committee on [Appropriations]",5,1,1,0,7
1092511,736107,2018-04-10,Senate,"Do pass, but first be re-referred to the Committee on [Appropriations]",2,3,2,0,7
1092511,736108,2018-04-10,Senate,"[04-10-2018] hearing: Motion to Reconsider. [Reconsideration Granted.]",7,0,0,0,7
1092514,745101,2018-04-25,Assembly,"Do pass",6,2,1,0,9
1092514,754265,2018-05-17,Assembly,"AB 2853 MEDINA Assembly Third Reading",52,21,5,0,78
1092514,762999,2018-06-13,Senate,"Do pass as amended",6,1,0,0,7
1092514,769809,2018-07-05,Senate,"Assembly 3rd Reading AB2853 Medina By Leyva",26,9,4,0,39
1092514,771219,2018-08-09,Assembly,"AB 2853 MEDINA Concurrence in Senate Amendments",58,19,3,0,80
1092515,744029,2018-04-25,Assembly,"Do pass and be re-referred to the Committee on [Judiciary]",7,0,0,0,7
1092515,750995,2018-05-08,Assembly,"Do pass. To Consent Calendar",10,0,0,0,10
1092515,752650,2018-05-14,Assembly,"AB 2912 IRWIN Consent Calendar Second Day Regular Session",76,0,2,0,78
1092515,762237,2018-06-12,Senate,"Do pass, but first be re-referred to the Committee on [Judiciary]",11,0,2,0,13
1092515,769735,2018-07-03,Senate,"Do pass as amended",7,0,0,0,7
1092515,771334,2018-08-13,Senate,"Assembly 3rd Reading AB2912 Irwin By Stern",36,0,4,0,40
1092515,772202,2018-08-20,Assembly,"AB 2912 IRWIN Concurrence in Senate Amendments",80,0,0,0,80
1092516,751145,2018-05-09,Senate,"Do pass, but first be re-referred to the Committee on [Appropriations]",7,0,0,0,7
1092516,755345,2018-05-22,Senate,"Placed on suspense file",7,0,0,0,7
1092516,756389,2018-05-25,Senate,"Do pass",7,0,0,0,7
1092516,758615,2018-05-31,Senate,"Special Consent SB1484",39,0,0,0,39
1092516,769719,2018-07-02,Assembly,"Do pass as amended and be re-referred to the Committee on [Appropriations]",9,0,1,0,10
1092516,771925,2018-08-16,Assembly,"Do pass",17,0,0,0,17
1092516,773926,2018-08-30,Assembly,"SB 1484 Hernandez Senate Third Reading By CHEN",80,0,0,0,80
1092516,774117,2018-08-31,Senate,"Unfinished Business SB1484 Hernandez et al. Concurrence",39,0,1,0,40
1092517,739861,2018-04-16,Senate,"Do pass, but first be re-referred to the Committee on [Environmental Quality]",8,0,1,0,9
1092517,740846,2018-04-18,Senate,"Do pass, but first be re-referred to the Committee on [Appropriations]",5,0,2,0,7
1092517,755350,2018-05-22,Senate,"Placed on suspense file",7,0,0,0,7
1092517,756303,2018-05-25,Senate,"Do pass as amended",7,0,0,0,7
1092517,757829,2018-05-30,Senate,"Senate 3rd Reading SB1301 Beall",36,0,3,0,39
1092517,768188,2018-06-26,Assembly,"Do pass and be re-referred to the Committee on [Appropriations]",13,1,1,0,15
1092517,771810,2018-08-16,Assembly,"Do pass",16,0,1,0,17
1092517,772943,2018-08-27,Assembly,"SB 1301 Beall Senate Third Reading By CABALLERO",78,0,2,0,80
1092517,773192,2018-08-28,Senate,"Unfinished Business SB1301 Beall et al. Concurrence",39,0,1,0,40
1092517,775338,2018-05-22,Senate,Placed,5,0,0,0,5
1092518,743220,2018-04-24,Assembly,"Do pass and be re-referred to the Committee on [Appropriations]",2,5,0,0,7
1092519,733265,2018-04-03,Senate,"Do pass and be ordered to the Consent Calendar",13,0,0,0,13
1092519,735611,2018-04-09,Senate,"Consent Calendar SB1387",39,0,0,0,39
1092519,767938,2018-06-25,Assembly,"Do pass and be re-referred to the Committee on [Appropriations]",13,0,1,0,14
1092519,771815,2018-08-16,Assembly,"Do pass",17,0,0,0,17
1092519,773086,2018-08-28,Assembly,"SB 1387 Beall Senate Third Reading By AGUIAR-CURRY",80,0,0,0,80
1092520,737468,2018-04-11,Assembly,"Do pass as amended and be re-referred to the Committee on [Appropriations]",9,3,1,0,13
1092520,756362,2018-05-25,Assembly,"Do pass",12,4,1,0,17
1092520,757502,2018-05-30,Assembly,"AB 2910 WOOD Assembly Third Reading",49,24,5,0,78
1092521,743180,2018-04-24,Senate,"Do pass, but first be re-referred to the Committee on [Appropriations] with the recommendation: To Consent Calendar",12,0,0,0,12
1092521,752123,2018-05-10,Senate,"Consent Calendar SB1452",38,0,1,0,39
1092522,743873,2018-04-25,Senate,"Do pass as amended, but first amend, and re-refer to the Committee on [Appropriations]",8,0,3,0,11
1092522,755317,2018-05-22,Senate,"Placed on suspense file",7,0,0,0,7
1092524,745062,2018-04-25,Assembly,"Do pass as amended and be re-referred to the Committee on [Appropriations]",6,0,1,0,7
1092524,756573,2018-05-25,Assembly,"Do pass as amended",16,0,1,0,17
1092524,757794,2018-05-30,Assembly,"AB 3096 RUBIO Assembly Third Reading",76,0,2,0,78
1092524,768993,2018-06-27,Senate,"Do pass as amended, but first amend, and re-refer to the Committee on [Appropriations]",4,2,1,0,7
1092524,770960,2018-08-06,Senate,"Placed on suspense file",7,0,0,0,7
1092525,740923,2018-04-17,Assembly,"Do pass and be re-referred to the Committee on [Business and Professions]",15,0,0,0,15
1092525,743087,2018-04-24,Assembly,"Do pass and be re-referred to the Committee on [Appropriations]",16,0,0,0,16
1092525,753843,2018-05-16,Assembly,"Do pass as amended",17,0,0,0,17
1092525,756185,2018-05-25,Assembly,"AB 2863 NAZARIAN Assembly Third Reading",70,0,8,0,78
1092525,762873,2018-06-13,Senate,"Do pass as amended, but first amend, and re-refer to the Committee on [Appropriations]",8,0,1,0,9
1092525,772167,2018-08-20,Senate,"Assembly 3rd Reading AB2863 Nazarian et al. By Wiener",39,0,1,0,40
1092525,773064,2018-08-28,Assembly,"With recommendation: That Senate amendments be concurred in",18,0,1,0,19
1092525,773471,2018-08-29,Assembly,"AB 2863 NAZARIAN Concurrence in Senate Amendments",79,0,1,0,80
1092527,744346,2018-04-25,Senate,"Do pass as amended, but first amend, and re-refer to the Committee on [Appropriations]",5,1,1,0,7
1092527,752812,2018-05-14,Senate,"Placed on suspense file",7,0,0,0,7
1092527,756286,2018-05-25,Senate,"Do pass",7,0,0,0,7
1092527,757047,2018-05-29,Senate,"Senate 3rd Reading SB1395 Moorlach",34,0,5,0,39
1092527,765501,2018-06-18,Assembly,"Do pass and be re-referred to the Committee on [Appropriations]",10,0,0,0,10
1092528,746999,2018-05-01,Senate,"Be adopted, but first be re-referred to the Committee on [Appropriations] with recommendation: To Consent Calendar",12,0,1,0,13
1092528,754961,2018-05-21,Senate,"Senate 3rd Reading SCR105 Nielsen",39,0,0,0,39
1092528,768049,2018-06-25,Assembly,"Be adopted. To Consent Calendar",13,0,1,0,14
1092528,769268,2018-06-28,Assembly,"SCR 105 Nielsen Consent Calendar Second Day Regular Session",75,0,5,0,80
1092529,743582,2018-04-23,Assembly,"Do pass as amended and be re-referred to the Committee on [Appropriations]",10,0,0,0,10
1092530,739868,2018-04-16,Senate,"Do pass, but first be re-referred to the Committee on [Appropriations] with the recommendation: To Consent Calendar",9,0,0,0,9
1092530,755347,2018-05-22,Senate,"Placed on suspense file",7,0,0,0,7
1092530,756227,2018-05-25,Senate,"Do pass",7,0,0,0,7
1092530,758457,2018-05-31,Senate,"Special Consent SB1310 McGuire et al. Urgency Clause",39,0,0,0,39
1092530,768192,2018-06-26,Assembly,"Do pass and be re-referred to the Committee on [Appropriations]",15,0,0,0,15
1092530,771673,2018-08-16,Assembly,"Do pass as amended",12,0,5,0,17
1092530,773750,2018-08-30,Assembly,"SB 1310 McGuire Third Reading Urgency By STONE",80,0,0,0,80
1092530,774213,2018-08-31,Senate,"Unfinished Business SB1310 McGuire et al. Urgency Clause Concurrence",39,0,1,0,40
1092533,740298,2018-04-17,Assembly,"Do pass and be re-referred to the Committee on [Appropriations]",7,0,0,0,7
1092535,744903,2018-04-25,Assembly,"Do pass as amended, and be re-referred to the Committee on [Appropriations] with recommendation: To Consent Calendar",7,0,0,0,7
1092535,756647,2018-05-25,Assembly,"Do pass",16,0,1,0,17
1092535,757832,2018-05-30,Assembly,"AB 3233 KILEY Assembly Third Reading",77,0,1,0,78
1092535,768979,2018-06-27,Senate,"Do pass as amended, but first amend, and re-refer to the Committee on [Appropriations] with the recommendation: To Consent Calendar",7,0,0,0,7
1092535,770271,2018-08-06,Senate,"Placed on suspense file",7,0,0,0,7
1092536,744717,2018-04-25,Assembly,"Do pass and be re-referred to the Committee on [Appropriations]",8,0,1,0,9
1092536,756373,2018-05-25,Assembly,"Do pass",16,0,1,0,17
1092536,757718,2018-05-30,Assembly,"AB 3068 DALY Assembly Third Reading",77,0,1,0,78
1092536,765928,2018-06-20,Senate,"Do pass, but first be re-referred to the Committee on [Judiciary]",6,1,0,0,7
1092536,768892,2018-06-26,Senate,"Do pass, but first be re-referred to the Committee on [Appropriations]",5,2,0,0,7
1092536,770514,2018-08-06,Senate,"Placed on suspense file",7,0,0,0,7
1092536,771707,2018-08-16,Senate,"Do pass",7,0,0,0,7
1092536,772507,2018-08-23,Senate,"Assembly 3rd Reading AB3068 Daly et al. By Bates",36,2,2,0,40
1092537,735562,2018-04-09,Assembly,"Do pass and be re-referred to the Committee on [Natural Resources]",14,0,0,0,14
1092537,743451,2018-04-23,Assembly,"Do pass as amended and be re-referred to the Committee on [Appropriations]",10,0,0,0,10
1092538,742252,2018-04-23,Assembly,"Do pass and be re-referred to the Committee on [Appropriations]",14,0,0,0,14
1092538,756550,2018-05-25,Assembly,"Do pass as amended",16,0,1,0,17
1092538,757616,2018-05-30,Assembly,"AB 3097 SALAS Assembly Third Reading",76,0,2,0,78
1092539,738851,2018-04-16,Assembly,"Do pass and be re-referred to the Committee on [Appropriations]",10,3,1,0,14
1092539,748104,2018-05-02,Assembly,"Do pass",12,4,1,0,17
1092539,752063,2018-05-10,Assembly,"AB 3135 FRAZIER Assembly Third Reading",51,20,7,0,78
1092539,768108,2018-06-26,Senate,"Do pass, but first be re-referred to the Committee on [Appropriations]",10,2,1,0,13
1092539,771257,2018-08-13,Senate,"Placed on suspense file",7,0,0,0,7
1092539,771871,2018-08-16,Senate,"Do pass",6,0,1,0,7
1092539,772377,2018-08-21,Senate,"Assembly 3rd Reading AB3135 Frazier By Beall",33,4,3,0,40
1092539,773609,2018-08-29,Assembly,"With recommendation: That Senate amendments be concurred in",14,0,0,0,14
1092539,773806,2018-08-30,Assembly,"AB 3135 FRAZIER Concurrence in Senate Amendments",79,0,1,0,80
1092540,736013,2018-04-09,Assembly,"Do pass and be re-referred to the Committee on [Appropriations]",6,3,1,0,10
1092540,751495,2018-05-09,Assembly,"Do pass",11,5,1,0,17
1092540,758738,2018-05-31,Assembly,"AB 2975 FRIEDMAN Assembly Third Reading",49,26,3,0,78
1092540,768588,2018-06-26,Senate,"Do pass, but first be re-referred to the Committee on [Appropriations]",7,2,0,0,9
1092540,771167,2018-08-09,Senate,"Assembly 3rd Reading AB2975 Friedman et al. By Allen",24,8,7,0,39
1092545,741668,2018-04-18,Assembly,"Do pass and be re-referred to the Committee on [Appropriations]",2,5,0,0,7
1092546,742978,2018-04-23,Assembly,"Do pass and be re-referred to the Committee on [Appropriations] with recommendation: To Consent Calendar",10,0,0,0,10
1092546,751849,2018-05-09,Assembly,"Do pass. To Consent Calendar",16,0,1,0,17
1092546,754337,2018-05-17,Assembly,"AB 3012 GALLAGHER Consent Calendar Second Day Regular Session",73,0,5,0,78
1092546,762158,2018-06-12,Senate,"Do pass as amended, but first amend, and re-refer to the Committee on [Environmental Quality] with the recommendation: To Consent Calendar",9,0,0,0,9
1092546,767035,2018-06-20,Senate,"Do pass, but first be re-referred to the Committee on [Appropriations] with the recommendation: To Consent Calendar",7,0,0,0,7
1092546,771290,2018-08-13,Senate,"Consent Calendar AB3012",37,0,3,0,40
1092546,772259,2018-08-20,Assembly,"AB 3012 GALLAGHER Concurrence in Senate Amendments",80,0,0,0,80
1092547,740462,2018-04-17,Assembly,"Do pass and be re-referred to the Committee on [Judiciary] with recommendation: To Consent Calendar",16,0,0,0,16
1092547,743156,2018-04-24,Assembly,"Do pass and be re-referred to the Committee on [Appropriations] with recommendation: To Consent Calendar",10,0,0,0,10
1092547,751790,2018-05-09,Assembly,"Do pass. To Consent Calendar",16,0,1,0,17
1092547,754408,2018-05-17,Assembly,"AB 3126 BROUGH Consent Calendar Second Day Regular Session",73,0,5,0,78
1092547,761823,2018-06-11,Senate,"Do pass, but first be re-referred to the Committee on [Judiciary]",8,0,1,0,9
1092547,766253,2018-06-19,Senate,"Do pass as amended, but first amend, and re-refer to the Committee on [Appropriations] with the recommendation: To Consent Calendar",7,0,0,0,7
1092547,770359,2018-08-06,Senate,"Do pass",7,0,0,0,7
1092547,772995,2018-08-27,Senate,"Assembly 3rd Reading AB3126 Brough By Cannella",39,0,1,0,40
1092547,773305,2018-08-29,Assembly,"AB 3126 BROUGH Concurrence in Senate Amendments",80,0,0,0,80
1092549,743445,2018-04-24,Senate,"Do pass, but first be re-referred to the Committee on [Appropriations]",12,0,0,0,12
1092549,755033,2018-05-21,Senate,"Senate 3rd Reading SB1313 Vidak",38,0,1,0,39
1092549,766023,2018-06-20,Assembly,"Do pass and be re-referred to the Committee on [Appropriations]",15,3,3,0,21
1092550,744437,2018-04-25,Senate,"Do pass as amended, but first amend, and re-refer to the Committee on [Appropriations]",8,1,2,0,11
1092550,752769,2018-05-14,Senate,"Placed on suspense file",7,0,0,0,7
1092550,756237,2018-05-25,Senate,"Do pass",5,2,0,0,7
1092550,756959,2018-05-29,Senate,"Senate 3rd Reading SB1434 Leyva",29,7,3,0,39
1092550,766135,2018-06-20,Assembly,"Do pass and be re-referred to the Committee on [Communications and Conveyance]",10,3,2,0,15
1092550,768914,2018-06-27,Assembly,"Do pass as amended and be re-referred to the Committee on [Appropriations]",7,3,3,0,13
1092551,750679,2018-05-07,Assembly,"Do pass as amended and be re-referred to the Committee on [Appropriations]",8,1,1,0,10
1092555,736162,2018-04-10,Assembly,"Do pass and be re-referred to the Committee on [Elections and Redistricting]",5,2,0,0,7
1092555,743911,2018-04-25,Assembly,"Do pass as amended and be re-referred to the Committee on [Appropriations]",5,2,0,0,7
1092555,756525,2018-05-25,Assembly,"Do pass",12,4,1,0,17
1092555,757556,2018-05-30,Assembly,"AB 3115 GIPSON Assembly Third Reading",45,29,4,0,78
1092555,768219,2018-06-26,Senate,"Do pass, but first be re-referred to the Committee on [Appropriations]",5,2,0,0,7
1092555,770499,2018-08-06,Senate,"Placed on suspense file",7,0,0,0,7
1092555,771896,2018-08-16,Senate,"Do pass",5,2,0,0,7
1092555,774112,2018-08-31,Senate,"Assembly 3rd Reading AB3115 Gipson et al. By Hertzberg",25,7,8,0,40
1092555,774113,2018-08-31,Assembly,"AB 3115 Gipson Concurrence in Senate Amendments",57,17,6,0,80
1092557,734414,2018-04-04,Assembly,"Do pass and be re-referred to the Committee on [Appropriations] with recommendation: To Consent Calendar",21,0,0,0,21
1092557,741209,2018-04-18,Assembly,"Do pass. To Consent Calendar",15,0,2,0,17
1092557,744921,2018-04-26,Assembly,"AB 2917 COOPER Consent Calendar Second Day Regular Session",74,0,4,0,78
1092557,762397,2018-06-12,Senate,"Do pass, but first be re-referred to the Committee on [Appropriations] with the recommendation: To Consent Calendar",10,0,2,0,12
1092559,739795,2018-04-17,Assembly,"Do pass. To Consent Calendar",7,0,0,0,7
1092560,747857,2018-05-02,Assembly,"Do pass. To Consent Calendar",20,0,1,0,21
1092560,752034,2018-05-10,Assembly,"AB 2795 GRAY Consent Calendar Second Day Regular Session",73,0,5,0,78
1092560,768320,2018-06-26,Senate,"Do pass and be ordered to the Consent Calendar",13,0,0,0,13
1092561,739765,2018-04-17,Assembly,"Do pass as amended and be re-referred to the Committee on [Appropriations]",16,0,0,0,16
1092561,751393,2018-05-09,Assembly,"Do pass. To Consent Calendar",16,0,1,0,17
1092561,754348,2018-05-17,Assembly,"AB 2899 RUBIO Consent Calendar Second Day Regular Session",73,0,5,0,78
1092561,767917,2018-06-25,Senate,"Do pass, but first be re-referred to the Committee on [Appropriations]",9,0,0,0,9
1092561,772162,2018-08-20,Senate,"Assembly 3rd Reading AB2899 Rubio et al. By Glazer",39,0,1,0,40
1092561,773089,2018-08-28,Assembly,"With recommendation: That Senate amendments be concurred in",18,0,1,0,19
1092561,773624,2018-08-29,Assembly,"AB 2899 RUBIO Concurrence in Senate Amendments",80,0,0,0,80
1092563,737185,2018-04-10,Assembly,"Do pass and be re-referred to the Committee on [Judiciary]",4,2,1,0,7
1092563,750532,2018-05-08,Assembly,"Do pass",7,2,1,0,10
1092563,757143,2018-05-29,Assembly,"AB 3138 MURATSUCHI Assembly Third Reading",52,22,4,0,78
1092563,767120,2018-06-20,Senate,"Do pass, but first be re-referred to the Committee on [Judiciary]",6,1,0,0,7
1092563,768747,2018-06-26,Senate,"Do pass",5,2,0,0,7
1092563,772412,2018-08-21,Senate,"Assembly 3rd Reading AB3138 Muratsuchi By Skinner",29,10,1,0,40
1092564,738808,2018-04-16,Assembly,"Be re-referred to the Committees on [Local Government] and [Revenue and Taxation]",9,0,2,0,11
1092564,745013,2018-04-25,Assembly,"Do pass and be re-referred to the Committee on [Revenue and Taxation]",6,2,1,0,9
1092564,750467,2018-05-07,Assembly,"Do pass",7,3,0,0,10
1092564,752677,2018-05-14,Assembly,"AB 2920 THURMOND Assembly Third Reading",47,29,2,0,78
1092564,766131,2018-06-20,Senate,"Do pass, but first be re-referred to the Committee on [Rules]",5,2,0,0,7
1092564,768204,2018-06-26,Senate,"Do pass",8,3,2,0,13
1092564,771177,2018-08-09,Senate,"Assembly 3rd Reading AB2920 Thurmond By McGuire",24,11,4,0,39
1092564,772256,2018-08-20,Assembly,"With recommendation: That Senate amendments be concurred in",6,3,0,0,9
1092564,772561,2018-08-23,Assembly,"AB 2920 THURMOND Concurrence in Senate Amendments",49,27,4,0,80
1092566,740645,2018-04-18,Assembly,"Do pass and be re-referred to the Committee on [Natural Resources]",5,3,1,0,9
1092566,743018,2018-04-23,Assembly,"Do pass as amended and be re-referred to the Committee on [Appropriations]",7,3,0,0,10
1092566,756184,2018-05-25,Assembly,"Do pass",12,4,1,0,17
1092566,758775,2018-05-31,Assembly,"AB 2923 CHIU Assembly Third Reading",42,32,4,0,78
1092566,768307,2018-06-26,Senate,"Do pass, but first be re-referred to the Committee on [Governance and Finance]",8,3,2,0,13
1092566,769260,2018-06-27,Senate,"Do pass as amended, but first amend, and re-refer to the Committee on [Appropriations]",5,2,0,0,7
1092566,771262,2018-08-13,Senate,"Placed on suspense file",7,0,0,0,7
1092566,771795,2018-08-16,Senate,"Do pass as amended",5,2,0,0,7
1092566,772520,2018-08-23,Senate,"Assembly 3rd Reading AB2923 Chiu et al. By McGuire",26,13,1,0,40
1092566,773066,2018-08-28,Assembly,"AB 2923 CHIU Concurrence in Senate Amendments",46,28,6,0,80
1092567,733892,2018-04-04,Senate,"Do pass, but first be re-referred to the Committee on [Appropriations]",6,0,1,0,7
1092567,738898,2018-04-16,Senate,"Do pass",7,0,0,0,7
1092567,742258,2018-04-23,Senate,"Senate 3rd Reading SB1363 Moorlach et al",38,0,1,0,39
1092567,762443,2018-06-11,Assembly,"Do pass as amended and be re-referred to the Committee on [Appropriations]",9,0,1,0,10
1092567,769025,2018-06-27,Assembly,"Do pass. To Consent Calendar",16,0,1,0,17
1092567,771559,2018-08-16,Assembly,"SB 1363 Moorlach Senate Third Reading By RODRIGUEZ",77,0,3,0,80
1092567,772270,2018-08-20,Senate,"Unfinished Business SB1363 Moorlach et al. Concurrence",39,0,1,0,40
1092568,740952,2018-04-17,Assembly,"Do pass as amended, and be re-referred to the Committee on [Appropriations] with recommendation: To Consent Calendar",15,0,0,0,15
1092568,756595,2018-05-25,Assembly,"Do pass",16,0,1,0,17
1092568,758683,2018-05-31,Assembly,"AB 2798 MAIENSCHEIN Assembly Third Reading",77,0,1,0,78
1092568,768997,2018-06-27,Senate,"Do pass, but first be re-referred to the Committee on [Appropriations]",9,0,0,0,9
1092568,770779,2018-08-06,Senate,"Placed on suspense file",7,0,0,0,7
1092568,772068,2018-08-16,Senate,"Do pass",7,0,0,0,7
1092568,772727,2018-08-24,Senate,"Special Consent AB2798",39,0,1,0,40
1092568,773667,2018-08-29,Assembly,"AB 2798 MAIENSCHEIN Concurrence in Senate Amendments",79,0,1,0,80
1092569,743897,2018-04-25,Senate,"Do pass, but first be re-referred to the Committee on [Appropriations]",4,2,1,0,7
1092569,757747,2018-05-30,Senate,"Senate 3rd Reading SB1333 Wieckowski",25,12,2,0,39
1092569,766275,2018-06-20,Assembly,"Do pass and be re-referred to the Committee on [Housing and Community Development]",5,2,2,0,9
1092569,768791,2018-06-27,Assembly,"Do pass and be re-referred to the Committee on [Appropriations]",4,2,1,0,7
1092569,771473,2018-08-15,Assembly,"Do pass",12,5,0,0,17
1092569,772647,2018-08-24,Assembly,"SB 1333 Wieckowski Senate Third Reading By GLORIA Amendment Set #1",49,24,7,0,80
1092569,773898,2018-08-30,Assembly,"SB 1333 Wieckowski Senate Third Reading By GLORIA",50,26,4,0,80
1092569,773974,2018-08-31,Senate,"Unfinished Business SB1333 Wieckowski et al. Concurrence",25,13,2,0,40
1092570,737309,2018-04-11,Senate,"Do pass, but first be re-referred to the Committee on [Judiciary]",4,0,1,0,5
1092570,740577,2018-04-17,Senate,"Do pass as amended, but first amend, and re-refer to the Committee on [Appropriations]",7,0,0,0,7
1092570,746184,2018-04-30,Senate,"Placed on suspense file",6,0,1,0,7
1092570,756267,2018-05-25,Senate,"Do pass as amended",6,0,1,0,7
1092570,757598,2018-05-30,Senate,"Senate 3rd Reading SB1343 Mitchell",38,0,1,0,39
1092570,768767,2018-06-27,Assembly,"Do pass and be re-referred to the Committee on [Appropriations]",7,0,0,0,7
1092570,771532,2018-08-16,Assembly,"Do pass as amended",12,0,5,0,17
1092570,773722,2018-08-30,Assembly,"SB 1343 Mitchell Senate Third Reading By GONZALEZ FLETCHER",78,0,2,0,80
1092570,774164,2018-08-31,Senate,"Unfinished Business SB1343 Mitchell et al. Concurrence",39,0,1,0,40
1092571,742931,2018-04-24,Assembly,"Do pass as amended and be re-referred to the Committee on [Appropriations]",4,2,1,0,7
1092573,733474,2018-04-03,Senate,"Do pass, but first be re-referred to the Committee on [Environmental Quality]",7,3,1,0,11
1092573,740651,2018-04-18,Senate,"Do pass as amended, but first amend, and re-refer to the Committee on [Appropriations]",5,0,2,0,7
1092573,755264,2018-05-22,Senate,"Placed on suspense file",7,0,0,0,7
1092573,756631,2018-05-25,Senate,"Do pass as amended",5,2,0,0,7
1092573,757612,2018-05-30,Senate,"Senate 3rd Reading SB1477 Stern",25,12,2,0,39
1092573,768261,2018-06-25,Assembly,"Do pass and be re-referred to the Committee on [Utilities and Energy]",7,3,0,0,10
1092573,768915,2018-06-27,Assembly,"Do pass as amended and be re-referred to the Committee on [Appropriations]",11,3,1,0,15
1092573,771816,2018-08-16,Assembly,"Do pass",12,5,0,0,17
1092573,773649,2018-08-29,Assembly,"SB 1477 Stern Senate Third Reading By HOLDEN",50,27,3,0,80
1092573,773733,2018-08-30,Senate,"Unfinished Business SB1477 Stern et al. Concurrence",26,13,1,0,40
1092574,742918,2018-04-24,Assembly,"Do pass and be re-referred to the Committee on [Appropriations]",4,0,3,0,7
1092574,756779,2018-05-25,Assembly,"Do pass",11,1,5,0,17
1092574,757687,2018-05-30,Assembly,"AB 3129 RUBIO Assembly Third Reading",45,16,17,0,78
1092574,768646,2018-06-26,Senate,"Do pass as amended, but first amend, and re-refer to the Committee on [Appropriations]",4,2,1,0,7
1092574,770937,2018-08-06,Senate,"Placed on suspense file",7,0,0,0,7
1092574,772006,2018-08-16,Senate,"Do pass",5,2,0,0,7
1092574,772542,2018-08-23,Senate,"Assembly 3rd Reading AB3129 Rubio By Skinner",26,7,7,0,40
1092574,772993,2018-08-27,Assembly,"AB 3129 RUBIO Concurrence in Senate Amendments",53,19,8,0,80
1092576,725468,2018-03-20,Assembly,"Do pass and be re-referred to the Committee on [Appropriations] with recommendation: To Consent Calendar",7,0,0,0,7
1092576,734228,2018-04-04,Assembly,"Do pass. To Consent Calendar",15,0,2,0,17
1092576,738160,2018-04-12,Assembly,"AB 2900 E.S. & T.M. Consent Calendar Second Day Regular Session",68,0,9,0,77
1092576,754098,2018-05-16,Senate,"Do pass, but first be re-referred to the Committee on [Appropriations] with the recommendation: To Consent Calendar",7,0,0,0,7
1092576,770535,2018-08-06,Senate,"Consent Calendar AB2900 E.S. & T.M. (Quirk)",37,0,2,0,39
1092577,738831,2018-04-16,Senate,"Do pass, but first be re-referred to the Committee on [Appropriations]",9,0,0,0,9
1092577,755004,2018-05-21,Senate,"Senate 3rd Reading SB1408 Pan",35,2,2,0,39
1092577,769330,2018-06-28,Assembly,"Do pass and be re-referred to the Committee on [Appropriations]",19,1,1,0,21
1092577,771144,2018-08-08,Assembly,"Do pass",15,2,0,0,17
1092577,772569,2018-08-23,Assembly,"SB 1408 Pan Senate Third Reading By WOOD",68,5,7,0,80
1092578,747032,2018-05-01,Assembly,"Do pass",10,0,0,0,10
1092578,748905,2018-05-03,Assembly,"AB 3041 CUNNINGHAM Assembly Third Reading",72,0,6,0,78
1092578,769732,2018-07-03,Senate,"Do pass and be ordered to the Consent Calendar",7,0,0,0,7
1092578,771308,2018-08-13,Senate,"Consent Calendar AB3041",37,0,3,0,40
1092579,740755,2018-04-17,Assembly,"Do pass and be re-referred to the Committee on [Appropriations]",12,3,0,0,15
1092580,733842,2018-04-04,Senate,"Do pass, but first be re-referred to the Committee on [Appropriations]",2,4,0,0,6
1092580,733843,2018-04-04,Senate,"[First] hearing set for [04-04-2018]: Failed passage in Committee. Reconsideration granted",6,0,0,0,6
1092581,743183,2018-04-23,Assembly,"Do pass as amended and be re-referred to the Committee on [Appropriations]",10,0,0,0,10
1092581,755713,2018-05-23,Assembly,"Do pass. To Consent Calendar",16,0,1,0,17
1092581,757178,2018-05-29,Assembly,"AB 2889 CABALLERO Consent Calendar Second Day Regular Session",78,0,0,0,78
1092581,768580,2018-06-26,Senate,"Do pass, but first be re-referred to the Committee on [Appropriations] with the recommendation: To Consent Calendar",9,0,0,0,9
1092581,771286,2018-08-13,Senate,"Consent Calendar AB2889",37,0,3,0,40
1092583,734052,2018-04-04,Senate,"Do pass, but first be re-referred to the Committee on [Appropriations] with the recommendation: To Consent Calendar",6,0,0,0,6
1092583,738848,2018-04-16,Senate,"Placed on suspense file",7,0,0,0,7
1092584,748603,2018-05-02,Assembly,"Do pass as amended",13,0,0,0,13
1092584,752700,2018-05-14,Assembly,"AB 2844 COOLEY Assembly Third Reading",73,2,3,0,78
1092584,769208,2018-06-27,Senate,"Do pass",11,0,2,0,13
1092584,773653,2018-08-29,Senate,"Assembly 3rd Reading AB2844 Cooley By Roth",39,0,1,0,40
1092584,773736,2018-08-30,Assembly,"AB 2844 COOLEY Concurrence in Senate Amendments",79,1,0,0,80
1092585,737391,2018-04-10,Assembly,"Do pass and be re-referred to the Committee on [Judiciary] with recommendation: To Consent Calendar",7,0,0,0,7
1092585,739819,2018-04-17,Assembly,"Do pass and be re-referred to the Committee on [Appropriations] with recommendation: To Consent Calendar",10,0,0,0,10
1092585,756256,2018-05-25,Assembly,"Do pass as amended",16,0,1,0,17
1092585,757641,2018-05-30,Assembly,"AB 3082 GONZALEZ FLETCHER Assembly Third Reading",77,0,1,0,78
1092585,768922,2018-06-26,Senate,"Do pass as amended, but first amend, and re-refer to the Committee on [Appropriations]",6,0,1,0,7
1092585,770536,2018-08-06,Senate,"Placed on suspense file",7,0,0,0,7
1092585,771876,2018-08-16,Senate,"Do pass as amended",7,0,0,0,7
1092585,772344,2018-08-21,Senate,"Assembly 3rd Reading AB3082 Gonzalez Fletcher By Mitchell",39,0,1,0,40
1092585,772854,2018-08-27,Assembly,"AB 3082 GONZALEZ FLETCHER Concurrence in Senate Amendments",80,0,0,0,80
1092587,739852,2018-04-17,Assembly,"Do pass as amended",8,0,2,0,10
1092587,744807,2018-04-26,Assembly,"AB 3189 COOPER Assembly Third Reading",51,17,10,0,78
1092587,766102,2018-06-19,Senate,"Do pass",5,2,0,0,7
1092587,771724,2018-08-16,Senate,"Assembly 3rd Reading AB3189 Cooper By Galgiani",25,13,2,0,40
1092587,772244,2018-08-20,Assembly,"AB 3189 COOPER Concurrence in Senate Amendments",55,22,3,0,80
1092588,733210,2018-04-03,Assembly,"Do pass as amended and be re-referred to the Committee on [Arts, Entertainment, Sports, Tourism, and Internet Media]",2,0,8,0,10
1092589,736523,2018-04-10,Assembly,"Do pass and be re-referred to the Committee on [Appropriations]",7,0,0,0,7
1092589,756452,2018-05-25,Assembly,"Do pass as amended",16,0,1,0,17
1092589,757557,2018-05-30,Assembly,"AB 2892 QUIRK Assembly Third Reading",78,0,0,0,78
1092589,768950,2018-06-27,Senate,"Do pass, but first be re-referred to the Committee on [Appropriations] with the recommendation: To Consent Calendar",9,0,0,0,9
1092589,770346,2018-08-06,Senate,"Placed on suspense file",7,0,0,0,7
1092591,742873,2018-04-24,Assembly,"Do pass and be re-referred to the Committee on [Appropriations]",15,0,1,0,16
1092591,747637,2018-05-01,Assembly,"Do pass. To Consent Calendar",10,0,0,0,10
1092591,752004,2018-05-10,Assembly,"AB 3067 CHAU Consent Calendar Second Day",73,0,5,0,78
1092591,761733,2018-06-11,Senate,"Do pass, but first be re-referred to the Committee on [Judiciary]",8,0,1,0,9
1092591,769688,2018-07-03,Senate,"Do pass and be ordered to the Consent Calendar",7,0,0,0,7
1092591,771360,2018-08-13,Senate,"Consent Calendar AB3067",37,0,3,0,40
1092593,735999,2018-04-10,Assembly,"Do pass",5,2,0,0,7
1092593,741426,2018-04-19,Assembly,"AB 2972 CABALLERO Assembly Third Reading",21,28,29,0,78
1092594,737314,2018-04-10,Assembly,"Do pass and be re-referred to the Committee on [Natural Resources] with recommendation: To Consent Calendar",7,0,0,0,7
1092594,743209,2018-04-23,Assembly,"Do pass and be re-referred to the Committee on [Appropriations] with recommendation: To Consent Calendar",10,0,0,0,10
1092594,751839,2018-05-09,Assembly,"Do pass. To Consent Calendar",16,0,1,0,17
1092594,754218,2018-05-17,Assembly,"AB 2928 CHEN Consent Calendar Second Day Regular Session",73,0,5,0,78
1092594,766963,2018-06-20,Senate,"Do pass, but first be re-referred to the Committee on [Appropriations]",7,0,0,0,7
1092594,772276,2018-08-20,Senate,"Assembly 3rd Reading AB2928 Chen By Stone",39,0,1,0,40
1092594,772598,2018-08-23,Assembly,"AB 2928 CHEN Concurrence in Senate Amendments",79,0,1,0,80
1092600,744028,2018-04-25,Senate,"Do pass as amended, but first amend, and re-refer to the Committee on [Appropriations]",9,1,1,0,11
1092600,755349,2018-05-22,Senate,"Placed on suspense file",7,0,0,0,7
1092600,756293,2018-05-25,Senate,"Do pass",5,2,0,0,7
1092600,757177,2018-05-29,Senate,"Senate 3rd Reading SB1369 Skinner et al",28,10,1,0,39
1092600,766183,2018-06-20,Assembly,"Do pass and be re-referred to the Committee on [Natural Resources]",10,4,1,0,15
1092600,768196,2018-06-25,Assembly,"Do pass as amended and be re-referred to the Committee on [Appropriations]",7,3,0,0,10
1092600,771823,2018-08-16,Assembly,"Do pass as amended",12,0,5,0,17
1092600,774076,2018-08-31,Senate,"Unfinished Business SB1369 Skinner et al. Concurrence",30,9,1,0,40
1092600,774077,2018-08-31,Assembly,"SB 1369 Skinner Senate Third Reading By BURKE",80,0,0,0,80
1092601,732576,2018-04-02,Assembly,"Do pass and be re-referred to the Committee on [Appropriations] with recommendation: To Consent Calendar",14,0,0,0,14
1092601,737454,2018-04-11,Assembly,"Do pass. To Consent Calendar",15,0,2,0,17
1092601,741433,2018-04-19,Assembly,"AB 3017 ACOSTA Consent Calendar Second Day Regular Session",71,0,7,0,78
1092601,768343,2018-06-26,Senate,"Do pass, but first be re-referred to the Committee on [Appropriations] with the recommendation: To Consent Calendar",7,0,0,0,7
1092602,742994,2018-04-23,Assembly,"Do pass as amended and be re-referred to the Committee on [Business and Professions]",8,0,2,0,10
1092602,750682,2018-05-08,Assembly,"Do pass as amended and be re-referred to the Committee on [Appropriations]",13,0,5,0,18
1092603,736938,2018-04-10,Assembly,"Do pass and be re-referred to the Committee on [Appropriations] with recommendation: To Consent Calendar",10,0,0,0,10
1092603,744102,2018-04-25,Assembly,"Do pass. To Consent Calendar",17,0,0,0,17
1092603,748722,2018-05-03,Assembly,"AB 3047 DALY Consent Calendar Second Day Regular Session",71,0,7,0,78
1092603,762980,2018-06-12,Senate,"Do pass, but first be re-referred to the Committee on [Appropriations] with the recommendation: To Consent Calendar",7,0,0,0,7
1092603,772242,2018-08-20,Senate,"Assembly 3rd Reading AB3047 Daly et al. By Galgiani",39,0,1,0,40
1092603,772624,2018-08-23,Assembly,"AB 3047 DALY Concurrence in Senate Amendments",76,0,4,0,80
1092604,736205,2018-04-09,Assembly,"Do pass and be re-referred to the Committee on [Appropriations]",7,3,0,0,10
1092604,756663,2018-05-25,Assembly,"Do pass as amended",12,4,1,0,17
1092604,757847,2018-05-30,Assembly,"AB 2864 LIMÓN Assembly Third Reading",72,0,6,0,78
1092604,768340,2018-06-26,Senate,"Do pass, but first be re-referred to the Committee on [Appropriations]",9,0,0,0,9
1092604,770871,2018-08-06,Senate,"Placed on suspense file",7,0,0,0,7
1092604,771967,2018-08-16,Senate,"Do pass",6,1,0,0,7
1092604,772475,2018-08-22,Senate,"Assembly 3rd Reading AB2864 Limón By Skinner",39,0,1,0,40
1092607,744043,2018-04-24,Senate,"Do pass, but first be re-referred to the Committee on [Appropriations]",10,1,2,0,13
1092607,750131,2018-05-07,Senate,"Do pass",6,0,1,0,7
1092607,754327,2018-05-17,Senate,"Senate 3rd Reading SB1360 Portantino",30,3,6,0,39
1092607,768098,2018-06-25,Assembly,"Do pass and be re-referred to the Committee on [Appropriations]",9,3,2,0,14
1092607,771817,2018-08-16,Assembly,"Do pass",12,4,1,0,17
1092608,737277,2018-04-11,Assembly,"Do pass and be re-referred to the Committee on [Local Government]",5,2,0,0,7
1092608,744774,2018-04-25,Assembly,"Do pass as amended and be re-referred to the Committee on [Appropriations]",6,2,1,0,9
1092609,740596,2018-04-17,Senate,"Do pass, but first be re-referred to the Committee on [Appropriations] with the recommendation: To Consent Calendar",7,0,0,0,7
1092609,746173,2018-04-30,Senate,"Placed on suspense file",6,0,1,0,7
1092609,756371,2018-05-25,Senate,"Do pass",7,0,0,0,7
1092609,758614,2018-05-31,Senate,"Special Consent SB1320",39,0,0,0,39
1092609,765182,2018-06-19,Assembly,"Do pass and be re-referred to the Committee on [Appropriations] with recommendation: To Consent Calendar",10,0,0,0,10
1092609,771612,2018-08-16,Assembly,"Do pass",17,0,0,0,17
1092609,772826,2018-08-27,Assembly,"SB 1320 Stern Senate Third Reading By STONE",79,0,1,0,80
1092611,743150,2018-04-24,Assembly,"Do pass and be re-referred to the Committee on [Appropriations]",6,0,1,0,7
1092611,753774,2018-05-16,Assembly,"Do pass",12,4,1,0,17
1092611,757990,2018-05-30,Assembly,"AB 2942 TING Assembly Third Reading",45,27,6,0,78
1092611,768152,2018-06-26,Senate,"Do pass, but first be re-referred to the Committee on [Appropriations]",7,0,0,0,7
1092611,770538,2018-08-06,Senate,"Placed on suspense file",7,0,0,0,7
1092611,771618,2018-08-16,Senate,"Do pass as amended",6,1,0,0,7
1092611,772446,2018-08-22,Senate,"Assembly 3rd Reading AB2942 Ting et al. By Skinner",33,6,1,0,40
1092611,772958,2018-08-27,Assembly,"AB 2942 TING Concurrence in Senate Amendments",53,23,4,0,80
1092612,735507,2018-04-09,Assembly,"Do pass and be re-referred to the Committee on [Natural Resources]",14,0,0,0,14
1092612,743306,2018-04-23,Assembly,"Do pass as amended and be re-referred to the Committee on [Appropriations]",10,0,0,0,10
1092614,741427,2018-04-18,Assembly,"Do pass and be re-referred to the Committee on [Judiciary]",5,1,1,0,7
1092614,743259,2018-04-24,Assembly,"Do pass and be re-referred to the Committee on [Appropriations]",7,3,0,0,10
1092614,756264,2018-05-25,Assembly,"Do pass as amended",12,4,1,0,17
1092614,757807,2018-05-30,Assembly,"AB 3080 GONZALEZ FLETCHER Assembly Third Reading",47,25,6,0,78
1092614,766172,2018-06-19,Senate,"Do pass, but first be re-referred to the Committee on [Labor and Industrial Relations]",5,2,0,0,7
1092614,769027,2018-06-27,Senate,"Do pass, but first be re-referred to the Committee on [Appropriations]",4,1,0,0,5
1092614,770245,2018-08-06,Senate,"Placed on suspense file",7,0,0,0,7
1092614,771988,2018-08-16,Senate,"Do pass",5,2,0,0,7
1092614,772456,2018-08-22,Senate,"Assembly 3rd Reading AB3080 Gonzalez Fletcher et al. By Jackson",26,12,2,0,40
1092616,737218,2018-04-11,Senate,"Do pass, but first be re-referred to the Committee on [Judiciary]",4,1,0,0,5
1092616,740667,2018-04-17,Senate,"Do pass, but first be re-referred to the Committee on [Appropriations]",5,2,0,0,7
1092616,746090,2018-04-30,Senate,"Placed on suspense file",6,0,1,0,7
1092616,756377,2018-05-25,Senate,"Do pass as amended",5,2,0,0,7
1092616,758380,2018-05-31,Senate,"Senate 3rd Reading SB1300 Jackson",22,11,6,0,39
1092616,767032,2018-06-20,Assembly,"Do pass and be re-referred to the Committee on [Judiciary]",5,2,0,0,7
1092616,768297,2018-06-26,Assembly,"Do pass as amended and be re-referred to the Committee on [Appropriations]",7,3,0,0,10
1092616,771579,2018-08-16,Assembly,"Do pass as amended",12,0,5,0,17
1092616,773740,2018-08-30,Assembly,"SB 1300 Jackson Senate Third Reading By FRIEDMAN",41,33,6,0,80
1092616,774052,2018-08-31,Senate,"Unfinished Business SB1300 Jackson et al. Concurrence",25,10,5,0,40
1092617,744022,2018-04-24,Assembly,"Do pass and be re-referred to the Committee on [Appropriations]",13,0,0,0,13
1092617,756767,2018-05-25,Assembly,"Do pass as amended",12,0,5,0,17
1092617,757593,2018-05-30,Assembly,"AB 3153 LEVINE Assembly Third Reading",67,6,5,0,78
1092617,766090,2018-06-20,Senate,"Do pass, but first be re-referred to the Committee on [Appropriations]",7,0,0,0,7
1092617,769616,2018-07-02,Senate,"Placed on suspense file",7,0,0,0,7
1092618,744145,2018-04-24,Assembly,"Do pass as amended and be re-referred to the Committee on [Appropriations]",7,0,0,0,7
1092619,742158,2018-04-23,Assembly,"Do pass as amended and be re-referred to the Committee on [Appropriations]",14,0,0,0,14
1092619,751730,2018-05-09,Assembly,"Do pass. To Consent Calendar",16,0,1,0,17
1092619,754956,2018-05-21,Assembly,"AB 2885 RODRIGUEZ Assembly Third Reading",69,0,9,0,78
1092619,760470,2018-06-06,Senate,"Do pass as amended, but first amend, and re-refer to the Committee on [Transportation and Housing]",5,0,2,0,7
1092619,768170,2018-06-26,Senate,"Do pass, but first be re-referred to the Committee on [Appropriations]",12,0,1,0,13
1092619,772867,2018-08-27,Senate,"Assembly 3rd Reading AB2885 Rodriguez et al. By Galgiani",39,0,1,0,40
1092619,773349,2018-08-29,Assembly,"AB 2885 RODRIGUEZ Concurrence in Senate Amendments",75,4,1,0,80
1092620,741409,2018-04-18,Assembly,"Do pass and be re-referred to the Committee on [Judiciary]",5,1,1,0,7
1092620,742842,2018-04-24,Assembly,"Do pass as amended and be re-referred to the Committee on [Appropriations]",8,2,0,0,10
1092620,756359,2018-05-25,Assembly,"Do pass as amended",12,4,1,0,17
1092620,758830,2018-05-31,Assembly,"AB 3081 GONZALEZ FLETCHER Assembly Third Reading",47,23,8,0,78
1092620,768941,2018-06-26,Senate,"Do pass, but first be re-referred to the Committee on [Labor and Industrial Relations]",5,2,0,0,7
1092620,768942,2018-06-27,Senate,"Do pass as amended, but first amend, and re-refer to the Committee on [Appropriations]",4,1,0,0,5
1092620,770530,2018-08-06,Senate,"Placed on suspense file",7,0,0,0,7
1092620,771721,2018-08-16,Senate,"Do pass as amended",5,2,0,0,7
1092620,773397,2018-08-29,Senate,"Assembly 3rd Reading AB3081 Gonzalez Fletcher et al. By Leyva",25,13,2,0,40
1092620,773863,2018-08-30,Assembly,"AB 3081 GONZALEZ FLETCHER Concurrence in Senate Amendments",47,25,8,0,80
1092621,742883,2018-04-24,Assembly,"Do pass as amended and be re-referred to the Committee on [Appropriations]",8,0,2,0,10
1092621,756432,2018-05-25,Assembly,"Do pass",12,2,3,0,17
1092621,757620,2018-05-30,Assembly,"AB 3120 GONZALEZ FLETCHER Assembly Third Reading",54,9,15,0,78
1092621,769693,2018-07-03,Senate,"Do pass as amended, but first amend, and re-refer to the Committee on [Appropriations]",5,2,0,0,7
1092621,771344,2018-08-13,Senate,"Placed on suspense file",7,0,0,0,7
1092621,771761,2018-08-16,Senate,"Do pass",6,0,1,0,7
1092621,773219,2018-08-28,Senate,"Assembly 3rd Reading AB3120 Gonzalez Fletcher By Jackson",33,2,5,0,40
1092621,773741,2018-08-30,Assembly,"AB 3120 GONZALEZ FLETCHER Concurrence in Senate Amendments",59,12,9,0,80
1092622,739532,2018-04-17,Assembly,"Do pass as amended and be re-referred to the Committee on [Appropriations]",10,0,0,0,10
1092622,756426,2018-05-25,Assembly,"Do pass",16,0,1,0,17
1092622,757769,2018-05-30,Assembly,"AB 2930 SANTIAGO Assembly Third Reading",77,0,1,0,78
1092622,766082,2018-06-19,Senate,"Do pass as amended, but first amend, and re-refer to the Committee on [Appropriations] with the recommendation: To Consent Calendar",7,0,0,0,7
1092622,771411,2018-08-13,Senate,"Consent Calendar AB2930",37,0,3,0,40
1092622,772155,2018-08-20,Assembly,"AB 2930 SANTIAGO Concurrence in Senate Amendments",80,0,0,0,80
1092624,742193,2018-04-23,Assembly,"Do pass as amended and be re-referred to the Committee on [Appropriations]",14,0,0,0,14
1092624,756612,2018-05-25,Assembly,"Do pass as amended",16,0,1,0,17
1092624,757563,2018-05-30,Assembly,"AB 2989 FLORA Assembly Third Reading",74,1,3,0,78
1092624,768265,2018-06-26,Senate,"Do pass as amended, but first amend, and re-refer to the Committee on [Appropriations]",12,0,1,0,13
1092624,772552,2018-08-23,Senate,"Assembly 3rd Reading AB2989 Flora et al. By Cannella",33,2,5,0,40
1092624,773374,2018-08-29,Assembly,"AB 2989 FLORA Concurrence in Senate Amendments",77,0,3,0,80
1092625,733351,2018-04-03,Assembly,"Do pass and be re-referred to the Committee on [Appropriations] with recommendation: To Consent Calendar",15,0,0,0,15
1092626,741664,2018-04-18,Assembly,"Do pass and be re-referred to the Committee on [Judiciary]",2,5,0,0,7
1092627,739658,2018-04-17,Assembly,"Do pass",8,2,0,0,10
1092627,744850,2018-04-26,Assembly,"AB 3121 KALRA Assembly Third Reading",45,22,11,0,78
1092627,766059,2018-06-19,Senate,"Do pass",5,2,0,0,7
1092628,739889,2018-04-17,Assembly,"Do pass as amended and be re-referred to the Committee on [Appropriations]",7,0,0,0,7
1092628,747644,2018-05-02,Assembly,"Do pass. To Consent Calendar",17,0,0,0,17
1092628,752003,2018-05-10,Assembly,"AB 3040 NAZARIAN Consent Calendar Second Day Regular Session",73,0,5,0,78
1092628,764981,2018-06-19,Senate,"Do pass, but first be re-referred to the Committee on [Appropriations] with the recommendation: To Consent Calendar",7,0,0,0,7
1092628,770860,2018-08-06,Senate,"Placed on suspense file",7,0,0,0,7
1092629,733219,2018-04-03,Senate,"Do pass, but first be re-referred to the Committee on [Appropriations]",10,3,0,0,13
1092629,742213,2018-04-23,Senate,"Do pass",5,2,0,0,7
1092629,744883,2018-04-26,Senate,"Senate 3rd Reading SB1328 Beall",26,9,4,0,39
1092629,761760,2018-06-11,Assembly,"Do pass and be re-referred to the Committee on [Appropriations]",10,4,0,0,14
1092629,771572,2018-08-16,Assembly,"Do pass",12,5,0,0,17
1092629,773067,2018-08-28,Assembly,"SB 1328 Beall Senate Third Reading By BERMAN",47,28,5,0,80
1092629,773405,2018-08-29,Senate,"Unfinished Business SB1328 Beall Concurrence",27,12,1,0,40
1092632,740796,2018-04-17,Senate,"Do pass, but first be re-referred to the Committee on [Rules]",10,0,3,0,13
1092632,752933,2018-05-14,Senate,"Placed on suspense file",7,0,0,0,7
1092632,756294,2018-05-25,Senate,"Do pass as amended",7,0,0,0,7
1092632,757738,2018-05-30,Senate,"Senate 3rd Reading SB1415 McGuire",36,0,3,0,39
1092632,765972,2018-06-20,Assembly,"Do pass and be re-referred to the Committee on [Appropriations]",7,0,0,0,7
1092632,768952,2018-06-27,Assembly,"Do pass",12,0,5,0,17
1092632,773107,2018-08-28,Assembly,"SB 1415 McGuire Senate Third Reading By BONTA",73,1,6,0,80
1092632,773343,2018-08-29,Senate,"Unfinished Business SB1415 McGuire Concurrence",39,0,1,0,40
1092633,740343,2018-04-17,Assembly,"Do pass and be re-referred to the Committee on [Appropriations] with recommendation: To Consent Calendar",7,0,0,0,7
1092633,756514,2018-05-25,Assembly,"Do pass as amended",12,0,5,0,17
1092633,757533,2018-05-30,Assembly,"AB 2988 WEBER Assembly Third Reading",78,0,0,0,78
1092633,768134,2018-06-26,Senate,"Do pass as amended, but first amend, and re-refer to the Committee on [Appropriations] with the recommendation: To Consent Calendar",7,0,0,0,7
1092633,770920,2018-08-06,Senate,"Placed on suspense file",7,0,0,0,7
1092633,771996,2018-08-16,Senate,"Do pass as amended",6,0,1,0,7
1092633,772606,2018-08-23,Senate,"Assembly 3rd Reading AB2988 Weber By Stone",39,0,1,0,40
1092633,773032,2018-08-27,Assembly,"AB 2988 WEBER Concurrence in Senate Amendments",78,0,2,0,80
1092634,737189,2018-04-10,Assembly,"Do pass as amended and be re-referred to the Committee on [Appropriations]",10,0,6,0,16
1092634,743716,2018-04-25,Assembly,"Do pass",13,2,2,0,17
1092634,750026,2018-05-07,Assembly,"AB 2859 CABALLERO Assembly Third Reading",58,8,12,0,78
1092634,767904,2018-06-25,Senate,"Do pass, but first be re-referred to the Committee on [Appropriations]",8,0,1,0,9
1092634,771151,2018-08-09,Senate,"Assembly 3rd Reading AB2859 Caballero et al. By McGuire",35,0,4,0,39
1092634,771256,2018-08-13,Assembly,"AB 2859 CABALLERO Concurrence in Senate Amendments",68,3,9,0,80
1092636,733765,2018-04-04,Senate,"Do pass, but first be re-referred to the Committee on [Governance and Finance]",2,4,0,0,6
1092636,733766,2018-04-04,Senate,"[First] hearing set for [04-04-2018]: Failed passage in Committee. Reconsideration granted",6,0,0,0,6
1092640,743916,2018-04-24,Senate,"Do pass, but first be re-referred to the Committee on [Governance and Finance]",8,0,5,0,13
1092640,743917,2018-04-25,Senate,"Do pass as amended, but first amend, and re-refer to the Committee on [Appropriations]",6,0,1,0,7
1092640,755270,2018-05-22,Senate,"Placed on suspense file",7,0,0,0,7
1092644,737367,2018-04-11,Senate,"Do pass, but first be re-referred to the Committee on [Judiciary]",4,1,0,0,5
1092644,740820,2018-04-17,Senate,"Do pass as amended, but first amend, and re-refer to the Committee on [Appropriations]",5,2,0,0,7
1092644,749873,2018-05-07,Senate,"Placed on suspense file",6,0,1,0,7
1092644,756254,2018-05-25,Senate,"Do pass as amended",5,2,0,0,7
1092644,758451,2018-05-31,Senate,"Senate 3rd Reading SB1284 Jackson",24,13,2,0,39
1092644,767010,2018-06-20,Assembly,"Do pass and be re-referred to the Committee on [Judiciary]",5,2,0,0,7
1092644,768230,2018-06-26,Assembly,"Do pass and be re-referred to the Committee on [Appropriations]",7,3,0,0,10
1092646,743323,2018-04-24,Senate,"Do pass as amended, but first amend, and re-refer to the Committee on [Appropriations] with the recommendation: To Consent Calendar",9,0,0,0,9
1092646,757065,2018-05-29,Senate,"Consent Calendar SB1365",37,0,2,0,39
1092646,768195,2018-06-25,Assembly,"Do pass as amended and be re-referred to the Committee on [Appropriations]",10,0,0,0,10
1092646,771125,2018-08-08,Assembly,"Do pass. To Consent Calendar",17,0,0,0,17
1092647,743024,2018-04-24,Senate,"Do pass as amended, but first amend, and re-refer to the Committee on [Appropriations]",3,2,2,0,7
1092648,743938,2018-04-25,Senate,"Do pass, but first be re-referred to the Committee on [Appropriations]",9,0,0,0,9
1092648,752658,2018-05-14,Senate,"Placed on suspense file",7,0,0,0,7
1092650,737240,2018-04-10,Assembly,"Do pass as amended",7,0,0,0,7
1092650,741421,2018-04-19,Assembly,"AB 3007 GARCIA, E. Assembly Third Reading",73,0,5,0,78
1092650,762998,2018-06-12,Senate,"Do pass, but first be re-referred to the Committee on [Health] with the recommendation: To Consent Calendar",6,0,1,0,7
1092650,766222,2018-06-20,Senate,"Do pass and be ordered to the Consent Calendar",8,0,1,0,9
1092650,769545,2018-07-02,Senate,"Consent Calendar AB3007",37,0,2,0,39
1092651,743217,2018-04-24,Senate,"Do pass, but first be re-referred to the Committee on [Appropriations]",12,0,0,0,12
1092651,750369,2018-05-07,Senate,"Placed on suspense file",6,0,1,0,7
1092651,756709,2018-05-25,Senate,"Do pass",7,0,0,0,7
1092651,758724,2018-05-31,Senate,"Special Consent SB1430",39,0,0,0,39
1092651,769324,2018-06-28,Assembly,"Do pass and be re-referred to the Committee on [Appropriations]",19,0,2,0,21
1092652,751389,2018-05-09,Assembly,"Do pass as amended",6,0,1,0,7
1092652,754958,2018-05-21,Assembly,"AB 3022 GONZALEZ FLETCHER Assembly Third Reading",68,2,8,0,78
1092652,762957,2018-06-13,Senate,"Do pass",7,0,0,0,7
1092652,771291,2018-08-13,Senate,"Assembly 3rd Reading AB3022 Gonzalez Fletcher By Lara",35,1,4,0,40
1092652,772248,2018-08-20,Assembly,"AB 3022 GONZALEZ FLETCHER Concurrence in Senate Amendments",75,1,4,0,80
1092653,738894,2018-04-16,Assembly,"Be re-referred to the Committee on [Housing and Community Development]",9,0,2,0,11
1092654,737461,2018-04-11,Assembly,"Do pass and be re-referred to the Committee on [Appropriations] with recommendation: To Consent Calendar",6,0,1,0,7
1092654,740863,2018-04-18,Assembly,"Do pass. To Consent Calendar",15,0,2,0,17
1092654,744870,2018-04-26,Assembly,"AB 2822 OBERNOLTE Consent Calendar Second Day Regular Session",74,0,4,0,78
1092654,768324,2018-06-26,Senate,"Do pass, but first be re-referred to the Committee on [Appropriations]",12,0,1,0,13
1092654,773042,2018-08-27,Senate,"Assembly 3rd Reading AB2822 Obernolte By Cannella",39,0,1,0,40
1092654,773591,2018-08-29,Assembly,"AB 2822 OBERNOLTE Concurrence in Senate Amendments",79,0,1,0,80
1092655,743807,2018-04-25,Assembly,"Do pass as amended and be re-referred to the Committee on [Appropriations]",8,4,1,0,13
1092657,738896,2018-04-16,Assembly,"Do pass and be re-referred to the Committee on [Appropriations]",12,0,2,0,14
1092657,753833,2018-05-16,Assembly,"Do pass",13,4,0,0,17
1092657,754907,2018-05-21,Assembly,"AB 2918 HOLDEN Assembly Third Reading",59,4,15,0,78
1092657,762243,2018-06-12,Senate,"Do pass as amended, but first amend, and re-refer to the Committee on [Appropriations]",12,0,1,0,13
1092657,768013,2018-06-25,Senate,"Placed on suspense file",7,0,0,0,7
1092657,772003,2018-08-16,Senate,"Do pass",7,0,0,0,7
1092657,773206,2018-08-28,Senate,"Assembly 3rd Reading AB2918 Holden By Skinner",39,0,1,0,40
1092657,773533,2018-08-29,Assembly,"AB 2918 HOLDEN Concurrence in Senate Amendments",66,7,7,0,80
1092657,774536,2018-06-25,Senate,,12,0,0,0,12
1092658,744050,2018-04-25,Assembly,"Do pass and be re-referred to the Committee on [Local Government]",7,0,0,0,7
1092658,744905,2018-04-25,Assembly,"Do pass and be re-referred to the Committee on [Appropriations]",5,1,3,0,9
1092659,739916,2018-04-17,Assembly,"Do pass and be re-referred to the Committee on [Judiciary]",2,5,0,0,7
1092660,739643,2018-04-17,Assembly,"Do pass and be re-referred to the Committee on [Appropriations]",12,0,1,0,13
1092661,743705,2018-04-24,Assembly,"Do pass as amended and be re-referred to the Committee on [Appropriations]",6,1,0,0,7
1092661,756588,2018-05-25,Assembly,"Do pass as amended",12,4,1,0,17
1092661,757613,2018-05-30,Assembly,"AB 2787 QUIRK Assembly Third Reading",61,10,7,0,78
1092661,772776,2018-08-27,Senate,"Do pass, but first be re-referred to the Committee on [Appropriations]",6,2,3,0,11
1092661,773283,2018-08-29,Senate,"Do pass",5,1,1,0,7
1092662,728058,2018-03-21,Assembly,"Do pass as amended and be re-referred to the Committee on [Appropriations]",4,2,1,0,7
1092662,743984,2018-04-25,Assembly,"Do pass as amended",12,5,0,0,17
1092662,751931,2018-05-10,Assembly,"AB 3042 SANTIAGO Assembly Third Reading",22,27,29,0,78
1092663,738249,2018-04-11,Assembly,"Do pass and be re-referred to the Committee on [Appropriations]",5,2,0,0,7
1092664,743157,2018-04-24,Assembly,"Do pass and be re-referred to the Committee on [Appropriations]",2,5,0,0,7
1092666,734582,2018-04-04,Assembly,"Do pass and be re-referred to the Committee on [Appropriations]",21,0,0,0,21
1092667,739941,2018-04-16,Assembly,"Do pass as amended and be re-referred to the Committee on [Judiciary]",10,0,1,0,11
1092667,742925,2018-04-24,Assembly,"Do pass and be re-referred to the Committee on [Appropriations]",10,0,0,0,10
1092667,756511,2018-05-25,Assembly,"Do pass",16,0,1,0,17
1092667,757778,2018-05-30,Assembly,"AB 2825 JONES-SAWYER Assembly Third Reading",77,0,1,0,78
1092667,769026,2018-06-26,Senate,"Do pass, but first be re-referred to the Committee on [Appropriations]",5,1,1,0,7
1092667,770777,2018-08-06,Senate,"Placed on suspense file",7,0,0,0,7
1092669,743079,2018-04-23,Assembly,"Do pass and be re-referred to the Committee on [Judiciary]",3,4,3,0,10
1092674,740849,2018-04-17,Senate,"Do pass, but first be re-referred to the Committee on [Rules]",13,0,0,0,13
1092674,743745,2018-04-25,Senate,"Do pass, but first be re-referred to the Committee on [Appropriations]",7,0,0,0,7
1092674,750410,2018-05-07,Senate,"Placed on suspense file",6,0,1,0,7
1092675,733283,2018-04-03,Senate,"Do pass, but first be re-referred to the Committee on [Appropriations]",5,1,1,0,7
1092675,752746,2018-05-14,Senate,"Senate 3rd Reading SB1393 Mitchell et al",23,14,2,0,39
1092675,762082,2018-06-12,Assembly,"Do pass and be re-referred to the Committee on [Appropriations]",5,2,0,0,7
1092675,771486,2018-08-15,Assembly,"Do pass",11,5,1,0,17
1092675,774125,2018-08-31,Assembly,"SB 1393 Mitchell Senate Third Reading By KALRA",41,33,6,0,80
1092676,733367,2018-04-03,Senate,"Do pass, but first be re-referred to the Committee on [Appropriations]",11,0,0,0,11
1092676,749037,2018-05-03,Senate,"Senate 3rd Reading SB1410 Morrell",38,0,1,0,39
1092676,766199,2018-06-20,Assembly,"Do pass and be re-referred to the Committee on [Appropriations]",15,0,0,0,15
1092676,771107,2018-08-08,Assembly,"Do pass as amended. To Consent Calendar",17,0,0,0,17
1092676,771615,2018-08-16,Assembly,"SB 1410 Morrell Consent Calendar Second Day Regular Session",76,0,4,0,80
1092676,772208,2018-08-20,Senate,"Unfinished Business SB1410 Morrell Concurrence",38,0,2,0,40
1092678,736199,2018-04-10,Assembly,"Do pass and be re-referred to the Committee on [Privacy and Consumer Protection]",5,2,0,0,7
1092678,740637,2018-04-17,Assembly,"Do pass and be re-referred to the Committee on [Appropriations]",7,2,1,0,10
1092678,756442,2018-05-25,Assembly,"Do pass as amended",12,4,1,0,17
1092678,757559,2018-05-30,Assembly,"AB 2998 BLOOM Assembly Third Reading",58,12,8,0,78
1092678,766846,2018-06-20,Senate,"Do pass, but first be re-referred to the Committee on [Business, Professions and Economic Development]",5,2,0,0,7
1092678,767902,2018-06-25,Senate,"Do pass as amended, but first amend, and re-refer to the Committee on [Appropriations]",7,2,0,0,9
1092678,771369,2018-08-13,Senate,"Placed on suspense file",7,0,0,0,7
1092678,771878,2018-08-16,Senate,"Do pass as amended",5,2,0,0,7
1092678,772773,2018-08-27,Senate,"Assembly 3rd Reading AB2998 Bloom et al. By Mitchell",29,9,2,0,40
1092678,773367,2018-08-29,Assembly,"AB 2998 BLOOM Concurrence in Senate Amendments",61,13,6,0,80
1092680,740610,2018-04-18,Senate,"Do pass as amended, but first amend, and re-refer to the Committee on [Appropriations]",6,0,1,0,7
1092680,750121,2018-05-07,Senate,"Placed on suspense file",6,0,1,0,7
1092681,734647,2018-04-04,Assembly,"Do pass and be re-referred to the Committee on [Appropriations]",20,0,1,0,21
1092681,741207,2018-04-18,Assembly,"Do pass. To Consent Calendar",15,0,2,0,17
1092681,744927,2018-04-26,Assembly,"AB 2838 LOW Consent Calendar Second Day Regular Session",74,0,4,0,78
1092681,768362,2018-06-26,Senate,"Do pass, but first be re-referred to the Committee on [Appropriations] with the recommendation: To Consent Calendar",13,0,0,0,13
1092681,773178,2018-08-28,Senate,"Assembly 3rd Reading AB2838 Low By Wiener",39,0,1,0,40
1092681,773437,2018-08-29,Assembly,"AB 2838 LOW Concurrence in Senate Amendments",80,0,0,0,80
1092682,732753,2018-04-02,Assembly,"Be re-referred to the Committee on [Environmental Safety and Toxic Materials]",6,0,5,0,11
1092682,743743,2018-04-24,Assembly,"Do pass as amended and be re-referred to the Committee on [Appropriations]",5,0,2,0,7
1092682,756353,2018-05-25,Assembly,"Do pass",13,0,4,0,17
1092682,757750,2018-05-30,Assembly,"AB 2934 STONE Assembly Third Reading",60,0,18,0,78
1092682,766950,2018-06-20,Senate,"Do pass, but first be re-referred to the Committee on [Appropriations]",7,0,0,0,7
1092682,770413,2018-08-06,Senate,"Placed on suspense file",7,0,0,0,7
1092683,744036,2018-04-25,Assembly,"Do pass and be re-referred to the Committee on [Appropriations]",11,0,2,0,13
1092683,751363,2018-05-09,Assembly,"Do pass. To Consent Calendar",16,0,1,0,17
1092683,754260,2018-05-17,Assembly,"AB 2986 CUNNINGHAM Consent Calendar Second Day Regular Session",73,0,5,0,78
1092683,762135,2018-06-12,Senate,"Do pass, but first be re-referred to the Committee on [Energy, Utilities and Communications] with the recommendation: To Consent Calendar",12,0,1,0,13
1092683,768842,2018-06-27,Senate,"Do pass, but first be re-referred to the Committee on [Appropriations]",10,0,1,0,11
1092683,772364,2018-08-21,Senate,"Assembly 3rd Reading AB2986 Cunningham et al. By Cannella",39,0,1,0,40
1092684,736155,2018-04-10,Assembly,"Do pass and be re-referred to the Committee on [Appropriations]",14,0,1,0,15
1092684,756556,2018-05-25,Assembly,"Do pass as amended",12,0,5,0,17
1092684,757806,2018-05-30,Assembly,"AB 2961 O'DONNELL Assembly Third Reading",78,0,0,0,78
1092684,769038,2018-06-27,Senate,"Do pass as amended, but first amend, and re-refer to the Committee on [Appropriations]",9,0,0,0,9
1092684,770955,2018-08-06,Senate,"Placed on suspense file",7,0,0,0,7
1092684,772093,2018-08-16,Senate,"Do pass",7,0,0,0,7
1092684,773516,2018-08-29,Senate,"Assembly 3rd Reading AB2961 O'Donnell et al. By Hernandez",39,0,1,0,40
1092684,773685,2018-08-30,Assembly,"AB 2961 O'DONNELL Concurrence in Senate Amendments",80,0,0,0,80
1092686,738396,2018-04-11,Assembly,"Do pass and be re-referred to the Committee on [Appropriations] with recommendation: To Consent Calendar",7,0,0,0,7
1092686,744478,2018-04-25,Assembly,"Do pass. To Consent Calendar",17,0,0,0,17
1092686,748837,2018-05-03,Assembly,"AB 2878 CHÁVEZ Consent Calendar Second Day Regular Session",71,0,7,0,78
1092686,763111,2018-06-13,Senate,"Do pass, but first be re-referred to the Committee on [Appropriations] with the recommendation: To Consent Calendar",7,0,0,0,7
1092686,771425,2018-08-13,Senate,"Assembly 3rd Reading AB2878 Chávez et al. By Wilk",37,0,3,0,40
1092686,773527,2018-08-29,Senate,"Assembly 3rd Reading AB2878 Chávez et al. By Wilk",39,0,1,0,40
1092686,773684,2018-08-30,Assembly,"AB 2878 CHÁVEZ Concurrence in Senate Amendments",80,0,0,0,80
1092687,743160,2018-04-24,Assembly,"Do pass and be re-referred to the Committee on [Appropriations]",15,0,0,0,15
1092687,756666,2018-05-25,Assembly,"Do pass",16,0,1,0,17
1092687,757756,2018-05-30,Assembly,"AB 2850 RUBIO Assembly Third Reading",78,0,0,0,78
1092687,768975,2018-06-27,Senate,"Do pass as amended, but first amend, and re-refer to the Committee on [Appropriations]",9,0,0,0,9
1092687,770958,2018-08-06,Senate,"Placed on suspense file",7,0,0,0,7
1092687,772032,2018-08-16,Senate,"Do pass as amended",7,0,0,0,7
1092687,773541,2018-08-29,Senate,"Assembly 3rd Reading AB2850 Rubio By Pan",39,0,1,0,40
1092687,773687,2018-08-30,Assembly,"AB 2850 RUBIO Concurrence in Senate Amendments",80,0,0,0,80
1092689,736345,2018-04-10,Assembly,"Do pass and be re-referred to the Committee on [Judiciary]",5,2,0,0,7
1092689,746908,2018-05-01,Assembly,"Do pass",7,2,1,0,10
1092689,754858,2018-05-21,Assembly,"AB 2803 LIMÓN Assembly Third Reading",41,27,10,0,78
1092689,762967,2018-06-12,Senate,"Do pass, but first be re-referred to the Committee on [Environmental Quality]",4,2,1,0,7
1092689,766892,2018-06-20,Senate,"Do pass, but first be re-referred to the Committee on [Appropriations]",5,2,0,0,7
1092690,741107,2018-04-18,Assembly,"Do pass as amended and be re-referred to the Committee on [Appropriations]",14,0,1,0,15
1092690,756683,2018-05-25,Assembly,"Do pass",16,0,1,0,17
1092690,757843,2018-05-30,Assembly,"AB 2831 LIMÓN Assembly Third Reading",78,0,0,0,78
1092690,765837,2018-06-19,Senate,"Do pass, but first be re-referred to the Committee on [Appropriations]",11,0,0,0,11
1092690,770354,2018-08-06,Senate,"Placed on suspense file",7,0,0,0,7
1092690,771980,2018-08-16,Senate,"Do pass",7,0,0,0,7
1092690,773655,2018-08-29,Senate,"Assembly 3rd Reading AB2831 Limón By Hueso",39,0,1,0,40
1092692,743820,2018-04-24,Senate,"Do pass, but first be re-referred to the Committee on [Appropriations]",11,0,2,0,13
1092692,752782,2018-05-14,Senate,"Placed on suspense file",7,0,0,0,7
1092692,756698,2018-05-25,Senate,"Do pass as amended",7,0,0,0,7
1092692,757854,2018-05-30,Senate,"Senate 3rd Reading SB1407 Newman",34,3,2,0,39
1092693,733217,2018-04-03,Senate,"Do pass, but first be re-referred to the Committee on [Appropriations]",6,0,1,0,7
1092693,738874,2018-04-16,Senate,"Placed on suspense file",7,0,0,0,7
1092693,756300,2018-05-25,Senate,"Do pass as amended",7,0,0,0,7
1092693,757536,2018-05-30,Senate,"Senate 3rd Reading SB1449 Leyva et al",38,0,1,0,39
1092693,768145,2018-06-26,Assembly,"Do pass and be re-referred to the Committee on [Appropriations]",7,0,0,0,7
1092693,771741,2018-08-16,Assembly,"Do pass",17,0,0,0,17
1092693,773746,2018-08-30,Assembly,"SB 1449 Leyva Senate Third Reading By CHIU",80,0,0,0,80
1092693,774091,2018-08-31,Senate,"Unfinished Business SB1449 Leyva et al. Concurrence",39,0,1,0,40
1092694,744738,2018-04-25,Assembly,"Do pass and be re-referred to the Committee on [Appropriations]",8,0,1,0,9
1092694,751499,2018-05-09,Assembly,"Do pass. To Consent Calendar",16,0,1,0,17
1092694,754375,2018-05-17,Assembly,"AB 3177 CHÁVEZ Consent Calendar Second Day Regular Session",73,0,5,0,78
1092694,768310,2018-06-26,Senate,"Do pass, but first be re-referred to the Committee on [Appropriations]",12,0,1,0,13
1092694,772932,2018-08-27,Senate,"Assembly 3rd Reading AB3177 Chávez et al. By Bates",39,0,1,0,40
1092694,773493,2018-08-29,Assembly,"AB 3177 CHÁVEZ Concurrence in Senate Amendments",80,0,0,0,80
1092695,740856,2018-04-18,Senate,"Do pass, but first be re-referred to the Committee on [Appropriations]",6,0,0,0,6
1092695,752047,2018-05-10,Senate,"Senate 3rd Reading SB1383 Fuller",38,0,1,0,39
1092695,769029,2018-06-27,Assembly,"Do pass as amended and be re-referred to the Committee on [Appropriations]",7,0,0,0,7
1092695,771094,2018-08-08,Assembly,"Do pass. To Consent Calendar",17,0,0,0,17
1092695,771633,2018-08-16,Assembly,"SB 1383 Fuller Consent Calendar Second Day Regular Session",76,0,4,0,80
1092695,772211,2018-08-20,Senate,"Unfinished Business SB1383 Fuller Concurrence",39,0,1,0,40
1092696,742314,2018-04-23,Senate,"Do pass, but first be re-referred to the Committee on [Appropriations]",9,0,0,0,9
1092696,755327,2018-05-22,Senate,"Placed on suspense file",7,0,0,0,7
1092696,756309,2018-05-25,Senate,"Do pass",5,1,1,0,7
1092696,757099,2018-05-29,Senate,"Senate 3rd Reading SB1480 Hill",34,4,1,0,39
1092696,764977,2018-06-19,Assembly,"Do pass as amended and be re-referred to the Committee on [Appropriations]",12,1,6,0,19
1092696,771743,2018-08-16,Assembly,"Do pass as amended",12,0,5,0,17
1092696,773800,2018-08-30,Assembly,"SB 1480 Hill Senate Third Reading By LOW",61,15,4,0,80
1092696,774007,2018-08-31,Senate,"Unfinished Business SB1480 Hill et al. Concurrence",30,6,4,0,40
1092697,736442,2018-04-09,Assembly,"Do pass as amended and be re-referred to the Committee on [Appropriations]",8,0,2,0,10
1092697,756695,2018-05-25,Assembly,"Do pass",16,0,1,0,17
1092697,757845,2018-05-30,Assembly,"AB 2855 BROUGH Assembly Third Reading",78,0,0,0,78
1092697,769289,2018-06-27,Senate,"Do pass as amended, but first amend, and re-refer to the Committee on [Appropriations]",7,0,0,0,7
1092697,770845,2018-08-06,Senate,"Placed on suspense file",7,0,0,0,7
1092698,744794,2018-04-25,Assembly,"Do pass as amended and be re-referred to the Committee on [Appropriations]",6,0,1,0,7
1092698,754101,2018-05-16,Assembly,"Do pass",12,3,2,0,17
1092698,756948,2018-05-29,Assembly,"AB 3228 BURKE Assembly Third Reading",53,20,5,0,78
1092698,766349,2018-06-20,Senate,"Do pass as amended, but first amend, and re-refer to the Committee on [Appropriations] with the recommendation: To Consent Calendar",5,1,1,0,7
1092698,768641,2018-06-20,Senate,"Do pass as amended, but first amend, and re-refer to the Committee on [Appropriations]",5,1,1,0,7
1092698,770834,2018-08-06,Senate,"Placed on suspense file",7,0,0,0,7
1092698,772059,2018-08-16,Senate,"Do pass",5,2,0,0,7
1092700,733695,2018-04-02,Assembly,"Do pass as amended and be re-referred to the Committee on [Appropriations]",9,0,1,0,10
1092700,743997,2018-04-25,Assembly,"Do pass. To Consent Calendar",17,0,0,0,17
1092700,748814,2018-05-03,Assembly,"AB 2938 BLOOM Consent Calendar Second Day Regular Session",71,0,7,0,78
1092700,771100,2018-08-08,Senate,"Do pass, but first be re-referred to the Committee on [Appropriations]",6,1,0,0,7
1092700,771433,2018-08-13,Senate,"Do pass",6,0,1,0,7
1092700,772306,2018-08-20,Senate,"Assembly 3rd Reading AB2938 Bloom By Allen",39,0,1,0,40
1092701,737447,2018-04-10,Assembly,"Do pass and be re-referred to the Committee on [Appropriations]",6,1,0,0,7
1092701,756425,2018-05-25,Assembly,"Do pass as amended",13,2,2,0,17
1092701,757529,2018-05-30,Assembly,"AB 2872 CARRILLO Assembly Third Reading",63,12,3,0,78
1092701,768801,2018-06-26,Senate,"Do pass, but first be re-referred to the Committee on [Appropriations]",5,0,2,0,7
1092701,770418,2018-08-06,Senate,"Placed on suspense file",7,0,0,0,7
1092701,771873,2018-08-16,Senate,"Do pass as amended",5,2,0,0,7
1092701,772886,2018-08-27,Senate,"Assembly 3rd Reading AB2872 Carrillo By Leyva",28,9,3,0,40
1092701,773540,2018-08-29,Assembly,"AB 2872 CARRILLO Concurrence in Senate Amendments",64,15,1,0,80
1092703,733250,2018-04-03,Senate,"Do pass, but first be re-referred to the Committee on [Appropriations]",6,0,1,0,7
1092703,742263,2018-04-23,Senate,"Senate 3rd Reading SB1355 Hill",38,0,1,0,39
1092703,765000,2018-06-19,Assembly,"Do pass and be re-referred to the Committee on [Appropriations]",10,0,0,0,10
1092703,768306,2018-06-26,Assembly,"Do pass and be re-referred to the Committee on [Appropriations]",7,0,0,0,7
1092703,771055,2018-08-08,Assembly,"Do pass. To Consent Calendar",17,0,0,0,17
1092703,771786,2018-08-16,Assembly,"SB 1355 Hill Consent Calendar Second Day Regular Session",76,0,4,0,80
1092703,772265,2018-08-20,Senate,"Unfinished Business SB1355 Hill Concurrence",39,0,1,0,40
1092703,774544,2018-04-03,Senate,?,0,0,1,0,1
1092705,738291,2018-04-11,Assembly,"Do pass as amended, and be re-referred to the Committee on [Human Services] with recommendation: To Consent Calendar",7,0,0,0,7
1092705,743700,2018-04-24,Assembly,"Do pass as amended and be re-referred to the Committee on [Appropriations]",7,0,0,0,7
1092705,756523,2018-05-25,Assembly,"Do pass as amended",16,0,1,0,17
1092705,757668,2018-05-30,Assembly,"AB 2960 THURMOND Assembly Third Reading",78,0,0,0,78
1092705,766121,2018-06-20,Senate,"Do pass, but first be re-referred to the Committee on [Human Services] with the recommendation: To Consent Calendar",7,0,0,0,7
1092705,769020,2018-06-26,Senate,"Do pass, but first be re-referred to the Committee on [Appropriations] with the recommendation: To Consent Calendar",6,0,1,0,7
1092705,770809,2018-08-06,Senate,"Placed on suspense file",7,0,0,0,7
1092705,772064,2018-08-16,Senate,"Do pass as amended",7,0,0,0,7
1092705,772774,2018-08-27,Senate,"Assembly 3rd Reading AB2960 Thurmond By Mitchell",39,0,1,0,40
1092705,773454,2018-08-29,Assembly,"AB 2960 THURMOND Concurrence in Senate Amendments",80,0,0,0,80
1092708,738776,2018-04-16,Assembly,"Do pass and be re-referred to the Committee on [Appropriations]",10,3,1,0,14
1092708,756633,2018-05-25,Assembly,"Do pass as amended",12,3,2,0,17
1092708,757579,2018-05-30,Assembly,"AB 3139 BONTA Assembly Third Reading",55,19,4,0,78
1092708,765178,2018-06-19,Senate,"Do pass, but first be re-referred to the Committee on [Appropriations]",12,0,1,0,13
1092708,770850,2018-08-06,Senate,"Placed on suspense file",7,0,0,0,7
1092708,772053,2018-08-16,Senate,"Do pass",5,1,1,0,7
1092708,772674,2018-08-24,Senate,"Assembly 3rd Reading AB3139 Bonta By Skinner",30,6,4,0,40
1092710,745031,2018-04-25,Assembly,"Do pass and be re-referred to the Committee on [Appropriations]",5,1,1,0,7
1092710,756764,2018-05-25,Assembly,"Do pass",12,4,1,0,17
1092710,757868,2018-05-30,Assembly,"AB 3018 LOW Assembly Third Reading",54,22,2,0,78
1092710,766060,2018-06-19,Senate,"Do pass, but first be re-referred to the Committee on [Labor and Industrial Relations]",5,2,0,0,7
1092710,768871,2018-06-27,Senate,"Do pass, but first be re-referred to the Committee on [Appropriations]",4,1,0,0,5
1092710,770922,2018-08-06,Senate,"Placed on suspense file",7,0,0,0,7
1092710,772048,2018-08-16,Senate,"Do pass as amended",5,2,0,0,7
1092710,773295,2018-08-29,Senate,"Assembly 3rd Reading AB3018 Low By Lara",26,12,2,0,40
1092710,773899,2018-08-30,Assembly,"AB 3018 LOW Concurrence in Senate Amendments",56,22,2,0,80
1092712,742176,2018-04-23,Assembly,"Do pass and be re-referred to the Committee on [Appropriations]",10,4,0,0,14
1092712,756462,2018-05-25,Assembly,"Do pass",12,4,1,0,17
1092712,757741,2018-05-30,Assembly,"AB 2865 CHIU Assembly Third Reading",49,28,1,0,78
1092712,768364,2018-06-26,Senate,"Do pass, but first be re-referred to the Committee on [Appropriations]",7,5,1,0,13
1092712,771400,2018-08-13,Senate,"Placed on suspense file",7,0,0,0,7
1092712,771781,2018-08-16,Senate,"Do pass",5,2,0,0,7
1092712,773575,2018-08-29,Senate,"Assembly 3rd Reading AB2865 Chiu By Wiener",26,12,2,0,40
1092712,773703,2018-08-30,Assembly,"AB 2865 CHIU Concurrence in Senate Amendments",49,29,2,0,80
1092713,736194,2018-04-10,Assembly,"Do pass and be re-referred to the Committee on [Appropriations]",7,0,0,0,7
1092713,756534,2018-05-25,Assembly,"Do pass as amended",16,0,1,0,17
1092713,757864,2018-05-30,Assembly,"AB 2832 DAHLE Assembly Third Reading",77,0,1,0,78
1092713,767267,2018-06-20,Senate,"Do pass as amended, but first amend, and re-refer to the Committee on [Appropriations] with the recommendation: To Consent Calendar",7,0,0,0,7
1092713,771240,2018-08-13,Senate,"Placed on suspense file",7,0,0,0,7
1092713,771949,2018-08-16,Senate,"Do pass",7,0,0,0,7
1092713,773010,2018-08-27,Senate,"Assembly 3rd Reading AB2832 Dahle et al. By Bradford",39,0,1,0,40
1092713,773407,2018-08-29,Assembly,"AB 2832 DAHLE Concurrence in Senate Amendments",80,0,0,0,80
1092714,741436,2018-04-18,Assembly,"Do pass and be re-referred to the Committee on [Appropriations]",6,0,1,0,7
1092714,756443,2018-05-25,Assembly,"Do pass",12,4,1,0,17
1092714,758769,2018-05-31,Assembly,"AB 3222 O'DONNELL Assembly Third Reading",54,19,5,0,78
1092714,768876,2018-06-27,Senate,"Do pass, but first be re-referred to the Committee on [Appropriations]",5,0,0,0,5
1092716,744749,2018-04-25,Assembly,"Do pass and be re-referred to the Committee on [Appropriations]",5,0,2,0,7
1092716,756512,2018-05-25,Assembly,"Do pass as amended",13,2,2,0,17
1092716,757691,2018-05-30,Assembly,"AB 2820 MCCARTY Assembly Third Reading",78,0,0,0,78
1092717,740319,2018-04-17,Assembly,"Do pass and be re-referred to the Committee on [Appropriations]",2,5,0,0,7
1092717,740320,2018-04-17,Assembly,Reconsideration,2,4,1,0,7
1092718,738247,2018-04-11,Assembly,"Do pass and be re-referred to the Committee on [Judiciary]",5,2,0,0,7
1092718,742980,2018-04-24,Assembly,"Do pass and be re-referred to the Committee on [Appropriations]",7,3,0,0,10
1092718,756602,2018-05-25,Assembly,"Do pass",12,4,1,0,17
1092718,758823,2018-05-31,Assembly,"AB 2946 KALRA Assembly Third Reading",19,30,29,0,78
1092718,777808,2018-05-25,Assembly,,7,4,1,0,12
1092719,743809,2018-04-25,Senate,"Do pass, but first be re-referred to the Committee on [Appropriations]",7,1,1,0,9
1092719,757070,2018-05-29,Senate,"Senate 3rd Reading SB1375 Hernandez et al",27,11,1,0,39
1092719,768142,2018-06-26,Assembly,"Do pass and be re-referred to the Committee on [Appropriations]",11,1,3,0,15
1092719,771502,2018-08-15,Assembly,"Do pass",12,5,0,0,17
1092719,772834,2018-08-27,Assembly,"SB 1375 Hernandez Senate Third Reading By WOOD",57,22,1,0,80
1092719,773146,2018-08-28,Senate,"Unfinished Business SB1375 Hernandez et al. Concurrence",27,12,1,0,40
1092720,736137,2018-04-09,Assembly,"Do pass as amended and be re-referred to the Committee on [Housing and Community Development]",8,0,2,0,10
1092720,751250,2018-05-09,Assembly,"Do pass and be re-referred to the Committee on [Appropriations]",7,0,0,0,7
1092721,742153,2018-04-23,Assembly,"Do pass and be re-referred to the Committee on [Appropriations]",14,0,0,0,14
1092722,746797,2018-05-01,Assembly,"Do pass as amended",6,3,1,0,10
1092722,758643,2018-05-31,Assembly,"AB 2925 BONTA Assembly Third Reading",16,36,26,0,78
1092724,733239,2018-04-03,Assembly,"Do pass as amended and be re-referred to the Committee on [Appropriations]",9,0,1,0,10
1092724,740843,2018-04-18,Assembly,"Do pass",12,0,5,0,17
1092724,746792,2018-04-30,Assembly,"AB 3002 GRAYSON Assembly Third Reading",73,1,4,0,78
1092724,763012,2018-06-12,Senate,"Do pass as amended, but first amend, and re-refer to the Committee on [Appropriations]",7,0,0,0,7
1092724,773620,2018-08-29,Senate,"Assembly 3rd Reading AB3002 Grayson et al. By Monning",39,0,1,0,40
1092724,773902,2018-08-30,Assembly,"AB 3002 GRAYSON Concurrence in Senate Amendments",78,0,2,0,80
1092725,751110,2018-05-08,Senate,"Do pass and be ordered to the Consent Calendar",7,0,0,0,7
1092725,754384,2018-05-17,Senate,"Consent Calendar SB1431",38,0,1,0,39
1092725,762260,2018-06-12,Assembly,"Do pass as amended. To Consent Calendar",9,0,1,0,10
1092725,767225,2018-06-21,Assembly,"SB 1431 Morrell Consent Calendar Second Day Regular Session",75,0,5,0,80
1092725,769649,2018-07-02,Senate,"Unfinished Business SB1431 Morrell Concurrence",37,0,2,0,39
1092726,740149,2018-04-17,Assembly,"Do pass and be re-referred to the Committee on [Higher Education]",7,0,0,0,7
1092726,743866,2018-04-24,Assembly,"Do pass and be re-referred to the Committee on [Appropriations]",13,0,0,0,13
1092726,756502,2018-05-25,Assembly,"Do pass as amended",16,0,1,0,17
1092726,757626,2018-05-30,Assembly,"AB 2836 GLORIA Assembly Third Reading",78,0,0,0,78
1092726,766536,2018-06-20,Senate,"Do pass, but first be re-referred to the Committee on [Appropriations]",7,0,0,0,7
1092726,769645,2018-07-02,Senate,"Placed on suspense file",7,0,0,0,7
1092726,772045,2018-08-16,Senate,"Do pass as amended",7,0,0,0,7
1092726,773465,2018-08-29,Senate,"Assembly 3rd Reading AB2836 Gloria et al. By Wilk",39,0,1,0,40
1092726,773757,2018-08-30,Assembly,"AB 2836 GLORIA Concurrence in Senate Amendments",79,0,1,0,80
1092727,747002,2018-05-01,Assembly,"Do pass. To Consent Calendar",10,0,0,0,10
1092727,750056,2018-05-07,Assembly,"AB 2792 CALDERON Consent Calendar Second Day Regular Session",72,0,6,0,78
1092727,762982,2018-06-12,Senate,"Do pass and be ordered to the Consent Calendar",7,0,0,0,7
1092727,767991,2018-06-25,Senate,"Consent Calendar AB2792",36,0,3,0,39
1092728,743174,2018-04-23,Assembly,"Do pass. To Consent Calendar",10,0,0,0,10
1092728,746192,2018-04-30,Assembly,"AB 2954 BONTA Consent Calendar Second Day",76,0,2,0,78
1092728,763309,2018-06-13,Senate,"Do pass",7,0,0,0,7
1092728,772187,2018-08-20,Senate,"Assembly 3rd Reading AB2954 Bonta By Skinner",39,0,1,0,40
1092728,772981,2018-08-27,Assembly,"AB 2954 BONTA Concurrence in Senate Amendments",78,0,2,0,80
1092730,734103,2018-04-04,Senate,"Do pass, but first be re-referred to the Committee on [Appropriations] with the recommendation: To Consent Calendar",6,0,0,0,6
1092730,742129,2018-04-23,Senate,"Consent Calendar SB1354",38,0,1,0,39
1092731,744849,2018-04-25,Assembly,"Do pass as amended and be re-referred to the Committee on [Appropriations]",6,1,0,0,7
1092732,743888,2018-04-25,Senate,"[First] hearing set for [04-25-2018]: Failed passage in Committee. Reconsideration granted",1,6,2,0,9
1092732,743889,2018-04-25,Senate,"Do pass, but first be re-referred to the Committee on [Appropriations]",1,6,2,0,9
1092733,737298,2018-04-11,Senate,"Do pass as amended, but first amend, and re-refer to the Committee on [Public Safety]",4,0,3,0,7
1092733,742963,2018-04-24,Senate,"Do pass, but first be re-referred to the Committee on [Appropriations]",5,2,0,0,7
1092733,752672,2018-05-14,Senate,"Placed on suspense file",7,0,0,0,7
1092733,756494,2018-05-25,Senate,"Do pass",5,2,0,0,7
1092733,758436,2018-05-31,Senate,"Senate 3rd Reading SB1303 Pan et al",26,9,4,0,39
1092733,766285,2018-06-20,Assembly,"Do pass and be re-referred to the Committee on [Public Safety]",5,2,2,0,9
1092733,768263,2018-06-26,Assembly,"Do pass and be re-referred to the Committee on [Appropriations]",5,1,1,0,7
1092733,771529,2018-08-16,Assembly,"Do pass as amended",11,0,6,0,17
1092733,773714,2018-08-30,Assembly,"SB 1303 Pan Senate Third Reading By KAMLAGER-DOVE",44,30,6,0,80
1092733,774153,2018-08-31,Senate,"Unfinished Business SB1303 Pan et al. Concurrence",26,11,3,0,40
1092733,775401,2018-05-25,Senate,,7,0,0,0,7
1092735,742307,2018-04-23,Senate,"Do pass as amended, but first amend, and re-refer to the Committee on [Appropriations]",9,0,0,0,9
1092735,755343,2018-05-22,Senate,"Placed on suspense file",7,0,0,0,7
1092735,756304,2018-05-25,Senate,"Do pass",7,0,0,0,7
1092735,757016,2018-05-29,Senate,"Senate 3rd Reading SB1482 Hill",38,0,1,0,39
1092735,768625,2018-06-26,Assembly,"Do pass as amended and be re-referred to the Committee on [Appropriations]",19,0,0,0,19
1092735,771098,2018-08-08,Assembly,"Do pass. To Consent Calendar",17,0,0,0,17
1092735,773090,2018-08-28,Assembly,"SB 1482 Hill Senate Third Reading By LOW",80,0,0,0,80
1092736,771407,2018-08-13,Assembly,"Be adopted. To third reading",10,0,1,0,11
1092736,773124,2018-08-28,Senate,"Assembly 3rd Reading ACR176 Rubio et al. By Monning",39,0,1,0,40
1092737,738129,2018-04-11,Assembly,"Do pass as amended and be re-referred to the Committee on [Appropriations]",6,0,1,0,7
1092737,756574,2018-05-25,Assembly,"Do pass",16,0,1,0,17
1092737,757507,2018-05-30,Assembly,"AB 3136 O'DONNELL Assembly Third Reading",77,0,1,0,78
1092737,766249,2018-06-20,Senate,"Do pass, but first be re-referred to the Committee on [Appropriations]",7,0,0,0,7
1092737,769622,2018-07-02,Senate,"Placed on suspense file",7,0,0,0,7
1092739,737498,2018-04-11,Assembly,"Do pass and be re-referred to the Committee on [Appropriations]",6,0,1,0,7
1092739,755725,2018-05-23,Assembly,"Do pass as amended",15,0,2,0,17
1092739,757189,2018-05-29,Assembly,"AB 2777 DALY Assembly Third Reading",74,0,4,0,78
1092739,768622,2018-06-26,Senate,"Do pass, but first be re-referred to the Committee on [Appropriations]",12,0,1,0,13
1092739,772479,2018-08-22,Senate,"Assembly 3rd Reading AB2777 Daly By Portantino",36,1,3,0,40
1092740,733682,2018-04-02,Assembly,"Do pass and be re-referred to the Committee on [Appropriations]",7,0,4,0,11
1092740,756385,2018-05-25,Assembly,"Do pass",12,0,5,0,17
1092740,757779,2018-05-30,Assembly,"AB 2953 LIMÓN Assembly Third Reading",54,1,23,0,78
1092740,766045,2018-06-20,Senate,"Do pass as amended, but first amend, and re-refer to the Committee on [Appropriations]",3,2,2,0,7
1092740,766046,2018-06-20,Senate,"[06-20-2018] hearing: Motion to Reconsider. [Reconsideration Granted.]",7,0,0,0,7
1092741,747062,2018-05-01,Senate,"Do pass as amended",12,0,1,0,13
1092742,741294,2018-04-18,Assembly,"Do pass and be re-referred to the Committee on [Appropriations]",5,1,1,0,7
1092742,748346,2018-05-02,Assembly,"Do pass",12,5,0,0,17
1092742,751914,2018-05-10,Assembly,"AB 3034 LOW Assembly Third Reading Amend By BAKER Set #1 Motion to Lay on the Table By CALDERON",48,23,7,0,78
1092742,751915,2018-05-10,Assembly,"AB 3034 LOW Assembly Third Reading Amend By BAKER Set #2 Motion to Lay on the Table By CALDERON",48,23,7,0,78
1092742,751916,2018-05-10,Assembly,"AB 3034 LOW Assembly Third Reading",50,23,5,0,78
1092742,767980,2018-06-25,Senate,"Do pass, but first be re-referred to the Committee on [Appropriations]",3,2,0,0,5
1092742,770849,2018-08-06,Senate,"Placed on suspense file",7,0,0,0,7
1092742,772029,2018-08-16,Senate,"Do pass",5,2,0,0,7
1092742,774263,2018-08-31,Senate,"Assembly 3rd Reading AB3034 Low By Pan",22,13,5,0,40
1092744,743879,2018-04-25,Senate,"[First] hearing set for [04-25-2018]: Failed passage in Committee. Reconsideration granted",1,5,3,0,9
1092744,743880,2018-04-25,Senate,"Do pass, but first be re-referred to the Committee on [Appropriations]",1,5,3,0,9
1092746,743999,2018-04-25,Assembly,"Do pass and be re-referred to the Committee on [Revenue and Taxation]",7,0,0,0,7
1092746,753489,2018-05-14,Assembly,"Do pass as amended and be re-referred to the Committee on [Appropriations]",9,0,1,0,10
1092747,740146,2018-04-17,Senate,"Do pass and be ordered to the Consent Calendar",7,0,0,0,7
1092747,742096,2018-04-23,Senate,"Consent Calendar SB1382",38,0,1,0,39
1092747,762466,2018-06-12,Assembly,"Do pass. To Consent Calendar",7,0,0,0,7
1092747,764148,2018-06-18,Assembly,"SB 1382 Vidak Consent Calendar Second Day Regular Session",80,0,0,0,80
1092750,721845,2018-03-12,Senate,"Senate 3rd Reading SCR104 Hertzberg",37,0,2,0,39
1092750,734403,2018-04-05,Assembly,"Be adopted. To Consent Calendar",8,0,3,0,11
1092750,738241,2018-04-12,Assembly,"SCR 104 Hertzberg Consent Calendar Second Day Regular Session",68,0,9,0,77
1092751,743702,2018-04-24,Assembly,"Do pass and be re-referred to the Committee on [Appropriations] with recommendation: To Consent Calendar",7,0,0,0,7
1092754,744808,2018-04-25,Assembly,"Do pass and be re-referred to the Committee on [Appropriations]",7,0,2,0,9
1092754,756463,2018-05-25,Assembly,"Do pass as amended",12,0,5,0,17
1092754,757509,2018-05-30,Assembly,"AB 3119 GONZALEZ FLETCHER Assembly Third Reading",61,2,15,0,78
1092754,769176,2018-06-27,Senate,"Do pass, but first be re-referred to the Committee on [Appropriations] with the recommendation: To Consent Calendar",7,0,0,0,7
1092754,775127,2018-05-25,Assembly,,7,0,5,0,12
1092755,743885,2018-04-25,Senate,"Do pass, but first be re-referred to the Committee on [Rules]",2,4,1,0,7
1092755,743886,2018-04-25,Senate,"[04-25-2018] hearing: Motion to Reconsider. [Reconsideration Granted.]",7,0,0,0,7
1092756,751222,2018-05-09,Senate,"Do pass",5,0,2,0,7
1092756,754951,2018-05-21,Senate,"Senate 3rd Reading SB1416 McGuire",33,1,5,0,39
1092756,768837,2018-06-27,Assembly,"Do pass",6,3,0,0,9
1092756,773114,2018-08-28,Assembly,"SB 1416 McGuire Senate Third Reading By BONTA",61,15,4,0,80
1092756,773592,2018-08-29,Senate,"Unfinished Business SB1416 McGuire Concurrence",39,0,1,0,40
1092757,739777,2018-04-17,Senate,"Do pass, but first be re-referred to the Committee on [Transportation and Housing]",10,0,1,0,11
1092757,743996,2018-04-24,Senate,"Do pass, but first be re-referred to the Committee on [Appropriations] with the recommendation: To Consent Calendar",11,0,2,0,13
1092757,755312,2018-05-22,Senate,"Placed on suspense file",7,0,0,0,7
1092757,756198,2018-05-25,Senate,"Do pass",7,0,0,0,7
1092757,758581,2018-05-31,Senate,"Special Consent SB1376",39,0,0,0,39
1092757,766077,2018-06-20,Assembly,"Do pass and be re-referred to the Committee on [Transportation]",9,1,3,0,13
1092757,767878,2018-06-25,Assembly,"Do pass and be re-referred to the Committee on [Appropriations]",10,0,4,0,14
1092757,771563,2018-08-16,Assembly,"Do pass",12,3,2,0,17
1092757,772565,2018-08-23,Assembly,"SB 1376 Hill Senate Third Reading By FRAZIER Amendment Set #1",54,22,4,0,80
1092757,773059,2018-08-28,Assembly,"SB 1376 Hill Senate Third Reading By FRAZIER",56,13,11,0,80
1092757,773284,2018-08-29,Senate,"That the Assembly amendments be concurred in",9,0,2,0,11
1092757,773864,2018-08-30,Senate,"Unfinished Business SB1376 Hill et al. Concurrence",30,8,2,0,40
1092757,774489,2018-08-23,Assembly,Noes:,12,22,4,0,38
1092758,740551,2018-04-17,Assembly,"Do pass and be re-referred to the Committee on [Appropriations] with recommendation: To Consent Calendar",15,0,0,0,15
1092758,747729,2018-05-02,Assembly,"Do pass. To Consent Calendar",17,0,0,0,17
1092758,751912,2018-05-10,Assembly,"AB 2983 ARAMBULA Consent Calendar Second Day Regular Session",73,0,5,0,78
1092758,768873,2018-06-27,Senate,"Do pass as amended, but first amend, and re-refer to the Committee on [Appropriations]",9,0,0,0,9
1092758,771347,2018-08-13,Senate,"Assembly 3rd Reading AB2983 Arambula By Roth",36,0,4,0,40
1092758,772225,2018-08-20,Assembly,"AB 2983 ARAMBULA Concurrence in Senate Amendments",80,0,0,0,80
1092759,737229,2018-04-11,Senate,"Do pass, but first be re-referred to the Committee on [Education]",5,0,0,0,5
1092759,740622,2018-04-18,Senate,"Do pass as amended, and be ordered to the Consent Calendar",6,0,0,0,6
1092759,746000,2018-04-30,Senate,"Consent Calendar SB1428 McGuire",36,0,3,0,39
1092759,763105,2018-06-13,Assembly,"Do pass and be re-referred to the Committee on [Labor and Employment]",5,0,2,0,7
1092759,767148,2018-06-20,Assembly,"Do pass",7,0,0,0,7
1092759,772216,2018-08-20,Assembly,"SB 1428 McGuire Senate Third Reading By O'DONNELL",78,1,1,0,80
1092760,740652,2018-04-18,Assembly,"Do pass as amended and be re-referred to the Committee on [Appropriations]",20,0,1,0,21
1092760,751710,2018-05-09,Assembly,"Do pass",16,0,1,0,17
1092760,754305,2018-05-17,Assembly,"AB 2958 QUIRK Assembly Third Reading",73,0,5,0,78
1092760,768183,2018-06-26,Senate,"Do pass, but first be re-referred to the Committee on [Appropriations]",12,0,1,0,13
1092760,773241,2018-08-28,Senate,"Assembly 3rd Reading AB2958 Quirk By Dodd",38,0,2,0,40
1092760,773585,2018-08-29,Assembly,"AB 2958 QUIRK Concurrence in Senate Amendments",79,0,1,0,80
1092761,739900,2018-04-17,Senate,"Do pass, but first be re-referred to the Committee on [Environmental Quality]",7,1,3,0,11
1092761,740893,2018-04-18,Senate,"Do pass as amended, but first amend, and re-refer to the Committee on [Appropriations]",5,0,2,0,7
1092761,750297,2018-05-07,Senate,"Placed on suspense file",6,0,1,0,7
1092763,743876,2018-04-24,Senate,"Do pass, but first be re-referred to the Committee on [Appropriations]",6,0,1,0,7
1092763,752066,2018-05-10,Senate,"Senate 3rd Reading SB1427 Hill",31,4,4,0,39
1092763,762126,2018-06-12,Assembly,"Do pass and be re-referred to the Committee on [Appropriations]",6,1,3,0,10
1092763,768943,2018-06-27,Assembly,"Do pass",13,0,4,0,17
1092763,772198,2018-08-20,Assembly,"SB 1427 Hill Senate Third Reading By IRWIN",60,0,20,0,80
1092763,772347,2018-08-21,Senate,"Unfinished Business SB1427 Hill Concurrence",30,3,7,0,40
1092765,739842,2018-04-17,Senate,"Do pass as amended, but first amend, and re-refer to the Committee on [Rules]",7,2,2,0,11
1092765,755353,2018-05-22,Senate,"Placed on suspense file",7,0,0,0,7
1092765,756251,2018-05-25,Senate,"Do pass",5,2,0,0,7
1092765,757175,2018-05-29,Senate,"Senate 3rd Reading SB1339 Stern",29,8,2,0,39
1092765,768741,2018-06-27,Assembly,"Do pass as amended and be re-referred to the Committee on [Appropriations]",12,2,1,0,15
1092765,771531,2018-08-16,Assembly,"Do pass",12,0,5,0,17
1092765,774243,2018-08-31,Assembly,"SB 1339 Stern Senate Third Reading By GARCIA, E",54,19,7,0,80
1092765,774277,2018-08-31,Senate,"Unfinished Business SB1339 Stern Concurrence",29,9,2,0,40
1092766,744804,2018-04-25,Assembly,"Do pass and be re-referred to the Committee on [Appropriations]",7,0,0,0,7
1092766,756403,2018-05-25,Assembly,"Do pass",16,0,1,0,17
1092766,757541,2018-05-30,Assembly,"AB 3205 O'DONNELL Assembly Third Reading",77,0,1,0,78
1092766,765989,2018-06-20,Senate,"Do pass as amended, but first amend, and re-refer to the Committee on [Appropriations] with the recommendation: To Consent Calendar",7,0,0,0,7
1092766,770567,2018-08-06,Senate,"Placed on suspense file",7,0,0,0,7
1092766,771697,2018-08-16,Senate,"Do pass as amended",7,0,0,0,7
1092766,772879,2018-08-27,Senate,"Assembly 3rd Reading AB3205 O'Donnell et al. By Dodd",39,0,1,0,40
1092766,773642,2018-08-29,Assembly,"AB 3205 O'DONNELL Concurrence in Senate Amendments",79,1,0,0,80
1092768,737353,2018-04-11,Assembly,"Do pass as amended and be re-referred to the Committee on [Natural Resources]",7,0,0,0,7
1092768,750038,2018-05-07,Assembly,"Do pass",9,0,0,0,9
1092768,757037,2018-05-29,Assembly,"AB 2797 BLOOM Assembly Third Reading",75,0,3,0,78
1092768,764906,2018-06-19,Senate,"Do pass, but first be re-referred to the Committee on [Natural Resources and Water] with the recommendation: To Consent Calendar",12,0,1,0,13
1092768,768217,2018-06-26,Senate,"Do pass and be ordered to the Consent Calendar",9,0,0,0,9
1092768,769564,2018-07-02,Senate,"Consent Calendar AB2797",37,0,2,0,39
1092768,773464,2018-08-29,Senate,"Assembly 3rd Reading AB2797 Bloom By Allen",39,0,1,0,40
1092768,773838,2018-08-30,Assembly,"AB 2797 BLOOM Concurrence in Senate Amendments",79,0,1,0,80
1092769,739831,2018-04-17,Assembly,"Do pass and be re-referred to the Committee on [Governmental Organization] with recommendation: To Consent Calendar",16,0,0,0,16
1092769,744911,2018-04-26,Assembly,"Do pass as amended and be re-referred to the Committee on [Appropriations]",15,0,6,0,21
1092769,755741,2018-05-23,Assembly,"Do pass. To Consent Calendar",16,0,1,0,17
1092769,757209,2018-05-29,Assembly,"AB 2914 COOLEY Consent Calendar Second Day Regular Session",78,0,0,0,78
1092769,765080,2018-06-18,Senate,"Do pass, but first be re-referred to the Committee on [Governmental Organization]",8,0,1,0,9
1092769,768311,2018-06-26,Senate,"Do pass as amended, but first amend, and re-refer to the Committee on [Appropriations]",13,0,0,0,13
1092769,772902,2018-08-27,Senate,"Assembly 3rd Reading AB2914 Cooley By Cannella",34,3,3,0,40
1092769,773306,2018-08-29,Assembly,"AB 2914 COOLEY Concurrence in Senate Amendments",78,0,2,0,80
1092770,740927,2018-04-18,Senate,"Do pass, but first be re-referred to the Committee on [Appropriations]",6,0,0,0,6
1092770,746347,2018-04-30,Senate,"Placed on suspense file",6,0,1,0,7
1092770,756708,2018-05-25,Senate,"Do pass as amended",7,0,0,0,7
1092770,757630,2018-05-30,Senate,"Senate 3rd Reading SB1356 Wilk et al",36,0,3,0,39
1092770,765218,2018-06-19,Assembly,"Do pass and be re-referred to the Committee on [Appropriations]",13,0,0,0,13
1092771,742178,2018-04-23,Assembly,"Do pass and be re-referred to the Committee on [Appropriations] with recommendation: To Consent Calendar",14,0,0,0,14
1092773,734560,2018-04-04,Assembly,"Do pass and be re-referred to the Committee on [Appropriations]",7,0,0,0,7
1092773,756753,2018-05-25,Assembly,"Do pass",16,0,1,0,17
1092773,757565,2018-05-30,Assembly,"AB 2915 CABALLERO Assembly Third Reading",78,0,0,0,78
1092773,768754,2018-06-27,Senate,"Do pass, but first be re-referred to the Committee on [Appropriations] with the recommendation: To Consent Calendar",5,0,0,0,5
1092773,770904,2018-08-06,Senate,"Placed on suspense file",7,0,0,0,7
1092773,772083,2018-08-16,Senate,"Do pass",7,0,0,0,7
1092773,772404,2018-08-21,Senate,"Assembly 3rd Reading AB2915 Caballero et al. By Portantino",39,0,1,0,40
1092773,772894,2018-08-27,Assembly,"AB 2915 CABALLERO Concurrence in Senate Amendments",80,0,0,0,80
1092775,733206,2018-04-03,Assembly,"Do pass",16,0,0,0,16
1092775,741487,2018-04-19,Assembly,"AB 2791 MURATSUCHI Assembly Third Reading Amend By MURATSUCHI Set #1",71,0,7,0,78
1092775,744933,2018-04-26,Assembly,"AB 2791 MURATSUCHI Assembly Third Reading",74,0,4,0,78
1092775,769654,2018-07-02,Senate,"Do pass and be ordered to the Consent Calendar",8,0,1,0,9
1092775,770818,2018-08-06,Senate,"Consent Calendar AB2791 Muratsuchi et al",37,0,2,0,39
1092777,739741,2018-04-17,Senate,"Do pass, but first be re-referred to the Committee on [Labor and Industrial Relations]",5,2,0,0,7
1092777,743753,2018-04-25,Senate,"Do pass, but first be re-referred to the Committee on [Appropriations]",4,1,0,0,5
1092777,749812,2018-05-07,Senate,"Placed on suspense file",6,0,1,0,7
1092779,733742,2018-04-03,Assembly,"Do pass as amended and be re-referred to the Committee on [Appropriations]",13,0,0,0,13
1092779,740852,2018-04-18,Assembly,"Do pass. To Consent Calendar",15,0,2,0,17
1092779,744832,2018-04-26,Assembly,"AB 2990 LOW Consent Calendar Second Day Regular Session",74,0,4,0,78
1092779,760433,2018-06-06,Senate,"Do pass, but first be re-referred to the Committee on [Appropriations] with the recommendation: To Consent Calendar",6,0,0,0,6
1092779,771441,2018-08-13,Senate,"Assembly 3rd Reading AB2990 Low By Allen",37,0,3,0,40
1092780,736113,2018-04-10,Assembly,"Do pass and be re-referred to the Committee on [Appropriations]",7,0,0,0,7
1092780,756424,2018-05-25,Assembly,"Do pass as amended",16,0,1,0,17
1092780,757606,2018-05-30,Assembly,"AB 3118 CHIU Assembly Third Reading",77,0,1,0,78
1092780,768226,2018-06-26,Senate,"Do pass as amended, but first amend, and re-refer to the Committee on [Appropriations]",7,0,0,0,7
1092780,770296,2018-08-06,Senate,"Placed on suspense file",7,0,0,0,7
1092780,771575,2018-08-16,Senate,"Do pass as amended",7,0,0,0,7
1092780,772570,2018-08-23,Senate,"Assembly 3rd Reading AB3118 Chiu et al. By Leyva",39,0,1,0,40
1092780,772977,2018-08-27,Assembly,"AB 3118 CHIU Concurrence in Senate Amendments",80,0,0,0,80
1092781,743988,2018-04-25,Senate,"Do pass, but first be re-referred to the Committee on [Appropriations]",10,0,1,0,11
1092781,757203,2018-05-29,Senate,"Senate 3rd Reading SB1338 Hueso",38,0,1,0,39
1092781,766543,2018-06-20,Assembly,"Do pass and be re-referred to the Committee on [Appropriations]",15,0,0,0,15
1092781,771117,2018-08-08,Assembly,"Do pass. To Consent Calendar",17,0,0,0,17
1092781,774210,2018-08-31,Assembly,"SB 1338 Hueso Senate Third Reading By REYES",79,0,1,0,80
1092782,740727,2018-04-18,Senate,"Do pass as amended, but first amend, and re-refer to the Committee on [Appropriations]",9,0,0,0,9
1092782,755333,2018-05-22,Senate,"Placed on suspense file",7,0,0,0,7
1092782,756382,2018-05-25,Senate,"Do pass",7,0,0,0,7
1092782,758559,2018-05-31,Senate,"Special Consent SB1464",39,0,0,0,39
1092782,768255,2018-06-26,Assembly,"Do pass and be re-referred to the Committee on [Appropriations] with recommendation: To Consent Calendar",15,0,0,0,15
1092783,743164,2018-04-23,Assembly,"Do pass as amended and be re-referred to the Committee on [Appropriations]",10,0,0,0,10
1092785,747011,2018-05-01,Assembly,"Do pass as amended",7,2,1,0,10
1092785,758756,2018-05-31,Assembly,"AB 2995 CARRILLO Assembly Third Reading",30,35,13,0,78
1092786,740550,2018-04-18,Senate,"Do pass as amended, but first amend, and re-refer to the Committee on [Appropriations]",7,2,0,0,9
1092786,755284,2018-05-22,Senate,"Do pass",5,2,0,0,7
1092786,756971,2018-05-29,Senate,"Senate 3rd Reading SB1288 Leyva et al",22,13,4,0,39
1092786,764930,2018-06-19,Assembly,"Do pass as amended and be re-referred to the Committee on [Appropriations]",11,4,0,0,15
1092786,771474,2018-08-15,Assembly,"Do pass",12,5,0,0,17
1092786,773082,2018-08-28,Assembly,"SB 1288 Leyva Senate Third Reading By SANTIAGO",49,26,5,0,80
1092786,773339,2018-08-29,Senate,"Unfinished Business SB1288 Leyva et al. Concurrence",25,14,1,0,40
1092787,740334,2018-04-17,Assembly,"Do pass as amended and be re-referred to the Committee on [Public Safety]",13,0,3,0,16
1092788,736007,2018-04-09,Assembly,"Do pass as amended and be re-referred to the Committee on [Appropriations]",7,3,0,0,10
1092788,756551,2018-05-25,Assembly,"Do pass",12,4,1,0,17
1092788,757811,2018-05-30,Assembly,"AB 2908 BERMAN Assembly Third Reading",45,28,5,0,78
1092788,766894,2018-06-20,Senate,"Do pass as amended, but first amend, and re-refer to the Committee on [Appropriations]",5,1,1,0,7
1092788,771245,2018-08-13,Senate,"Placed on suspense file",7,0,0,0,7
1092788,771956,2018-08-16,Senate,"Do pass",5,2,0,0,7
1092788,772611,2018-08-23,Senate,"Assembly 3rd Reading AB2908 Berman et al. By Allen",24,13,3,0,40
1092788,773038,2018-08-27,Assembly,"AB 2908 BERMAN Concurrence in Senate Amendments",46,30,4,0,80
1092788,777394,2018-08-23,Senate,,5,13,3,0,21
1092792,745029,2018-04-25,Assembly,"Do pass as amended and be re-referred to the Committee on [Appropriations]",7,0,0,0,7
1092792,756577,2018-05-25,Assembly,"Do pass",16,0,1,0,17
1092792,757830,2018-05-30,Assembly,"AB 2979 BURKE Assembly Third Reading",77,0,1,0,78
1092792,768907,2018-06-27,Senate,"Do pass as amended, but first amend, and re-refer to the Committee on [Appropriations]",7,0,0,0,7
1092792,770934,2018-08-06,Senate,"Placed on suspense file",7,0,0,0,7
1092792,772039,2018-08-16,Senate,"Do pass",7,0,0,0,7
1092793,738810,2018-04-16,Assembly,"Do pass and be re-referred to the Committee on [Appropriations]",14,0,0,0,14
1092794,743117,2018-04-24,Assembly,"Do pass and be re-referred to the Committee on [Appropriations]",16,0,0,0,16
1092794,751852,2018-05-09,Assembly,"Do pass. To Consent Calendar",16,0,1,0,17
1092794,754204,2018-05-17,Assembly,"AB 2968 LEVINE Consent Calendar Second Day Regular Session",73,0,5,0,78
1092794,767939,2018-06-25,Senate,"Do pass, but first be re-referred to the Committee on [Appropriations]",9,0,0,0,9
1092794,772396,2018-08-21,Senate,"Assembly 3rd Reading AB2968 Levine By Galgiani",39,0,1,0,40
1092794,773195,2018-08-28,Assembly,"AB 2968 LEVINE Concurrence in Senate Amendments",80,0,0,0,80
1092795,737453,2018-04-10,Assembly,"Do pass as amended and be re-referred to the Committee on [Aging and Long-Term Care]",5,0,2,0,7
1092795,740580,2018-04-17,Assembly,"Do pass and be re-referred to the Committee on [Appropriations]",5,0,2,0,7
1092795,751735,2018-05-09,Assembly,"Do pass",11,0,6,0,17
1092795,752781,2018-05-14,Assembly,"AB 3088 CHU Assembly Third Reading",64,1,13,0,78
1092795,762838,2018-06-12,Senate,"Do pass, but first be re-referred to the Committee on [Appropriations]",6,0,1,0,7
1092795,772976,2018-08-27,Senate,"Assembly 3rd Reading AB3088 Chu By Monning",30,9,1,0,40
1092795,773354,2018-08-29,Assembly,"AB 3088 CHU Concurrence in Senate Amendments",74,1,5,0,80
1092796,743145,2018-04-24,Assembly,"Do pass as amended and be re-referred to the Committee on [Appropriations]",16,0,0,0,16
1092796,756546,2018-05-25,Assembly,"Do pass",16,0,1,0,17
1092796,757801,2018-05-30,Assembly,"AB 3141 B. & P. Assembly Third Reading By LOW",75,0,3,0,78
1092796,767872,2018-06-25,Senate,"Do pass, but first be re-referred to the Committee on [Appropriations]",9,0,0,0,9
1092796,770944,2018-08-06,Senate,"Placed on suspense file",7,0,0,0,7
1092796,771970,2018-08-16,Senate,"Do pass",7,0,0,0,7
1092796,772884,2018-08-27,Senate,"Assembly 3rd Reading AB3141 Low et al. By Hill",39,0,1,0,40
1092796,773633,2018-08-29,Assembly,"AB 3141 LOW Concurrence in Senate Amendments",78,0,2,0,80
1092798,741060,2018-04-18,Senate,"Do pass, but first be re-referred to the Committee on [Appropriations] with the recommendation: To Consent Calendar",7,0,0,0,7
1092798,748839,2018-05-03,Senate,"Consent Calendar SB1361",38,0,1,0,39
1092798,764257,2018-06-18,Assembly,"Do pass and be re-referred to the Committee on [Appropriations]",11,0,0,0,11
1092798,766026,2018-06-18,Assembly,"Do pass and be re-referred to the Committee on [Appropriations] with recommendation: To Consent Calendar",11,0,0,0,11
1092798,771050,2018-08-08,Assembly,"Do pass. To Consent Calendar",17,0,0,0,17
1092798,771587,2018-08-16,Assembly,"SB 1361 Bradford Consent Calendar Second Day Regular Session",76,0,4,0,80
1092798,772327,2018-08-21,Senate,"That the Assembly amendments be concurred in",7,0,0,0,7
1092798,773145,2018-08-28,Senate,"Unfinished Business SB1361 Bradford Concurrence",39,0,1,0,40
1092799,736409,2018-04-10,Assembly,"Do pass and be re-referred to the Committee on [Privacy and Consumer Protection] with recommendation: To Consent Calendar",7,0,0,0,7
1092799,740537,2018-04-17,Assembly,"Do pass and be re-referred to the Committee on [Appropriations] with recommendation: To Consent Calendar",10,0,0,0,10
1092799,747887,2018-05-02,Assembly,"Do pass. To Consent Calendar",17,0,0,0,17
1092799,752021,2018-05-10,Assembly,"AB 3229 BURKE Consent Calendar Second Day Regular Session",73,0,5,0,78
1092799,762244,2018-06-12,Senate,"Do pass, but first be re-referred to the Committee on [Banking and Financial Institutions] with the recommendation: To Consent Calendar",7,0,0,0,7
1092799,766084,2018-06-20,Senate,"Do pass, but first be re-referred to the Committee on [Appropriations] with the recommendation: To Consent Calendar",7,0,0,0,7
1092799,771315,2018-08-13,Senate,"Consent Calendar AB3229",37,0,3,0,40
1092800,739633,2018-04-16,Senate,"Do pass, but first be re-referred to the Committee on [Governmental Organization]",6,2,1,0,9
1092800,743071,2018-04-24,Senate,"Do pass as amended, but first amend, and re-refer to the Committee on [Appropriations]",7,4,1,0,12
1092800,755276,2018-05-22,Senate,"Placed on suspense file",7,0,0,0,7
1092800,756263,2018-05-25,Senate,"Do pass",5,2,0,0,7
1092800,757554,2018-05-30,Senate,"Senate 3rd Reading SB1316 Glazer et al",24,13,2,0,39
1092800,768125,2018-06-26,Assembly,"Do pass and be re-referred to the Committee on [Accountability and Administrative Review]",8,6,1,0,15
1092800,768895,2018-06-27,Assembly,"Do pass and be re-referred to the Committee on [Appropriations]",5,2,0,0,7
1092801,733632,2018-04-03,Assembly,"Do pass and be re-referred to the Committee on [Labor and Employment]",12,3,1,0,16
1092801,741441,2018-04-18,Assembly,"Do pass and be re-referred to the Committee on [Appropriations]",6,0,1,0,7
1092801,747829,2018-05-02,Assembly,"Do pass",12,5,0,0,17
1092801,752728,2018-05-14,Assembly,"AB 2799 JONES-SAWYER Assembly Third Reading",55,21,2,0,78
1092801,761704,2018-06-11,Senate,"Do pass, but first be re-referred to the Committee on [Appropriations]",7,1,1,0,9
1092801,773999,2018-08-31,Senate,"Assembly 3rd Reading AB2799 Jones-Sawyer By Wilk",33,6,1,0,40
1092801,774000,2018-08-31,Assembly,"AB 2799 Jones-Sawyer Concurrence in Senate Amendments",59,19,2,0,80
1092802,736032,2018-04-10,Senate,"Do pass, but first be re-referred to the Committee on [Environmental Quality]",2,5,0,0,7
1092802,736033,2018-04-10,Senate,"[First] hearing set for [04-10-2018]: Failed passage in Committee. Reconsideration granted",7,0,0,0,7
1092803,743152,2018-04-24,Assembly,"Do pass as amended and be re-referred to the Committee on [Appropriations]",15,0,0,0,15
1092803,756434,2018-05-25,Assembly,"Do pass as amended",16,0,1,0,17
1092803,757739,2018-05-30,Assembly,"AB 2861 SALAS Assembly Third Reading",78,0,0,0,78
1092803,768854,2018-06-27,Senate,"Do pass, but first be re-referred to the Committee on [Appropriations] with the recommendation: To Consent Calendar",9,0,0,0,9
1092803,771248,2018-08-13,Senate,"Placed on suspense file",7,0,0,0,7
1092803,771826,2018-08-16,Senate,"Do pass",7,0,0,0,7
1092803,772376,2018-08-21,Senate,"Assembly 3rd Reading AB2861 Salas By Beall",39,0,1,0,40
1092803,772978,2018-08-27,Assembly,"AB 2861 SALAS Concurrence in Senate Amendments",80,0,0,0,80
1092805,736719,2018-04-09,Assembly,"Do pass as amended and be re-referred to the Committee on [Appropriations]",7,0,3,0,10
1092806,743021,2018-04-24,Senate,"Do pass",5,2,0,0,7
1092806,748836,2018-05-03,Senate,"Senate 3rd Reading SB1346 Jackson",26,8,5,0,39
1092806,762206,2018-06-12,Assembly,"Do pass",6,0,1,0,7
1092806,774127,2018-08-31,Senate,"Unfinished Business SB1346 Jackson et al. Concurrence",28,9,3,0,40
1092806,774128,2018-08-31,Assembly,"SB 1346 Jackson Senate Third Reading By GABRIEL",57,19,4,0,80
1092808,736028,2018-04-10,Senate,"Do pass as amended, but first amend, and re-refer to the Committee on [Environmental Quality] with the recommendation: To Consent Calendar",13,0,0,0,13
1092808,740697,2018-04-18,Senate,"Do pass, but first be re-referred to the Committee on [Appropriations]",7,0,0,0,7
1092808,746106,2018-04-30,Senate,"Placed on suspense file",6,0,1,0,7
1092808,756354,2018-05-25,Senate,"Do pass as amended",7,0,0,0,7
1092808,757671,2018-05-30,Senate,"Senate 3rd Reading SB1403 Lara",36,0,3,0,39
1092808,764233,2018-06-18,Assembly,"Do pass and be re-referred to the Committee on [Natural Resources] with recommendation: To Consent Calendar",12,0,2,0,14
1092808,768254,2018-06-25,Assembly,"Do pass and be re-referred to the Committee on [Appropriations] with recommendation: To Consent Calendar",10,0,0,0,10
1092808,771747,2018-08-16,Assembly,"Do pass",17,0,0,0,17
1092808,773116,2018-08-28,Assembly,"SB 1403 Lara Senate Third Reading By REYES",79,0,1,0,80
1092809,733284,2018-04-03,Senate,"Do pass, but first be re-referred to the Committee on [Appropriations]",5,1,1,0,7
1092809,757011,2018-05-29,Senate,"Senate 3rd Reading SB1392 Mitchell et al",17,14,8,0,39
1092809,757012,2018-05-29,Senate,"Senate 3rd Reading SB1392 Mitchell et al. Reconsider",37,0,2,0,39
1092809,758519,2018-05-31,Senate,"Senate 3rd Reading SB1392 Mitchell et al",18,16,5,0,39
1092809,777239,2018-04-03,Senate,"Do pass, but first be re-referred to the Committee on [Appropriations=""No Votes Recorded"">No Votes Recorded:",0,0,1,0,1
1092810,740360,2018-04-17,Senate,"Do pass, but first be re-referred to the Committee on [Appropriations]",5,2,0,0,7
1092810,746485,2018-04-30,Senate,"Placed on suspense file",6,0,1,0,7
1092810,756195,2018-05-25,Senate,"Do pass as amended",5,2,0,0,7
1092810,757786,2018-05-30,Senate,"Senate 3rd Reading SB1279 Bradford et al",22,14,3,0,39
1092810,765662,2018-06-19,Assembly,"Do pass and be re-referred to the Committee on [Appropriations]",5,2,0,0,7
1092810,771811,2018-08-16,Assembly,"Do pass",11,5,1,0,17
1092810,774229,2018-08-31,Assembly,"SB 1279 Bradford Senate Third Reading By CHIU",10,50,20,0,80
1092811,739717,2018-04-17,Assembly,"Do pass",10,0,0,0,10
1092811,741414,2018-04-19,Assembly,"AB 3211 KALRA Assembly Third Reading",73,0,5,0,78
1092811,769697,2018-07-03,Senate,"Do pass as amended",7,0,0,0,7
1092811,772154,2018-08-20,Senate,"Assembly 3rd Reading AB3211 Kalra By Allen",39,0,1,0,40
1092811,772510,2018-08-23,Assembly,"AB 3211 KALRA Concurrence in Senate Amendments",76,0,4,0,80
1092812,742210,2018-04-23,Assembly,"Do pass and be re-referred to the Committee on [Appropriations]",14,0,0,0,14
1092812,756418,2018-05-25,Assembly,"Do pass as amended",16,0,1,0,17
1092812,757546,2018-05-30,Assembly,"AB 2851 GRAYSON Assembly Third Reading",78,0,0,0,78
1092812,768193,2018-06-26,Senate,"Do pass, but first be re-referred to the Committee on [Appropriations] with the recommendation: To Consent Calendar",8,0,5,0,13
1092812,770291,2018-08-06,Senate,"Placed on suspense file",7,0,0,0,7
1092812,771674,2018-08-16,Senate,"Do pass",7,0,0,0,7
1092815,740947,2018-04-17,Assembly,"Do pass and be re-referred to the Committee on [Appropriations] with recommendation: To Consent Calendar",15,0,0,0,15
1092815,755733,2018-05-23,Assembly,"Do pass. To Consent Calendar",16,0,1,0,17
1092815,757118,2018-05-29,Assembly,"AB 2904 CARRILLO Consent Calendar Second Day Regular Session",78,0,0,0,78
1092815,768968,2018-06-27,Senate,"Do pass as amended, and be ordered to the Consent Calendar",7,0,0,0,7
1092816,736114,2018-04-09,Assembly,"Do pass and be re-referred to the Committee on [Appropriations]",7,0,3,0,10
1092818,753243,2018-05-14,Assembly,"Do pass and be re-referred to the Committee on [Appropriations]",9,0,1,0,10
1092819,736163,2018-04-10,Assembly,"Do pass and be re-referred to the Committee on [Appropriations]",6,0,1,0,7
1092819,756774,2018-05-25,Assembly,"Do pass",16,0,1,0,17
1092819,757841,2018-05-30,Assembly,"AB 2992 DALY Assembly Third Reading",78,0,0,0,78
1092819,768638,2018-06-26,Senate,"Do pass, but first be re-referred to the Committee on [Appropriations] with the recommendation: To Consent Calendar",7,0,0,0,7
1092819,770824,2018-08-06,Senate,"Placed on suspense file",7,0,0,0,7
1092819,772084,2018-08-16,Senate,"Do pass as amended",7,0,0,0,7
1092819,772324,2018-08-21,Senate,"Assembly 3rd Reading AB2992 Daly et al. By Skinner",39,0,1,0,40
1092819,772866,2018-08-27,Assembly,"AB 2992 DALY Concurrence in Senate Amendments",80,0,0,0,80
1092820,737423,2018-04-11,Senate,"Do pass, but first be re-referred to the Committee on [Judiciary]",2,6,1,0,9
1092821,742940,2018-04-23,Assembly,"Do pass as amended and be re-referred to the Committee on [Veterans Affairs]",10,0,0,0,10
1092821,751384,2018-05-08,Assembly,"Do pass and be re-referred to the Committee on [Appropriations]",8,0,2,0,10
1092822,736595,2018-04-10,Assembly,"Do pass and be re-referred to the Committee on [Appropriations]",6,0,1,0,7
1092822,756651,2018-05-25,Assembly,"Do pass as amended",12,0,5,0,17
1092822,758688,2018-05-31,Assembly,"AB 2781 LOW Assembly Third Reading",73,0,5,0,78
1092822,768245,2018-06-26,Senate,"Do pass, but first be re-referred to the Committee on [Appropriations]",7,0,0,0,7
1092822,770521,2018-08-06,Senate,"Placed on suspense file",7,0,0,0,7
1092823,733869,2018-04-04,Senate,"Do pass, but first be re-referred to the Committee on [Judiciary]",6,0,0,0,6
1092823,743895,2018-04-24,Senate,"Do pass as amended, but first amend, and re-refer to the Committee on [Appropriations] with the recommendation: To Consent Calendar",7,0,0,0,7
1092823,752730,2018-05-14,Senate,"Placed on suspense file",7,0,0,0,7
1092824,740254,2018-04-16,Senate,"Do pass, but first be re-referred to the Committee on [Environmental Quality]",7,2,0,0,9
1092824,757356,2018-05-29,Senate,"Senate 3rd Reading SB1370 Stern",28,10,1,0,39
1092824,768344,2018-06-25,Assembly,"Do pass and be re-referred to the Committee on [Appropriations]",8,0,2,0,10
1092824,771513,2018-08-15,Assembly,"Do pass",12,5,0,0,17
1092825,733834,2018-04-04,Senate,"Be adopted, but first be re-referred to the Committee on [Elections and Constitutional Amendments]",2,4,0,0,6
1092825,733835,2018-04-04,Senate,"[First] hearing set for [04-04-2018]: Failed passage in Committee. Reconsideration granted",6,0,0,0,6
1092826,734787,2018-04-04,Assembly,"Do pass and be re-referred to the Committee on [Appropriations]",19,0,2,0,21
1092828,743090,2018-04-23,Assembly,"Do pass as amended and be re-referred to the Committee on [Appropriations]",9,0,1,0,10
1092828,755704,2018-05-23,Assembly,"Do pass",15,0,2,0,17
1092828,756967,2018-05-29,Assembly,"AB 2782 FRIEDMAN Assembly Third Reading",74,1,3,0,78
1092828,767047,2018-06-20,Senate,"Do pass, but first be re-referred to the Committee on [Appropriations]",7,0,0,0,7
1092828,771156,2018-08-09,Senate,"Assembly 3rd Reading AB2782 Friedman By Wiener",36,0,3,0,39
1092829,733814,2018-04-04,Senate,"Do pass as amended, but first amend, and re-refer to the Committee on [Appropriations]",6,0,0,0,6
1092829,742232,2018-04-23,Senate,"Placed on suspense file",7,0,0,0,7
1092830,743033,2018-04-23,Assembly,"Do pass and be re-referred to the Committee on [Labor and Employment]",6,2,2,0,10
1092830,751451,2018-05-09,Assembly,"Do pass",12,3,2,0,17
1092830,758801,2018-05-31,Assembly,"AB 3030 CABALLERO Assembly Third Reading",59,11,8,0,78
1092830,767006,2018-06-20,Senate,"Do pass, but first be re-referred to the Committee on [Appropriations]",5,1,1,0,7
1092830,771327,2018-08-13,Senate,"Placed on suspense file",7,0,0,0,7
1092830,774582,2018-04-23,Assembly,,0,0,2,0,2
1092831,725449,2018-03-20,Assembly,"Do pass as amended, and be re-referred to the Committee on [Appropriations] with recommendation: To Consent Calendar",7,0,0,0,7
1092831,734083,2018-04-04,Assembly,"Do pass. To Consent Calendar",15,0,2,0,17
1092831,738180,2018-04-12,Assembly,"AB 2902 E.S. & T.M. Consent Calendar Second Day Regular Session",68,0,9,0,77
1092831,760593,2018-06-06,Senate,"Do pass, but first be re-referred to the Committee on [Appropriations] with the recommendation: To Consent Calendar",5,0,2,0,7
1092831,773172,2018-08-28,Senate,"Assembly 3rd Reading AB2902 E.S. & T.M. (Quirk) By Gaines",39,0,1,0,40
1092831,773436,2018-08-29,Assembly,"AB 2902 E.S. & T.M. Concurrence in Senate Amendments By QUIRK",80,0,0,0,80
1092832,736077,2018-04-10,Assembly,"Do pass and be re-referred to the Committee on [Judiciary]",2,5,0,0,7
1092832,736078,2018-04-10,Assembly,Reconsideration,7,0,0,0,7
1092832,743077,2018-04-24,Assembly,"Do pass and be re-referred to the Committee on [Judiciary]",2,5,0,0,7
1092833,739590,2018-04-17,Assembly,"Do pass and be re-referred to the Committee on [Appropriations]",13,0,0,0,13
1092835,738175,2018-04-11,Assembly,"Do pass and be re-referred to the Committee on [Business and Professions]",7,1,2,0,10
1092836,740595,2018-04-18,Assembly,"Do pass and be re-referred to the Committee on [Appropriations]",21,0,0,0,21
1092837,739603,2018-04-16,Senate,"Do pass as amended, but first amend, and re-refer to the Committee on [Appropriations] with the recommendation: To Consent Calendar",9,0,0,0,9
1092837,749892,2018-05-07,Senate,"Placed on suspense file",6,0,1,0,7
1092837,756223,2018-05-25,Senate,"Do pass",7,0,0,0,7
1092837,758446,2018-05-31,Senate,"Special Consent SB1311",39,0,0,0,39
1092837,768105,2018-06-26,Assembly,"Do pass as amended and be re-referred to the Committee on [Appropriations]",15,0,0,0,15
1092838,743007,2018-04-24,Assembly,"Do pass as amended and be re-referred to the Committee on [Appropriations]",16,0,0,0,16
1092838,743987,2018-04-24,Assembly,"Do pass and be re-referred to the Committee on [Appropriations]",16,0,0,0,16
1092840,740583,2018-04-18,Senate,"Do pass, but first be re-referred to the Committee on [Judiciary]",0,8,1,0,9
1092841,739875,2018-04-17,Senate,"Do pass, but first be re-referred to the Committee on [Environmental Quality]",8,1,2,0,11
1092841,740860,2018-04-18,Senate,"Do pass as amended, but first amend, and re-refer to the Committee on [Appropriations]",5,2,0,0,7
1092841,752957,2018-05-14,Senate,"Placed on suspense file",7,0,0,0,7
1092841,756275,2018-05-25,Senate,"Do pass as amended",6,1,0,0,7
1092841,757666,2018-05-30,Senate,"Senate 3rd Reading SB1440 Hueso et al",27,9,3,0,39
1092841,766035,2018-06-20,Assembly,"Do pass and be re-referred to the Committee on [Natural Resources]",9,1,5,0,15
1092841,768150,2018-06-25,Assembly,"Do pass as amended and be re-referred to the Committee on [Appropriations]",6,1,3,0,10
1092841,771807,2018-08-16,Assembly,"Do pass as amended",10,0,7,0,17
1092841,773661,2018-08-29,Assembly,"SB 1440 Hueso Senate Third Reading By GRAYSON",52,17,11,0,80
1092841,773996,2018-08-31,Senate,"Unfinished Business SB1440 Hueso et al. Concurrence",29,10,1,0,40
1092842,737762,2018-04-11,Assembly,"Do pass and be re-referred to the Committee on [Appropriations]",6,0,1,0,7
1092842,744396,2018-04-25,Assembly,"Do pass. To Consent Calendar",17,0,0,0,17
1092842,748924,2018-05-03,Assembly,"AB 3075 BERMAN Consent Calendar Second Day Regular Session",71,0,7,0,78
1092842,760429,2018-06-06,Senate,"Do pass, but first be re-referred to the Committee on [Appropriations]",5,0,0,0,5
1092842,770804,2018-08-06,Senate,"Assembly 3rd Reading AB3075 Berman et al. By Stern",25,8,6,0,39
1092842,771333,2018-08-13,Assembly,"AB 3075 BERMAN Concurrence in Senate Amendments",57,19,4,0,80
1092843,747401,2018-04-30,Assembly,"Do pass as amended and be re-referred to the Committee on [Appropriations]",7,0,3,0,10
1092844,737361,2018-04-11,Senate,"Do pass, but first be re-referred to the Committee on [Appropriations] with the recommendation: To Consent Calendar",9,0,0,0,9
1092844,755375,2018-05-22,Senate,"Do pass",7,0,0,0,7
1092844,756989,2018-05-29,Senate,"Senate 3rd Reading SB1457 Hernandez et al",38,0,1,0,39
1092844,764964,2018-06-19,Assembly,"Do pass as amended and be re-referred to the Committee on [Appropriations]",15,0,0,0,15
1092844,771498,2018-08-15,Assembly,"Do pass. To Consent Calendar",17,0,0,0,17
1092845,741345,2018-04-18,Assembly,"Do pass and be re-referred to the Committee on [Judiciary]",2,5,0,0,7
1092846,739815,2018-04-17,Assembly,"Do pass and be re-referred to the Committee on [Education]",13,0,0,0,13
1092846,744868,2018-04-25,Assembly,"Do pass and be re-referred to the Committee on [Appropriations] with recommendation: To Consent Calendar",7,0,0,0,7
1092849,741650,2018-04-18,Assembly,"Do pass and be re-referred to the Committee on [Appropriations]",2,5,0,0,7
1092851,738153,2018-04-10,Assembly,"Do pass and be re-referred to the Committee on [Accountability and Administrative Review]",10,0,0,0,10
1092851,743964,2018-04-25,Assembly,"Do pass and be re-referred to the Committee on [Appropriations] with recommendation: To Consent Calendar",7,0,0,0,7
1092851,756548,2018-05-25,Assembly,"Do pass",16,0,1,0,17
1092851,757804,2018-05-30,Assembly,"AB 2790 IRWIN Assembly Third Reading",77,0,1,0,78
1092851,762261,2018-06-12,Senate,"Do pass, but first be re-referred to the Committee on [Judiciary]",5,0,2,0,7
1092851,769046,2018-06-26,Senate,"Do pass, but first be re-referred to the Committee on [Appropriations] with the recommendation: To Consent Calendar",7,0,0,0,7
1092851,770272,2018-08-06,Senate,"Placed on suspense file",7,0,0,0,7
1092851,772049,2018-08-16,Senate,"Do pass",7,0,0,0,7
1092851,772392,2018-08-21,Senate,"Assembly 3rd Reading AB2790 Irwin By Roth",39,0,1,0,40
1092855,733819,2018-04-04,Senate,"Do pass as amended, but first amend, and re-refer to the Committee on [Appropriations] with the recommendation: To Consent Calendar",6,0,0,0,6
1092855,746183,2018-04-30,Senate,"Senate 3rd Reading SB1406 Hill et al",36,0,3,0,39
1092855,768763,2018-06-26,Assembly,"Do pass and be re-referred to the Committee on [Appropriations]",12,0,1,0,13
1092855,771805,2018-08-16,Assembly,"Do pass",17,0,0,0,17
1092855,773071,2018-08-28,Assembly,"SB 1406 Hill Senate Third Reading By MEDINA",78,0,2,0,80
1092856,738275,2018-04-11,Assembly,"Do pass and be re-referred to the Committee on [Appropriations] with recommendation: To Consent Calendar",7,0,0,0,7
1092856,744401,2018-04-25,Assembly,"Do pass. To Consent Calendar",17,0,0,0,17
1092856,748765,2018-05-03,Assembly,"AB 3188 THURMOND Consent Calendar Second Day Regular Session",71,0,7,0,78
1092856,760751,2018-06-06,Senate,"Do pass, but first be re-referred to the Committee on [Appropriations] with the recommendation: To Consent Calendar",6,0,0,0,6
1092856,771422,2018-08-13,Senate,"Assembly 3rd Reading AB3188 Thurmond By Pan",37,0,3,0,40
1092856,773311,2018-08-29,Senate,"Assembly 3rd Reading AB3188 Thurmond By Pan",39,0,1,0,40
1092856,773906,2018-08-30,Assembly,"AB 3188 THURMOND Concurrence in Senate Amendments",79,0,1,0,80
1092857,736049,2018-04-10,Senate,"Do pass as amended, but first amend, and re-refer to the Committee on [Transportation and Housing]",7,0,0,0,7
1092857,743762,2018-04-24,Senate,"Do pass, but first be re-referred to the Committee on [Appropriations] with the recommendation: To Consent Calendar",11,0,2,0,13
1092857,750252,2018-05-07,Senate,"Placed on suspense file",6,0,1,0,7
1092857,756722,2018-05-25,Senate,"Do pass as amended",7,0,0,0,7
1092857,757867,2018-05-30,Senate,"Senate 3rd Reading SB1357 Gaines et al",36,0,3,0,39
1092858,740764,2018-04-17,Assembly,"Do pass and be re-referred to the Committee on [Judiciary]",11,4,0,0,15
1092858,742910,2018-04-24,Assembly,"Do pass and be re-referred to the Committee on [Appropriations]",7,2,1,0,10
1092858,756395,2018-05-25,Assembly,"Do pass",11,4,2,0,17
1092858,758609,2018-05-31,Assembly,"AB 2874 THURMOND Assembly Third Reading",23,33,22,0,78
1092859,736159,2018-04-10,Assembly,"Do pass as amended and be re-referred to the Committee on [Appropriations]",14,0,1,0,15
1092859,751360,2018-05-09,Assembly,"Do pass. To Consent Calendar",16,0,1,0,17
1092859,754341,2018-05-17,Assembly,"AB 2941 BERMAN Consent Calendar Second Day Regular Session",73,0,5,0,78
1092859,762986,2018-06-13,Senate,"Do pass as amended, but first amend, and re-refer to the Committee on [Appropriations]",7,0,2,0,9
1092859,769541,2018-07-02,Senate,"Do pass",7,0,0,0,7
1092859,770546,2018-08-06,Senate,"Assembly 3rd Reading AB2941 Berman By Dodd",37,0,2,0,39
1092859,771194,2018-08-09,Assembly,"AB 2941 BERMAN Concurrence in Senate Amendments",77,0,3,0,80
1092860,748124,2018-05-02,Assembly,"Do pass. To Consent Calendar",20,0,1,0,21
1092860,752099,2018-05-10,Assembly,"AB 2857 GRAY Consent Calendar Second Day Regular Session",73,0,5,0,78
1092860,768348,2018-06-26,Senate,"Do pass and be ordered to the Consent Calendar",13,0,0,0,13
1092861,734237,2018-04-04,Senate,"Do pass, but first be re-referred to the Committee on [Appropriations]",5,1,0,0,6
1092861,738846,2018-04-16,Senate,"Placed on suspense file",7,0,0,0,7
1092861,756472,2018-05-25,Senate,"Do pass",5,2,0,0,7
1092861,757075,2018-05-29,Senate,"Senate 3rd Reading SB1348 Pan",27,11,1,0,39
1092861,765086,2018-06-19,Assembly,"Do pass and be re-referred to the Committee on [Appropriations]",9,4,0,0,13
1092861,771568,2018-08-16,Assembly,"Do pass as amended",12,0,5,0,17
1092861,773811,2018-08-30,Assembly,"SB 1348 Pan Senate Third Reading By MEDINA",55,24,1,0,80
1092861,774041,2018-08-31,Senate,"Unfinished Business SB1348 Pan Concurrence",27,11,2,0,40
1092862,737426,2018-04-10,Assembly,"Do pass as amended and be re-referred to the Committee on [Appropriations]",9,0,7,0,16
1092865,743254,2018-04-24,Assembly,"Do pass as amended, and be re-referred to the Committee on [Appropriations] with recommendation: To Consent Calendar",15,0,0,0,15
1092865,755665,2018-05-23,Assembly,"Do pass. To Consent Calendar",16,0,1,0,17
1092865,757141,2018-05-29,Assembly,"AB 2967 QUIRK-SILVA Consent Calendar Second Day Regular Session",78,0,0,0,78
1092865,766171,2018-06-20,Senate,"Do pass as amended, but first amend, and re-refer to the Committee on [Appropriations] with the recommendation: To Consent Calendar",8,0,1,0,9
1092865,770260,2018-08-06,Senate,"Placed on suspense file",7,0,0,0,7
1092865,771712,2018-08-16,Senate,"Do pass",7,0,0,0,7
1092865,773662,2018-08-29,Senate,"Assembly 3rd Reading AB2967 Quirk-Silva By Monning",39,0,1,0,40
1092865,773743,2018-08-30,Assembly,"AB 2967 QUIRK-SILVA Concurrence in Senate Amendments",78,0,2,0,80
1092867,747634,2018-05-02,Assembly,"Do pass",15,0,6,0,21
1092867,752675,2018-05-14,Assembly,"AB 2969 LOW Assembly Third Reading",59,0,19,0,78
1092867,762637,2018-06-12,Senate,"Do pass",9,0,3,0,12
1092867,769189,2018-06-28,Senate,"Assembly 3rd Reading AB2969 Low et al. By Lara",31,2,6,0,39
1092869,737388,2018-04-11,Senate,"Do pass as amended",9,0,0,0,9
1092869,756975,2018-05-29,Senate,"Senate 3rd Reading SB1287 Hernandez",38,0,1,0,39
1092869,768333,2018-06-26,Assembly,"Do pass and be re-referred to the Committee on [Appropriations]",15,0,0,0,15
1092869,771505,2018-08-15,Assembly,"Do pass",17,0,0,0,17
1092869,772962,2018-08-27,Assembly,"SB 1287 Hernandez Senate Third Reading By WOOD",80,0,0,0,80
1092869,773141,2018-08-28,Senate,"Unfinished Business SB1287 Hernandez et al. Concurrence",39,0,1,0,40
1092870,743399,2018-04-24,Senate,"Do pass, but first be re-referred to the Committee on [Appropriations]",7,0,0,0,7
1092870,750168,2018-05-07,Senate,"Placed on suspense file",6,0,1,0,7
1092870,756273,2018-05-25,Senate,"Do pass",7,0,0,0,7
1092870,758560,2018-05-31,Senate,"Special Consent SB1314",39,0,0,0,39
1092870,768800,2018-06-26,Assembly,"Do pass and be re-referred to the Committee on [Appropriations]",7,0,3,0,10
1092871,743662,2018-04-24,Senate,"Do pass, but first be re-referred to the Committee on [Appropriations]",7,0,0,0,7
1092871,755239,2018-05-21,Senate,"Senate 3rd Reading SB1304 Newman",38,0,1,0,39
1092871,769069,2018-06-26,Assembly,"Do pass as amended and be re-referred to the Committee on [Appropriations]",9,0,1,0,10
1092871,771139,2018-08-08,Assembly,"Do pass. To Consent Calendar",17,0,0,0,17
1092871,771528,2018-08-16,Assembly,"SB 1304 Roth Consent Calendar Second Day Regular Session",76,0,4,0,80
1092871,772180,2018-08-20,Senate,"Unfinished Business SB1304 Roth Concurrence",39,0,1,0,40
1092872,747016,2018-05-01,Assembly,"Do pass. To Consent Calendar",10,0,0,0,10
1092872,749954,2018-05-07,Assembly,"AB 3066 STONE Consent Calendar Second Day Regular Session",72,0,6,0,78
1092872,768819,2018-06-26,Senate,"Do pass, but first be re-referred to the Committee on [Appropriations]",5,2,0,0,7
1092872,770921,2018-08-06,Senate,"Placed on suspense file",7,0,0,0,7
1092872,772073,2018-08-16,Senate,"Do pass as amended",5,2,0,0,7
1092872,773492,2018-08-29,Senate,"Assembly 3rd Reading AB3066 Mark Stone et al. By Jackson",24,14,2,0,40
1092872,773826,2018-08-30,Assembly,"With recommendation: That Senate amendments be concurred in",5,2,0,0,7
1092872,773978,2018-08-31,Assembly,"AB 3066 STONE Concurrence in Senate Amendments",54,23,3,0,80
1092874,744023,2018-04-25,Senate,"Do pass as amended",10,0,1,0,11
1092874,757188,2018-05-29,Senate,"Senate 3rd Reading SB1374 Hueso",38,0,1,0,39
1092874,766266,2018-06-20,Assembly,"Do pass and be re-referred to the Committee on [Natural Resources]",15,0,0,0,15
1092874,768168,2018-06-25,Assembly,"Do pass as amended and be re-referred to the Committee on [Appropriations]",10,0,0,0,10
1092874,771116,2018-08-08,Assembly,"Do pass. To Consent Calendar",17,0,0,0,17
1092874,773956,2018-08-30,Assembly,"SB 1374 Hueso Senate Third Reading By QUIRK",80,0,0,0,80
1092874,774069,2018-08-31,Senate,"Unfinished Business SB1374 Hueso Concurrence",39,0,1,0,40
1092875,739471,2018-04-17,Senate,"Do pass, but first be re-referred to the Committee on [Appropriations] with the recommendation: To Consent Calendar",7,0,0,0,7
1092875,752708,2018-05-14,Senate,"Placed on suspense file",7,0,0,0,7
1092876,739893,2018-04-17,Assembly,"Do pass and be re-referred to the Committee on [Human Services]",13,0,0,0,13
1092876,743857,2018-04-24,Assembly,"Do pass and be re-referred to the Committee on [Appropriations] with recommendation: To Consent Calendar",7,0,0,0,7
1092876,756398,2018-05-25,Assembly,"Do pass",16,0,1,0,17
1092876,758787,2018-05-31,Assembly,"AB 2933 MEDINA Assembly Third Reading",78,0,0,0,78
1092876,766216,2018-06-20,Senate,"Do pass, but first be re-referred to the Committee on [Human Services] with the recommendation: To Consent Calendar",7,0,0,0,7
1092876,768783,2018-06-26,Senate,"Do pass, but first be re-referred to the Committee on [Appropriations]",6,0,1,0,7
1092876,770552,2018-08-06,Senate,"Placed on suspense file",7,0,0,0,7
1092876,775187,2018-05-25,Assembly,,7,0,1,0,8
1092877,743767,2018-04-24,Senate,"Do pass, but first be re-referred to the Committee on [Appropriations]",8,2,3,0,13
1092878,733962,2018-04-04,Senate,"Do pass, but first be re-referred to the Committee on [Business, Professions and Economic Development]",9,0,0,0,9
1092878,738837,2018-04-16,Senate,"Do pass, but first be re-referred to the Committee on [Judiciary]",9,0,0,0,9
1092878,743955,2018-04-24,Senate,"Do pass as amended, but first amend, and re-refer to the Committee on [Appropriations] with the recommendation: To Consent Calendar",7,0,0,0,7
1092878,758595,2018-05-31,Senate,"Senate 3rd Reading SB1305 Glazer et al",39,0,0,0,39
1092878,765029,2018-06-19,Assembly,"Do pass as amended and be re-referred to the Committee on [Judiciary]",17,0,2,0,19
1092878,768218,2018-06-26,Assembly,"Do pass as amended and be re-referred to the Committee on [Appropriations]",10,0,0,0,10
1092878,771515,2018-08-15,Assembly,"Do pass. To Consent Calendar",17,0,0,0,17
1092878,773916,2018-08-30,Assembly,"SB 1305 Glazer Senate Third Reading By BAKER",80,0,0,0,80
1092878,774115,2018-08-31,Senate,"Unfinished Business SB1305 Glazer et al. Concurrence",39,0,1,0,40
1092878,774553,2018-04-24,Senate,?,9,0,0,0,9
1092910,733237,2018-04-03,Senate,"Do pass and be ordered to the Consent Calendar",6,0,1,0,7
1092910,735627,2018-04-09,Senate,"Consent Calendar SB1289 JUD. (Jackson)",39,0,0,0,39
1092910,762216,2018-06-12,Assembly,"Do pass. To Consent Calendar",9,0,1,0,10
1092910,764301,2018-06-18,Assembly,"SB 1289 JUD. Consent Calendar Second Day Regular Session",80,0,0,0,80
1092918,733803,2018-04-04,Senate,"Do pass, but first be re-referred to the Committee on [Judiciary]",2,3,1,0,6
1092918,733804,2018-04-04,Senate,"[First] hearing set for [04-04-2018]: Failed passage in Committee. Reconsideration granted",6,0,0,0,6
1092920,750706,2018-05-08,Assembly,"Do pass as amended",10,0,0,0,10
1092920,754221,2018-05-17,Assembly,"AB 3217 BERMAN Assembly Third Reading",71,0,7,0,78
1092922,743468,2018-04-24,Assembly,"Do pass as amended and be re-referred to the Committee on [Appropriations]",15,0,0,0,15
1092922,756607,2018-05-25,Assembly,"Do pass as amended",12,0,5,0,17
1092922,757831,2018-05-30,Assembly,"AB 3218 ARAMBULA Assembly Third Reading",78,0,0,0,78
1092922,768564,2018-06-26,Senate,"Do pass, but first be re-referred to the Committee on [Appropriations]",9,0,0,0,9
1092922,770406,2018-08-06,Senate,"Placed on suspense file",7,0,0,0,7
1092922,772036,2018-08-16,Senate,"Do pass",7,0,0,0,7
1092922,773131,2018-08-28,Senate,"Assembly 3rd Reading AB3218 Arambula By Cannella",39,0,1,0,40
1092924,742222,2018-04-23,Senate,"Do pass, but first be re-referred to the Committee on [Appropriations]",6,0,3,0,9
1092924,755371,2018-05-22,Senate,"Do pass as amended",5,1,1,0,7
1092924,757064,2018-05-29,Senate,"Senate 3rd Reading SB1386 McGuire",28,5,6,0,39
1092924,765084,2018-06-19,Assembly,"Do pass as amended and be re-referred to the Committee on [Appropriations]",17,0,2,0,19
1092924,771489,2018-08-15,Assembly,"Do pass. To Consent Calendar",17,0,0,0,17
1092924,772573,2018-08-23,Assembly,"SB 1386 McGuire Consent Calendar Second Day Regular Session",75,0,5,0,80
1092924,772654,2018-08-24,Senate,"Unfinished Business SB1386 McGuire Concurrence",36,0,4,0,40
1092930,719935,2018-03-08,Assembly,"Be adopted. To third reading",8,0,3,0,11
1092932,740076,2018-04-17,Assembly,"Do pass. To Consent Calendar",7,0,0,0,7
1092932,742211,2018-04-23,Assembly,"AB 2876 JONES-SAWYER Consent Calendar Second Day Regular Session",75,0,3,0,78
1092932,764945,2018-06-19,Senate,"Do pass, but first be re-referred to the Committee on [Appropriations]",6,1,0,0,7
1092932,773564,2018-08-29,Senate,"Assembly 3rd Reading AB2876 Jones-Sawyer By Lara",36,2,2,0,40
1092932,773900,2018-08-30,Assembly,"AB 2876 JONES-SAWYER Concurrence in Senate Amendments",75,2,3,0,80
1092936,734112,2018-04-04,Senate,"Do pass, but first be re-referred to the Committee on [Natural Resources and Water] with the recommendation: To Consent Calendar",7,0,0,0,7
1092936,742917,2018-04-24,Senate,"Do pass, but first be re-referred to the Committee on [Appropriations] with the recommendation: To Consent Calendar",9,0,0,0,9
1092936,751948,2018-05-10,Senate,"Consent Calendar SB1401",38,0,1,0,39
1092938,736271,2018-04-10,Assembly,"Do pass",5,1,1,0,7
1092938,746093,2018-04-30,Assembly,"AB 2867 GONZALEZ FLETCHER Assembly Third Reading",59,1,18,0,78
1092938,762233,2018-06-12,Senate,"Do pass as amended",5,2,0,0,7
1092938,771320,2018-08-13,Senate,"Assembly 3rd Reading AB2867 Gonzalez Fletcher By Lara",29,4,7,0,40
1092938,772166,2018-08-20,Assembly,"AB 2867 GONZALEZ FLETCHER Concurrence in Senate Amendments",60,9,11,0,80
1092946,721770,2018-03-12,Assembly,"Be adopted. To third reading",7,0,4,0,11
1092946,735636,2018-04-09,Senate,"Special Consent ACR178",39,0,0,0,39
1092950,743372,2018-04-24,Assembly,"Be adopted as amended. To Consent Calendar",15,0,0,0,15
1092950,748734,2018-05-03,Assembly,"ACR 177 JONES-SAWYER Consent Calendar Second Day",71,0,7,0,78
1092950,769663,2018-07-02,Senate,"Assembly 3rd Reading ACR177 Jones-Sawyer By Beall",30,4,5,0,39
1092956,751435,2018-05-09,Senate,"Do pass as amended, but first amend, and re-refer to the Committee on [Appropriations]",5,0,2,0,7
1092956,755265,2018-05-22,Senate,"Placed on suspense file",7,0,0,0,7
1092968,743036,2018-04-23,Assembly,"Do pass as amended and be re-referred to the Committee on [Appropriations]",10,0,0,0,10
1092968,753796,2018-05-16,Assembly,"Do pass. To Consent Calendar",17,0,0,0,17
1092968,756457,2018-05-25,Assembly,"AB 3178 RUBIO Consent Calendar Second Day Regular Session",70,0,8,0,78
1092968,767054,2018-06-20,Senate,"Do pass as amended, but first amend, and re-refer to the Committee on [Appropriations]",7,0,0,0,7
1092968,772152,2018-08-20,Senate,"Assembly 3rd Reading AB3178 Rubio By Lara",39,0,1,0,40
1092968,772547,2018-08-23,Assembly,"AB 3178 RUBIO Concurrence in Senate Amendments",77,0,3,0,80
1094004,746161,2018-04-30,Assembly,"Be adopted. To third reading",10,0,1,0,11
1094004,757015,2018-05-29,Senate,"Special Consent ACR180",37,0,2,0,39
1094058,771448,2018-08-14,Assembly,"Be adopted. To third reading",5,0,2,0,7
1094058,772186,2018-08-20,Assembly,"AJR 33 LIMÓN Assembly Third Reading",53,16,11,0,80
1094058,773155,2018-08-28,Senate,"Assembly 3rd Reading AJR33 Limón et al. By Monning",25,10,5,0,40
1094109,735600,2018-04-09,Assembly,"Be adopted. To Consent Calendar",12,0,2,0,14
1094109,738281,2018-04-12,Assembly,"ACR 179 FLORA Consent Calendar Second Day Regular Session",68,0,9,0,77
1094109,769736,2018-07-03,Senate,"Be adopted, but first be re-referred to the Committee on [Appropriations] with recommendation: To Consent Calendar",12,0,1,0,13
1094109,771299,2018-08-13,Senate,"Consent Calendar ACR179",37,0,3,0,40
1095057,742127,2018-04-23,Senate,"Do pass, but first be re-referred to the Committee on [Appropriations] with the recommendation: To Consent Calendar",9,0,0,0,9
1095057,754329,2018-05-17,Senate,"Consent Calendar SB1491 B.P.&E.D",38,0,1,0,39
1095057,765813,2018-06-19,Assembly,"Do pass and be re-referred to the Committee on [Appropriations] with recommendation: To Consent Calendar",17,0,2,0,19
1095057,771516,2018-08-15,Assembly,"Do pass. To Consent Calendar",17,0,0,0,17
1095057,773176,2018-08-28,Assembly,"SB 1491 B., P. & E.D. Senate Third Reading By LOW",80,0,0,0,80
1095069,742113,2018-04-23,Senate,"Do pass, but first be re-referred to the Committee on [Appropriations] with the recommendation: To Consent Calendar",9,0,0,0,9
1095069,754365,2018-05-17,Senate,"Consent Calendar SB1492 B.P.&E.D",38,0,1,0,39
1095069,765798,2018-06-19,Assembly,"Do pass and be re-referred to the Committee on [Higher Education] with recommendation: To Consent Calendar",17,0,2,0,19
1095069,768978,2018-06-26,Assembly,"Do pass and be re-referred to the Committee on [Appropriations]",12,0,1,0,13
1095069,771096,2018-08-08,Assembly,"Do pass. To Consent Calendar",17,0,0,0,17
1095069,771714,2018-08-16,Assembly,"SB 1492 B., P. & E.D. Consent Calendar Second Day Regular Session",76,0,4,0,80
1095069,772288,2018-08-20,Senate,"Unfinished Business SB1492 B.P.&E.D. (Hill) Concurrence",39,0,1,0,40
1095093,739871,2018-04-16,Senate,"Do pass, but first be re-referred to the Committee on [Appropriations] with the recommendation: To Consent Calendar",9,0,0,0,9
1095093,748851,2018-05-03,Senate,"Consent Calendar SB1493 N.R. & W",38,0,1,0,39
1095093,761795,2018-06-11,Assembly,"Do pass and be re-referred to the Committee on [Water, Parks, and Wildlife] with recommendation: To Consent Calendar",10,0,0,0,10
1095093,768370,2018-06-26,Assembly,"Do pass and be re-referred to the Committee on [Appropriations]",15,0,0,0,15
1095093,771511,2018-08-15,Assembly,"Do pass as amended. To Consent Calendar",17,0,0,0,17
1095093,772968,2018-08-27,Assembly,"SB 1493 N.R. & W. Consent Calendar Second Day Regular Session",80,0,0,0,80
1095093,773230,2018-08-28,Senate,"Unfinished Business SB1493 N.R. & W. (Hertzberg) Concurrence",39,0,1,0,40
1095104,708577,2018-02-22,Senate,"Be adopted. Ordered to third reading",3,0,2,0,5
1095680,719943,2018-03-08,Assembly,"Be adopted. To third reading",8,0,3,0,11
1095686,732615,2018-04-02,Assembly,"Be adopted. To Consent Calendar",14,0,0,0,14
1095686,734521,2018-04-05,Assembly,"ACR 181 FLORA Consent Calendar Second Day Regular Session",70,0,7,0,77
1095686,769742,2018-07-03,Senate,"Be adopted, but first be re-referred to the Committee on [Appropriations] with recommendation: To Consent Calendar",12,0,1,0,13
1095686,771325,2018-08-13,Senate,"Consent Calendar ACR181",37,0,3,0,40
1095693,727970,2018-03-22,Senate,"Senate 3rd Reading SCR106 McGuire",37,0,2,0,39
1095693,735452,2018-04-09,Assembly,"Be adopted. To Consent Calendar",10,0,1,0,11
1095693,738179,2018-04-12,Assembly,"SCR 106 McGuire Consent Calendar Second Day Regular Session",68,0,9,0,77
1095700,738868,2018-04-16,Assembly,"Do pass and be re-referred to the Committee on [Appropriations] with recommendation: To Consent Calendar",14,0,0,0,14
1095700,747620,2018-05-02,Assembly,"Do pass. To Consent Calendar",17,0,0,0,17
1095700,751968,2018-05-10,Assembly,"AB 3246 TRANS. Consent Calendar Second Day Regular Session",73,0,5,0,78
1095700,764858,2018-06-19,Senate,"Do pass, but first be re-referred to the Committee on [Appropriations] with the recommendation: To Consent Calendar",12,0,1,0,13
1095700,770506,2018-08-06,Senate,"Consent Calendar AB3246 TRANS. (Frazier)",37,0,2,0,39
1095700,771152,2018-08-09,Assembly,"AB 3246 TRANS. Concurrence in Senate Amendments By FRAZIER",76,0,4,0,80
1095706,717527,2018-03-05,Assembly,"Be adopted as amended",7,0,4,0,11
1095706,741522,2018-04-19,Senate,"Assembly 3rd Reading ACR182 Baker et al. By Galgiani",35,0,4,0,39
1095713,725229,2018-03-19,Senate,"Senate 3rd Reading SR86 Hill",38,0,1,0,39
1095719,742908,2018-04-24,Senate,"Do pass, but first be re-referred to the Committee on [Appropriations] with the recommendation: To Consent Calendar",7,0,0,0,7
1095719,754324,2018-05-17,Senate,"Consent Calendar SB1494 PUB. S",38,0,1,0,39
1095719,765011,2018-06-19,Assembly,"Do pass and be re-referred to the Committee on [Appropriations] with recommendation: To Consent Calendar",7,0,0,0,7
1095719,771499,2018-08-15,Assembly,"Do pass. To Consent Calendar",17,0,0,0,17
1095719,772556,2018-08-23,Assembly,"SB 1494 PUB. S. Consent Calendar Second Day Regular Session",75,0,5,0,80
1095719,772643,2018-08-24,Senate,"Unfinished Business SB1494 PUB. S. (Skinner) Concurrence",39,0,1,0,40
1095725,740889,2018-04-18,Assembly,"Do pass. To Consent Calendar",6,0,1,0,7
1095725,744916,2018-04-26,Assembly,"AB 3245 P.E., R. & S.S. Consent Calendar Second Day Regular Session",74,0,4,0,78
1095725,777397,2018-04-18,Assembly,,0,0,1,0,1
1096750,716798,2018-03-05,Assembly,"Be adopted. To third reading",7,0,4,0,11
1096811,733163,2018-04-02,Assembly,"Be adopted. To Consent Calendar",14,0,0,0,14
1096811,734363,2018-04-05,Assembly,"ACR 184 BIGELOW Consent Calendar Second Day Regular Session",70,0,7,0,77
1096811,769751,2018-07-03,Senate,"Be adopted, but first be re-referred to the Committee on [Appropriations] with recommendation: To Consent Calendar",12,0,1,0,13
1096811,771319,2018-08-13,Senate,"Consent Calendar ACR184",37,0,3,0,40
1096830,735448,2018-04-09,Senate,"Senate 3rd Reading SCR108 Newman",39,0,0,0,39
1096830,742224,2018-04-23,Assembly,"Be adopted. To Consent Calendar",8,0,3,0,11
1096830,744887,2018-04-26,Assembly,"SCR 108 Newman Consent Calendar Second Day Regular Session",74,0,4,0,78
1096830,750463,2018-05-07,Senate,"Unfinished Business SCR108 Newman Concurrence",37,0,2,0,39
1096869,738141,2018-04-12,Senate,"Senate 3rd Reading SCR107 Beall",37,0,2,0,39
1096869,762198,2018-06-12,Assembly,"Be adopted as amended",7,0,0,0,7
1096869,771197,2018-08-09,Senate,"Unfinished Business SCR107 Beall et al. Concurrence",36,0,3,0,39
1096886,723527,2018-03-15,Assembly,"Be adopted. To third reading",6,0,5,0,11
1096886,735648,2018-04-09,Senate,"Special Consent ACR183",39,0,0,0,39
1097630,748713,2018-05-03,Senate,"Senate 3rd Reading SCR109 Pan et al",38,0,1,0,39
1097671,750556,2018-05-08,Assembly,"Do pass and be re-referred to the Committee on [Appropriations]",10,0,0,0,10
1097671,755707,2018-05-23,Assembly,"Do pass",16,0,1,0,17
1097671,757820,2018-05-30,Assembly,"AB 3249 JUD. Assembly Third Reading By STONE",78,0,0,0,78
1097671,768883,2018-06-26,Senate,"Do pass as amended, but first amend, and re-refer to the Committee on [Appropriations] with the recommendation: To Consent Calendar",7,0,0,0,7
1097671,773248,2018-08-28,Senate,"Assembly 3rd Reading AB3249 JUD. (Stone) By Jackson",39,0,1,0,40
1097671,773307,2018-08-29,Assembly,"AB 3249 JUD. Concurrence in Senate Amendments By STONE",80,0,0,0,80
1097691,747026,2018-05-01,Assembly,"Do pass. To Consent Calendar",10,0,0,0,10
1097691,750079,2018-05-07,Assembly,"AB 3248 JUD. Consent Calendar Second Day Regular Session",72,0,6,0,78
1097691,762991,2018-06-12,Senate,"Do pass and be ordered to the Consent Calendar",7,0,0,0,7
1097691,773203,2018-08-28,Senate,"Assembly 3rd Reading AB3248 JUD. (Stone) By Jackson",39,0,1,0,40
1097691,773695,2018-08-30,Assembly,"With recommendation: That Senate amendments be concurred in",8,0,1,0,9
1097691,774058,2018-08-31,Assembly,"AB 3248 JUD. Concurrence in Senate Amendments By STONE",80,0,0,0,80
1097714,742991,2018-04-24,Assembly,"Do pass. To Consent Calendar",10,0,0,0,10
1097714,745957,2018-04-30,Assembly,"AB 3250 JUD. Consent Calendar Second Day Regular Session",76,0,2,0,78
1097714,769681,2018-07-03,Senate,"Do pass",5,2,0,0,7
1097714,773237,2018-08-28,Senate,"Assembly 3rd Reading AB3250 JUD. (Stone) By Jackson",30,7,3,0,40
1097714,773640,2018-08-29,Assembly,"AB 3250 JUD. Concurrence in Senate Amendments By STONE",65,9,6,0,80
1097735,733967,2018-04-04,Senate,"Be adopted, but first be re-referred to the Committee on [Judiciary]",7,2,0,0,9
1097735,747863,2018-05-01,Senate,"Be adopted. Ordered to third reading",4,2,1,0,7
1097735,755185,2018-05-21,Senate,"Senate 3rd Reading SCR110 Wiener et al",25,12,2,0,39
1097735,762350,2018-06-12,Assembly,"Be adopted and re-referred to the Committee on [Judiciary]",9,1,5,0,15
1097735,771469,2018-08-14,Assembly,"Be adopted as amended",7,1,1,0,9
1097735,773196,2018-08-28,Senate,"Unfinished Business SCR110 Wiener et al. Concurrence",25,13,2,0,40
1097757,750577,2018-05-08,Assembly,"Do pass. To Consent Calendar",10,0,0,0,10
1097757,752734,2018-05-14,Assembly,"AB 3247 JUD. Consent Calendar Second Day Regular Session",76,0,2,0,78
1097757,766146,2018-06-19,Senate,"Do pass and be ordered to the Consent Calendar",7,0,0,0,7
1097757,769558,2018-07-02,Senate,"Consent Calendar AB3247 JUD",37,0,2,0,39
1098467,716815,2018-03-05,Assembly,"Be adopted. To third reading",7,0,4,0,11
1098467,735599,2018-04-09,Senate,"Special Consent ACR186",39,0,0,0,39
1098783,761188,2018-06-07,Assembly,"Be adopted. To third reading",6,0,5,0,11
1098783,771444,2018-08-13,Senate,"Special Consent ACR187",37,0,3,0,40
1098796,738897,2018-04-16,Assembly,"Be adopted. To Consent Calendar",14,0,0,0,14
1098796,741458,2018-04-19,Assembly,"ACR 188 QUIRK-SILVA Consent Calendar Second Day Regular Session",71,0,7,0,78
1098796,765466,2018-06-19,Senate,"Be adopted, but first be re-referred to the Committee on [Appropriations]",11,0,2,0,13
1098796,769803,2018-07-05,Senate,"Assembly 3rd Reading ACR188 Quirk-Silva et al. By Nguyen",34,0,5,0,39
1098810,725406,2018-03-20,Assembly,"Be adopted. To Consent Calendar",10,0,0,0,10
1098810,727620,2018-03-22,Assembly,"ACR 189 GALLAGHER Consent Calendar Second Day Regular Session",69,0,8,0,77
1098810,735568,2018-04-09,Senate,"Special Consent ACR189",39,0,0,0,39
1098825,743707,2018-04-25,Senate,"Do pass, but first be re-referred to the Committee on [Appropriations] with the recommendation: To Consent Calendar",9,0,0,0,9
1098825,754295,2018-05-17,Senate,"Consent Calendar SB1495 HEALTH",38,0,1,0,39
1098825,768269,2018-06-26,Assembly,"Do pass and be re-referred to the Committee on [Appropriations]",15,0,0,0,15
1098825,771490,2018-08-15,Assembly,"Do pass. To Consent Calendar",17,0,0,0,17
1098825,772588,2018-08-23,Assembly,"SB 1495 HEALTH Consent Calendar Second Day Regular Session",75,0,5,0,80
1098825,772861,2018-08-27,Senate,"Unfinished Business SB1495 HEALTH (Pan) Concurrence",39,0,1,0,40
1099854,733840,2018-04-04,Senate,"Do pass and be ordered to the Consent Calendar",6,0,1,0,7
1099854,738190,2018-04-12,Senate,"Consent Calendar SB1496 GOV. & F. (McGuire) Urgency Clause",38,0,1,0,39
1099854,751472,2018-05-09,Assembly,"Do pass. To Consent Calendar",9,0,0,0,9
1099854,754279,2018-05-17,Assembly,"SB 1496 GOV.& F. Consent Calendar Second Day Regular Session",73,0,5,0,78
1099873,743951,2018-04-25,Senate,"Do pass, but first be re-referred to the Committee on [Appropriations] with the recommendation: To Consent Calendar",7,0,0,0,7
1099873,752201,2018-05-10,Senate,"Consent Calendar SB1498 GOV. & F",38,0,1,0,39
1099873,768897,2018-06-27,Assembly,"Do pass and be re-referred to the Committee on [Appropriations] with recommendation: To Consent Calendar",9,0,0,0,9
1099873,771080,2018-08-08,Assembly,"Do pass. To Consent Calendar",17,0,0,0,17
1099873,771596,2018-08-16,Assembly,"SB 1498 GOV.& F. Consent Calendar Second Day Regular Session",76,0,4,0,80
1099873,772678,2018-08-24,Senate,"Unfinished Business SB1498 GOV. & F. (McGuire) Concurrence",37,0,3,0,40
1099891,748781,2018-05-03,Assembly,"Be adopted. To third reading",6,0,5,0,11
1099891,757089,2018-05-29,Senate,"Special Consent ACR190",37,0,2,0,39
1099912,733841,2018-04-04,Senate,"Do pass and be ordered to the Consent Calendar",6,0,1,0,7
1099912,738197,2018-04-12,Senate,"Consent Calendar SB1497 GOV. & F. (McGuire) Urgency Clause",38,0,1,0,39
1099912,751477,2018-05-09,Assembly,"Do pass. To Consent Calendar",9,0,0,0,9
1099912,754296,2018-05-17,Assembly,"SB 1497 GOV.& F. Consent Calendar Second Day Regular Session",73,0,5,0,78
1099931,767271,2018-06-20,Assembly,"Be adopted. To third reading",4,0,3,0,7
1099931,767910,2018-06-25,Assembly,"AJR 34 GARCIA, E. Assembly Third Reading",60,0,20,0,80
1099931,771066,2018-08-08,Senate,"Be adopted. Ordered to third reading",3,0,2,0,5
1099931,772640,2018-08-23,Senate,"Assembly 3rd Reading AJR34 Eduardo Garcia et al. By Cannella",32,1,7,0,40
1099950,734143,2018-04-04,Senate,"Do pass and be ordered to the Consent Calendar",6,0,1,0,7
1099950,751476,2018-05-09,Assembly,"Do pass. To Consent Calendar",9,0,0,0,9
1099950,754290,2018-05-17,Assembly,"SB 1499 GOV.& F. Consent Calendar Second Day Regular Session",73,0,5,0,78
1099950,755376,2018-04-12,Senate,"Consent Calendar SB1499 GOV. & F. (McGuire)",38,0,1,0,39
1099968,724846,2018-03-19,Assembly,"Be adopted. To third reading",8,0,3,0,11
1101265,753658,2018-05-15,Senate,"Be adopted, but first be re-referred to the Committee on [Appropriations] with recommendation: To Consent Calendar",11,0,2,0,13
1101265,769638,2018-07-02,Senate,"Consent Calendar SCR111",37,0,2,0,39
1101265,772636,2018-08-23,Assembly,"Be adopted. To Consent Calendar",13,0,1,0,14
1101265,773016,2018-08-27,Assembly,"SCR 111 Leyva Consent Calendar Second Day Regular Session",80,0,0,0,80
1101280,770564,2018-08-06,Assembly,"Be adopted. To third reading",9,0,2,0,11
1101280,772720,2018-08-24,Senate,"Special Consent ACR192",39,0,1,0,40
1101318,755010,2018-05-21,Assembly,"Be adopted. To third reading",9,0,2,0,11
1101318,767017,2018-06-21,Senate,"Assembly 3rd Reading ACR191 Limón et al. By Leyva",37,0,2,0,39
1101340,744519,2018-04-25,Assembly,"Do pass and be re-referred to the Committee on [Appropriations] with recommendation: To Consent Calendar",10,0,0,0,10
1101340,751723,2018-05-09,Assembly,"Do pass. To Consent Calendar",16,0,1,0,17
1101340,754302,2018-05-17,Assembly,"AB 3252 AGRI. Consent Calendar Second Day Regular Session",73,0,5,0,78
1101340,764848,2018-06-19,Senate,"Do pass, but first be re-referred to the Committee on [Appropriations] with the recommendation: To Consent Calendar",4,0,1,0,5
1101340,770861,2018-08-06,Senate,"Consent Calendar AB3252 AGRI. (Caballero)",37,0,2,0,39
1101340,771480,2018-08-15,Assembly,"With recommendation: That Senate amendments be concurred in",9,0,1,0,10
1101340,772163,2018-08-20,Assembly,"AB 3252 AGRI. Concurrence in Senate Amendments By CABALLERO",80,0,0,0,80
1101360,737504,2018-04-10,Assembly,"Do pass and be re-referred to the Committee on [Accountability and Administrative Review]",10,0,0,0,10
1101360,744353,2018-04-25,Assembly,"Do pass and be re-referred to the Committee on [Appropriations] with recommendation: To Consent Calendar",7,0,0,0,7
1101360,751717,2018-05-09,Assembly,"Do pass. To Consent Calendar",16,0,1,0,17
1101360,754256,2018-05-17,Assembly,"AB 3251 V. A. Consent Calendar Second Day Regular Session",73,0,5,0,78
1101360,762568,2018-06-12,Senate,"Do pass, but first be re-referred to the Committee on [Veterans Affairs] with the recommendation: To Consent Calendar",10,0,2,0,12
1101360,768155,2018-06-26,Senate,"Do pass, but first be re-referred to the Committee on [Appropriations] with the recommendation: To Consent Calendar",6,0,0,0,6
1101360,770928,2018-08-06,Senate,"Placed on suspense file",7,0,0,0,7
1101360,772024,2018-08-16,Senate,"Do pass",7,0,0,0,7
1101360,772668,2018-08-24,Senate,"Special Consent AB3251 V.A",39,0,1,0,40
1101360,773386,2018-08-29,Assembly,"AB 3251 V. A. Concurrence in Senate Amendments By IRWIN",80,0,0,0,80
1101380,747004,2018-05-01,Senate,"Be adopted, but first be re-referred to the Committee on [Appropriations] with recommendation: To Consent Calendar",12,0,1,0,13
1101380,754928,2018-05-21,Senate,"Senate 3rd Reading SCR112 Leyva",38,0,1,0,39
1101380,768019,2018-06-25,Assembly,"Be adopted. To Consent Calendar",13,0,1,0,14
1101380,769230,2018-06-28,Assembly,"SCR 112 Leyva Consent Calendar Second Day Regular Session",75,0,5,0,80
1101942,749248,2018-05-03,Senate,"Senate 3rd Reading SJR20 Hertzberg",37,0,2,0,39
1101942,769729,2018-07-03,Assembly,"Be adopted. To Consent Calendar",14,0,1,0,15
1101942,770805,2018-08-06,Assembly,"SJR 20 Hertzberg Consent Calendar Second Day Regular Session",75,0,5,0,80
1101995,719767,2018-03-08,Assembly,"Be adopted. To third reading",8,0,3,0,11
1101995,735625,2018-04-09,Senate,"Special Consent ACR193",39,0,0,0,39
1102055,753303,2018-05-15,Senate,"Be adopted, but first be re-referred to the Committee on [Appropriations]",4,1,0,0,5
1102055,755342,2018-05-22,Senate,"Placed on suspense file",7,0,0,0,7
1102108,742952,2018-04-24,Senate,"Do pass and be ordered to the Consent Calendar",7,0,0,0,7
1102108,746199,2018-04-30,Senate,"Consent Calendar SB1501 V.A. (Newman)",36,0,3,0,39
1102108,769047,2018-06-26,Assembly,"Do pass. To Consent Calendar",9,0,1,0,10
1102108,769783,2018-07-05,Assembly,"SB 1501 V. A. Consent Calendar Second Day Regular Session",69,0,11,0,80
1102163,736261,2018-04-10,Senate,"Do pass, but first be re-referred to the Committee on [Judiciary] with the recommendation: To Consent Calendar",7,0,0,0,7
1102163,744197,2018-04-24,Senate,"Do pass, but first be re-referred to the Committee on [Appropriations] with the recommendation: To Consent Calendar",7,0,0,0,7
1102163,754283,2018-05-17,Senate,"Consent Calendar SB1500 V.A",38,0,1,0,39
1102163,762961,2018-06-12,Assembly,"Do pass and be re-referred to the Committee on [Judiciary]",10,0,0,0,10
1102163,765335,2018-06-19,Assembly,"Do pass and be re-referred to the Committee on [Appropriations] with recommendation: To Consent Calendar",10,0,0,0,10
1102163,769024,2018-06-27,Assembly,"Do pass. To Consent Calendar",16,0,1,0,17
1102163,769801,2018-07-05,Assembly,"SB 1500 V. A. Consent Calendar Second Day Regular Session",69,0,11,0,80
1102640,723725,2018-03-15,Assembly,"Be adopted. To third reading",6,0,5,0,11
1102640,742262,2018-04-23,Senate,"Special Consent ACR194",38,0,1,0,39
1102658,723636,2018-03-15,Assembly,"Be adopted. To third reading",6,0,5,0,11
1102658,735654,2018-04-09,Senate,"Special Consent ACR195",39,0,0,0,39
1102676,723722,2018-03-15,Senate,"Senate 3rd Reading SCR113 Jackson",38,0,1,0,39
1102676,734399,2018-04-05,Assembly,"Be adopted. To Consent Calendar",8,0,3,0,11
1102676,738272,2018-04-12,Assembly,"SCR 113 Jackson Consent Calendar Second Day Regular Session",68,0,9,0,77
1102695,724853,2018-03-19,Senate,"Senate 3rd Reading SR89 Galgiani et al",38,0,1,0,39
1102738,751186,2018-05-09,Senate,"Be adopted as amended, but first amend, and re-refer to the Committee on [Elections and Constitutional Amendments]",7,0,0,0,7
1102738,753307,2018-05-15,Senate,"Be adopted, but first be re-referred to the Committee on [Appropriations]",5,0,0,0,5
1102738,755259,2018-05-22,Senate,"Placed on suspense file",7,0,0,0,7
1103375,724851,2018-03-19,Senate,"Senate 3rd Reading SR91 Dodd et al",38,0,1,0,39
1103390,764322,2018-06-18,Assembly,"Be adopted. To third reading",7,0,4,0,11
1103390,771401,2018-08-13,Senate,"Special Consent ACR196",37,0,3,0,40
1103405,741189,2018-04-18,Senate,"Do pass as amended, and be ordered to the Consent Calendar",7,0,0,0,7
1103405,746231,2018-04-30,Senate,"Consent Calendar SB1502 E.Q. (Wieckowski)",36,0,3,0,39
1103405,761816,2018-06-11,Assembly,"Do pass. To Consent Calendar",10,0,0,0,10
1103405,763381,2018-06-14,Assembly,"SB 1502 E.Q. Consent Calendar Second Day Regular Session",78,0,2,0,80
1103420,751065,2018-05-08,Assembly,"Be adopted. To third reading",5,0,2,0,7
1103420,767319,2018-06-21,Senate,"Assembly 3rd Reading ACR197 Jones-Sawyer et al. By Jackson",30,5,4,0,39
1103434,752192,2018-05-10,Senate,"Senate 3rd Reading SR90 Pan",38,0,1,0,39
1104812,724646,2018-03-19,Assembly,"Be adopted. To third reading",8,0,3,0,11
1104812,742179,2018-04-23,Senate,"Special Consent ACR199",38,0,1,0,39
1104822,727732,2018-03-22,Assembly,"Be adopted. To third reading",7,0,4,0,11
1104822,742196,2018-04-23,Senate,"Special Consent ACR198",38,0,1,0,39
1104839,738787,2018-04-16,Senate,"Placed on suspense file",7,0,0,0,7
1104839,756296,2018-05-25,Senate,"Be adopted. Ordered to third reading",7,0,0,0,7
1104839,769793,2018-07-05,Senate,"Senate 3rd Reading SCR114 Stern et al",35,0,4,0,39
1104839,771503,2018-08-15,Assembly,"Be adopted as amended, and re-refer to the Committee on [Appropriations]",6,0,1,0,7
1104839,772955,2018-08-27,Assembly,"Be adopted. To Consent Calendar",16,0,1,0,17
1104839,773638,2018-08-29,Assembly,"SCR 114 Stern Consent Calendar Second Day Regular Session",78,0,2,0,80
1104839,773639,2018-08-29,Assembly,"SCR 114 Stern Consent Calendar Second Day Regular Session",78,0,2,0,80
1104839,773915,2018-08-30,Senate,"Unfinished Business SCR114 Stern et al. Concurrence",39,0,1,0,40
1104847,724725,2018-03-19,Assembly,"Be adopted. To third reading",8,0,3,0,11
1105374,769552,2018-07-02,Senate,"Senate 3rd Reading SR92 Cannella",37,0,2,0,39
1105385,742241,2018-04-23,Assembly,"Be adopted. To Consent Calendar",14,0,0,0,14
1105385,744891,2018-04-26,Assembly,"ACR 202 DAHLE Consent Calendar Second Day Regular Session",74,0,4,0,78
1105385,769745,2018-07-03,Senate,"Be adopted, but first be re-referred to the Committee on [Appropriations] with recommendation: To Consent Calendar",12,0,1,0,13
1105385,771375,2018-08-13,Senate,"Consent Calendar ACR202",37,0,3,0,40
1105398,768008,2018-06-25,Assembly,"Be adopted. To Consent Calendar",13,0,1,0,14
1105398,769223,2018-06-28,Assembly,"ACR 201 FONG Consent Calendar Second Day",75,0,5,0,80
1105398,771453,2018-08-14,Senate,"Be adopted, but first be re-referred to the Committee on [Appropriations]",13,0,0,0,13
1105398,773194,2018-08-28,Senate,"Assembly 3rd Reading ACR201 Fong et al. By Fuller",39,0,1,0,40
1105408,738066,2018-04-12,Assembly,"Be adopted. To third reading",7,0,4,0,11
1105408,754918,2018-05-21,Senate,"Special Consent ACR200",39,0,0,0,39
1105408,757142,2018-05-29,Assembly,"ACR 200 BAKER Concurrence in Senate Amendments",78,0,0,0,78
1105935,727800,2018-03-22,Senate,"Senate 3rd Reading SR93 Fuller et al",37,0,2,0,39
1105946,743225,2018-04-23,Senate,"Do pass, but first be re-referred to the Committee on [Appropriations] with the recommendation: To Consent Calendar",4,0,1,0,5
1105946,752185,2018-05-10,Senate,"Consent Calendar SB1504 P.E. & R",38,0,1,0,39
1105946,766825,2018-06-20,Assembly,"Do pass and be re-referred to the Committee on [Appropriations]",6,0,1,0,7
1105946,771048,2018-08-08,Assembly,"Do pass. To Consent Calendar",17,0,0,0,17
1105946,773100,2018-08-28,Assembly,"SB 1504 P.E. & R. Senate Third Reading By RODRIGUEZ",80,0,0,0,80
1105946,773764,2018-08-30,Senate,"That the Assembly amendments be concurred in",5,0,0,0,5
1105946,774132,2018-08-31,Senate,"Unfinished Business SB1504 P.E. & R. (Pan) Concurrence",39,0,1,0,40
1105956,732733,2018-04-02,Assembly,"Be adopted. To third reading",6,0,5,0,11
1105956,744812,2018-04-26,Senate,"Special Consent ACR203 Quirk-Silva et al",36,0,3,0,39
1105967,743355,2018-04-24,Senate,"Do pass, but first be re-referred to the Committee on [Appropriations] with the recommendation: To Consent Calendar",12,0,0,0,12
1105967,752188,2018-05-10,Senate,"Consent Calendar SB1503 G.O",38,0,1,0,39
1105967,766533,2018-06-20,Assembly,"Do pass and be re-referred to the Committee on [Appropriations] with recommendation: To Consent Calendar",19,0,2,0,21
1105967,771112,2018-08-08,Assembly,"Do pass. To Consent Calendar",17,0,0,0,17
1105967,771628,2018-08-16,Assembly,"SB 1503 G.O. Consent Calendar Second Day Regular Session",76,0,4,0,80
1105978,735622,2018-04-09,Assembly,"Be adopted. To third reading",10,0,1,0,11
1105988,744834,2018-04-26,Senate,"Senate 3rd Reading SCR115 McGuire et al",34,0,5,0,39
1105988,762362,2018-06-12,Assembly,"Be adopted, and re-refer to the Committee on [Appropriations] with recommendation: To Consent Calendar",13,0,2,0,15
1105988,772033,2018-08-16,Assembly,"Be adopted as amended",13,0,4,0,17
1105988,774264,2018-08-31,Senate,"Unfinished Business SCR115 McGuire et al. Concurrence",39,0,1,0,40
1105988,774265,2018-08-31,Assembly,"SCR 115 McGuire Senate Third Reading By ARAMBULA",79,0,1,0,80
1105998,752820,2018-05-14,Assembly,"Be adopted. To third reading",8,0,3,0,11
1105998,757410,2018-05-29,Assembly,"AJR 35 LEVINE Assembly Third Reading",76,0,2,0,78
1106007,751387,2018-05-09,Assembly,"Do pass. To Consent Calendar",9,0,0,0,9
1106007,755003,2018-05-21,Assembly,"AB 3254 L. GOV. Assembly Third Reading By AGUIAR-CURRY",74,0,4,0,78
1106007,763294,2018-06-13,Senate,"Do pass and be ordered to the Consent Calendar",7,0,0,0,7
1106007,768051,2018-06-25,Senate,"Consent Calendar AB3254 L. GOV",36,0,3,0,39
1106458,738191,2018-04-12,Senate,"Senate 3rd Reading SCR118 Newman",38,0,1,0,39
1106458,742202,2018-04-23,Assembly,"Be adopted. To Consent Calendar",8,0,3,0,11
1106458,744855,2018-04-26,Assembly,"SCR 118 Newman Consent Calendar Second Day Regular Session",74,0,4,0,78
1106470,738236,2018-04-12,Senate,"Senate 3rd Reading SCR117 Newman et al",38,0,1,0,39
1106470,752019,2018-05-10,Assembly,"Be adopted. To Consent Calendar",9,0,2,0,11
1106470,754282,2018-05-17,Assembly,"SCR 117 Newman Consent Calendar Second Day Regular Session",73,0,5,0,78
1106493,743709,2018-04-24,Assembly,"Do pass and be re-referred to the Committee on [Appropriations]",13,0,0,0,13
1106493,751343,2018-05-09,Assembly,"Do pass. To Consent Calendar",16,0,1,0,17
1106493,754336,2018-05-17,Assembly,"AB 3255 HIGHER ED. Consent Calendar Second Day Regular Session",73,0,5,0,78
1106493,762893,2018-06-13,Senate,"Do pass, but first be re-referred to the Committee on [Appropriations] with the recommendation: To Consent Calendar",7,0,0,0,7
1106493,772970,2018-08-27,Senate,"Assembly 3rd Reading AB3255 HIGHER ED. (Medina) By Allen",39,0,1,0,40
1106493,773497,2018-08-29,Assembly,"AB 3255 HIGHER ED. Concurrence in Senate Amendments By MEDINA",80,0,0,0,80
1106504,734507,2018-04-05,Senate,"Senate 3rd Reading SCR116 Nguyen",37,0,2,0,39
1106504,738789,2018-04-16,Assembly,"Be adopted. To Consent Calendar",9,0,2,0,11
1106504,741407,2018-04-19,Assembly,"SCR 116 Nguyen Consent Calendar Second Day Regular Session",71,0,7,0,78
1106516,733153,2018-04-02,Assembly,"Be adopted. To third reading",6,0,5,0,11
1106516,744873,2018-04-26,Senate,"Special Consent ACR204 Baker et al",35,0,4,0,39
1106527,741326,2018-04-18,Senate,"Be adopted, but first be re-referred to the Committee on [Appropriations]",7,0,0,0,7
1106527,746391,2018-04-30,Senate,"Placed on suspense file",6,0,1,0,7
1106527,756732,2018-05-25,Senate,"Be adopted as amended",7,0,0,0,7
1106527,757790,2018-05-30,Senate,"Senate 3rd Reading SJR22 Hueso et al",36,0,3,0,39
1106527,768380,2018-06-26,Assembly,"Be adopted. To third reading",6,0,1,0,7
1106527,772281,2018-08-20,Assembly,"SJR 22 Hueso Senate Third Reading By GONZALEZ FLETCHER",74,0,6,0,80
1106527,773914,2018-08-30,Senate,"Unfinished Business SJR22 Hueso et al. Concurrence",37,0,3,0,40
1107240,743844,2018-04-25,Assembly,"Do pass and be re-referred to the Committee on [Appropriations]",7,0,0,0,7
1107240,755714,2018-05-23,Assembly,"Do pass. To Consent Calendar",16,0,1,0,17
1107240,757029,2018-05-29,Assembly,"AB 3256 A.,E.,S.,T., & I.M. Consent Calendar Second Day Regular Session",78,0,0,0,78
1107240,767941,2018-06-25,Senate,"Do pass, but first be re-referred to the Committee on [Appropriations] with the recommendation: To Consent Calendar",9,0,0,0,9
1107240,771423,2018-08-13,Senate,"Consent Calendar AB3256 A.,E.,S.,T.,",37,0,3,0,40
1107265,734472,2018-04-05,Senate,"Senate 3rd Reading SJR23 Newman et al",38,0,1,0,39
1107265,762317,2018-06-12,Assembly,"Be adopted. To Consent Calendar",13,0,2,0,15
1107265,764225,2018-06-18,Assembly,"SJR 23 Newman Consent Calendar Second Day Regular Session",80,0,0,0,80
1107291,742185,2018-04-23,Assembly,"Be adopted. To Consent Calendar",14,0,0,0,14
1107291,754222,2018-05-17,Assembly,"ACR 205 WALDRON Assembly Third Reading",72,0,6,0,78
1107291,769749,2018-07-03,Senate,"Be adopted, but first be re-referred to the Committee on [Appropriations] with recommendation: To Consent Calendar",12,0,1,0,13
1107291,771343,2018-08-13,Senate,"Consent Calendar ACR205",37,0,3,0,40
1107313,746998,2018-05-01,Assembly,"Be adopted as amended",9,0,1,0,10
1107313,748910,2018-05-03,Assembly,"AJR 36 TING Assembly Third Reading",51,0,27,0,78
1107313,768977,2018-06-26,Senate,"Be adopted. Ordered to third reading",6,1,0,0,7
1107313,771187,2018-08-09,Senate,"Assembly 3rd Reading AJR36 Ting et al. By Pan",29,0,10,0,39
1107747,734342,2018-04-05,Senate,"Senate 3rd Reading SCR119 Jackson",37,0,2,0,39
1107747,745130,2018-04-26,Assembly,"Be adopted. To Consent Calendar",8,0,3,0,11
1107747,748903,2018-05-03,Assembly,"SCR 119 Jackson Consent Calendar Second Day Regular Session",71,0,7,0,78
1107755,736161,2018-04-10,Senate,"Be adopted, but first be re-referred to the Committee on [Public Employment and Retirement]",5,2,0,0,7
1107755,743242,2018-04-23,Senate,"Be adopted, but first be re-referred to the Committee on [Appropriations]",3,1,1,0,5
1107755,749799,2018-05-07,Senate,"Placed on suspense file",6,0,1,0,7
1107755,756740,2018-05-25,Senate,"Be adopted. Ordered to third reading",5,2,0,0,7
1107755,757168,2018-05-29,Senate,"Senate 3rd Reading SJR24 Jackson",24,9,6,0,39
1107755,766725,2018-06-20,Assembly,"Be adopted and re-referred to the Committee on [Appropriations]",1,1,5,0,7
1107760,734362,2018-04-05,Senate,"Senate 3rd Reading SCR120 Hill",38,0,1,0,39
1107760,738221,2018-04-12,Assembly,"Be adopted. To third reading",7,0,4,0,11
1107760,741440,2018-04-19,Assembly,"SCR 120 Hill Senate Third Reading By GRAYSON",71,0,7,0,78
1107761,761771,2018-06-11,Assembly,"Be adopted. To third reading",9,0,2,0,11
1107766,732814,2018-04-02,Senate,"Senate 2nd Reading SR95 Hueso",37,0,2,0,39
1107770,727762,2018-03-22,Senate,"Senate 3rd Reading SR94 Atkins",37,0,2,0,39
1107775,743153,2018-04-23,Assembly,"Do pass and be re-referred to the Committee on [Appropriations] with recommendation: To Consent Calendar",10,0,0,0,10
1107775,756664,2018-05-25,Assembly,"Do pass as amended",16,0,1,0,17
1107775,758718,2018-05-31,Assembly,"AB 3257 NAT. RES. Assembly Third Reading",77,0,1,0,78
1107775,768350,2018-06-26,Senate,"Do pass, but first be re-referred to the Committee on [Appropriations] with the recommendation: To Consent Calendar",9,0,0,0,9
1107775,771383,2018-08-13,Senate,"Placed on suspense file",7,0,0,0,7
1107775,771957,2018-08-16,Senate,"Do pass",7,0,0,0,7
1107775,772805,2018-08-27,Senate,"Assembly 3rd Reading AB3257 NAT. RES. (Muratsuchi) By Allen",39,0,1,0,40
1107775,773594,2018-08-29,Assembly,"AB 3257 NAT. RES. Concurrence in Senate Amendments By MURATSUCHI",80,0,0,0,80
1107778,735543,2018-04-09,Assembly,"Be adopted. To third reading",10,0,1,0,11
1107783,727651,2018-03-22,Assembly,"Be adopted. To third reading",7,0,4,0,11
1107783,742100,2018-04-23,Senate,"Special Consent ACR206",38,0,1,0,39
1108152,747882,2018-05-02,Senate,"Do pass and be ordered to the Consent Calendar",7,0,0,0,7
1108152,752103,2018-05-10,Senate,"Consent Calendar SB1510 GOV. & F",38,0,1,0,39
1108152,769701,2018-07-02,Assembly,"Do pass. To Consent Calendar",9,0,1,0,10
1108158,738379,2018-04-12,Assembly,"Be adopted. To third reading",7,0,4,0,11
1108158,754990,2018-05-21,Senate,"Special Consent ACR207",39,0,0,0,39
1108166,743600,2018-04-24,Senate,"Do pass, but first be re-referred to the Committee on [Appropriations] with the recommendation: To Consent Calendar",12,0,0,0,12
1108166,752013,2018-05-10,Senate,"Consent Calendar SB1505 G.O",38,0,1,0,39
1108166,769004,2018-06-27,Assembly,"Do pass and be re-referred to the Committee on [Appropriations] with recommendation: To Consent Calendar",7,0,0,0,7
1108166,771123,2018-08-08,Assembly,"Do pass. To Consent Calendar",17,0,0,0,17
1108166,771776,2018-08-16,Assembly,"SB 1505 G.O. Consent Calendar Second Day Regular Session",76,0,4,0,80
1108166,772266,2018-08-20,Senate,"Unfinished Business SB1505 G.O. (Dodd) Concurrence",38,0,2,0,40
1108174,743708,2018-04-25,Senate,"Do pass, but first be re-referred to the Committee on [Appropriations] with the recommendation: To Consent Calendar",7,0,0,0,7
1108174,750214,2018-05-07,Senate,"Placed on suspense file",6,0,1,0,7
1108174,756692,2018-05-25,Senate,"Do pass",7,0,0,0,7
1108174,758712,2018-05-31,Senate,"Special Consent SB1508 GOV. & F",39,0,0,0,39
1108174,768512,2018-06-25,Assembly,"Do pass as amended, and be re-referred to the Committee on [Appropriations] with recommendation: To Consent Calendar",9,0,1,0,10
1108180,744688,2018-04-25,Senate,"Do pass, but first be re-referred to the Committee on [Appropriations] with the recommendation: To Consent Calendar",7,0,0,0,7
1108180,752064,2018-05-10,Senate,"Consent Calendar SB1509 GOV. & F",38,0,1,0,39
1108180,768743,2018-06-27,Assembly,"Do pass and be re-referred to the Committee on [Appropriations] with recommendation: To Consent Calendar",7,0,0,0,7
1108180,771104,2018-08-08,Assembly,"Do pass. To Consent Calendar",17,0,0,0,17
1108180,771555,2018-08-16,Assembly,"SB 1509 GOV.& F. Consent Calendar Second Day Regular Session",76,0,4,0,80
1108180,772673,2018-08-24,Senate,"Unfinished Business SB1509 GOV. & F. (McGuire) Concurrence",39,0,1,0,40
1108187,743846,2018-04-25,Assembly,"Do pass as amended, and be re-referred to the Committee on [Appropriations] with recommendation: To Consent Calendar",10,0,0,0,10
1108187,751382,2018-05-09,Assembly,"Do pass. To Consent Calendar",16,0,1,0,17
1108187,754376,2018-05-17,Assembly,"AB 3260 AGRI. Consent Calendar Second Day Regular Session",73,0,5,0,78
1108187,765276,2018-06-19,Senate,"Do pass, but first be re-referred to the Committee on [Appropriations] with the recommendation: To Consent Calendar",4,0,1,0,5
1108187,770437,2018-08-06,Senate,"Consent Calendar AB3260 AGRI. (Caballero)",37,0,2,0,39
1108193,744266,2018-04-25,Senate,"Do pass, but first be re-referred to the Committee on [Appropriations] with the recommendation: To Consent Calendar",7,0,0,0,7
1108193,752127,2018-05-10,Senate,"Consent Calendar SB1506 GOV. & F",38,0,1,0,39
1108193,762257,2018-06-11,Assembly,"Do pass and be re-referred to the Committee on [Appropriations] with recommendation: To Consent Calendar",9,0,1,0,10
1108193,769033,2018-06-27,Assembly,"Do pass. To Consent Calendar",16,0,1,0,17
1108193,769772,2018-07-05,Assembly,"SB 1506 GOV.& F. Consent Calendar Second Day Regular Session",69,0,11,0,80
1108201,769628,2018-07-02,Senate,"Senate 3rd Reading SR96 Wilk et al",27,1,11,0,39
1108207,751829,2018-05-09,Assembly,"Do pass as amended. To Consent Calendar",7,0,0,0,7
1108207,754910,2018-05-21,Assembly,"AB 3259 E. & R. Consent Calendar Second Day By BERMAN",72,0,6,0,78
1108207,760357,2018-06-06,Senate,"Do pass and be ordered to the Consent Calendar",5,0,0,0,5
1108207,763515,2018-06-14,Senate,"Consent Calendar AB3259 E. & R",37,0,2,0,39
1108213,734422,2018-04-05,Senate,"Senate 3rd Reading SCR121 Anderson et al",38,0,1,0,39
1108213,768535,2018-06-26,Assembly,"Be adopted. To third reading",7,0,0,0,7
1108220,744348,2018-04-25,Assembly,"Do pass and be re-referred to the Committee on [Appropriations] with recommendation: To Consent Calendar",7,0,0,0,7
1108220,751788,2018-05-09,Assembly,"Do pass. To Consent Calendar",16,0,1,0,17
1108220,754406,2018-05-17,Assembly,"AB 3258 E. & R. Consent Calendar Second Day Regular Session",73,0,5,0,78
1108220,760426,2018-06-06,Senate,"Do pass, but first be re-referred to the Committee on [Appropriations] with the recommendation: To Consent Calendar",5,0,0,0,5
1108220,772291,2018-08-20,Senate,"Assembly 3rd Reading AB3258 E. & R. (Berman) By Stern",39,0,1,0,40
1108220,772615,2018-08-23,Assembly,"AB 3258 E. & R. Concurrence in Senate Amendments By BERMAN",75,0,5,0,80
1108225,748062,2018-05-02,Senate,"Do pass and be ordered to the Consent Calendar",7,0,0,0,7
1108225,752002,2018-05-10,Senate,"Consent Calendar SB1507 GOV. & F",38,0,1,0,39
1108225,765126,2018-06-18,Assembly,"Do pass. To Consent Calendar",10,0,0,0,10
1108225,767990,2018-06-25,Assembly,"SB 1507 GOV.& F. Consent Calendar Second Day Regular Session",75,0,5,0,80
1108225,770862,2018-08-06,Senate,"Unfinished Business SB1507 GOV. & F. (McGuire) Concurrence",37,0,2,0,39
1108859,739004,2018-04-16,Senate,"Senate 3rd Reading SCR122 Nguyen",36,0,3,0,39
1108859,751981,2018-05-10,Assembly,"Be adopted. To third reading",9,0,2,0,11
1108860,741397,2018-04-19,Assembly,"Be adopted. To third reading",9,0,2,0,11
1108860,742108,2018-04-23,Assembly,"AJR 37 FRIEDMAN Assembly Third Reading",75,0,3,0,78
1108860,754935,2018-05-21,Senate,"Special Consent AJR37",39,0,0,0,39
1108861,735664,2018-04-09,Senate,"Senate 3rd Reading SCR123 Newman et al",39,0,0,0,39
1108861,751934,2018-05-10,Assembly,"Be adopted. To Consent Calendar",9,0,2,0,11
1108861,754286,2018-05-17,Assembly,"SCR 123 Newman Consent Calendar Second Day Regular Session",73,0,5,0,78
1108862,743771,2018-04-25,Senate,"Be adopted, but first be re-referred to the Committee on [Elections and Constitutional Amendments]",7,0,0,0,7
1108862,753282,2018-05-15,Senate,"Be adopted, but first be re-referred to the Committee on [Appropriations]",3,1,1,0,5
1108862,755278,2018-05-22,Senate,"Placed on suspense file",7,0,0,0,7
1108863,746990,2018-05-01,Senate,"Be adopted, but first be re-referred to the Committee on [Appropriations] with recommendation: To Consent Calendar",12,0,1,0,13
1108863,757233,2018-05-29,Senate,"Senate 3rd Reading SCR124 McGuire et al",38,0,1,0,39
1108863,767960,2018-06-25,Assembly,"Be adopted. To Consent Calendar",13,0,1,0,14
1108863,769286,2018-06-28,Assembly,"SCR 124 McGuire Consent Calendar Second Day Regular Session",75,0,5,0,80
1110558,743236,2018-04-24,Assembly,"Be adopted. To third reading",15,0,0,0,15
1110558,744949,2018-04-26,Assembly,"AJR 38 MATHIS Assembly Third Reading",73,0,5,0,78
1110558,754963,2018-05-21,Senate,"Special Consent AJR38",39,0,0,0,39
1110559,734390,2018-04-05,Assembly,"Be adopted. To third reading",8,0,3,0,11
1110559,744848,2018-04-26,Senate,"Special Consent ACR211",35,0,4,0,39
1110561,735530,2018-04-09,Assembly,"Be adopted. To third reading",10,0,1,0,11
1110561,745972,2018-04-30,Senate,"Assembly 3rd Reading ACR208 Aguiar-Curry et al. By Dodd",36,0,3,0,39
1110563,746783,2018-04-30,Assembly,"Be adopted. To third reading",10,0,1,0,11
1110563,757108,2018-05-29,Senate,"Special Consent ACR209",37,0,2,0,39
1110564,741359,2018-04-19,Assembly,"Be adopted. To third reading",9,0,2,0,11
1110565,735413,2018-04-09,Assembly,"Be adopted. To third reading",10,0,1,0,11
1110565,746150,2018-04-30,Senate,"Assembly 3rd Reading ACR210 Frazier et al. By Portantino",36,0,3,0,39
1110567,746330,2018-04-30,Senate,"Senate 3rd Reading SR98 Wieckowski",37,0,2,0,39
1110569,734371,2018-04-05,Assembly,"Be adopted. To third reading",8,0,3,0,11
1110570,735619,2018-04-09,Senate,"Senate 3rd Reading SCR126 Dodd et al",39,0,0,0,39
1110570,742136,2018-04-23,Assembly,"Be adopted. To third reading",8,0,3,0,11
1110570,748895,2018-05-03,Senate,"Unfinished Business SCR126 Dodd et al. Concurrence",38,0,1,0,39
1110572,746332,2018-04-30,Senate,"Senate 3rd Reading SCR125 Hueso et al",37,0,2,0,39
1110572,749820,2018-05-07,Assembly,"Be adopted. To Consent Calendar",8,0,3,0,11
1110572,751965,2018-05-10,Assembly,"SCR 125 Hueso Consent Calendar Second Day Regular Session",73,0,5,0,78
1110573,750745,2018-05-08,Assembly,"Do pass. To Consent Calendar",16,0,2,0,18
1110573,752784,2018-05-14,Assembly,"AB 3261 B. & P. Consent Calendar Second Day By LOW",76,0,2,0,78
1110573,767884,2018-06-25,Senate,"Do pass and be ordered to the Consent Calendar",9,0,0,0,9
1110573,769557,2018-07-02,Senate,"Consent Calendar AB3261",37,0,2,0,39
1110573,773168,2018-08-28,Senate,"Assembly 3rd Reading AB3261 Low By Hill",38,0,2,0,40
1110573,773422,2018-08-29,Assembly,"AB 3261 LOW Concurrence in Senate Amendments",76,0,4,0,80
1110884,741464,2018-04-19,Senate,"Senate 3rd Reading SR99 Stone",35,0,4,0,39
1110886,742182,2018-04-23,Assembly,"Be adopted as amended. To Consent Calendar",14,0,0,0,14
1110886,748843,2018-05-03,Assembly,"ACR 214 GIPSON Consent Calendar Second Day Regular Session",71,0,7,0,78
1110886,769744,2018-07-03,Senate,"Be adopted as amended, but first amend, and re-refer to the Committee on [Appropriations] with the recommendation: To Consent Calendar",12,0,1,0,13
1110886,771311,2018-08-13,Senate,"Consent Calendar ACR214",37,0,3,0,40
1110886,772626,2018-08-23,Assembly,"ACR 214 GIPSON Concurrence in Senate Amendments",79,0,1,0,80
1110888,748522,2018-05-03,Senate,"Senate 3rd Reading SCR127 Beall",38,0,1,0,39
1110888,752596,2018-05-14,Assembly,"Be adopted. To third reading",8,0,3,0,11
1110890,761863,2018-06-11,Assembly,"Be adopted. To Consent Calendar",14,0,0,0,14
1110890,763522,2018-06-14,Assembly,"ACR 212 KILEY Consent Calendar Second Day",78,0,2,0,80
1110890,769720,2018-07-03,Senate,"Be adopted, but first be re-referred to the Committee on [Appropriations] with recommendation: To Consent Calendar",12,0,1,0,13
1110890,771293,2018-08-13,Senate,"Consent Calendar ACR212",37,0,3,0,40
1110891,738363,2018-04-12,Assembly,"Be adopted. To third reading",7,0,4,0,11
1110891,754988,2018-05-21,Senate,"Special Consent ACR213",39,0,0,0,39
1111034,738118,2018-04-12,Senate,"Senate 3rd Reading SR100 McGuire et al",38,0,1,0,39
1111035,751582,2018-05-08,Senate,"Be adopted and be ordered to the Consent Calendar",7,0,0,0,7
1111035,754306,2018-05-17,Senate,"Consent Calendar SCR128",38,0,1,0,39
1111035,762187,2018-06-12,Assembly,"Be adopted. To Consent Calendar",9,0,1,0,10
1111035,763550,2018-06-14,Assembly,"SCR 128 Nguyen Consent Calendar Second Day Regular Session",78,0,2,0,80
1111035,769644,2018-07-02,Senate,"Unfinished Business SCR128 Nguyen et al. Concurrence",37,0,2,0,39
1111036,745210,2018-04-26,Senate,"Senate 3rd Reading SCR129 Fuller et al",35,0,4,0,39
1111036,750060,2018-05-07,Assembly,"Be adopted. To Consent Calendar",8,0,3,0,11
1111036,752133,2018-05-10,Assembly,"SCR 129 Fuller Consent Calendar Second Day Regular Session",73,0,5,0,78
1111230,752115,2018-05-10,Assembly,"Do pass. To Consent Calendar",17,0,4,0,21
1111230,754367,2018-05-17,Assembly,"AB 3262 G.O. Consent Calendar Second Day Regular Session",73,0,5,0,78
1111230,768571,2018-06-26,Senate,"Do pass and be ordered to the Consent Calendar",13,0,0,0,13
1111230,772810,2018-08-27,Senate,"Assembly 3rd Reading AB3262 Gray et al. By Lara Urgency Clause",39,0,1,0,40
1111230,773622,2018-08-29,Assembly,"AB 3262 GRAY Concurrence - Urgency Added",80,0,0,0,80
1111231,765521,2018-06-19,Assembly,"Be adopted. To third reading",10,0,0,0,10
1111231,771464,2018-08-14,Senate,"Be adopted. Ordered to third reading",5,0,2,0,7
1111231,773920,2018-08-30,Senate,"Assembly 3rd Reading ACR215 Kiley et al. By Moorlach",39,0,1,0,40
1111232,751329,2018-05-09,Senate,"Be adopted, but first be re-referred to the Committee on [Elections and Constitutional Amendments]",4,2,1,0,7
1111232,753296,2018-05-15,Senate,"Be adopted, but first be re-referred to the Committee on [Appropriations]",4,1,0,0,5
1111232,755339,2018-05-22,Senate,"Placed on suspense file",7,0,0,0,7
1111233,752101,2018-05-10,Assembly,"Do pass. To Consent Calendar",17,0,4,0,21
1111233,754366,2018-05-17,Assembly,"AB 3263 G.O. Consent Calendar Second Day Regular Session",73,0,5,0,78
1111233,768464,2018-06-26,Senate,"Do pass and be ordered to the Consent Calendar",13,0,0,0,13
1111234,738178,2018-04-12,Assembly,"Be adopted. To third reading",7,0,4,0,11
1111235,752326,2018-05-10,Assembly,"Do pass. To Consent Calendar",17,0,4,0,21
1111235,754393,2018-05-17,Assembly,"AB 3264 G.O. Consent Calendar Second Day Regular Session",73,0,5,0,78
1111235,768547,2018-06-26,Senate,"Do pass and be ordered to the Consent Calendar",13,0,0,0,13
1111235,773245,2018-08-28,Senate,"Assembly 3rd Reading AB3264 G.O. (Gray) By Dodd",38,0,2,0,40
1111235,773922,2018-08-30,Assembly,"AB 3264 G.O. Concurrence in Senate Amendments By GRAY",79,0,1,0,80
1111874,752588,2018-05-14,Senate,"Senate 3rd Reading SCR131 Newman",37,0,2,0,39
1111874,756748,2018-05-25,Assembly,"Be adopted. To Consent Calendar",8,0,3,0,11
1111874,757770,2018-05-30,Assembly,"SCR 131 Newman Consent Calendar Second Day",74,0,4,0,78
1111875,742289,2018-04-23,Assembly,"Be adopted. To third reading",8,0,3,0,11
1111877,738850,2018-04-16,Senate,"W/O REF. TO FILE SR102 Lara",37,0,2,0,39
1111880,742306,2018-04-23,Senate,"Senate 3rd Reading SCR130 Fuller et al",38,0,1,0,39
1111880,746041,2018-04-30,Assembly,"Be adopted. To Consent Calendar",10,0,1,0,11
1111880,748766,2018-05-03,Assembly,"SCR 130 Fuller Consent Calendar Second Day Regular Session",71,0,7,0,78
1111881,746460,2018-04-30,Senate,"Senate 3rd Reading SR101 Bradford et al",37,0,2,0,39
1111882,752853,2018-05-14,Assembly,"Be adopted. To third reading",8,0,3,0,11
1111882,757180,2018-05-29,Senate,"Assembly 3rd Reading ACR216 Muratsuchi et al. By Allen",37,0,2,0,39
1111883,768753,2018-06-27,Assembly,"Be adopted. To Consent Calendar",9,0,1,0,10
1111883,769775,2018-07-05,Assembly,"ACR 217 LEVINE Consent Calendar Second Day",69,0,11,0,80
1111883,772724,2018-08-24,Senate,"Special Consent ACR217",39,0,1,0,40
1112316,746606,2018-04-30,Assembly,"Be adopted. To third reading",10,0,1,0,11
1112316,757045,2018-05-29,Senate,"Special Consent ACR218",37,0,2,0,39
1112318,742171,2018-04-23,Senate,"Senate 3rd Reading SCR132 Anderson et al",38,0,1,0,39
1112318,772639,2018-08-23,Assembly,"Be adopted. To Consent Calendar",11,0,0,0,11
1112318,773034,2018-08-27,Assembly,"SCR 132 Anderson Consent Calendar Second Day Regular Session",80,0,0,0,80
1112322,746692,2018-04-30,Assembly,"Be adopted. To third reading",10,0,1,0,11
1112324,762983,2018-06-12,Senate,"Do pass as amended, but first amend, and re-refer to the Committee on [Appropriations] with the recommendation: To Consent Calendar",7,0,0,0,7
1112324,769657,2018-07-02,Senate,"Placed on suspense file",7,0,0,0,7
1112324,771928,2018-08-16,Senate,"Do pass as amended",7,0,0,0,7
1112640,738798,2018-04-16,Assembly,"Be adopted. To third reading",9,0,2,0,11
1112644,741401,2018-04-19,Assembly,"Be adopted. To third reading",9,0,2,0,11
1112985,744760,2018-04-26,Senate,"Senate 3rd Reading SR104 Jackson",36,0,3,0,39
1112986,761589,2018-06-11,Assembly,"Be adopted. To Consent Calendar",14,0,0,0,14
1112986,763412,2018-06-14,Assembly,"ACR 220 MATHIS Consent Calendar Second Day Regular Session",78,0,2,0,80
1112986,769718,2018-07-03,Senate,"Be adopted, but first be re-referred to the Committee on [Appropriations] with recommendation: To Consent Calendar",12,0,1,0,13
1112986,771294,2018-08-13,Senate,"Consent Calendar ACR220",37,0,3,0,40
1112987,750779,2018-05-08,Assembly,"Be adopted. To third reading",5,0,2,0,7
1112987,767285,2018-06-21,Senate,"Assembly 3rd Reading ACR219 Jones-Sawyer et al. By Skinner",25,11,3,0,39
1113385,752899,2018-05-14,Senate,"Senate 3rd Reading SJR25 Wilk et al",38,0,1,0,39
1113385,765476,2018-06-19,Assembly,"Be adopted. To Consent Calendar",15,0,0,0,15
1113385,767887,2018-06-25,Assembly,"SJR 25 Wilk Consent Calendar Second Day Regular Session",75,0,5,0,80
1113389,754539,2018-05-17,Senate,"Senate 3rd Reading SR106 Wilk et al",38,0,1,0,39
1113394,752815,2018-05-14,Assembly,"Be adopted. To third reading",8,0,3,0,11
1113394,760933,2018-06-07,Senate,"Special Consent ACR221",37,0,2,0,39
1113399,747906,2018-05-01,Assembly,"Be adopted as amended. To Consent Calendar",10,0,0,0,10
1113399,751907,2018-05-10,Assembly,"ACR 222 GRAY Consent Calendar Second Day Regular Session",73,0,5,0,78
1113399,761056,2018-06-07,Senate,"Special Consent ACR222",37,0,2,0,39
1113404,746869,2018-05-01,Senate,"Be adopted, but first be re-referred to the Committee on [Appropriations] with recommendation: To Consent Calendar",12,0,1,0,13
1113404,771218,2018-08-09,Senate,"Senate 3rd Reading SCR133 Berryhill et al. By Bates",36,0,3,0,39
1113404,773444,2018-08-29,Assembly,"Be adopted. To Consent Calendar",14,0,0,0,14
1113404,774181,2018-08-31,Assembly,"SCR 133 Berryhill, T. Consent Calendar Second Day Regular Session",79,0,1,0,80
1113408,742155,2018-04-23,Assembly,"Be adopted. To third reading",8,0,3,0,11
1114100,742274,2018-04-23,Senate,"Senate 3rd Reading SR107 Portantino et al",38,0,1,0,39
1114343,749821,2018-05-07,Senate,"Senate 3rd Reading SCR134 Galgiani et al",36,0,3,0,39
1114343,749822,2018-05-07,Assembly,"SCR 134 Galgiani Senate Third Reading By CERVANTES",74,0,4,0,78
1114344,746116,2018-04-30,Assembly,"Be adopted. To third reading",10,0,1,0,11
1114956,758508,2018-05-31,Assembly,"Be adopted. To third reading",7,0,4,0,11
1114956,767227,2018-06-21,Senate,"Assembly 3rd Reading ACR225 Choi et al. By Bates",36,1,2,0,39
1114977,761657,2018-06-11,Assembly,"Be adopted. To Consent Calendar",14,0,0,0,14
1114977,763491,2018-06-14,Assembly,"ACR 224 GRAY Consent Calendar Second Day Regular Session",78,0,2,0,80
1114977,769722,2018-07-03,Senate,"Be adopted, but first be re-referred to the Committee on [Appropriations] with recommendation: To Consent Calendar",12,0,1,0,13
1114977,771295,2018-08-13,Senate,"Consent Calendar ACR224",37,0,3,0,40
1115183,754385,2018-05-17,Senate,"Senate 3rd Reading SCR136 Newman",38,0,1,0,39
1115183,756685,2018-05-25,Assembly,"Be adopted. To Consent Calendar",8,0,3,0,11
1115183,757642,2018-05-30,Assembly,"SCR 136 Newman Consent Calendar Second Day Regular Session",74,0,4,0,78
1115203,763485,2018-06-14,Senate,"Senate 3rd Reading SCR135 Cannella et al",36,0,3,0,39
1115203,770259,2018-08-06,Assembly,"Be adopted. To Consent Calendar",9,0,2,0,11
1115203,771168,2018-08-09,Assembly,"SCR 135 Cannella Consent Calendar Second Day Regular Session",71,0,9,0,80
1115387,748867,2018-05-03,Assembly,"Be adopted. To third reading",6,0,5,0,11
1115407,754362,2018-05-17,Assembly,"Be adopted. To third reading",9,0,2,0,11
1115407,761073,2018-06-07,Senate,"Special Consent ACR226",37,0,2,0,39
1115426,749973,2018-05-07,Senate,"Senate 3rd Reading SCR137 Lara et al",32,2,5,0,39
1115426,752810,2018-05-14,Assembly,"Be adopted. To third reading",8,0,3,0,11
1115445,771447,2018-08-14,Assembly,"Be adopted. To Consent Calendar",8,0,1,0,9
1115445,771912,2018-08-16,Assembly,"AJR 39 CHOI Consent Calendar Second Day",76,0,4,0,80
1115445,773550,2018-08-29,Senate,"Assembly 3rd Reading AJR39 Choi By Glazer",39,0,1,0,40
1115719,761011,2018-06-07,Assembly,"Be adopted. To third reading",6,0,5,0,11
1115721,751919,2018-05-10,Senate,"Senate 3rd Reading SCR138 Pan et al",38,0,1,0,39
1115723,750046,2018-05-07,Assembly,"Be adopted. To third reading",8,0,3,0,11
1115723,761065,2018-06-07,Senate,"Special Consent ACR228",37,0,2,0,39
1115724,751929,2018-05-10,Assembly,"Be adopted. To third reading",9,0,2,0,11
1115724,761037,2018-06-07,Senate,"Special Consent ACR227",37,0,2,0,39
1115725,749811,2018-05-07,Senate,"Senate 3rd Reading SR108 Monning",37,0,2,0,39
1115726,766849,2018-06-21,Senate,"Senate 3rd Reading SCR139 Monning",28,6,5,0,39
1115726,771171,2018-08-09,Assembly,"Be adopted. To third reading",7,2,2,0,11
1115726,772494,2018-08-23,Assembly,"SCR 139 Monning Senate Third Reading By CALDERON",53,16,11,0,80
1116020,761700,2018-06-11,Assembly,"Be adopted. To Consent Calendar",14,0,0,0,14
1116020,763465,2018-06-14,Assembly,"ACR 230 REYES Consent Calendar Second Day Regular Session",78,0,2,0,80
1116020,769721,2018-07-03,Senate,"Be adopted, but first be re-referred to the Committee on [Appropriations] with recommendation: To Consent Calendar",12,0,1,0,13
1116020,771322,2018-08-13,Senate,"Consent Calendar ACR230",37,0,3,0,40
1116023,752674,2018-05-14,Senate,"Senate 3rd Reading SR109 Allen et al",37,0,2,0,39
1116026,756988,2018-05-29,Senate,"Senate 3rd Reading SCR140 Dodd et al",38,0,1,0,39
1116026,763697,2018-06-14,Assembly,"Be adopted. To Consent Calendar",7,0,4,0,11
1116026,767152,2018-06-21,Assembly,"SCR 140 Dodd Consent Calendar Second Day Regular Session",75,0,5,0,80
1116181,755195,2018-05-21,Senate,"Senate 3rd Reading SCR142 Gaines",39,0,0,0,39
1116181,763691,2018-06-14,Assembly,"Be adopted. To Consent Calendar",7,0,4,0,11
1116181,767135,2018-06-21,Assembly,"SCR 142 Gaines Consent Calendar Second Day Regular Session",75,0,5,0,80
1116182,754238,2018-05-17,Senate,"Senate 3rd Reading SCR141 Moorlach et al",38,0,1,0,39
1116182,756644,2018-05-25,Assembly,"Be adopted. To Consent Calendar",8,0,3,0,11
1116182,757835,2018-05-30,Assembly,"SCR 141 Moorlach Consent Calendar Second Day Regular Session",74,0,4,0,78
1116184,752585,2018-05-14,Assembly,"Be adopted. To third reading",8,0,3,0,11
1116184,761076,2018-06-07,Senate,"Special Consent ACR233",37,0,2,0,39
1116185,752186,2018-05-10,Assembly,"Be adopted. To third reading",9,0,2,0,11
1116185,761074,2018-06-07,Senate,"Special Consent ACR232",37,0,2,0,39
1116186,752046,2018-05-10,Assembly,"Be adopted. To third reading",9,0,2,0,11
1116186,761083,2018-06-07,Senate,"Special Consent ACR231",37,0,2,0,39
1116365,768330,2018-06-26,Assembly,"Be adopted, and re-refer to the Committee on [Appropriations] with recommendation: To Consent Calendar",15,0,0,0,15
1116365,771113,2018-08-08,Assembly,"Be adopted. To Consent Calendar",17,0,0,0,17
1116365,771243,2018-08-13,Assembly,"ACR 234 RUBIO Consent Calendar Second Day",77,0,3,0,80
1116365,772802,2018-08-27,Senate,"Assembly 3rd Reading ACR234 Rubio et al. By Mitchell",39,0,1,0,40
1116365,773292,2018-08-29,Assembly,"ACR 234 RUBIO Concurrence in Senate Amendments",80,0,0,0,80
1116684,751950,2018-05-10,Assembly,"Be adopted. To third reading",9,0,2,0,11
1117016,760390,2018-06-06,Senate,"Be adopted, but first be re-referred to the Committee on [Appropriations]",6,0,3,0,9
1117016,769592,2018-07-02,Senate,"Senate 3rd Reading SCR143 Pan",24,8,7,0,39
1117016,772463,2018-08-21,Assembly,"Be adopted and re-referred to the Committee on [Appropriations]",7,0,8,0,15
1117025,761724,2018-06-11,Assembly,"Be adopted. To Consent Calendar",14,0,0,0,14
1117025,763514,2018-06-14,Assembly,"ACR 236 RODRIGUEZ Consent Calendar Second Day Regular Session",78,0,2,0,80
1117025,769723,2018-07-03,Senate,"Be adopted, but first be re-referred to the Committee on [Appropriations] with recommendation: To Consent Calendar",12,0,1,0,13
1117025,771304,2018-08-13,Senate,"Consent Calendar ACR236",37,0,3,0,40
1117034,754192,2018-05-17,Assembly,"Be adopted. To third reading",9,0,2,0,11
1117042,754355,2018-05-17,Assembly,"Be adopted. To third reading",9,0,2,0,11
1117042,760935,2018-06-07,Senate,"Special Consent ACR235",37,0,2,0,39
1117275,752753,2018-05-14,Assembly,"Be adopted. To third reading",8,0,3,0,11
1117275,760973,2018-06-07,Senate,"Special Consent ACR237",37,0,2,0,39
1117289,754950,2018-05-21,Senate,"Senate 3rd Reading SJR26 Dodd et al",38,0,1,0,39
1117289,763276,2018-06-12,Assembly,"Be adopted. To Consent Calendar",10,0,0,0,10
1117289,764324,2018-06-18,Assembly,"SJR 26 Dodd Consent Calendar Second Day Regular Session",80,0,0,0,80
1117304,761728,2018-06-11,Assembly,"Be adopted. To third reading",9,0,2,0,11
1117304,771428,2018-08-13,Senate,"Special Consent ACR238",37,0,3,0,40
1118021,763591,2018-06-14,Assembly,"Be adopted. To third reading",7,0,4,0,11
1118021,771443,2018-08-13,Senate,"Special Consent ACR239",37,0,3,0,40
1118024,756752,2018-05-25,Senate,"Senate 3rd Reading SCR144 Fuller et al",35,0,4,0,39
1118024,761663,2018-06-11,Assembly,"Be adopted. To Consent Calendar",9,0,2,0,11
1118024,763419,2018-06-14,Assembly,"SCR 144 Fuller Consent Calendar Second Day Regular Session",78,0,2,0,80
1118349,757092,2018-05-29,Senate,"Senate 3rd Reading SR110 Beall",38,0,1,0,39
1118362,761920,2018-06-11,Senate,"Senate 3rd Reading SCR145 Bradford",38,0,1,0,39
1118362,764255,2018-06-18,Assembly,"Be adopted. To Consent Calendar",7,0,4,0,11
1118362,766857,2018-06-21,Assembly,"SCR 145 Bradford Consent Calendar Second Day Regular Session",75,0,5,0,80
1118375,763797,2018-06-14,Assembly,"Be adopted. To third reading",7,0,4,0,11
1118388,764398,2018-06-18,Senate,"Senate 3rd Reading SR111 Lara et al",30,1,8,0,39
1118401,763623,2018-06-14,Assembly,"Be adopted. To third reading",7,0,4,0,11
1118401,771442,2018-08-13,Senate,"Special Consent ACR240",37,0,3,0,40
1118413,756696,2018-05-25,Assembly,"Be adopted. To third reading",8,0,3,0,11
1118413,771418,2018-08-13,Senate,"Special Consent ACR241",37,0,3,0,40
1118635,758613,2018-05-31,Senate,"Senate 3rd Reading SR112 Allen et al",39,0,0,0,39
1118868,754940,2018-05-21,Assembly,"Be adopted. To third reading",9,0,2,0,11
1118893,761938,2018-06-11,Senate,"Senate 3rd Reading SCR146 McGuire et al",38,0,1,0,39
1118893,769325,2018-06-28,Assembly,"Be adopted. To third reading",9,0,2,0,11
1119290,756482,2018-05-25,Assembly,"Be adopted. To third reading",8,0,3,0,11
1119569,758629,2018-05-31,Assembly,"Be adopted. To third reading",7,0,4,0,11
1119569,771415,2018-08-13,Senate,"Special Consent ACR242",37,0,3,0,40
1119811,772325,2018-08-21,Senate,"Senate 3rd Reading SCR147 McGuire et al",37,0,3,0,40
1120036,767073,2018-06-21,Assembly,"Be adopted. To third reading",9,0,2,0,11
1120036,773689,2018-08-30,Senate,"Assembly 3rd Reading ACR243 Eduardo Garcia By Portantino",39,0,1,0,40
1120154,758597,2018-05-31,Assembly,"Be adopted. To third reading",7,0,4,0,11
1120154,771440,2018-08-13,Senate,"Special Consent ACR244",37,0,3,0,40
1120162,772731,2018-08-24,Senate,"Senate 3rd Reading SCR148 Galgiani et al",39,0,1,0,40
1120162,772889,2018-08-27,Assembly,"Be adopted. To Consent Calendar",10,0,1,0,11
1120162,773420,2018-08-29,Assembly,"SCR 148 Galgiani Consent Calendar Second Day Regular Session",78,0,2,0,80
1120433,758572,2018-05-31,Assembly,"Be adopted. To third reading",7,0,4,0,11
1120433,759160,2018-06-04,Assembly,"ACR 245 ACOSTA Assembly Third Reading",46,6,26,0,78
1120433,773173,2018-08-28,Senate,"Assembly 3rd Reading ACR245 Acosta et al. By Wilk",29,4,7,0,40
1120434,766507,2018-06-20,Assembly,"Be adopted. To third reading",5,1,1,0,7
1120434,767217,2018-06-21,Assembly,"AJR 41 THURMOND Assembly Third Reading",62,0,18,0,80
1120434,771472,2018-08-13,Senate,"Be adopted. Ordered to third reading",4,0,1,0,5
1120434,773167,2018-08-28,Senate,"Assembly 3rd Reading AJR41 Thurmond et al. By De León",35,0,5,0,40
1120738,770978,2018-08-07,Senate,"Be adopted, but first be re-referred to the Committee on [Elections and Constitutional Amendments]",5,1,1,0,7
1120738,771111,2018-08-08,Senate,"Be adopted, but first be re-referred to the Committee on [Appropriations]",3,0,2,0,5
1120738,771416,2018-08-13,Senate,"Placed on suspense file",7,0,0,0,7
1120739,759067,2018-06-04,Assembly,"Be adopted. To third reading",8,0,3,0,11
1120739,769796,2018-07-05,Senate,"Assembly 3rd Reading ACR246 Calderon et al. By Monning",35,0,4,0,39
1120740,769731,2018-07-02,Assembly,"Be adopted. To third reading",2,5,3,0,10
1121002,764511,2018-06-18,Assembly,"Be adopted. To third reading",7,0,4,0,11
1121002,771436,2018-08-13,Senate,"Special Consent ACR248",37,0,3,0,40
1121003,763569,2018-06-14,Assembly,"Be adopted. To third reading",7,0,4,0,11
1121003,771439,2018-08-13,Senate,"Special Consent ACR249",37,0,3,0,40
1121407,772130,2018-08-20,Senate,"Senate 3rd Reading SCR149 Hueso et al",38,0,2,0,40
1121407,772601,2018-08-23,Assembly,"Be adopted. To Consent Calendar",11,0,0,0,11
1121407,773025,2018-08-27,Assembly,"SCR 149 Hueso Consent Calendar Second Day Regular Session",80,0,0,0,80
1121419,763543,2018-06-14,Assembly,"Be adopted. To third reading",7,0,4,0,11
1121441,767048,2018-06-21,Senate,"Senate 3rd Reading SCR151 Pan",33,2,4,0,39
1121441,771217,2018-08-09,Assembly,"Be adopted. To third reading",7,1,3,0,11
1121441,772638,2018-08-23,Assembly,"SCR 151 Pan Senate Third Reading By MCCARTY",56,15,9,0,80
1121584,763456,2018-06-14,Assembly,"Be adopted. To third reading",7,0,4,0,11
1121584,769795,2018-07-05,Senate,"Assembly 3rd Reading ACR251 Gloria et al. By Pan",35,0,4,0,39
1121608,767945,2018-06-25,Assembly,"Be adopted. To Consent Calendar",13,0,1,0,14
1121608,769215,2018-06-28,Assembly,"ACR 250 HOLDEN Consent Calendar Second Day Regular Session",75,0,5,0,80
1121608,771456,2018-08-14,Senate,"Be adopted, but first be re-referred to the Committee on [Appropriations]",13,0,0,0,13
1121608,773582,2018-08-29,Senate,"Assembly 3rd Reading ACR250 Holden By Portantino",39,0,1,0,40
1121608,773710,2018-08-30,Assembly,"ACR 250 HOLDEN Concurrence in Senate Amendments",79,0,1,0,80
1121805,766870,2018-06-21,Assembly,"Be adopted. To third reading",9,0,2,0,11
1121805,772723,2018-08-24,Senate,"Special Consent ACR252",39,0,1,0,40
1121810,771451,2018-08-14,Assembly,"Be adopted. To third reading",7,0,2,0,9
1121810,772231,2018-08-20,Assembly,"AJR 42 KAMLAGER-DOVE Assembly Third Reading",56,15,9,0,80
1121810,773190,2018-08-28,Senate,"Assembly 3rd Reading AJR42 Kamlager-Dove et al. By Leyva",25,11,4,0,40
1121815,767092,2018-06-21,Senate,"Senate 3rd Reading SCR152 Lara et al",37,0,2,0,39
1121815,769529,2018-07-02,Assembly,"Be adopted. To Consent Calendar",9,0,2,0,11
1121815,769759,2018-07-05,Assembly,"SCR 152 Lara Consent Calendar Second Day Regular Session",69,0,11,0,80
1122023,771201,2018-08-09,Assembly,"Be adopted. To third reading",10,0,1,0,11
1122305,771461,2018-08-14,Assembly,"Be adopted. To third reading",8,0,1,0,9
1122318,771487,2018-08-15,Senate,"Be adopted. Ordered to third reading",2,3,2,0,7
1122318,771488,2018-08-15,Senate,"[08-15-2018] hearing: Motion to Reconsider. [Reconsideration Granted.]",7,0,0,0,7
1122469,768321,2018-06-26,Senate,"Be adopted. Ordered to third reading",4,0,3,0,7
1122469,769549,2018-07-02,Senate,"Senate 3rd Reading SR114 De León et al",31,1,7,0,39
1122484,769310,2018-06-28,Assembly,"Be adopted. To third reading",9,0,2,0,11
1122499,771214,2018-08-09,Assembly,"Be adopted. To third reading",10,0,1,0,11
1122499,773835,2018-08-30,Senate,"Assembly 3rd Reading ACR255 Harper et al. By Moorlach",39,0,1,0,40
1122727,771205,2018-08-09,Assembly,"Be adopted. To third reading",10,0,1,0,11
1122727,772594,2018-08-23,Senate,"Assembly 3rd Reading ACR258 Gloria et al. By Wiener",39,0,1,0,40
1122729,771174,2018-08-09,Senate,"Senate 3rd Reading SCR154 Fuller et al",37,0,2,0,39
1122729,772634,2018-08-23,Assembly,"Be adopted. To Consent Calendar",11,0,0,0,11
1122729,773006,2018-08-27,Assembly,"SCR 154 Fuller Consent Calendar Second Day Regular Session",80,0,0,0,80
1122731,771160,2018-08-09,Assembly,"Be adopted. To third reading",10,0,1,0,11
1122733,767163,2018-06-21,Assembly,"Be adopted. To third reading",9,0,2,0,11
1122733,772725,2018-08-24,Senate,"Special Consent ACR257",39,0,1,0,40
1122735,773246,2018-08-28,Assembly,"Be adopted. To third reading",6,1,0,0,7
1122735,773903,2018-08-30,Assembly,"AJR 43 BLOOM Assembly Third Reading",58,16,6,0,80
1122737,769213,2018-06-28,Assembly,"Be adopted. To third reading",9,0,2,0,11
1122737,772416,2018-08-21,Senate,"Assembly 3rd Reading ACR256 Reyes et al. By Morrell",39,0,1,0,40
1122739,771782,2018-08-16,Senate,"Senate 3rd Reading SCR153 Fuller",38,0,2,0,40
1122739,772707,2018-08-24,Assembly,"Be adopted. To Consent Calendar",10,0,1,0,11
1122739,773152,2018-08-28,Assembly,"SCR 153 Fuller Consent Calendar Second Day Regular Session",80,0,0,0,80
1122861,769617,2018-07-02,Assembly,"Be adopted. To third reading",9,0,2,0,11
1122861,772716,2018-08-24,Senate,"Special Consent ACR259",39,0,1,0,40
1122880,770901,2018-08-06,Senate,"Senate 3rd Reading SR115 Bates et al",37,0,2,0,39
1122989,773048,2018-08-27,Assembly,"Be adopted as amended. To Consent Calendar",5,0,2,0,7
1122989,773825,2018-08-30,Assembly,"AJR 44 LOW Consent Calendar Second Day Regular Session",75,1,4,0,80
1122998,770907,2018-08-06,Senate,"Senate 3rd Reading SCR156 Hertzberg et al",37,0,2,0,39
1122998,771934,2018-08-16,Assembly,"Be adopted. To Consent Calendar",9,0,2,0,11
1122998,772482,2018-08-23,Assembly,"SCR 156 Hertzberg Consent Calendar Second Day Regular Session",75,0,5,0,80
1123008,771458,2018-08-14,Assembly,"Be adopted as amended",7,0,2,0,9
1123008,773164,2018-08-28,Senate,"Assembly 3rd Reading ACR260 Low et al. By Wiener",29,7,4,0,40
1123018,769583,2018-07-02,Senate,"Senate 3rd Reading SCR155 Mitchell et al",37,0,2,0,39
1123018,771207,2018-08-09,Assembly,"Be adopted. To Consent Calendar",10,0,1,0,11
1123018,771901,2018-08-16,Assembly,"SCR 155 Mitchell Consent Calendar Second Day Regular Session",76,0,4,0,80
1123029,771417,2018-08-13,Senate,"Senate 3rd Reading SR116 Allen et al",36,0,4,0,40
1123092,772637,2018-08-23,Senate,"Senate 3rd Reading SR117 Leyva et al",39,0,1,0,40
1123102,770979,2018-08-07,Senate,"Be adopted as amended, and be ordered to the Consent Calendar",7,0,0,0,7
1123102,771950,2018-08-16,Senate,"Consent Calendar SCR157 Portantino et al",39,0,1,0,40
1123102,773265,2018-08-29,Assembly,"Be adopted. To Consent Calendar",7,0,0,0,7
1123102,774140,2018-08-31,Assembly,"SCR 157 Portantino Consent Calendar Second Day Regular Session",79,0,1,0,80
1123113,769566,2018-07-02,Assembly,"AJR 46 GONZALEZ FLETCHER Assembly Third Reading",66,0,14,0,80
1123113,771465,2018-08-14,Senate,"Be adopted. Ordered to third reading",5,0,2,0,7
1123113,772949,2018-08-27,Senate,"Assembly 3rd Reading AJR46 Gonzalez Fletcher et al. By Hueso",30,4,6,0,40
1123113,773562,2018-08-29,Assembly,"AJR 46 GONZALEZ FLETCHER Concurrence in Senate Amendments",64,0,16,0,80
1123124,769636,2018-07-02,Assembly,"Be adopted. To third reading",9,0,2,0,11
1123124,769807,2018-07-05,Assembly,"AJR 45 CHOI Assembly Third Reading",67,0,13,0,80
1123385,770951,2018-08-06,Assembly,"Be adopted. To third reading",9,0,2,0,11
1123385,774204,2018-08-31,Senate,"Assembly 3rd Reading ACR261 Kalra et al. By Delgado",39,0,1,0,40
1123401,769625,2018-07-02,Assembly,"Be adopted. To third reading",9,0,2,0,11
1123401,772719,2018-08-24,Senate,"Special Consent ACR262",39,0,1,0,40
1123563,772555,2018-08-23,Assembly,"Be adopted. To Consent Calendar",13,0,1,0,14
1123563,772950,2018-08-27,Assembly,"ACR 263 RIVAS Consent Calendar Second Day Regular Session",80,0,0,0,80
1123563,773888,2018-08-30,Senate,"Be adopted, but first be re-referred to the Committee on [Appropriations] with recommendation: To Consent Calendar",13,0,0,0,13
1123563,774221,2018-08-31,Senate,"Assembly 3rd Reading ACR263 Rivas By Portantino",38,0,2,0,40
1123573,770813,2018-08-06,Assembly,"Be adopted. To third reading",9,0,2,0,11
1123583,770493,2018-08-06,Assembly,"Be adopted. To third reading",9,0,2,0,11
1123981,771671,2018-08-16,Senate,"Senate 3rd Reading SR119 Fuller",38,0,2,0,40
1123982,772395,2018-08-20,Assembly,"Be adopted and re-referred to the Committee on [Appropriations]",8,1,0,0,9
1123982,772998,2018-08-27,Assembly,"Be adopted. To third reading",12,2,3,0,17
1123982,773940,2018-08-30,Assembly,"AJR 47 BLOOM Assembly Third Reading",67,4,9,0,80
1123983,771921,2018-08-16,Senate,"Senate 3rd Reading SCR158 Fuller",38,0,2,0,40
1123983,772700,2018-08-24,Assembly,"Be adopted. To Consent Calendar",10,0,1,0,11
1123983,773134,2018-08-28,Assembly,"SCR 158 Fuller Consent Calendar Second Day Regular Session",80,0,0,0,80
1123994,771181,2018-08-09,Assembly,"Be adopted. To third reading",10,0,1,0,11
1123994,772718,2018-08-24,Senate,"Special Consent ACR264",39,0,1,0,40
1123999,771165,2018-08-09,Assembly,"Be adopted. To third reading",10,0,1,0,11
1124003,770866,2018-08-06,Assembly,"Be adopted. To third reading",9,0,2,0,11
1124003,772999,2018-08-27,Senate,"Assembly 3rd Reading ACR265 Berman et al. By Allen",39,0,1,0,40
1124041,771398,2018-08-13,Assembly,"Be adopted. To third reading",10,0,1,0,11
1124041,772296,2018-08-20,Assembly,"AJR 48 LIMÓN Assembly Third Reading",64,6,10,0,80
1124041,773163,2018-08-28,Senate,"Assembly 3rd Reading AJR48 Limón et al. By Mitchell",30,4,6,0,40
1124042,771198,2018-08-09,Assembly,"Be adopted. To third reading",10,0,1,0,11
1124042,772284,2018-08-20,Senate,"Assembly 3rd Reading ACR266 Rubio et al. By Wiener",39,0,1,0,40
1124043,771432,2018-08-13,Assembly,"Be adopted. To third reading",10,0,1,0,11
1124043,773348,2018-08-29,Senate,"Assembly 3rd Reading ACR267 Kalra et al. By Wieckowski",39,0,1,0,40
1124044,771510,2018-08-15,Assembly,"Be adopted and re-referred to the Committee on [Appropriations]",6,0,1,0,7
1124044,772991,2018-08-27,Assembly,"Be adopted. To Consent Calendar",16,0,1,0,17
1124044,773294,2018-08-29,Assembly,"ACR 268 THURMOND Consent Calendar Second Day Regular Session",78,0,2,0,80
1124044,774253,2018-08-31,Senate,"Assembly 3rd Reading ACR268 Thurmond et al. By Hill",34,0,6,0,40
1125332,771170,2018-08-09,Senate,"Senate 3rd Reading SCR161 Wiener et al",36,0,3,0,39
1125332,771524,2018-08-16,Assembly,"Be adopted. To Consent Calendar",9,0,2,0,11
1125332,772490,2018-08-23,Assembly,"SCR 161 Wiener Consent Calendar Second Day Regular Session",75,0,5,0,80
1125333,771452,2018-08-14,Senate,"Be adopted, but first be re-referred to the Committee on [Appropriations]",12,0,1,0,13
1125333,772403,2018-08-21,Senate,"Senate 3rd Reading SCR159 Bates et al",39,0,1,0,40
1125333,772677,2018-08-24,Assembly,"Be adopted. To Consent Calendar",12,0,2,0,14
1125333,773122,2018-08-28,Assembly,"SCR 159 Bates Consent Calendar Second Day Regular Session",80,0,0,0,80
1125334,771202,2018-08-09,Assembly,"Be adopted. To third reading",10,0,1,0,11
1125335,771203,2018-08-09,Assembly,"Be adopted. To third reading",10,0,1,0,11
1125335,773126,2018-08-28,Senate,"Assembly 3rd Reading ACR269 Choi et al. By Vidak",39,0,1,0,40
1125336,771958,2018-08-16,Assembly,"Be adopted. To third reading",9,0,2,0,11
1125336,773166,2018-08-28,Senate,"Assembly 3rd Reading ACR273 Waldron et al. By Leyva",38,0,2,0,40
1125337,771948,2018-08-16,Assembly,"Be adopted. To third reading",9,0,2,0,11
1125337,773794,2018-08-30,Senate,"Assembly 3rd Reading ACR271 Acosta et al. By McGuire",39,0,1,0,40
1125338,772136,2018-08-20,Assembly,"Be adopted. To third reading",9,0,2,0,11
1125338,773824,2018-08-30,Senate,"Assembly 3rd Reading ACR274 Gabriel By Pan",39,0,1,0,40
1125340,771916,2018-08-16,Senate,"Senate 3rd Reading SCR160 McGuire et al",38,0,2,0,40
1125340,772685,2018-08-24,Assembly,"Be adopted. To Consent Calendar",10,0,1,0,11
1125340,773093,2018-08-28,Assembly,"SCR 160 McGuire Consent Calendar Second Day Regular Session",80,0,0,0,80
1125341,772390,2018-08-20,Assembly,"Be adopted as amended",7,1,1,0,9
1125341,773909,2018-08-30,Assembly,"AJR 50 REYES Assembly Third Reading",62,8,10,0,80
1125342,771338,2018-08-13,Senate,"Senate 3rd Reading SR120 Pan",31,3,6,0,40
1125344,771468,2018-08-14,Senate,"Be adopted. Ordered to third reading",5,0,2,0,7
1125344,771554,2018-08-16,Senate,"Senate 3rd Reading SJR29 Pan et al",29,3,8,0,40
1125344,773079,2018-08-28,Assembly,"Be adopted. To third reading",7,0,2,0,9
1125344,774184,2018-08-31,Assembly,"SJR 29 Pan Senate Third Reading By CARRILLO",59,0,21,0,80
1125345,771527,2018-08-16,Assembly,"Be adopted. To third reading",9,0,2,0,11
1125345,773382,2018-08-29,Senate,"Assembly 3rd Reading ACR270 Acosta et al. By Jackson",39,0,1,0,40
1125346,771172,2018-08-09,Senate,"Senate 3rd Reading SR121 Hertzberg et al",36,0,3,0,39
1125353,771298,2018-08-13,Senate,"Senate 3rd Reading SCR163 Portantino",35,0,5,0,40
1125353,772546,2018-08-23,Assembly,"Be adopted. To Consent Calendar",11,0,0,0,11
1125353,772930,2018-08-27,Assembly,"SCR 163 Portantino Consent Calendar Second Day Regular Session",80,0,0,0,80
1125354,772605,2018-08-23,Assembly,"Be adopted. To third reading",7,4,0,0,11
1125354,773938,2018-08-30,Assembly,"AJR 51 COOPER Assembly Third Reading",55,15,10,0,80
1125356,772486,2018-08-23,Assembly,"Be adopted as amended",13,0,1,0,14
1125358,771909,2018-08-16,Assembly,"Be adopted. To third reading",9,0,2,0,11
1125360,771377,2018-08-13,Senate,"Senate 3rd Reading SCR164 Portantino",35,0,5,0,40
1125360,772608,2018-08-23,Assembly,"Be adopted. To Consent Calendar",11,0,0,0,11
1125360,773035,2018-08-27,Assembly,"SCR 164 Portantino Consent Calendar Second Day Regular Session",80,0,0,0,80
1125369,771960,2018-08-16,Assembly,"Be adopted. To third reading",9,0,2,0,11
1125370,771905,2018-08-16,Assembly,"Be adopted. To third reading",9,0,2,0,11
1125371,771517,2018-08-16,Senate,"Senate 3rd Reading SCR165 Lara et al",38,0,2,0,40
1125371,772665,2018-08-24,Assembly,"Be adopted. To Consent Calendar",10,0,1,0,11
1125371,773180,2018-08-28,Assembly,"SCR 165 Lara Consent Calendar Second Day Regular Session",80,0,0,0,80
1125372,771898,2018-08-16,Assembly,"Be adopted. To third reading",9,0,2,0,11
1125372,773799,2018-08-30,Senate,"Assembly 3rd Reading ACR277 Medina et al. By Pan",39,0,1,0,40
1125373,772529,2018-08-23,Senate,"Senate 3rd Reading SR122 Hertzberg et al",39,0,1,0,40
1125393,772209,2018-08-20,Senate,"Senate 3rd Reading SJR30 McGuire et al",33,0,7,0,40
1125393,772612,2018-08-23,Assembly,"Be adopted. To Consent Calendar",13,0,1,0,14
1125393,773525,2018-08-29,Assembly,"SJR 30 McGuire Senate Third Reading By FRIEDMAN",72,0,8,0,80
1125394,771646,2018-08-16,Assembly,"Be adopted. To third reading",9,0,2,0,11
1125394,773133,2018-08-28,Senate,"Assembly 3rd Reading ACR278 Arambula et al. By Pan",39,0,1,0,40
1125424,772558,2018-08-23,Assembly,"Be adopted. To Consent Calendar",11,0,0,0,11
1125424,773040,2018-08-27,Assembly,"ACR 279 KALRA Consent Calendar Second Day",80,0,0,0,80
1125424,773716,2018-08-30,Senate,"Assembly 3rd Reading ACR279 Kalra et al. By Lara",39,0,1,0,40
1125442,772621,2018-08-23,Assembly,"Be adopted. To Consent Calendar",11,0,0,0,11
1125442,772974,2018-08-27,Assembly,"ACR 282 GLORIA Consent Calendar Second Day Regular Session",80,0,0,0,80
1125442,773833,2018-08-30,Senate,"Assembly 3rd Reading ACR282 Gloria et al. By Pan",39,0,1,0,40
1125444,772516,2018-08-23,Assembly,"Be adopted. To Consent Calendar",11,0,0,0,11
1125444,772887,2018-08-27,Assembly,"ACR 281 CHOI Consent Calendar Second Day Regular Session",80,0,0,0,80
1125444,774173,2018-08-31,Senate,"Assembly 3rd Reading ACR281 Choi et al. By Chang",39,0,1,0,40
1125481,772514,2018-08-23,Assembly,"Be adopted. To Consent Calendar",11,0,0,0,11
1125481,772898,2018-08-27,Assembly,"ACR 283 COOLEY Consent Calendar Second Day Regular Session",80,0,0,0,80
1125481,773696,2018-08-30,Senate,"Assembly 3rd Reading ACR283 Cooley By Gaines",38,0,2,0,40
1125483,772453,2018-08-22,Senate,"Senate 3rd Reading SCR166 Dodd et al",37,0,3,0,40
1125483,772948,2018-08-27,Assembly,"Be adopted. To Consent Calendar",10,0,1,0,11
1125483,773495,2018-08-29,Assembly,"SCR 166 Dodd Consent Calendar Second Day Regular Session",78,0,2,0,80
1125505,773014,2018-08-27,Assembly,"Be adopted as amended. To Consent Calendar",10,0,1,0,11
1125505,773734,2018-08-30,Assembly,"AJR 52 KALRA Consent Calendar Second Day",78,0,2,0,80
1125508,772445,2018-08-22,Senate,"Senate 3rd Reading SR123 Dodd et al",38,0,2,0,40
1125512,772473,2018-08-22,Senate,"Senate 3rd Reading SR124 Pan",39,0,1,0,40
1125529,772609,2018-08-23,Assembly,"Be adopted. To Consent Calendar",11,0,0,0,11
1125529,773030,2018-08-27,Assembly,"ACR 284 THURMOND Consent Calendar Second Day Regular Session",80,0,0,0,80
1125529,773936,2018-08-30,Senate,"Assembly 3rd Reading ACR284 Thurmond By Jackson",39,0,1,0,40
1125530,772715,2018-08-24,Assembly,"Be adopted. To Consent Calendar",10,0,1,0,11
1125530,773123,2018-08-28,Assembly,"ACR 285 GONZALEZ FLETCHER Consent Calendar Second Day",80,0,0,0,80
1125530,773715,2018-08-30,Senate,"Assembly 3rd Reading ACR285 Gonzalez Fletcher et al. By Nguyen",39,0,1,0,40
1125555,772969,2018-08-27,Assembly,"Be adopted. To Consent Calendar",10,0,1,0,11
1125555,773673,2018-08-29,Assembly,"ACR 286 KAMLAGER-DOVE Consent Calendar Second Day",78,0,2,0,80
1125555,773993,2018-08-31,Senate,"Assembly 3rd Reading ACR286 Kamlager-Dove By Mitchell",39,0,1,0,40
1125766,773908,2018-08-30,Senate,"Senate 3rd Reading SR125 Lara et al",35,0,5,0,40
1125795,774148,2018-08-31,Senate,"Senate 3rd Reading SR126 Wiener et al",36,0,4,0,40
