bill_id,roll_call_id,date,chamber,description,yea,nay,nv,absent,total
1131476,779481,2018-12-03,Assembly,"HR 1 COOLEY",59,20,1,0,80
1131590,779483,2018-12-03,Assembly,"HR 3 RENDON By CALDERON",79,0,1,0,80
1131709,779482,2018-12-03,Assembly,"HR 2 RENDON By CALDERON",79,0,1,0,80
1131832,779484,2018-12-03,Assembly,"SCR 2 Roth By CALDERON",79,0,1,0,80
1131832,779486,2018-12-03,Senate,"W/O REF. TO FILE SCR2 Roth",40,0,0,0,40
1131846,779485,2018-12-03,Senate,"W/O REF. TO FILE SCR1 Wilk",39,0,1,0,40
1131873,788332,2019-01-29,Assembly,"Do pass as amended",28,0,4,0,32
1131873,792405,2019-02-04,Assembly,"AB 73 BUDGET Assembly Third Reading By TING",74,0,6,0,80
1131873,795564,2019-02-07,Senate,"Do pass",15,0,3,0,18
1131873,797409,2019-02-11,Senate,"Assembly 3rd Reading AB73 BUDGET (Ting) By Mitchell",37,0,1,0,38
1131874,836941,2019-04-03,Assembly,"Do pass and be re-referred to the Committee on [Appropriations]",20,0,1,0,21
1131874,866391,2019-05-16,Assembly,"Do pass",18,0,0,0,18
1131874,871637,2019-05-23,Assembly,"AB 41 Gallagher Third Reading Urgency",78,0,2,0,80
1131874,887753,2019-06-25,Senate,"Do pass, but first be re-referred to the Committee on [Appropriations]",16,0,0,0,16
1131874,891984,2019-08-12,Senate,"Placed on suspense file",7,0,0,0,7
1131875,902832,2020-01-14,Assembly,"Do pass and be re-referred to the Committee on [Appropriations]",11,0,1,0,12
1131875,905369,2020-01-23,Assembly,"Do pass",18,0,0,0,18
1131875,906429,2020-01-27,Assembly,"AB 70 Berman Assembly Third Reading",78,0,2,0,80
1131875,975364,2020-08-08,Senate,"Do pass, but first be re-referred to the Committee on [Appropriations]",4,3,2,0,9
1131875,975365,2020-08-08,Senate,"[First] hearing set for [08-10-2020]: Failed passage in Committee. Reconsideration granted",9,0,0,0,9
1131875,975366,2020-08-08,Senate,"Amendments (Committee's)",8,0,1,0,9
1131875,976162,2020-08-19,Senate,"Placed on suspense file",7,0,0,0,7
1131875,976314,2020-08-20,Senate,"Do pass as amended",7,0,0,0,7
1131875,977349,2020-08-28,Senate,"Assembly 3rd Reading AB70 Berman et al. By Hill",39,0,1,0,40
1131875,978109,2020-08-30,Assembly,"AB 70 Berman Concurrence in Senate Amendments",75,0,4,0,79
1131876,809349,2019-02-26,Assembly,"Do pass",4,3,1,0,8
1131876,809350,2019-02-26,Assembly,Reconsideration,8,0,0,0,8
1131876,851683,2019-04-23,Assembly,"Do pass",6,2,0,0,8
1131876,859548,2019-05-06,Assembly,"AB 61 Ting Assembly Third Reading",54,17,9,0,80
1131876,883969,2019-06-18,Senate,"Do pass as amended, but first amend, and re-refer to the Committee on [Appropriations]",5,2,0,0,7
1131876,890946,2019-07-08,Senate,"Placed on suspense file",7,0,0,0,7
1131876,890947,2019-08-30,Senate,"Do pass as amended",5,2,0,0,7
1131876,890948,2019-09-04,Senate,"Assembly 3rd Reading AB61 Ting et al. By Skinner",30,10,0,0,40
1131876,890949,2019-09-09,Assembly,"AB 61 Ting Concurrence in Senate Amendments",57,18,4,0,79
1131877,842721,2019-04-11,Assembly,"AB 104 Ting Assembly Third Reading",54,13,13,0,80
1131877,881112,2019-06-12,Senate,"Do pass",11,1,6,0,18
1131880,903137,2020-01-15,Assembly,"Do pass as amended and be re-referred to the Committee on [Appropriations]",6,0,2,0,8
1131883,839865,2019-04-09,Senate,"Do pass, but first be re-referred to the Committee on [Appropriations]",6,1,0,0,7
1131883,854359,2019-04-29,Senate,"Placed on suspense file",6,0,0,0,6
1131883,865521,2019-05-16,Senate,"Do pass as amended",4,2,0,0,6
1131883,871119,2019-05-23,Senate,"Senate 3rd Reading SB42 Skinner",35,3,0,0,38
1131883,887591,2019-06-25,Assembly,"Do pass as amended and be re-referred to the Committee on [Appropriations]",7,0,1,0,8
1131883,891679,2019-08-30,Assembly,"Do pass as amended",13,0,5,0,18
1131883,891680,2019-09-10,Assembly,"SB 42 Skinner Senate Third Reading By Eggman",65,1,13,0,79
1131883,891681,2019-09-11,Senate,"Unfinished Business SB42 Skinner et al. Concurrence",35,4,1,0,40
1131884,841345,2019-04-09,Assembly,"Do pass and be re-referred to the Committee on [Appropriations]",11,3,1,0,15
1131884,866259,2019-05-16,Assembly,"Do pass as amended",11,4,3,0,18
1131884,873932,2019-05-28,Assembly,"AB 4 Arambula Assembly Third Reading",51,17,12,0,80
1131885,826035,2019-03-20,Assembly,"Do pass as amended and be re-referred to the Committee on [Appropriations]",5,2,0,0,7
1131885,865887,2019-05-16,Assembly,"Do pass",12,5,1,0,18
1131885,874143,2019-05-28,Assembly,"AB 35 Kalra Assembly Third Reading",49,22,9,0,80
1131885,888150,2019-06-26,Senate,"Do pass, but first be re-referred to the Committee on [Labor, Public Employment and Retirement ]",7,2,0,0,9
1131885,890493,2019-07-10,Senate,"Do pass, but first be re-referred to the Committee on [Appropriations]",4,1,0,0,5
1131885,890494,2019-08-12,Senate,"Placed on suspense file",7,0,0,0,7
1131885,890495,2019-08-30,Senate,"Do pass",5,2,0,0,7
1131885,890496,2019-09-09,Senate,"Assembly 3rd Reading AB35 Kalra et al. By Leyva",27,12,1,0,40
1131885,890497,2019-09-10,Assembly,"AB 35 Kalra Concurrence in Senate Amendments",51,22,6,0,79
1131886,842774,2019-04-11,Assembly,"AB 100 Ting Assembly Third Reading",54,13,13,0,80
1131886,886974,2019-06-24,Senate,"Do pass",16,1,1,0,18
1131886,969421,2020-06-26,Assembly,"AB 100 BUDGET Concurrence in Senate Amendments By TING",75,0,4,0,79
1131886,969745,2020-06-24,Senate,"Do pass",16,1,1,0,18
1131886,969746,2020-06-25,Senate,"Assembly 3rd Reading AB100 BUDGET (Ting)",40,0,0,0,40
1131888,788175,2019-01-29,Assembly,"Do pass as amended",28,0,4,0,32
1131888,792124,2019-02-04,Assembly,"AB 72 BUDGET Assembly Third Reading By TING",74,0,6,0,80
1131888,795398,2019-02-07,Senate,"Do pass",15,0,3,0,18
1131888,797248,2019-02-11,Senate,"Assembly 3rd Reading AB72 BUDGET (Ting) By Mitchell",37,0,1,0,38
1131889,842896,2019-04-10,Assembly,"Do pass and be re-referred to the Committee on [Appropriations]",5,1,0,0,6
1131889,865655,2019-05-16,Assembly,"Do pass",17,1,0,0,18
1131889,870040,2019-05-22,Assembly,"AB 39 Muratsuchi Assembly Third Reading",74,0,6,0,80
1131889,881088,2019-06-12,Senate,"Do pass, but first be re-referred to the Committee on [Appropriations]",7,0,0,0,7
1131889,887020,2019-06-24,Senate,"Placed on suspense file",7,0,0,0,7
1131889,893058,2019-08-30,Senate,"Do pass as amended",7,0,0,0,7
1131889,895249,2019-05-22,Assembly,05/16/19,17,0,0,0,17
1131890,831629,2019-03-27,Assembly,"Be adopted and re-referred to the Committee on [Appropriations]",5,2,1,0,8
1131890,866144,2019-05-16,Assembly,"Be adopted",11,7,0,0,18
1131890,892772,2019-08-19,Assembly,"ACA 1 Aguiar-Curry Assembly Third Reading",44,20,15,0,79
1131891,860710,2019-05-06,Assembly,"Do pass and be re-referred to the Committee on [Appropriations]",11,0,0,0,11
1131891,905372,2020-01-23,Assembly,"Do pass",18,0,0,0,18
1131891,906373,2020-01-27,Assembly,"AB 66 Gonzalez Assembly Third Reading",78,0,2,0,80
1131891,974988,2020-08-07,Senate,"Do pass, but first be re-referred to the Committee on [Appropriations]",5,1,1,0,7
1131891,975989,2020-08-17,Senate,"Placed on suspense file",7,0,0,0,7
1131891,976398,2020-08-20,Senate,"Do pass as amended",5,2,0,0,7
1131892,903139,2020-01-15,Senate,"Do pass as amended, but first amend, and re-refer to the Committee on [Rules]",4,2,1,0,7
1131893,842939,2019-04-11,Assembly,"AB 109 Ting Assembly Third Reading",54,13,13,0,80
1131893,891906,2019-09-10,Senate,"Do pass",13,4,1,0,18
1131894,826063,2019-03-19,Assembly,"Do pass and be re-referred to the Committee on [Appropriations]",11,1,0,0,12
1131894,866453,2019-05-16,Assembly,"Do pass as amended",14,4,0,0,18
1131894,874582,2019-05-29,Assembly,"AB 2 Santiago Assembly Third Reading",72,0,8,0,80
1131894,893068,2019-07-10,Senate,"Do pass, but first be re-referred to the Committee on [Appropriations]",7,0,0,0,7
1131894,893069,2019-08-12,Senate,"Placed on suspense file",7,0,0,0,7
1131894,893070,2019-08-30,Senate,"Do pass as amended",7,0,0,0,7
1131894,893071,2019-09-09,Senate,"Assembly 3rd Reading AB2 Santiago et al. By Portantino",40,0,0,0,40
1131894,893072,2019-09-10,Assembly,"AB 2 Santiago Concurrence in Senate Amendments",77,0,2,0,79
1131895,809162,2019-02-26,Assembly,"Do pass and be re-referred to the Committee on [Judiciary]",8,0,0,0,8
1131895,820070,2019-03-12,Assembly,"Do pass and be re-referred to the Committee on [Appropriations]",11,0,1,0,12
1131895,826036,2019-03-20,Assembly,"Do pass",12,0,6,0,18
1131895,827986,2019-03-25,Assembly,"AB 54 Ting Third Reading Urgency",65,6,9,0,80
1131895,877591,2019-06-04,Senate,"Do pass, but first be re-referred to the Committee on [Public Safety]",7,0,2,0,9
1131895,880571,2019-06-11,Senate,"Do pass, but first be re-referred to the Committee on [Appropriations]",6,1,0,0,7
1131895,892824,2019-09-11,Senate,"Do pass, but first be re-referred to the Committee on [Appropriations]",7,0,0,0,7
1131895,893630,2019-09-12,Senate,"Do pass",7,0,0,0,7
1131895,893923,2019-09-14,Assembly,"AB 54 Ting Concurrence in Senate Amendments",77,0,2,0,79
1131895,894204,2019-09-13,Senate,"Assembly 3rd Reading AB54 Ting et al. By Skinner Urgency Clause",40,0,0,0,40
1131896,853162,2019-04-24,Assembly,"Do pass and be re-referred to the Committee on [Appropriations]",8,0,0,0,8
1131896,865999,2019-05-16,Assembly,"Do pass as amended",16,1,1,0,18
1131896,871176,2019-05-23,Assembly,"AB 67 Luz Rivas Assembly Third Reading",70,4,6,0,80
1131896,892532,2019-07-02,Senate,"Do pass as amended, but first amend, and re-refer to the Committee on [Appropriations]",8,2,1,0,11
1131896,892533,2019-08-12,Senate,"Placed on suspense file",7,0,0,0,7
1131897,842980,2019-04-11,Assembly,"AB 99 Ting Assembly Third Reading",54,13,13,0,80
1131898,816319,2019-03-06,Assembly,"Do pass and be re-referred to the Committee on [Appropriations]",5,0,2,0,7
1131898,865737,2019-05-16,Assembly,"Do pass",13,2,3,0,18
1131898,871400,2019-05-23,Assembly,"AB 9 Reyes Assembly Third Reading",53,5,22,0,80
1131898,890533,2019-07-09,Senate,"Do pass as amended, but first amend, and re-refer to the Committee on [Appropriations]",7,1,1,0,9
1131898,890534,2019-08-12,Senate,"Placed on suspense file",7,0,0,0,7
1131898,890535,2019-08-30,Senate,"Do pass",5,1,1,0,7
1131898,890536,2019-09-04,Senate,"Assembly 3rd Reading AB9 Reyes et al. By Gonzalez",30,7,3,0,40
1131898,890537,2019-09-09,Assembly,"AB 9 Reyes Concurrence in Senate Amendments",60,5,14,0,79
1131899,902199,2020-01-13,Senate,"Do pass, but first be re-referred to the Committee on [Appropriations]",5,0,0,0,5
1131899,904099,2020-01-21,Senate,"Placed on suspense file",7,0,0,0,7
1131899,905354,2020-01-23,Senate,"Do pass",7,0,0,0,7
1131899,906409,2020-01-27,Senate,"Senate 3rd Reading SB33 Skinner",39,0,0,0,39
1131899,974746,2020-08-03,Assembly,"Do pass as amended, and be re-referred to the Committee on [Appropriations] with recommendation: To Consent Calendar",6,0,2,0,8
1131900,841760,2019-04-10,Senate,"Do pass, but first be re-referred to the Committee on [Housing]",5,1,1,0,7
1131900,850473,2019-04-22,Senate,"Do pass as amended, but first amend, and re-refer to the Committee on [Appropriations]",8,3,0,0,11
1131900,863108,2019-05-13,Senate,"Placed on suspense file",6,0,0,0,6
1131901,834905,2019-04-03,Assembly,"Do pass as amended and be re-referred to the Committee on [Appropriations]",8,0,0,0,8
1131901,865892,2019-05-16,Assembly,"Do pass",18,0,0,0,18
1131901,869957,2019-05-22,Assembly,"AB 69 Ting Assembly Third Reading",78,0,2,0,80
1131901,883798,2019-06-18,Senate,"Do pass as amended, but first amend, and re-refer to the Committee on [Appropriations]",11,0,0,0,11
1131901,889214,2019-07-01,Senate,"Placed on suspense file",7,0,0,0,7
1131901,892947,2019-08-30,Senate,"Do pass",7,0,0,0,7
1131901,974942,2020-08-06,Senate,"Do pass, but first be re-referred to the Committee on [Appropriations]",8,1,2,0,11
1131901,975994,2020-08-17,Senate,"Placed on suspense file",7,0,0,0,7
1131901,976450,2020-08-20,Senate,"Do pass",5,2,0,0,7
1131901,977472,2020-08-31,Assembly,"With recommendation: That Senate amendments be concurred in",6,2,0,0,8
1131901,978161,2020-08-30,Senate,"Assembly 3rd Reading AB69 Ting et al. By Hertzberg",31,7,2,0,40
1131901,978162,2020-08-31,Assembly,"AB 69 TING Concurrence in Senate Amendments",58,12,9,0,79
1131903,842758,2019-04-11,Assembly,"AB 106 Ting Assembly Third Reading",54,13,13,0,80
1131903,974480,2020-07-30,Senate,"Do pass",12,5,1,0,18
1131905,842778,2019-04-11,Assembly,"AB 114 Ting Assembly Third Reading",54,13,13,0,80
1131905,892245,2019-09-10,Senate,"Do pass",12,4,2,0,18
1131905,893666,2019-09-12,Senate,"Assembly 3rd Reading AB114 BUDGET (Ting) By Mitchell",30,10,0,0,40
1131905,893667,2019-09-12,Assembly,"AB 114 BUDGET Concurrence in Senate Amendments By TING",79,0,0,0,79
1131906,823893,2019-03-13,Assembly,"Do pass as amended and be re-referred to the Committee on [Health]",5,0,1,0,6
1131906,849875,2019-04-23,Assembly,"Do pass and be re-referred to the Committee on [Appropriations]",10,1,4,0,15
1131906,865543,2019-05-16,Assembly,"Do pass as amended",13,2,3,0,18
1131906,871421,2019-05-23,Assembly,"AB 8 Chu Assembly Third Reading",62,8,10,0,80
1131906,881083,2019-06-12,Senate,"Do pass, but first be re-referred to the Committee on [Health]",7,0,0,0,7
1131907,842698,2019-04-11,Assembly,"AB 94 Ting Assembly Third Reading",54,13,13,0,80
1131907,881066,2019-06-12,Senate,"Do pass",13,2,3,0,18
1131907,969777,2020-06-24,Senate,"Do pass",13,5,0,0,18
1131907,969778,2020-06-25,Senate,"Assembly 3rd Reading AB94 BUDGET (Ting)",30,10,0,0,40
1131908,834649,2019-03-27,Assembly,"Do pass as amended and be re-referred to the Committee on [Appropriations]",6,0,0,0,6
1131908,866018,2019-05-16,Assembly,"Do pass",18,0,0,0,18
1131908,869781,2019-05-22,Assembly,"AB 16 Luz Rivas Assembly Third Reading",78,0,2,0,80
1131908,892364,2019-07-03,Senate,"Do pass, but first be re-referred to the Committee on [Appropriations] with the recommendation: To Consent Calendar",7,0,0,0,7
1131908,892365,2019-08-12,Senate,"Placed on suspense file",7,0,0,0,7
1131908,892366,2019-08-30,Senate,"Do pass as amended",7,0,0,0,7
1131908,892367,2019-09-05,Senate,"Assembly 3rd Reading AB16 Luz Rivas et al. By Wiener",40,0,0,0,40
1131908,892368,2019-09-09,Assembly,"AB 16 Luz Rivas Concurrence in Senate Amendments",79,0,0,0,79
1131909,841728,2019-04-10,Assembly,"Do pass as amended and be re-referred to the Committee on [Appropriations]",5,1,1,0,7
1131909,864824,2019-05-15,Assembly,"Do pass",14,2,2,0,18
1131909,867834,2019-05-20,Assembly,"AB 59 Kalra Assembly Third Reading",63,10,7,0,80
1131909,891298,2019-07-02,Senate,"Do pass, but first be re-referred to the Committee on [Appropriations]",4,1,0,0,5
1131909,891299,2019-08-12,Senate,"Placed on suspense file",7,0,0,0,7
1131909,891300,2019-08-30,Senate,"Do pass",5,1,1,0,7
1131909,891301,2019-09-09,Senate,"Assembly 3rd Reading AB59 Kalra et al. By Umberg",31,8,1,0,40
1131909,891302,2019-09-10,Assembly,"AB 59 Kalra Concurrence in Senate Amendments",65,11,3,0,79
1131911,819890,2019-03-12,Senate,"Do pass, but first be re-referred to the Committee on [Rules]",13,0,3,0,16
1131911,851480,2019-04-24,Senate,"Do pass as amended, but first amend, and re-refer to the Committee on [Appropriations]",10,2,1,0,13
1131911,863197,2019-05-13,Senate,"Placed on suspense file",6,0,0,0,6
1131912,843017,2019-04-11,Assembly,"AB 90 Ting Assembly Third Reading",54,13,13,0,80
1131912,884773,2019-06-19,Senate,"Do pass",14,0,4,0,18
1131912,969429,2020-06-26,Assembly,"AB 90 BUDGET Concurrence in Senate Amendments By TING",58,17,4,0,79
1131912,969732,2020-06-24,Senate,"Do pass",13,5,0,0,18
1131912,969733,2020-06-25,Senate,"Assembly 3rd Reading AB90 BUDGET (Ting)",29,11,0,0,40
1131914,819949,2019-03-12,Assembly,"Do pass as amended and be re-referred to the Committee on [Judiciary]",10,4,0,0,14
1131914,829322,2019-03-26,Assembly,"Do pass as amended and be re-referred to the Committee on [Appropriations]",9,2,1,0,12
1131914,866061,2019-05-16,Assembly,"Do pass",13,5,0,0,18
1131914,871552,2019-05-23,Assembly,"AB 44 Friedman Assembly Third Reading Amend By FRIEDMAN Set #1",56,20,4,0,80
1131914,873914,2019-05-28,Assembly,"AB 44 Friedman Assembly Third Reading",52,16,12,0,80
1131914,887497,2019-06-25,Senate,"Do pass, but first be re-referred to the Committee on [Judiciary]",5,2,2,0,9
1131914,893486,2019-07-09,Senate,"Do pass, but first be re-referred to the Committee on [Appropriations]",7,1,1,0,9
1131914,893487,2019-08-12,Senate,"Placed on suspense file",7,0,0,0,7
1131914,893488,2019-08-30,Senate,"Do pass as amended",4,1,2,0,7
1131914,893489,2019-09-10,Senate,"Assembly 3rd Reading AB44 Friedman By Jackson",27,8,5,0,40
1131914,893490,2019-09-11,Assembly,"AB 44 Friedman Concurrence in Senate Amendments",55,18,6,0,79
1131915,842920,2019-04-10,Assembly,"Do pass and be re-referred to the Committee on [Higher Education]",5,0,1,0,6
1131915,851550,2019-04-23,Assembly,"Do pass and be re-referred to the Committee on [Appropriations]",9,0,3,0,12
1131915,865530,2019-05-16,Assembly,"Do pass as amended",14,0,4,0,18
1131915,872205,2019-05-24,Assembly,"AB 48 O'Donnell Assembly Third Reading",69,1,10,0,80
1131915,884566,2019-06-19,Senate,"Do pass, but first be re-referred to the Committee on [Governance and Finance]",7,0,0,0,7
1131915,892083,2019-07-03,Senate,"Do pass as amended, but first amend, and re-refer to the Committee on [Appropriations]",6,1,0,0,7
1131915,892084,2019-08-19,Senate,"Placed on suspense file",5,0,2,0,7
1131915,892085,2019-08-30,Senate,"Do pass, but first be re-referred to the Committee on [Rules]",5,1,1,0,7
1131915,893646,2019-09-12,Senate,"That the measure be returned to Senate Floor for consideration. Ordered to third reading",6,0,1,0,7
1131915,893921,2019-09-13,Assembly,"With recommendation: That Senate amendments be concurred in",11,0,1,0,12
1131915,893922,2019-09-14,Assembly,"AB 48 O'Donnell Concurrence in Senate Amendments",78,1,0,0,79
1131915,894208,2019-09-13,Senate,"Assembly 3rd Reading AB48 O'Donnell et al",35,4,1,0,40
1131916,816454,2019-03-06,Assembly,"Do pass and be re-referred to the Committee on [Judiciary]",5,1,1,0,7
1131916,825070,2019-03-19,Assembly,"Do pass as amended and be re-referred to the Committee on [Appropriations]",9,3,0,0,12
1131916,865708,2019-05-16,Assembly,"Do pass",13,5,0,0,18
1131916,870177,2019-05-22,Assembly,"AB 51 Gonzalez Assembly Third Reading",47,20,13,0,80
1131916,884873,2019-06-19,Senate,"Do pass, but first be re-referred to the Committee on [Judiciary]",4,1,0,0,5
1131916,892428,2019-07-09,Senate,"Do pass, but first be re-referred to the Committee on [Appropriations]",7,1,1,0,9
1131916,892429,2019-08-12,Senate,"Placed on suspense file",7,0,0,0,7
1131916,892430,2019-08-30,Senate,"Do pass",5,2,0,0,7
1131916,892431,2019-09-05,Senate,"Assembly 3rd Reading AB51 Gonzalez By Jackson",26,11,3,0,40
1131916,893852,2019-09-05,Senate,08/30/19,5,11,0,0,16
1131917,783528,2019-01-17,Senate,"Be adopted. Ordered to third reading",6,0,2,0,8
1131917,784608,2019-01-22,Senate,"Senate 3rd Reading SR7 Leyva et al",27,9,2,0,38
1131918,851406,2019-04-23,Assembly,"Do pass as amended and be re-referred to the Committee on [Appropriations]",15,0,0,0,15
1131918,865619,2019-05-16,Assembly,"Do pass",18,0,0,0,18
1131918,874112,2019-05-28,Assembly,"AB 50 Kalra Assembly Third Reading",76,0,4,0,80
1131918,888051,2019-06-26,Senate,"Do pass, but first be re-referred to the Committee on [Appropriations]",8,0,1,0,9
1131918,893196,2019-07-08,Senate,"Placed on suspense file",7,0,0,0,7
1131920,842713,2019-04-11,Assembly,"AB 78 Ting Assembly Third Reading",54,13,13,0,80
1131920,884885,2019-06-19,Senate,"Do pass",11,5,2,0,18
1131920,969394,2020-06-26,Assembly,"AB 78 BUDGET Concurrence in Senate Amendments By TING",59,13,7,0,79
1131920,969790,2020-06-24,Senate,"Do pass",13,5,0,0,18
1131920,969791,2020-06-25,Senate,"Assembly 3rd Reading AB78 BUDGET (Ting)",28,12,0,0,40
1131922,842688,2019-04-11,Assembly,"AB 108 Ting Assembly Third Reading",54,13,13,0,80
1131923,842730,2019-04-10,Senate,"Do pass, but first be re-referred to the Committee on [Appropriations]",7,0,0,0,7
1131923,854855,2019-04-29,Senate,"Placed on suspense file",6,0,0,0,6
1131923,866133,2019-05-16,Senate,"Do pass",6,0,0,0,6
1131923,867831,2019-05-20,Senate,"Senate 3rd Reading SB9 Beall et al",38,0,0,0,38
1131923,974300,2020-07-29,Assembly,"Do pass as amended and be re-referred to the Committee on [Appropriations]",8,0,0,0,8
1131923,976310,2020-08-20,Assembly,"Do pass as amended",18,0,0,0,18
1131923,977898,2020-08-31,Assembly,"SB 9 Durazo Senate Third Reading By Carrillo",76,0,3,0,79
1131924,843023,2019-04-11,Assembly,"AB 83 Ting Assembly Third Reading",54,13,13,0,80
1131924,881079,2019-06-12,Senate,"Do pass",12,5,1,0,18
1131924,969434,2020-06-26,Assembly,"AB 83 BUDGET Concurrence in Senate Amendments By TING",74,1,4,0,79
1131924,969796,2020-06-24,Senate,"Do pass",13,3,2,0,18
1131924,969797,2020-06-25,Senate,"Assembly 3rd Reading AB83 BUDGET (Ting)",31,3,6,0,40
1131925,825053,2019-03-13,Assembly,"Do pass as amended and be re-referred to the Committee on [Appropriations]",6,0,0,0,6
1131926,820073,2019-03-11,Assembly,"Do pass and be re-referred to the Committee on [Veterans Affairs] with recommendation: To Consent Calendar",15,0,0,0,15
1131926,829525,2019-03-26,Assembly,"Do pass and be re-referred to the Committee on [Appropriations]",11,0,0,0,11
1131928,826056,2019-03-20,Senate,"Do pass as amended, but first amend, and re-refer to the Committee on [Housing]",5,1,1,0,7
1131928,826057,2019-03-20,Senate,"[03-20-2019] set for [Second] hearing: Reconsideration of favorable vote granted",5,0,2,0,7
1131928,826058,2019-03-20,Senate,"Do pass as amended, but first amend, and re-refer to the Committee on [Housing]",6,0,1,0,7
1131928,835462,2019-04-02,Senate,"Do pass as amended, but first amend, and re-refer to the Committee on [Appropriations]",9,1,1,0,11
1131928,854283,2019-04-29,Senate,"Placed on suspense file",6,0,0,0,6
1131928,865815,2019-05-16,Senate,"Do pass as amended",4,2,0,0,6
1131928,874555,2019-05-29,Senate,"Senate 3rd Reading SB5 Beall et al",31,4,3,0,38
1131928,891489,2019-07-03,Assembly,"Do pass and be re-referred to the Committee on [Local Government]",6,1,1,0,8
1131928,891490,2019-07-10,Assembly,"Do pass as amended and be re-referred to the Committee on [Appropriations]",6,0,2,0,8
1131928,891491,2019-08-30,Assembly,"Do pass",12,6,0,0,18
1131928,891492,2019-09-10,Assembly,"SB 5 Beall Senate Third Reading By Mullin",55,19,5,0,79
1131928,891493,2019-09-11,Senate,"Unfinished Business SB5 Beall et al. Concurrence",29,9,2,0,40
1131930,842745,2019-04-11,Assembly,"AB 86 Ting Assembly Third Reading",54,13,13,0,80
1131930,977458,2020-08-29,Senate,"Do pass",13,5,0,0,18
1131931,856963,2019-04-30,Senate,"Do pass as amended",9,0,0,0,9
1131931,859589,2019-05-06,Senate,"Senate 3rd Reading SB41 Hertzberg et al",38,0,0,0,38
1131931,877695,2019-06-04,Assembly,"Do pass as amended",11,0,1,0,12
1131931,889282,2019-07-01,Assembly,"SB 41 Hertzberg Senate Third Reading By Chiu",78,0,1,0,79
1131931,890492,2019-07-11,Senate,"Special Consent SB41",39,0,1,0,40
1131932,860784,2019-05-07,Senate,"Be adopted, but first be re-referred to the Committee on [Appropriations]",4,1,0,0,5
1131932,863209,2019-05-13,Senate,"Placed on suspense file",6,0,0,0,6
1131932,865800,2019-05-16,Senate,"Be adopted",4,2,0,0,6
1131932,891170,2019-07-11,Senate,"Senate 3rd Reading SCA2 Allen",28,11,1,0,40
1131935,842798,2019-04-11,Assembly,"AB 87 Ting Assembly Third Reading",54,13,13,0,80
1131935,881077,2019-06-12,Senate,"Do pass",12,3,3,0,18
1131936,852669,2019-04-24,Assembly,"Do pass as amended and be re-referred to the Committee on [Appropriations]",5,0,2,0,7
1131936,866356,2019-05-16,Assembly,"Do pass",14,3,1,0,18
1131936,873979,2019-05-28,Assembly,"AB 123 McCarty Assembly Third Reading",62,0,18,0,80
1131936,974278,2020-07-29,Senate,"Do pass as amended, but first amend, and re-refer to the Committee on [Appropriations]",7,0,0,0,7
1131936,975816,2020-08-13,Senate,"Placed on suspense file",7,0,0,0,7
1131937,842972,2019-04-11,Assembly,"AB 82 Ting Assembly Third Reading",54,13,13,0,80
1131937,881011,2019-06-12,Senate,"Do pass",14,3,1,0,18
1131937,969419,2020-06-26,Assembly,"AB 82 BUDGET Concurrence in Senate Amendments By TING",57,11,11,0,79
1131937,969725,2020-06-24,Senate,"Do pass",13,5,0,0,18
1131937,969726,2020-06-25,Senate,"Assembly 3rd Reading AB82 BUDGET (Ting)",29,11,0,0,40
1131938,853052,2019-04-24,Assembly,"Do pass and be re-referred to the Committee on [Utilities and Energy]",17,1,3,0,21
1131938,856788,2019-05-01,Assembly,"Do pass",10,0,5,0,15
1131938,862270,2019-05-09,Assembly,"AB 7 Chu Third Reading Urgency",72,0,8,0,80
1131939,825900,2019-03-20,Senate,"Do pass, but first be re-referred to the Committee on [Natural Resources and Water]",5,2,0,0,7
1131939,839975,2019-04-09,Senate,"Do pass as amended, but first amend, and re-refer to the Committee on [Judiciary]",7,2,0,0,9
1131939,851455,2019-04-23,Senate,"Do pass, but first be re-referred to the Committee on [Appropriations]",6,2,1,0,9
1131939,863161,2019-05-13,Senate,"Placed on suspense file",6,0,0,0,6
1131939,865790,2019-05-16,Senate,"Do pass as amended",4,2,0,0,6
1131939,874669,2019-05-29,Senate,"Senate 3rd Reading SB1 Atkins et al",28,10,0,0,38
1131939,884801,2019-06-18,Assembly,"Do pass and be re-referred to the Committee on [Natural Resources]",6,1,1,0,8
1131939,892323,2019-07-08,Assembly,"Do pass and be re-referred to the Committee on [Judiciary]",8,3,0,0,11
1131939,892324,2019-07-09,Assembly,"Do pass and be re-referred to the Committee on [Appropriations]",8,2,2,0,12
1131939,892325,2019-08-30,Assembly,"Do pass as amended",13,5,0,0,18
1131939,893920,2019-09-13,Assembly,"SB 1 Atkins Senate Third Reading By FRIEDMAN",48,22,9,0,79
1131939,894152,2019-09-13,Senate,"Unfinished Business SB1 Atkins",26,14,0,0,40
1131939,894406,2019-09-14,Senate,"Unfinished Business SB1 Atkins",26,14,0,0,40
1131940,839938,2019-04-08,Assembly,"Do pass and be re-referred to the Committee on [Natural Resources]",14,0,1,0,15
1131940,849326,2019-04-22,Assembly,"Do pass as amended and be re-referred to the Committee on [Appropriations]",11,0,0,0,11
1131940,865767,2019-05-16,Assembly,"Do pass",17,0,1,0,18
1131940,873873,2019-05-28,Assembly,"AB 126 Cooper Assembly Third Reading",75,0,5,0,80
1131940,884809,2019-06-19,Senate,"Do pass as amended, but first amend, and re-refer to the Committee on [Transportation]",5,1,1,0,7
1131941,781985,2019-01-10,Assembly,"Be adopted. To third reading",11,0,0,0,11
1131941,792313,2019-02-04,Senate,"Assembly 3rd Reading ACR3 Choi et al. By Chang",36,0,2,0,38
1131941,795563,2019-02-07,Assembly,"ACR 3 Choi Concurrence in Senate Amendments",75,0,5,0,80
1131942,842725,2019-04-11,Assembly,"AB 96 Ting Assembly Third Reading",54,13,13,0,80
1131942,881008,2019-06-12,Senate,"Do pass",10,5,3,0,18
1131943,829187,2019-03-26,Senate,"Do pass, but first be re-referred to the Committee on [Appropriations]",5,0,2,0,7
1131943,838487,2019-04-08,Senate,"Placed on suspense file",6,0,0,0,6
1131943,866278,2019-05-16,Senate,"Do pass as amended",6,0,0,0,6
1131943,868760,2019-05-21,Senate,"Senate 3rd Reading SB23 Wiener et al",34,1,3,0,38
1131943,887598,2019-06-25,Assembly,"Do pass as amended and be re-referred to the Committee on [Appropriations]",6,0,2,0,8
1131943,895971,2019-04-08,Senate,Result,6,0,0,0,6
1131943,896114,2019-05-21,Senate,05/16/19,6,1,0,0,7
1131944,829164,2019-03-26,Senate,"Do pass, but first be re-referred to the Committee on [Environmental Quality]",7,1,1,0,9
1131944,835096,2019-04-03,Senate,"Do pass as amended, but first amend, and re-refer to the Committee on [Governance and Finance]",5,1,1,0,7
1131944,852999,2019-04-24,Senate,"Do pass, but first be re-referred to the Committee on [Appropriations]",5,2,0,0,7
1131944,904089,2020-01-21,Senate,"Placed on suspense file",7,0,0,0,7
1131944,905381,2020-01-23,Senate,"Do pass as amended",5,1,1,0,7
1131944,910522,2020-01-29,Senate,"Senate 3rd Reading SB45 Allen et al. Urgency Clause",29,6,4,0,39
1131945,836753,2019-04-03,Senate,"Do pass as amended, but first amend, and re-refer to the Committee on [Education]",7,2,0,0,9
1131945,851285,2019-04-24,Senate,"Do pass, but first be re-referred to the Committee on [Appropriations]",5,2,0,0,7
1131945,863136,2019-05-13,Senate,"Placed on suspense file",6,0,0,0,6
1131945,865529,2019-05-16,Senate,"Do pass",4,2,0,0,6
1131945,867708,2019-05-20,Senate,"Senate 3rd Reading SB24 Leyva et al",28,10,0,0,38
1131945,880300,2019-06-11,Assembly,"Do pass as amended and be re-referred to the Committee on [Higher Education]",10,4,1,0,15
1131945,887972,2019-06-25,Assembly,"Do pass and be re-referred to the Committee on [Appropriations]",9,3,0,0,12
1131945,892720,2019-08-30,Assembly,"Do pass",13,5,0,0,18
1131945,893952,2019-09-13,Assembly,"SB 24 Leyva Senate Third Reading By Carrillo",55,19,5,0,79
1131945,894147,2019-09-13,Senate,"Unfinished Business SB24 Leyva Letter to Journal",29,11,0,0,40
1131946,842975,2019-04-11,Assembly,"AB 79 Ting Assembly Third Reading",54,13,13,0,80
1131946,884902,2019-06-19,Senate,"Do pass",13,0,5,0,18
1131946,969403,2020-06-26,Assembly,"AB 79 BUDGET Concurrence in Senate Amendments By TING",73,0,6,0,79
1131946,969793,2020-06-24,Senate,"Do pass",13,5,0,0,18
1131946,969794,2020-06-25,Senate,"Assembly 3rd Reading AB79 BUDGET (Ting)",29,11,0,0,40
1131947,842865,2019-04-10,Senate,"Do pass as amended, but first amend, and re-refer to the Committee on [Environmental Quality]",11,1,1,0,13
1131947,851419,2019-04-24,Senate,"Do pass as amended, but first amend, and re-refer to the Committee on [Appropriations]",5,1,1,0,7
1131947,863139,2019-05-13,Senate,"Placed on suspense file",6,0,0,0,6
1131947,866053,2019-05-16,Senate,"Do pass",4,2,0,0,6
1131947,867837,2019-05-20,Senate,"Senate 3rd Reading SB49 Skinner",30,8,0,0,38
1131947,887089,2019-06-24,Assembly,"Do pass and be re-referred to the Committee on [Utilities and Energy]",8,2,1,0,11
1131947,890441,2019-07-10,Assembly,"Do pass as amended and be re-referred to the Committee on [Appropriations]",11,2,2,0,15
1131947,890442,2019-08-30,Assembly,"Do pass",14,4,0,0,18
1131947,890443,2019-09-10,Assembly,"SB 49 Skinner Senate Third Reading By Mullin",60,15,4,0,79
1131947,890444,2019-09-11,Senate,"That the Assembly amendments be concurred in",11,1,1,0,13
1131947,893658,2019-09-12,Senate,"Unfinished Business SB49 Skinner Concurrence",31,9,0,0,40
1131948,809212,2019-02-26,Assembly,"Do pass and be re-referred to the Committee on [Appropriations]",6,0,2,0,8
1131948,865908,2019-05-16,Assembly,"Do pass as amended",13,5,0,0,18
1131948,871827,2019-05-23,Assembly,"AB 32 Bonta Assembly Third Reading",61,13,6,0,80
1131948,890608,2019-07-02,Senate,"Do pass, but first be re-referred to the Committee on [Public Safety]",7,1,1,0,9
1131948,890609,2019-07-09,Senate,"Do pass, but first be re-referred to the Committee on [Appropriations]",5,2,0,0,7
1131948,890610,2019-08-12,Senate,"Placed on suspense file",7,0,0,0,7
1131948,890611,2019-08-30,Senate,"Do pass",5,2,0,0,7
1131948,890612,2019-09-10,Senate,"Assembly 3rd Reading AB32 Bonta et al. By Durazo",33,6,1,0,40
1131948,890613,2019-09-11,Assembly,"AB 32 Bonta Concurrence in Senate Amendments",65,11,3,0,79
1131948,894514,2019-09-10,Senate,Noes,5,6,0,0,11
1131950,842949,2019-04-11,Assembly,"AB 116 Ting Assembly Third Reading",54,13,13,0,80
1131950,890369,2019-09-10,Senate,"Do pass",12,4,2,0,18
1131950,890370,2019-09-11,Senate,"Assembly 2nd Reading AB116 Ting By Mitchell",29,11,0,0,40
1131950,893860,2019-09-13,Assembly,"With recommendation: That Senate amendments be concurred in",5,3,0,0,8
1131950,893902,2019-09-13,Assembly,"AB 116 Ting Concurrence in Senate Amendments",44,28,7,0,79
1131951,809251,2019-02-26,Assembly,"Do pass and be re-referred to the Committee on [Appropriations]",6,1,1,0,8
1131951,865879,2019-05-16,Assembly,"Do pass",11,6,1,0,18
1131951,871490,2019-05-23,Assembly,"AB 45 Mark Stone Assembly Third Reading",47,24,9,0,80
1131951,887630,2019-06-25,Senate,"Do pass, but first be re-referred to the Committee on [Appropriations]",6,1,0,0,7
1131951,891328,2019-08-12,Senate,"Placed on suspense file",7,0,0,0,7
1131951,891329,2019-08-30,Senate,"Do pass",5,2,0,0,7
1131951,891330,2019-09-09,Senate,"Assembly 3rd Reading AB45 Mark Stone et al. By Bradford",29,11,0,0,40
1131952,820658,2019-03-11,Assembly,"Be adopted. To Consent Calendar",15,0,0,0,15
1131952,823995,2019-03-18,Assembly,"ACR 4 Frazier Assembly Third Reading",76,0,4,0,80
1131952,880698,2019-06-11,Senate,"Be adopted, but first be re-referred to the Committee on [Appropriations] with recommendation: To Consent Calendar",10,0,2,0,12
1131952,889312,2019-07-01,Senate,"Special Consent ACR4 Frazier et al",38,0,2,0,40
1131953,877712,2019-06-04,Senate,"Be adopted, but first be re-referred to the Committee on [Elections and Constitutional Amendments]",9,0,2,0,11
1131953,893242,2019-07-02,Senate,"Be adopted, but first be re-referred to the Committee on [Appropriations]",4,0,1,0,5
1131953,893243,2019-08-12,Senate,"Placed on suspense file",7,0,0,0,7
1131953,893244,2019-08-30,Senate,"Be adopted",6,0,1,0,7
1131953,893245,2019-09-10,Senate,"Senate 3rd Reading SCA1 Allen et al",40,0,0,0,40
1131955,835769,2019-04-02,Senate,"Do pass, but first be re-referred to the Committee on [Judiciary]",8,0,3,0,11
1131955,851731,2019-04-23,Senate,"Do pass as amended, but first amend, and re-refer to the Committee on [Appropriations]",7,1,1,0,9
1131955,851732,2019-04-23,Senate,"[04-24-2019] set for [First] hearing: Reconsideration of favorable vote granted",9,0,0,0,9
1131955,851733,2019-04-23,Senate,"Do pass as amended, but first amend, and re-refer to the Committee on [Appropriations]",7,2,0,0,9
1131955,863073,2019-05-13,Senate,"Placed on suspense file",6,0,0,0,6
1131955,866066,2019-05-16,Senate,"Do pass as amended",4,2,0,0,6
1131955,873949,2019-05-28,Senate,"Senate 3rd Reading SB18 Skinner et al",38,0,0,0,38
1131955,884746,2019-06-19,Assembly,"Do pass and be re-referred to the Committee on [Judiciary] with recommendation: To Consent Calendar",8,0,0,0,8
1131955,887523,2019-06-25,Assembly,"Do pass. To Consent Calendar",12,0,0,0,12
1131955,892246,2019-07-05,Assembly,"SB 18 Skinner Consent Calendar Second Day Regular Session",70,0,9,0,79
1131955,894070,2019-05-28,Senate,Date,4,0,0,0,4
1131956,834910,2019-04-02,Senate,"Do pass as amended, but first amend, and re-refer to the Committee on [Governance and Finance]",10,0,1,0,11
1131956,841310,2019-04-10,Senate,"Do pass as amended, but first amend, and re-refer to the Committee on [Appropriations]",7,0,0,0,7
1131956,859600,2019-05-06,Senate,"Placed on suspense file",5,0,1,0,6
1131956,866022,2019-05-16,Senate,"Do pass as amended",6,0,0,0,6
1131956,869872,2019-05-22,Senate,"Senate 3rd Reading SB13 Wieckowski et al",34,2,2,0,38
1131956,884615,2019-06-19,Assembly,"Do pass as amended and be re-referred to the Committee on [Local Government]",6,0,2,0,8
1131956,892047,2019-07-10,Assembly,"Do pass as amended and be re-referred to the Committee on [Appropriations]",8,0,0,0,8
1131956,892048,2019-08-30,Assembly,"Do pass as amended",14,1,3,0,18
1131956,893916,2019-09-13,Assembly,"SB 13 Wieckowski Senate Third Reading By Voepel",68,6,5,0,79
1131956,894211,2019-09-13,Senate,"Unifinished Business SB13 Wieckowski",35,4,1,0,40
1131957,834539,2019-04-02,Senate,"Do pass, but first be re-referred to the Committee on [Governance and Finance]",8,1,2,0,11
1131958,842979,2019-04-11,Assembly,"AB 91 Ting Assembly Third Reading",54,13,13,0,80
1131958,882993,2019-06-17,Senate,"Do pass",12,5,1,0,18
1131958,882994,2019-06-17,Senate,"Assembly 3rd Reading AB91 Burke et al. By Mitchell Urgency Clause",27,10,3,0,40
1131958,886070,2019-06-20,Assembly,"AB 91 Burke Concurrence - Urgency Added",60,2,17,0,79
1131959,830877,2019-03-26,Assembly,"Do pass and be re-referred to the Committee on [Appropriations]",11,0,0,0,11
1131960,841752,2019-04-10,Assembly,"Do pass as amended and be re-referred to the Committee on [Appropriations]",6,0,1,0,7
1131960,856669,2019-05-01,Assembly,"Do pass. To Consent Calendar",18,0,0,0,18
1131960,862088,2019-05-09,Assembly,"AB 49 Cervantes Consent Calendar Second Day Regular Session",76,0,4,0,80
1131960,893271,2019-07-02,Senate,"Do pass as amended, but first amend, and re-refer to the Committee on [Appropriations]",4,1,0,0,5
1131960,893272,2019-09-09,Senate,"Assembly 3rd Reading AB49 Cervantes et al. By Durazo",34,4,2,0,40
1131960,893273,2019-09-10,Assembly,"AB 49 Cervantes Concurrence in Senate Amendments",79,0,0,0,79
1131961,831554,2019-03-27,Senate,"Do pass, but first be re-referred to the Committee on [Appropriations]",8,1,0,0,9
1131961,848899,2019-04-22,Senate,"Placed on suspense file",6,0,0,0,6
1131961,866077,2019-05-16,Senate,"Do pass as amended",4,2,0,0,6
1131961,903174,2020-01-15,Senate,"Do pass, but first be re-referred to the Committee on [Appropriations]",7,0,0,0,7
1131961,905425,2020-01-23,Senate,"Senate 3rd Reading SB38 Hill et al",37,0,2,0,39
1131961,974192,2020-07-27,Assembly,"Do pass and be re-referred to the Committee on [Appropriations] with recommendation: To Consent Calendar",9,0,1,0,10
1131961,975497,2020-08-11,Assembly,"Do pass. To Consent Calendar",17,0,0,0,17
1131961,978100,2020-08-30,Senate,"Unfinished Business SB38 Hill et al. Concurrence",39,0,1,0,40
1131961,978101,2020-08-30,Assembly,"SB 38 Hill Consent Calendar Second Day Regular Session",75,0,4,0,79
1131962,825128,2019-03-19,Senate,"Do pass, but first be re-referred to the Committee on [Judiciary]",3,1,1,0,5
1131962,834565,2019-04-02,Senate,"Do pass, but first be re-referred to the Committee on [Appropriations]",7,1,0,0,8
1131962,858250,2019-05-02,Senate,"Senate 3rd Reading SB27 McGuire et al. Urgency Clause",27,10,1,0,38
1131962,884581,2019-06-19,Assembly,"Do pass and be re-referred to the Committee on [Appropriations]",5,0,2,0,7
1131962,886810,2019-03-19,Senate,"Do pass, but first b",0,0,1,0,1
1131962,887986,2019-06-26,Assembly,"Do pass as amended",11,4,3,0,18
1131962,892030,2019-07-08,Assembly,"SB 27 McGuire Third Reading Urgency By SANTIAGO",57,17,5,0,79
1131962,892031,2019-07-11,Senate,"Unfinished Business SB27 McGuire et al. Urgency Clause Concurrence",29,10,1,0,40
1131962,894721,2019-07-08,Assembly,06/26/19,11,17,0,0,28
1131963,821228,2019-03-12,Assembly,"Be adopted. To third reading",5,0,3,0,8
1131963,880305,2019-06-10,Senate,"Be adopted. Ordered to third reading",5,0,1,0,6
1131963,893631,2019-09-12,Senate,"Assembly 3rd Reading ACR1 Bonta et al. By Pan",29,3,8,0,40
1131963,893949,2019-09-13,Assembly,"ACR 1 Bonta Concurrence in Senate Amendments",61,0,18,0,79
1131965,843018,2019-04-11,Assembly,"AB 111 Ting Assembly Third Reading",54,13,13,0,80
1131965,890958,2019-07-10,Senate,"Do pass",13,1,4,0,18
1131965,890959,2019-07-11,Senate,"Assembly 2nd Reading AB111 BUDGET (Ting) By Mitchell",35,4,1,0,40
1131965,890960,2019-07-11,Assembly,"AB 111 BUDGET Concurrence in Senate Amendments By TING",74,0,5,0,79
1131967,850478,2019-04-23,Assembly,"Do pass as amended. To Consent Calendar",12,0,0,0,12
1131967,858244,2019-05-02,Assembly,"AB 46 Carrillo Consent Calendar Second Day",76,0,4,0,80
1131967,877585,2019-06-04,Senate,"Do pass and be ordered to the Consent Calendar",9,0,0,0,9
1131967,883047,2019-06-17,Senate,"Consent Calendar AB46",40,0,0,0,40
1131969,835044,2019-04-03,Senate,"Do pass, but first be re-referred to the Committee on [Appropriations]",5,0,2,0,7
1131969,849031,2019-04-22,Senate,"Placed on suspense file",6,0,0,0,6
1131970,834662,2019-04-02,Senate,"Do pass, but first be re-referred to the Committee on [Governance and Finance]",8,0,3,0,11
1131970,841626,2019-04-10,Senate,"Do pass, but first be re-referred to the Committee on [Environmental Quality]",6,0,1,0,7
1131970,851389,2019-04-24,Senate,"Do pass as amended, but first amend, and re-refer to the Committee on [Appropriations]",4,2,1,0,7
1131970,863179,2019-05-13,Senate,"Placed on suspense file",6,0,0,0,6
1131971,815305,2019-03-05,Assembly,"Do pass as amended and be re-referred to the Committee on [Education]",11,0,1,0,12
1131971,842947,2019-04-10,Assembly,"Do pass and be re-referred to the Committee on [Appropriations] with recommendation: To Consent Calendar",6,0,0,0,6
1131971,865540,2019-05-16,Assembly,"Do pass as amended",18,0,0,0,18
1131971,873742,2019-05-28,Assembly,"AB 30 Holden Assembly Third Reading",76,0,4,0,80
1131971,881062,2019-06-12,Senate,"Do pass, but first be re-referred to the Committee on [Appropriations] with the recommendation: To Consent Calendar",7,0,0,0,7
1131971,886991,2019-06-24,Senate,"Placed on suspense file",7,0,0,0,7
1131971,892440,2019-08-30,Senate,"Do pass as amended",7,0,0,0,7
1131971,892441,2019-09-10,Senate,"Assembly 3rd Reading AB30 Holden et al. By Roth",40,0,0,0,40
1131971,892442,2019-09-11,Assembly,"AB 30 Holden Concurrence in Senate Amendments",78,0,1,0,79
1131972,831426,2019-03-26,Assembly,"Do pass as amended",6,0,2,0,8
1131972,838624,2019-04-08,Assembly,"AB 12 Irwin Assembly Third Reading",53,13,14,0,80
1131972,883930,2019-06-18,Senate,"Do pass as amended, but first amend, and re-refer to the Committee on [Appropriations]",5,1,1,0,7
1131972,891319,2019-07-08,Senate,"Placed on suspense file",7,0,0,0,7
1131972,891320,2019-08-30,Senate,"Do pass",5,1,1,0,7
1131972,891321,2019-09-09,Senate,"Assembly 3rd Reading AB12 Irwin et al. By Stern",30,8,2,0,40
1131972,891322,2019-09-10,Assembly,"AB 12 Irwin Concurrence in Senate Amendments",59,15,5,0,79
1131973,831424,2019-03-27,Senate,"Do pass, but first be re-referred to the Committee on [Appropriations]",9,0,0,0,9
1131973,838481,2019-04-08,Senate,"Placed on suspense file",6,0,0,0,6
1131973,866121,2019-05-16,Senate,"Do pass as amended",6,0,0,0,6
1131973,868727,2019-05-21,Senate,"Senate 3rd Reading SB10 Beall et al",38,0,0,0,38
1131973,891129,2019-07-02,Assembly,"Do pass and be re-referred to the Committee on [Appropriations]",15,0,0,0,15
1131973,891130,2019-08-30,Assembly,"Do pass",18,0,0,0,18
1131973,891131,2019-09-05,Assembly,"SB 10 Beall Senate Third Reading By Waldron",79,0,0,0,79
1131973,891132,2019-09-06,Senate,"Unfinished Business SB10 Beall et al. Concurrence",39,0,1,0,40
1131974,842837,2019-04-11,Assembly,"AB 93 Ting Assembly Third Reading",54,13,13,0,80
1131974,881081,2019-06-12,Senate,"Do pass",16,0,2,0,18
1131974,969432,2020-06-26,Assembly,"AB 93 BUDGET Concurrence in Senate Amendments By TING",58,16,5,0,79
1131974,969805,2020-06-24,Senate,"Do pass",13,5,0,0,18
1131974,969806,2020-06-25,Senate,"Assembly 3rd Reading AB93 BUDGET (Ting)",29,10,1,0,40
1131975,841365,2019-04-09,Senate,"Do pass, but first be re-referred to the Committee on [Public Safety]",8,0,0,0,8
1131975,851664,2019-04-23,Senate,"Do pass as amended, but first amend, and re-refer to the Committee on [Appropriations]",6,0,1,0,7
1131975,863205,2019-05-13,Senate,"Placed on suspense file",6,0,0,0,6
1131975,866116,2019-05-16,Senate,"Do pass",6,0,0,0,6
1131975,867616,2019-05-20,Senate,"Senate 3rd Reading SB40 Wiener et al. Urgency Clause",36,0,2,0,38
1131975,891727,2019-07-02,Assembly,"Do pass and be re-referred to the Committee on [Health]",12,0,0,0,12
1131975,891728,2019-07-09,Assembly,"Do pass and be re-referred to the Committee on [Appropriations]",14,0,1,0,15
1131975,891729,2019-08-30,Assembly,"Do pass",18,0,0,0,18
1131975,891730,2019-09-05,Assembly,"SB 40 Wiener Third Reading Urgency By Chiu",77,1,1,0,79
1131975,891731,2019-09-06,Senate,"Unfinished Business SB40 Wiener et al. Urgency Clause Concurrence",38,0,2,0,40
1131976,843123,2019-04-11,Assembly,"AB 119 Ting Assembly Third Reading",54,13,13,0,80
1131976,969411,2020-06-26,Assembly,"AB 119 Ting Concurrence in Senate Amendments",65,8,6,0,79
1131976,969721,2020-06-24,Senate,"Do pass",13,5,0,0,18
1131976,969722,2020-06-25,Senate,"Assembly 3rd Reading AB119 Ting",29,10,1,0,40
1131977,836770,2019-04-03,Assembly,"Do pass and be re-referred to the Committee on [Appropriations]",5,0,2,0,7
1131977,865701,2019-05-16,Assembly,"Do pass",13,3,2,0,18
1131977,874384,2019-05-29,Assembly,"AB 5 Gonzalez Assembly Third Reading",59,15,6,0,80
1131977,890313,2019-07-10,Senate,"Do pass as amended, but first amend, and re-refer to the Committee on [Appropriations]",4,1,0,0,5
1131977,890314,2019-08-12,Senate,"Placed on suspense file",7,0,0,0,7
1131977,890315,2019-08-30,Senate,"Do pass as amended",5,2,0,0,7
1131977,890316,2019-09-10,Senate,"Assembly 3rd Reading AB5 Gonzalez et al. By Durazo",29,11,0,0,40
1131977,890317,2019-09-11,Assembly,"AB 5 Gonzalez Concurrence in Senate Amendments Motion to Appeal the Decision of the Chair By GALLAGHER",16,53,10,0,79
1131977,890318,2019-09-11,Assembly,"AB 5 Gonzalez Concurrence in Senate Amendments",61,16,2,0,79
1131978,825951,2019-03-20,Senate,"Do pass, but first be re-referred to the Committee on [Appropriations]",7,1,1,0,9
1131978,848927,2019-04-22,Senate,"Placed on suspense file",6,0,0,0,6
1131978,866175,2019-05-16,Senate,"Do pass as amended",4,2,0,0,6
1131978,874453,2019-05-29,Senate,"Senate 3rd Reading SB29 Durazo et al",24,11,3,0,38
1131978,890741,2019-07-09,Assembly,"Do pass and be re-referred to the Committee on [Appropriations]",10,3,2,0,15
1131978,890742,2019-08-30,Assembly,"Do pass as amended",11,6,1,0,18
1131979,829409,2019-03-26,Senate,"Do pass, but first be re-referred to the Committee on [Appropriations]",7,0,0,0,7
1131979,838694,2019-04-08,Senate,"Placed on suspense file",6,0,0,0,6
1131979,866283,2019-05-16,Senate,"Do pass as amended",6,0,0,0,6
1131979,868663,2019-05-21,Senate,"Senate 3rd Reading SB22 Leyva et al",38,0,0,0,38
1131979,880567,2019-06-11,Assembly,"Do pass and be re-referred to the Committee on [Appropriations]",8,0,0,0,8
1131979,893337,2019-08-30,Assembly,"Do pass",18,0,0,0,18
1131979,893338,2019-09-10,Assembly,"SB 22 Leyva Senate Third Reading By Chiu",79,0,0,0,79
1131979,894115,2019-08-30,Assembly,Result,18,0,0,0,18
1131980,841689,2019-04-10,Assembly,"Do pass and be re-referred to the Committee on [Appropriations]",7,0,0,0,7
1131982,842954,2019-04-10,Senate,"Do pass as amended, but first amend, and re-refer to the Committee on [Judiciary]",5,2,0,0,7
1131982,851464,2019-04-23,Senate,"Do pass as amended, but first amend, and re-refer to the Committee on [Appropriations]",5,1,3,0,9
1131982,871220,2019-05-23,Senate,"Senate 3rd Reading SB25 Caballero et al",28,6,4,0,38
1131982,888388,2019-06-26,Assembly,"Do pass and be re-referred to the Committee on [Natural Resources]",6,1,0,0,7
1131984,842669,2019-04-11,Assembly,"AB 113 Ting Assembly Third Reading",54,13,13,0,80
1131984,891570,2019-09-10,Senate,"Do pass",12,3,3,0,18
1131985,830374,2019-03-26,Senate,"Do pass as amended, but first amend, and re-refer to the Committee on [Appropriations]",8,0,0,0,8
1131985,853143,2019-04-25,Senate,"Senate 3rd Reading SB30 Wiener",30,4,4,0,38
1131985,877683,2019-06-04,Assembly,"Do pass as amended and be re-referred to the Committee on [Appropriations]",10,0,2,0,12
1131985,884641,2019-06-19,Assembly,"Do pass",12,0,6,0,18
1131985,889230,2019-07-01,Assembly,"SB 30 Wiener Senate Third Reading By Petrie-Norris",60,0,19,0,79
1131985,890431,2019-07-05,Senate,"Unfinished Business SB30 Wiener et al. Concurrence",29,0,11,0,40
1131986,821182,2019-03-13,Assembly,"Do pass and be re-referred to the Committee on [Appropriations] with recommendation: To Consent Calendar",7,0,0,0,7
1131986,826071,2019-03-20,Assembly,"Do pass as amended. To Consent Calendar",13,0,5,0,18
1131986,831392,2019-03-28,Assembly,"AB 57 Low Consent Calendar Second Day Regular Session",72,0,8,0,80
1131986,860848,2019-05-07,Senate,"Do pass, but first be re-referred to the Committee on [Appropriations] with the recommendation: To Consent Calendar",5,0,0,0,5
1131986,889275,2019-07-01,Senate,"Consent Calendar AB57",39,0,1,0,40
1131987,835247,2019-04-02,Senate,"Do pass, but first be re-referred to the Committee on [Governmental Organization] with the recommendation: To Consent Calendar",11,0,0,0,11
1131987,840092,2019-04-09,Senate,"Do pass, but first be re-referred to the Committee on [Appropriations] with the recommendation: To Consent Calendar",16,0,0,0,16
1131987,854382,2019-04-29,Senate,"Placed on suspense file",6,0,0,0,6
1131987,866208,2019-05-16,Senate,"Do pass",6,0,0,0,6
1131987,867658,2019-05-20,Senate,"Senate 3rd Reading SB6 Beall et al",38,0,0,0,38
1131987,884781,2019-06-19,Assembly,"Do pass and be re-referred to the Committee on [Accountability and Administrative Review]",8,0,0,0,8
1131987,891458,2019-07-03,Assembly,"Do pass and be re-referred to the Committee on [Appropriations]",6,0,1,0,7
1131987,891459,2019-08-30,Assembly,"Do pass",18,0,0,0,18
1131987,891460,2019-09-10,Assembly,"SB 6 Beall Senate Third Reading By Ting",79,0,0,0,79
1131987,891461,2019-09-11,Senate,"Unfinished Business SB6 Beall et al. Concurrence",40,0,0,0,40
1131988,821021,2019-03-13,Assembly,"Do pass and be re-referred to the Committee on [Appropriations]",6,0,0,0,6
1131988,865883,2019-05-16,Assembly,"Do pass",18,0,0,0,18
1131988,870203,2019-05-22,Assembly,"AB 28 Obernolte Assembly Third Reading",78,0,2,0,80
1131988,884796,2019-06-19,Senate,"Do pass as amended, but first amend, and re-refer to the Committee on [Appropriations] with the recommendation: To Consent Calendar",6,0,1,0,7
1131988,892810,2019-07-08,Senate,"Placed on suspense file",7,0,0,0,7
1131988,892811,2019-08-30,Senate,"Do pass",7,0,0,0,7
1131988,892812,2019-09-09,Senate,"Special Consent AB28",40,0,0,0,40
1131988,892813,2019-09-10,Assembly,"AB 28 Obernolte Concurrence in Senate Amendments",79,0,0,0,79
1131989,829424,2019-03-26,Senate,"Do pass, but first be re-referred to the Committee on [Appropriations]",7,0,0,0,7
1131989,838300,2019-04-08,Senate,"Placed on suspense file",6,0,0,0,6
1131989,865963,2019-05-16,Senate,"Do pass as amended",6,0,0,0,6
1131989,873933,2019-05-28,Senate,"Senate 3rd Reading SB35 Chang",37,0,1,0,38
1131989,887636,2019-06-25,Assembly,"Do pass and be re-referred to the Committee on [Appropriations]",8,0,0,0,8
1131989,892177,2019-08-30,Assembly,"Do pass as amended",18,0,0,0,18
1131989,892178,2019-09-09,Assembly,"SB 35 Chang Senate Third Reading By Gabriel",79,0,0,0,79
1131989,892179,2019-09-10,Senate,"Unfinished Business SB35 Chang et al. Concurrence",40,0,0,0,40
1131989,895644,2019-05-16,Senate,Result,6,0,0,0,6
1131990,851463,2019-04-23,Assembly,"Do pass and be re-referred to the Committee on [Appropriations] with recommendation: To Consent Calendar",15,0,0,0,15
1131990,865607,2019-05-16,Assembly,"Do pass as amended",18,0,0,0,18
1131990,871006,2019-05-23,Assembly,"AB 43 Gloria Assembly Third Reading",78,0,2,0,80
1131990,884552,2019-06-19,Senate,"Do pass as amended, but first amend, and re-refer to the Committee on [Appropriations] with the recommendation: To Consent Calendar",9,0,0,0,9
1131990,891382,2019-07-08,Senate,"Placed on suspense file",7,0,0,0,7
1131992,834983,2019-04-02,Senate,"Do pass as amended, but first amend, and re-refer to the Committee on [Appropriations] with the recommendation: To Consent Calendar",8,0,0,0,8
1131992,848788,2019-04-22,Senate,"Placed on suspense file",6,0,0,0,6
1131993,842737,2019-04-11,Assembly,"AB 76 Ting Assembly Third Reading",54,13,13,0,80
1131993,881120,2019-06-12,Senate,"Do pass",16,0,2,0,18
1131993,965940,2020-06-12,Senate,"Do pass",17,0,1,0,18
1131993,966465,2020-06-15,Senate,"WORF AB76 BUDGET (Ting) By Mitchell",40,0,0,0,40
1131993,966466,2020-06-15,Assembly,"AB 76 BUDGET Concurrence in Senate Amendments By TING",79,0,0,0,79
1131994,821177,2019-03-13,Assembly,"Do pass and be re-referred to the Committee on [Appropriations]",5,1,1,0,7
1131994,835068,2019-04-03,Assembly,"Do pass",13,1,4,0,18
1131994,838304,2019-04-08,Assembly,"AB 17 Salas Assembly Third Reading",58,11,11,0,80
1131994,877722,2019-06-04,Senate,"Do pass, but first be re-referred to the Committee on [Judiciary]",5,0,0,0,5
1131994,884853,2019-06-18,Senate,"Do pass, but first be re-referred to the Committee on [Appropriations]",8,1,0,0,9
1131994,893255,2019-08-22,Senate,"Assembly 3rd Reading AB17 Salas et al. By Allen",35,0,5,0,40
1131994,893256,2019-08-26,Assembly,"AB 17 Salas Concurrence in Senate Amendments",61,3,15,0,79
1131996,819811,2019-03-12,Senate,"Do pass, but first be re-referred to the Committee on [Appropriations]",15,0,1,0,16
1131996,849008,2019-04-22,Senate,"Senate 3rd Reading SB21 Dodd Urgency Clause",38,0,0,0,38
1131996,887921,2019-06-26,Assembly,"Do pass and be re-referred to the Committee on [Appropriations]",19,0,2,0,21
1131996,893282,2019-08-14,Assembly,"Do pass",18,0,0,0,18
1131996,893283,2019-09-03,Assembly,"SB 21 Dodd Third Reading Urgency By Gray",75,0,4,0,79
1131996,893284,2019-09-04,Senate,"Unfinished Business SB21 Dodd Urgency Clause Concurrence",40,0,0,0,40
1131997,842982,2019-04-11,Assembly,"AB 121 Ting Assembly Third Reading",54,13,13,0,80
1131997,892978,2019-09-10,Senate,"Do pass",13,2,3,0,18
1131997,893814,2019-09-12,Senate,"Assembly 3rd Reading AB121 BUDGET (Ting) By Mitchell",32,2,6,0,40
1131997,893815,2019-09-12,Assembly,"AB 121 BUDGET Concurrence in Senate Amendments By TING",77,0,2,0,79
1131999,842899,2019-04-11,Assembly,"AB 103 Ting Assembly Third Reading",54,13,13,0,80
1131999,887033,2019-06-24,Senate,"Do pass",12,5,1,0,18
1131999,969405,2020-06-26,Assembly,"AB 103 BUDGET Concurrence in Senate Amendments By TING",75,0,4,0,79
1131999,969767,2020-06-24,Senate,"Do pass",18,0,0,0,18
1131999,969768,2020-06-25,Senate,"Assembly 3rd Reading AB103 BUDGET (Ting)",40,0,0,0,40
1132000,842734,2019-04-11,Assembly,"AB 77 Ting Assembly Third Reading",54,13,13,0,80
1132000,881065,2019-06-12,Senate,"Do pass",15,2,1,0,18
1132000,969730,2020-06-24,Senate,"Do pass",13,5,0,0,18
1132001,820087,2019-03-12,Senate,"Do pass, but first be re-referred to the Committee on [Appropriations]",8,0,1,0,9
1132001,838552,2019-04-08,Senate,"Placed on suspense file",6,0,0,0,6
1132001,865689,2019-05-16,Senate,"Do pass",5,1,0,0,6
1132001,867756,2019-05-20,Senate,"Senate 3rd Reading SB19 Dodd",37,0,1,0,38
1132001,883908,2019-06-18,Assembly,"Do pass and be re-referred to the Committee on [Appropriations]",13,0,0,0,13
1132001,891224,2019-08-30,Assembly,"Do pass",18,0,0,0,18
1132001,891225,2019-09-05,Assembly,"SB 19 Dodd Senate Third Reading By Wood",79,0,0,0,79
1132001,891226,2019-09-06,Senate,"Unfinished Business SB19 Dodd et al. Concurrence",39,0,1,0,40
1132002,842983,2019-04-11,Assembly,"AB 102 Ting Assembly Third Reading",54,13,13,0,80
1132002,884798,2019-06-19,Senate,"Do pass",13,2,3,0,18
1132002,969426,2020-06-26,Assembly,"AB 102 BUDGET Concurrence in Senate Amendments By TING",59,15,5,0,79
1132002,969798,2020-06-24,Senate,"Do pass",13,5,0,0,18
1132002,969799,2020-06-25,Senate,"Assembly 3rd Reading AB102 BUDGET (Ting)",29,11,0,0,40
1132003,820013,2019-03-11,Assembly,"Do pass and be re-referred to the Committee on [Appropriations]",13,0,2,0,15
1132003,865682,2019-05-16,Assembly,"Do pass as amended",13,0,5,0,18
1132003,871146,2019-05-23,Assembly,"AB 47 Daly Assembly Third Reading",75,0,5,0,80
1132003,887574,2019-06-25,Senate,"Do pass as amended, but first amend, and re-refer to the Committee on [Appropriations]",12,0,1,0,13
1132003,892167,2019-07-08,Senate,"Do pass",6,0,1,0,7
1132003,892168,2019-08-26,Senate,"Assembly 3rd Reading AB47 Daly By Skinner",39,0,1,0,40
1132003,892169,2019-09-03,Assembly,"AB 47 Daly Concurrence in Senate Amendments",73,0,6,0,79
1132003,894028,2019-08-26,Senate,"Assembly iv class=""statusCell"">",6,0,0,0,6
1132004,826070,2019-03-20,Senate,"Do pass, but first be re-referred to the Committee on [Governance and Finance]",6,0,1,0,7
1132004,834923,2019-04-03,Senate,"Do pass as amended, but first amend, and re-refer to the Committee on [Appropriations]",5,1,1,0,7
1132004,854177,2019-04-29,Senate,"Placed on suspense file",6,0,0,0,6
1132004,865626,2019-05-16,Senate,"Do pass",5,1,0,0,6
1132004,869865,2019-05-22,Senate,"Senate 3rd Reading SB14 Glazer et al",34,4,0,0,38
1132004,880394,2019-06-11,Assembly,"Do pass and be re-referred to the Committee on [Appropriations]",10,0,2,0,12
1132004,891862,2019-08-30,Assembly,"Do pass and be re-referred to the Committee on [Rules]",14,1,3,0,18
1132004,894972,2019-05-16,Senate,Result,5,1,0,0,6
1132005,828311,2019-03-25,Assembly,"Be re-referred to the Committee on [Water, Parks, and Wildlife]",12,0,0,0,12
1132005,840047,2019-04-09,Assembly,"Do pass and be re-referred to the Committee on [Appropriations]",9,3,2,0,14
1132006,823824,2019-03-13,Assembly,"Do pass as amended, and be re-referred to the Committee on [Appropriations] with recommendation: To Consent Calendar",6,0,0,0,6
1132007,851679,2019-04-23,Senate,"Do pass, but first be re-referred to the Committee on [Appropriations] with the recommendation: To Consent Calendar",9,0,0,0,9
1132007,862084,2019-05-09,Senate,"Consent Calendar SB17",38,0,0,0,38
1132007,883929,2019-06-18,Assembly,"Do pass as amended and be re-referred to the Committee on [Appropriations]",12,0,0,0,12
1132007,890551,2019-08-30,Assembly,"Do pass as amended",18,0,0,0,18
1132007,890552,2019-09-09,Assembly,"SB 17 Umberg Senate Third Reading By Gabriel",79,0,0,0,79
1132007,890553,2019-09-10,Senate,"Unfinished Business SB17 Umberg Concurrence",40,0,0,0,40
1132008,842956,2019-04-10,Assembly,"Do pass and be re-referred to the Committee on [Natural Resources]",11,1,3,0,15
1132008,849120,2019-04-22,Assembly,"Do pass as amended and be re-referred to the Committee on [Appropriations]",6,2,3,0,11
1132008,866016,2019-05-16,Assembly,"Do pass",13,3,2,0,18
1132008,875341,2019-05-30,Assembly,"AB 56 Eduardo Garcia Assembly Third Reading",41,21,18,0,80
1132008,891446,2019-07-10,Senate,"Do pass as amended, but first amend, and re-refer to the Committee on [Appropriations]",5,3,5,0,13
1132008,891447,2019-08-28,Senate,"[08-28-2019] hearing: Motion to Reconsider. [Reconsideration Granted.]",11,0,2,0,13
1132010,842766,2019-04-11,Assembly,"AB 92 Ting Assembly Third Reading",54,13,13,0,80
1132010,881080,2019-06-12,Senate,"Do pass",15,0,3,0,18
1132010,969435,2020-06-26,Assembly,"AB 92 BUDGET Concurrence in Senate Amendments By TING",56,18,5,0,79
1132010,969727,2020-06-24,Senate,"Do pass",11,7,0,0,18
1132010,969728,2020-06-25,Senate,"Assembly 3rd Reading AB92 BUDGET (Ting)",27,13,0,0,40
1132011,842674,2019-04-11,Assembly,"AB 88 Ting Assembly Third Reading",54,13,13,0,80
1132011,969740,2020-06-24,Senate,"Do pass",12,6,0,0,18
1132011,969741,2020-06-25,Senate,"Assembly 3rd Reading AB88 BUDGET (Ting)",28,12,0,0,40
1132013,829337,2019-03-25,Assembly,"Do pass and be re-referred to the Committee on [Appropriations]",11,0,4,0,15
1132013,841325,2019-04-10,Assembly,"Do pass",12,1,5,0,18
1132013,873925,2019-05-28,Assembly,"AB 29 Holden Assembly Third Reading",57,13,10,0,80
1132013,891151,2019-07-09,Senate,"Do pass as amended, but first amend, and re-refer to the Committee on [Appropriations]",12,0,1,0,13
1132013,891152,2019-08-19,Senate,"Placed on suspense file",5,0,2,0,7
1132013,891153,2019-08-30,Senate,"Do pass as amended",5,2,0,0,7
1132013,893928,2019-09-14,Assembly,"AB 29 HOLDEN Concurrence in Senate Amendments",0,0,0,0,0
1132013,894199,2019-09-13,Senate,"Assembly 3rd Reading AB29 Holden et al. By Leyva",32,4,0,0,36
1132013,894378,2019-09-14,Senate,"Assembly 3rd Reading AB29 Holden et al. By Leyva",32,4,4,0,40
1132014,839926,2019-04-08,Assembly,"Do pass and be re-referred to the Committee on [Appropriations]",10,1,0,0,11
1132014,865814,2019-05-16,Assembly,"Do pass",17,1,0,0,18
1132014,871497,2019-05-23,Assembly,"AB 37 Jones-Sawyer Assembly Third Reading",69,1,10,0,80
1132014,881048,2019-06-12,Senate,"Do pass as amended, but first amend, and re-refer to the Committee on [Appropriations]",4,1,2,0,7
1132014,887074,2019-06-24,Senate,"Placed on suspense file",7,0,0,0,7
1132014,893033,2019-08-30,Senate,"Do pass as amended",6,1,0,0,7
1132014,893034,2019-09-04,Senate,"Assembly 3rd Reading AB37 Jones-Sawyer et al. By McGuire",33,5,2,0,40
1132014,893035,2019-09-09,Assembly,"AB 37 Jones-Sawyer Concurrence in Senate Amendments",71,3,5,0,79
1132014,894035,2019-08-30,Senate,Date,7,0,0,0,7
1132015,842966,2019-04-11,Assembly,"AB 107 Ting Assembly Third Reading",54,13,13,0,80
1132015,977446,2020-08-29,Senate,"Do pass",13,5,0,0,18
1132015,977873,2020-08-31,Senate,"Assembly 3rd Reading AB107 BUDGET (Ting) By Mitchell",29,10,1,0,40
1132015,977874,2020-08-31,Assembly,"AB 107 BUDGET Concurrence in Senate Amendments By TING",59,17,3,0,79
1132016,842985,2019-04-11,Assembly,"AB 117 Ting Assembly Third Reading",54,13,13,0,80
1132017,902212,2020-01-13,Assembly,"Do pass as amended and be re-referred to the Committee on [Appropriations]",11,0,0,0,11
1132018,829407,2019-03-25,Assembly,"Do pass and be re-referred to the Committee on [Appropriations]",11,0,0,0,11
1132018,835336,2019-04-03,Assembly,"Do pass. To Consent Calendar",17,0,1,0,18
1132018,848923,2019-04-22,Assembly,"AB 65 Petrie-Norris Assembly Third Reading",77,0,3,0,80
1132018,880325,2019-06-11,Senate,"Do pass as amended, but first amend, and re-refer to the Committee on [Environmental Quality] with the recommendation: To Consent Calendar",8,0,1,0,9
1132018,884982,2019-06-19,Senate,"Do pass, but first be re-referred to the Committee on [Rules] with the recommendation: To Consent Calendar",7,0,0,0,7
1132018,890428,2019-07-03,Senate,"Do pass, but first be re-referred to the Committee on [Appropriations] with the recommendation: To Consent Calendar",7,0,0,0,7
1132018,890429,2019-09-10,Senate,"Assembly 3rd Reading AB65 Petrie-Norris et al. By Hill",39,1,0,0,40
1132018,890430,2019-09-11,Assembly,"AB 65 Petrie-Norris Concurrence in Senate Amendments",79,0,0,0,79
1132019,843022,2019-04-11,Assembly,"AB 118 Ting Assembly Third Reading",54,13,13,0,80
1132019,891998,2019-09-10,Senate,"Do pass",13,2,3,0,18
1132019,893803,2019-09-12,Senate,"Assembly 3rd Reading AB118 BUDGET (Ting) By Mitchell",32,3,5,0,40
1132019,893804,2019-09-12,Assembly,"AB 118 BUDGET Concurrence in Senate Amendments By TING",76,0,3,0,79
1132020,842984,2019-04-11,Assembly,"AB 97 Ting Assembly Third Reading",54,13,13,0,80
1132020,881078,2019-06-12,Senate,"Do pass",11,3,4,0,18
1132020,887010,2019-06-24,Senate,"Assembly 2nd Reading AB97 BUDGET (Ting) By Mitchell Urgency Clause",28,9,3,0,40
1132020,888390,2019-06-27,Assembly,"AB 97 BUDGET Concurrence - Urgency Added By TING",57,11,11,0,79
1132021,842976,2019-04-11,Assembly,"AB 74 Ting Assembly Third Reading",54,13,13,0,80
1132021,867760,2019-05-20,Senate,"Assembly 3rd Reading AB74 Ting By Mitchell",28,10,0,0,38
1132021,870148,2019-05-22,Assembly,"AB 74 Ting Concurrence in Senate Amendments",1,75,4,0,80
1132021,881542,2019-06-13,Assembly,"AB 74 Ting Conference Report",60,17,2,0,79
1132021,882256,2019-06-13,Senate,"Conference Report AB74 Ting By Mitchell",29,11,0,0,40
1132022,834559,2019-04-02,Assembly,"Do pass and be re-referred to the Committee on [Appropriations]",12,0,0,0,12
1132022,866238,2019-05-16,Assembly,"Do pass as amended",13,0,5,0,18
1132022,871591,2019-05-23,Assembly,"AB 15 Nazarian Assembly Third Reading",77,0,3,0,80
1132022,894841,2019-05-16,Assembly,Result,13,0,0,0,13
1132023,833181,2019-03-27,Assembly,"Do pass as amended and be re-referred to the Committee on [Human Services]",5,1,0,0,6
1132023,839971,2019-04-09,Assembly,"Do pass and be re-referred to the Committee on [Appropriations]",8,0,0,0,8
1132023,865886,2019-05-16,Assembly,"Do pass",17,0,1,0,18
1132023,873911,2019-05-28,Assembly,"AB 6 Reyes Assembly Third Reading",72,0,8,0,80
1132023,884850,2019-06-19,Senate,"Do pass, but first be re-referred to the Committee on [Human Services]",7,0,0,0,7
1132023,892208,2019-07-08,Senate,"Do pass, but first be re-referred to the Committee on [Appropriations]",5,0,1,0,6
1132023,892209,2019-08-12,Senate,"Placed on suspense file",7,0,0,0,7
1132023,892210,2019-08-30,Senate,"Do pass as amended",7,0,0,0,7
1132024,834323,2019-04-02,Senate,"Do pass, but first be re-referred to the Committee on [Public Safety]",4,0,1,0,5
1132024,851589,2019-04-23,Senate,"Do pass, but first be re-referred to the Committee on [Appropriations]",5,1,1,0,7
1132024,868917,2019-05-21,Senate,"Senate 3rd Reading SB47 Allen",31,5,2,0,38
1132024,891928,2019-07-03,Assembly,"Do pass and be re-referred to the Committee on [Appropriations]",5,0,2,0,7
1132024,891929,2019-08-14,Assembly,"Do pass",14,3,1,0,18
1132024,891930,2019-09-11,Assembly,"SB 47 Allen Senate Third Reading By Mullin",64,11,4,0,79
1132024,893632,2019-09-12,Senate,"Unfinished Business SB47 Allen et al. Concurrence",32,8,0,0,40
1132025,842990,2019-04-11,Assembly,"AB 98 Ting Assembly Third Reading",54,13,13,0,80
1132026,842864,2019-04-11,Assembly,"AB 80 Ting Assembly Third Reading",54,13,13,0,80
1132026,884848,2019-06-19,Senate,"Do pass",11,3,4,0,18
1132026,969412,2020-06-26,Assembly,"AB 80 BUDGET Concurrence in Senate Amendments By TING",58,13,8,0,79
1132026,969747,2020-06-24,Senate,"Do pass",13,5,0,0,18
1132026,969748,2020-06-25,Senate,"Assembly 3rd Reading AB80 BUDGET (Ting)",29,11,0,0,40
1132028,850126,2019-04-22,Assembly,"Do pass and be re-referred to the Committee on [Appropriations]",10,0,1,0,11
1132028,905344,2020-01-23,Assembly,"Do pass as amended",18,0,0,0,18
1132028,906434,2020-01-27,Assembly,"AB 31 Cristina Garcia Assembly Third Reading",77,0,3,0,80
1132029,825922,2019-03-20,Senate,"Do pass, but first be re-referred to the Committee on [Governance and Finance]",5,2,0,0,7
1132029,852998,2019-04-24,Senate,"Do pass as amended, but first amend, and re-refer to the Committee on [Appropriations]",4,2,1,0,7
1132029,863270,2019-05-13,Senate,"Placed on suspense file",6,0,0,0,6
1132029,866078,2019-05-16,Senate,"Do pass as amended",4,2,0,0,6
1132029,873948,2019-05-28,Senate,"Senate 3rd Reading SB43 Allen",26,10,2,0,38
1132029,887040,2019-06-24,Assembly,"Do pass and be re-referred to the Committee on [Revenue and Taxation]",8,3,0,0,11
1132029,890759,2019-07-08,Assembly,"Do pass and be re-referred to the Committee on [Appropriations]",5,1,5,0,11
1132029,890760,2019-07-08,Assembly,Reconsideration,10,0,1,0,11
1132030,856683,2019-05-01,Assembly,"Do pass",6,0,1,0,7
1132030,862235,2019-05-09,Assembly,"AB 1 Cooper Assembly Third Reading",68,0,12,0,80
1132030,888080,2019-06-26,Senate,"Do pass",9,0,0,0,9
1132030,891149,2019-07-11,Senate,"Special Consent AB1",39,0,1,0,40
1132031,842771,2019-04-11,Assembly,"AB 120 Ting Assembly Third Reading",54,13,13,0,80
1132032,842925,2019-04-11,Assembly,"AB 81 Ting Assembly Third Reading",54,13,13,0,80
1132032,884630,2019-06-19,Senate,"Do pass",12,0,6,0,18
1132032,969407,2020-06-26,Assembly,"AB 81 BUDGET Concurrence in Senate Amendments By TING",59,10,10,0,79
1132032,969737,2020-06-24,Senate,"Do pass",13,5,0,0,18
1132032,969738,2020-06-25,Senate,"Assembly 3rd Reading AB81 BUDGET (Ting)",28,11,1,0,40
1132033,829376,2019-03-26,Senate,"Do pass, but first be re-referred to the Committee on [Appropriations]",7,0,0,0,7
1132033,853099,2019-04-25,Senate,"Senate 3rd Reading SB36 Hertzberg et al",37,0,1,0,38
1132033,880581,2019-06-11,Assembly,"Do pass and be re-referred to the Committee on [Appropriations] with recommendation: To Consent Calendar",8,0,0,0,8
1132033,884679,2019-06-19,Assembly,"Do pass. To Consent Calendar",17,0,1,0,18
1132033,891636,2019-09-10,Assembly,"SB 36 Hertzberg Senate Third Reading By Weber",79,0,0,0,79
1132033,891637,2019-09-11,Senate,"Unfinished Business SB36 Hertzberg et al. Concurrence",40,0,0,0,40
1132034,842933,2019-04-11,Assembly,"AB 95 Ting Assembly Third Reading",54,13,13,0,80
1132034,881068,2019-06-12,Senate,"Do pass",16,0,2,0,18
1132038,842929,2019-04-11,Assembly,"AB 85 Ting Assembly Third Reading",54,13,13,0,80
1132038,881006,2019-06-12,Senate,"Do pass",12,5,1,0,18
1132038,965938,2020-06-12,Senate,"Do pass",12,5,1,0,18
1132038,966452,2020-06-15,Senate,"WORF AB85 BUDGET (Ting) By Mitchell",27,11,2,0,40
1132038,966453,2020-06-15,Assembly,"AB 85 BUDGET Concurrence in Senate Amendments By TING",56,20,3,0,79
1132039,822757,2019-03-14,Assembly,"Be adopted. To third reading",11,0,1,0,12
1132039,848752,2019-04-22,Senate,"Special Consent ACR2",38,0,0,0,38
1132040,842845,2019-04-11,Assembly,"AB 110 Ting Assembly Third Reading",54,13,13,0,80
1132040,893215,2019-07-10,Senate,"Do pass",12,2,4,0,18
1132040,893216,2019-07-11,Senate,"Assembly 2nd Reading AB110 Ting By Mitchell",32,6,2,0,40
1132040,893217,2019-07-11,Assembly,"AB 110 TING Concurrence in Senate Amendments",76,0,3,0,79
1132041,819904,2019-03-12,Senate,"Do pass, but first be re-referred to the Committee on [Appropriations]",7,2,0,0,9
1132041,838630,2019-04-08,Senate,"Placed on suspense file",6,0,0,0,6
1132041,866198,2019-05-16,Senate,"Do pass",4,2,0,0,6
1132041,871124,2019-05-23,Senate,"Senate 3rd Reading SB8 Glazer et al",28,10,0,0,38
1132041,883856,2019-06-18,Assembly,"Do pass and be re-referred to the Committee on [Appropriations]",10,3,0,0,13
1132041,890801,2019-08-30,Assembly,"Do pass",14,4,0,0,18
1132041,890802,2019-09-10,Assembly,"SB 8 Glazer Senate Third Reading By Levine",59,17,3,0,79
1132041,890803,2019-09-11,Senate,"Unfinished Business SB8 Glazer et al. Concurrence",29,10,1,0,40
1132042,853163,2019-04-23,Assembly,"Do pass as amended and be re-referred to the Committee on [Appropriations]",7,0,0,0,7
1132042,866377,2019-05-16,Assembly,"Do pass",18,0,0,0,18
1132042,873845,2019-05-28,Assembly,"AB 23 Burke Assembly Third Reading",76,0,4,0,80
1132042,882817,2019-06-17,Senate,"Do pass, but first be re-referred to the Committee on [Appropriations]",8,0,1,0,9
1132042,889250,2019-07-01,Senate,"Placed on suspense file",7,0,0,0,7
1132042,890451,2019-08-30,Senate,"Do pass as amended",7,0,0,0,7
1132042,890452,2019-09-11,Senate,"Assembly 3rd Reading AB23 Burke By Allen",40,0,0,0,40
1132042,893760,2019-09-12,Assembly,"AB 23 Burke Concurrence in Senate Amendments",79,0,0,0,79
1132043,835426,2019-04-03,Senate,"Do pass, but first be re-referred to the Committee on [Governmental Organization]",7,0,0,0,7
1132043,850509,2019-04-23,Senate,"Do pass, but first be re-referred to the Committee on [Appropriations]",16,0,0,0,16
1132043,863175,2019-05-13,Senate,"Placed on suspense file",6,0,0,0,6
1132043,865636,2019-05-16,Senate,"Do pass",6,0,0,0,6
1132043,867850,2019-05-20,Senate,"Senate 3rd Reading SB3 Allen et al",38,0,0,0,38
1132043,888033,2019-06-25,Assembly,"Do pass and be re-referred to the Committee on [Appropriations]",12,0,0,0,12
1132045,842702,2019-04-11,Assembly,"AB 112 Ting Assembly Third Reading",54,13,13,0,80
1132045,892402,2019-09-10,Senate,"Do pass",13,4,1,0,18
1132046,842682,2019-04-11,Assembly,"AB 105 Ting Assembly Third Reading",54,13,13,0,80
1132046,884575,2019-06-19,Senate,"Do pass",11,3,4,0,18
1132046,969753,2020-06-24,Senate,"Do pass",13,5,0,0,18
1132046,969754,2020-06-25,Senate,"Assembly 3rd Reading AB105 Ting",28,11,1,0,40
1132047,842852,2019-04-11,Assembly,"AB 115 Ting Assembly Third Reading",54,13,13,0,80
1132047,892585,2019-09-10,Senate,"Do pass",12,4,2,0,18
1132047,893691,2019-09-12,Senate,"Assembly 3rd Reading AB115 BUDGET (Ting) By Mitchell",29,11,0,0,40
1132047,893692,2019-09-12,Assembly,"AB 115 BUDGET Concurrence in Senate Amendments By TING",55,13,11,0,79
1132048,831394,2019-03-27,Senate,"Do pass, but first be re-referred to the Committee on [Appropriations]",9,0,0,0,9
1132048,859581,2019-05-06,Senate,"Senate 3rd Reading SB39 Hill et al",38,0,0,0,38
1132048,890887,2019-07-10,Assembly,"Do pass and be re-referred to the Committee on [Appropriations]",21,0,0,0,21
1132048,890888,2019-08-14,Assembly,"Do pass",18,0,0,0,18
1132048,890889,2019-09-03,Assembly,"SB 39 Hill Senate Third Reading By McCarty",77,0,2,0,79
1132049,852849,2019-04-24,Assembly,"Do pass and be re-referred to the Committee on [Appropriations] with recommendation: To Consent Calendar",7,0,0,0,7
1132050,841631,2019-04-09,Assembly,"Do pass and be re-referred to the Committee on [Revenue and Taxation]",5,3,0,0,8
1132050,850500,2019-04-22,Assembly,"Do pass as amended and be re-referred to the Committee on [Appropriations]",8,3,0,0,11
1132051,842673,2019-04-11,Assembly,"AB 89 Ting Assembly Third Reading",54,13,13,0,80
1132051,969406,2020-06-26,Assembly,"AB 89 Ting Concurrence in Senate Amendments",58,17,4,0,79
1132051,969786,2020-06-24,Senate,"Do pass",13,5,0,0,18
1132051,969787,2020-06-25,Senate,"Assembly 3rd Reading AB89 Ting",29,11,0,0,40
1132052,842637,2019-04-11,Assembly,"AB 75 Ting Assembly Third Reading",54,13,13,0,80
1132052,884624,2019-06-19,Senate,"Do pass",12,4,2,0,18
1132052,965941,2020-06-12,Senate,"Do pass",17,0,1,0,18
1132052,969414,2020-06-26,Assembly,"AB 75 BUDGET Concurrence in Senate Amendments By TING",75,0,4,0,79
1132052,969739,2020-06-25,Senate,"Assembly 3rd Reading AB75 BUDGET (Ting) By Mitchell",40,0,0,0,40
1132054,819830,2019-03-12,Senate,"Do pass, but first be re-referred to the Committee on [Appropriations]",15,0,1,0,16
1132054,838641,2019-04-08,Senate,"Placed on suspense file",6,0,0,0,6
1132054,865938,2019-05-16,Senate,"Do pass",6,0,0,0,6
1132054,867790,2019-05-20,Senate,"Senate 3rd Reading SB20 Dodd et al",38,0,0,0,38
1132054,893239,2019-07-03,Assembly,"Do pass and be re-referred to the Committee on [Appropriations]",6,0,1,0,7
1132054,893240,2019-08-14,Assembly,"Do pass",18,0,0,0,18
1132054,893241,2019-08-22,Assembly,"SB 20 Dodd Senate Third Reading By Aguiar-Curry",74,0,5,0,79
1132056,842811,2019-04-10,Assembly,"Do pass and be re-referred to the Committee on [Appropriations]",6,0,0,0,6
1132056,851614,2019-04-24,Assembly,"Do pass. To Consent Calendar",18,0,0,0,18
1132056,858219,2019-05-02,Assembly,"AB 34 Ramos Consent Calendar Second Day Regular Session",76,0,4,0,80
1132056,878262,2019-06-05,Senate,"Do pass as amended, but first amend, and re-refer to the Committee on [Appropriations] with the recommendation: To Consent Calendar",7,0,0,0,7
1132056,893664,2019-08-26,Senate,"Assembly 3rd Reading AB34 Ramos et al. By Rubio",39,0,1,0,40
1132056,893665,2019-08-30,Assembly,"AB 34 Ramos Concurrence in Senate Amendments",75,0,4,0,79
1132057,851379,2019-04-23,Assembly,"Do pass and be re-referred to the Committee on [Appropriations]",10,0,1,0,11
1132057,856964,2019-05-01,Assembly,"Do pass. To Consent Calendar",18,0,0,0,18
1132057,874654,2019-05-29,Assembly,"AB 25 Chau Assembly Third Reading",77,0,3,0,80
1132057,890691,2019-07-09,Senate,"Do pass as amended, but first amend, and re-refer to the Committee on [Appropriations]",8,0,1,0,9
1132057,893771,2019-09-12,Senate,"Assembly 3rd Reading AB25 Chau et al. By Dodd",40,0,0,0,40
1132057,893905,2019-09-13,Assembly,"AB 25 Chau Concurrence in Senate Amendments",78,0,1,0,79
1132059,851277,2019-04-23,Assembly,"Do pass and be re-referred to the Committee on [Appropriations] with recommendation: To Consent Calendar",19,0,1,0,20
1132060,835278,2019-04-03,Assembly,"Do pass and be re-referred to the Committee on [Local Government]",6,0,2,0,8
1132060,841312,2019-04-10,Assembly,"Do pass and be re-referred to the Committee on [Appropriations]",6,1,1,0,8
1132060,865824,2019-05-16,Assembly,"Do pass",15,1,2,0,18
1132060,869930,2019-05-22,Assembly,"AB 68 Ting Assembly Third Reading",61,10,9,0,80
1132060,883755,2019-06-18,Senate,"Do pass, but first be re-referred to the Committee on [Environmental Quality]",9,0,2,0,11
1132060,892358,2019-07-03,Senate,"Do pass, but first be re-referred to the Committee on [Governance and Finance]",4,1,2,0,7
1132060,892359,2019-07-10,Senate,"Do pass, but first be re-referred to the Committee on [Appropriations]",6,0,1,0,7
1132060,892360,2019-08-12,Senate,"Placed on suspense file",7,0,0,0,7
1132060,892361,2019-08-30,Senate,"Do pass",5,2,0,0,7
1132060,893901,2019-09-13,Assembly,"AB 68 Ting Concurrence in Senate Amendments",66,5,8,0,79
1132060,894148,2019-09-13,Senate,"Assembly 3rd Reading AB68 Ting et al. By Nielsen",26,10,4,0,40
1132061,842665,2019-04-11,Assembly,"AB 101 Ting Assembly Third Reading",54,13,13,0,80
1132061,889212,2019-07-01,Senate,"Do pass",15,0,3,0,18
1132061,889213,2019-07-01,Senate,"Assembly 3rd Reading AB101 BUDGET (Ting) By Mitchell",39,0,1,0,40
1132061,892304,2019-07-05,Assembly,"AB 101 BUDGET Concurrence in Senate Amendments By TING",65,0,14,0,79
1132062,854060,2019-04-24,Senate,"Do pass as amended, but first amend, and re-refer to the Committee on [Appropriations]",7,1,1,0,9
1132062,863133,2019-05-13,Senate,"Placed on suspense file",6,0,0,0,6
1132063,839719,2019-04-03,Assembly,"Do pass as amended and be re-referred to the Committee on [Natural Resources]",14,1,6,0,21
1132063,849076,2019-04-22,Assembly,"Do pass as amended and be re-referred to the Committee on [Appropriations]",9,1,1,0,11
1132063,865923,2019-05-16,Assembly,"Do pass as amended",14,1,3,0,18
1132063,871502,2019-05-23,Assembly,"AB 38 Wood Assembly Third Reading",70,2,8,0,80
1132063,887384,2019-06-25,Senate,"Do pass as amended, but first amend, and re-refer to the Committee on [Governmental Organization]",8,1,0,0,9
1132063,892262,2019-07-09,Senate,"Do pass, but first be re-referred to the Committee on [Appropriations]",13,1,2,0,16
1132063,892263,2019-08-12,Senate,"Placed on suspense file",7,0,0,0,7
1132063,892264,2019-08-30,Senate,"Do pass as amended",5,1,1,0,7
1132063,892265,2019-09-11,Senate,"Assembly 3rd Reading AB38 Wood et al. By Stern",35,2,3,0,40
1132063,893890,2019-09-13,Assembly,"With recommendation: That Senate amendments be concurred in, but first be re-referred to Com. on [Natural Resources]",17,0,4,0,21
1132063,893965,2019-09-13,Assembly,"With recommendation: That Senate amendments be concurred in",9,0,2,0,11
1132063,893966,2019-09-14,Assembly,"AB 38 Wood Concurrence in Senate Amendments",78,0,1,0,79
1132064,831456,2019-03-27,Senate,"Do pass, but first be re-referred to the Committee on [Appropriations]",9,0,0,0,9
1132064,838505,2019-04-08,Senate,"Placed on suspense file",6,0,0,0,6
1132064,865979,2019-05-16,Senate,"Do pass as amended",6,0,0,0,6
1132064,871492,2019-05-23,Senate,"Senate 3rd Reading SB12 Beall et al",37,0,1,0,38
1132064,883789,2019-06-18,Assembly,"Do pass and be re-referred to the Committee on [Appropriations]",14,0,1,0,15
1132064,895764,2019-05-16,Senate,Result,6,0,0,0,6
1132065,841548,2019-04-09,Senate,"Do pass, but first be re-referred to the Committee on [Appropriations]",11,1,0,0,12
1132065,855236,2019-04-29,Senate,"Placed on suspense file",6,0,0,0,6
1132065,866008,2019-05-16,Senate,"Do pass as amended",5,0,1,0,6
1132065,869968,2019-05-22,Senate,"Senate 3rd Reading SB7 Portantino et al",38,0,0,0,38
1132065,889221,2019-07-01,Assembly,"Do pass and be re-referred to the Committee on [Appropriations]",13,0,2,0,15
1132065,892732,2019-08-30,Assembly,"Do pass as amended",17,0,1,0,18
1132065,893913,2019-09-14,Assembly,"SB 7 Portantino Senate Third Reading By Carrillo",63,7,9,0,79
1132065,894193,2019-09-13,Senate,"Unfinished Business SB7 Portantino",33,0,0,0,33
1132065,894359,2019-09-14,Senate,"Unfinished Business SB7 Portantino",33,0,7,0,40
1132066,839919,2019-04-03,Senate,"Do pass as amended, but first amend, and re-refer to the Committee on [Appropriations]",7,0,0,0,7
1132066,854176,2019-04-29,Senate,"Placed on suspense file",6,0,0,0,6
1132066,865602,2019-05-16,Senate,"Do pass",6,0,0,0,6
1132066,873749,2019-05-28,Senate,"Senate 3rd Reading SB2 Glazer et al",37,0,1,0,38
1132067,841709,2019-04-10,Assembly,"Do pass and be re-referred to the Committee on [Local Government]",6,2,0,0,8
1132067,853024,2019-04-24,Assembly,"Do pass and be re-referred to the Committee on [Appropriations]",6,2,0,0,8
1132068,826014,2019-03-20,Senate,"Do pass as amended, but first amend, and re-refer to the Committee on [Business, Professions and Economic Development]",7,0,0,0,7
1132068,833202,2019-04-01,Senate,"Do pass as amended, but first amend, and re-refer to the Committee on [Appropriations]",9,0,0,0,9
1132068,848894,2019-04-22,Senate,"Placed on suspense file",6,0,0,0,6
1132068,866189,2019-05-16,Senate,"Do pass",6,0,0,0,6
1132068,867835,2019-05-20,Senate,"Senate 3rd Reading SB34 Wiener et al. Urgency Clause",35,0,3,0,38
1132068,880388,2019-06-11,Assembly,"Do pass and be re-referred to the Committee on [Revenue and Taxation]",15,0,4,0,19
1132068,892186,2019-07-08,Assembly,"Do pass and be re-referred to the Committee on [Appropriations]",10,0,1,0,11
1132068,892187,2019-08-30,Assembly,"Do pass as amended",16,0,2,0,18
1132068,892188,2019-09-10,Assembly,"SB 34 Wiener Senate Third Reading By Wood",73,0,6,0,79
1132068,892189,2019-09-11,Senate,"Unfinished Business SB34 Wiener et al. Concurrence",37,0,3,0,40
1132069,860711,2019-05-06,Assembly,"Do pass and be re-referred to the Committee on [Appropriations]",9,1,1,0,11
1132070,841737,2019-04-09,Assembly,"Do pass and be re-referred to the Committee on [Education]",7,0,1,0,8
1132070,852874,2019-04-24,Assembly,"Do pass and be re-referred to the Committee on [Appropriations] with recommendation: To Consent Calendar",7,0,0,0,7
1132070,866071,2019-05-16,Assembly,"Do pass as amended",18,0,0,0,18
1132070,874596,2019-05-29,Assembly,"AB 125 McCarty Assembly Third Reading",78,0,2,0,80
1132070,892146,2019-07-10,Senate,"Do pass, but first be re-referred to the Committee on [Appropriations] with the recommendation: To Consent Calendar",7,0,0,0,7
1132070,976004,2020-08-17,Senate,"Placed on suspense file",7,0,0,0,7
1132071,830399,2019-03-27,Assembly,"Do pass and be re-referred to the Committee on [Appropriations]",8,0,0,0,8
1132071,834803,2019-04-03,Assembly,"Do pass. To Consent Calendar",17,0,1,0,18
1132071,842841,2019-04-11,Assembly,"AB 58 Luz Rivas Consent Calendar Second Day Regular Session",72,0,8,0,80
1132071,880334,2019-06-10,Senate,"Do pass, but first be re-referred to the Committee on [Housing] with the recommendation: To Consent Calendar",5,0,1,0,6
1132071,891352,2019-07-02,Senate,"Do pass, but first be re-referred to the Committee on [Appropriations] with the recommendation: To Consent Calendar",11,0,0,0,11
1132071,891353,2019-09-03,Senate,"Assembly 3rd Reading AB58 Luz Rivas et al. By Durazo",40,0,0,0,40
1132071,891354,2019-09-05,Assembly,"AB 58 Luz Rivas Concurrence in Senate Amendments",79,0,0,0,79
1132071,894808,2019-09-03,Senate,"Assembly 3rd Reading AB58 div class=""statusCell"">",11,0,0,0,11
1132072,841366,2019-04-10,Senate,"Do pass as amended, but first amend, and re-refer to the Committee on [Transportation]",5,2,0,0,7
1132072,850503,2019-04-23,Senate,"Do pass as amended, but first amend, and re-refer to the Committee on [Appropriations]",9,3,0,0,12
1132072,863104,2019-05-13,Senate,"Placed on suspense file",6,0,0,0,6
1132072,866222,2019-05-16,Senate,"Do pass",4,2,0,0,6
1132072,867804,2019-05-20,Senate,"Senate 3rd Reading SB44 Skinner",30,7,1,0,38
1132072,889228,2019-07-01,Assembly,"Do pass and be re-referred to the Committee on [Natural Resources]",12,2,1,0,15
1132072,891418,2019-07-08,Assembly,"Do pass and be re-referred to the Committee on [Appropriations]",9,2,0,0,11
1132072,891419,2019-08-30,Assembly,"Do pass",14,4,0,0,18
1132072,891420,2019-09-09,Assembly,"SB 44 Skinner Senate Third Reading By Gabriel",63,12,4,0,79
1132072,891421,2019-09-11,Senate,"Unfinished Business SB44 Skinner et al. Concurrence",30,9,1,0,40
1132073,834955,2019-04-02,Senate,"Do pass, but first be re-referred to the Committee on [Governance and Finance]",9,1,1,0,11
1132073,852780,2019-04-24,Senate,"Do pass as amended, but first amend, and re-refer to the Committee on [Appropriations]",6,1,0,0,7
1132073,863033,2019-05-13,Senate,"Placed on suspense file",6,0,0,0,6
1132073,910526,2020-01-29,Senate,"Senate 3rd Reading SB50 Wiener et al",18,15,6,0,39
1132073,910527,2020-01-29,Senate,"Senate 3rd Reading SB50 Wiener et al. Reconsider",38,0,1,0,39
1132073,912027,2020-01-30,Senate,"Senate 3rd Reading SB50 Wiener et al",18,15,6,0,39
1132075,842889,2019-04-11,Assembly,"AB 84 Ting Assembly Third Reading",54,13,13,0,80
1132075,880965,2019-06-12,Senate,"Do pass",12,0,6,0,18
1132075,969388,2020-06-26,Assembly,"AB 84 BUDGET Concurrence in Senate Amendments By TING",58,16,5,0,79
1132075,969749,2020-06-24,Senate,"Do pass",13,4,1,0,18
1132075,969750,2020-06-25,Senate,"Assembly 3rd Reading AB84 BUDGET (Ting)",30,9,1,0,40
1132075,969751,2020-06-25,Senate,"Assembly 3rd Reading AB84 BUDGET (Ting) Reconsider",40,0,0,0,40
1132075,969752,2020-06-25,Senate,"Assembly 3rd Reading AB84 BUDGET (Ting)",29,10,1,0,40
1132076,830376,2019-03-27,Assembly,"Do pass and be re-referred to the Committee on [Revenue and Taxation]",8,0,0,0,8
1132076,860761,2019-05-06,Assembly,"Do pass and be re-referred to the Committee on [Appropriations]",11,0,0,0,11
1132076,865876,2019-05-16,Assembly,"Do pass",18,0,0,0,18
1132076,870123,2019-05-22,Assembly,"AB 10 Chiu Assembly Third Reading",77,0,3,0,80
1132076,892550,2019-07-02,Senate,"Do pass, but first be re-referred to the Committee on [Governance and Finance]",10,0,1,0,11
1132076,892551,2019-08-14,Senate,"Do pass, but first be re-referred to the Committee on [Appropriations]",6,0,1,0,7
1132076,892552,2019-08-26,Senate,"Placed on suspense file",6,0,1,0,7
1132251,841608,2019-04-09,Assembly,"Do pass as amended and be re-referred to the Committee on [Appropriations]",10,1,3,0,14
1132251,856760,2019-05-01,Assembly,"Do pass",14,0,4,0,18
1132251,862082,2019-05-09,Assembly,"AB 128 Gloria Assembly Third Reading",70,0,10,0,80
1132251,890572,2019-07-09,Senate,"Do pass, but first be re-referred to the Committee on [Appropriations]",7,1,1,0,9
1132251,890573,2019-09-04,Senate,"Assembly 3rd Reading AB128 Gloria et al. By Hertzberg",33,5,2,0,40
1132251,890574,2019-09-09,Assembly,"AB 128 Gloria Concurrence in Senate Amendments",73,0,6,0,79
1132253,809266,2019-02-26,Assembly,"Do pass. To Consent Calendar",8,0,0,0,8
1132253,816506,2019-03-07,Assembly,"AB 127 Lackey Consent Calendar Second Day",74,0,6,0,80
1132253,877731,2019-06-04,Senate,"Do pass and be ordered to the Consent Calendar",7,0,0,0,7
1132253,882977,2019-06-17,Senate,"Consent Calendar AB127 Lackey et al. Urgency Clause",40,0,0,0,40
1132253,889294,2019-07-01,Assembly,"AB 127 Lackey Concurrence in Senate Amendments",78,0,1,0,79
1132253,895285,2019-06-17,Senate,"Consent Calendar AB127 Lackey lass=""statusCell"">",7,0,0,0,7
1132257,834599,2019-04-03,Senate,"Do pass, but first be re-referred to the Committee on [Governance and Finance]",6,1,0,0,7
1132257,852894,2019-04-24,Senate,"Do pass as amended, but first amend, and re-refer to the Committee on [Appropriations]",6,1,0,0,7
1132257,863138,2019-05-13,Senate,"Placed on suspense file",6,0,0,0,6
1132257,865700,2019-05-16,Senate,"Do pass",4,1,1,0,6
1132257,868651,2019-05-21,Senate,"Senate 3rd Reading SB51 Hertzberg et al. Urgency Clause",36,1,1,0,38
1132257,887008,2019-06-24,Assembly,"Do pass and be re-referred to the Committee on [Business and Professions]",10,0,2,0,12
1132257,892942,2019-07-09,Assembly,"Do pass and be re-referred to the Committee on [Appropriations]",18,0,1,0,19
1132257,892943,2019-08-30,Assembly,"Do pass",16,1,1,0,18
1132257,977441,2020-08-30,Assembly,"Do pass and be re-referred to the Committee on [Appropriations]",9,0,2,0,11
1132257,977480,2020-08-31,Assembly,"Do pass",12,2,3,0,17
1132259,853105,2019-04-24,Senate,"Be adopted, but first be re-referred to the Committee on [Elections and Constitutional Amendments]",5,2,0,0,7
1132259,860596,2019-05-07,Senate,"Be adopted, but first be re-referred to the Committee on [Appropriations]",4,1,0,0,5
1132259,863069,2019-05-13,Senate,"Placed on suspense file",6,0,0,0,6
1132259,866543,2019-05-16,Senate,"Be adopted",4,2,0,0,6
1132259,894844,2019-05-16,Senate,Result,4,2,0,0,6
1132263,835404,2019-04-02,Assembly,"Do pass and be re-referred to the Committee on [Appropriations]",10,0,2,0,12
1132263,865652,2019-05-16,Assembly,"Do pass",18,0,0,0,18
1132263,870224,2019-05-22,Assembly,"AB 130 Low Assembly Third Reading",76,1,3,0,80
1132263,888101,2019-06-26,Senate,"Do pass, but first be re-referred to the Committee on [Governmental Organization]",7,0,0,0,7
1132263,892647,2019-07-09,Senate,"Do pass as amended, but first amend, and re-refer to the Committee on [Appropriations]",15,0,1,0,16
1132263,892648,2019-08-19,Senate,"Placed on suspense file",5,0,2,0,7
1132263,892649,2019-08-30,Senate,"Do pass",6,0,1,0,7
1132263,892650,2019-09-11,Senate,"Assembly 3rd Reading AB130 Low et al. By Allen",39,1,0,0,40
1132263,893697,2019-09-12,Assembly,"AB 130 Low Concurrence in Senate Amendments",78,1,0,0,79
1132342,860841,2019-05-06,Assembly,"Do pass and be re-referred to the Committee on [Appropriations]",10,0,1,0,11
1132342,865975,2019-05-16,Assembly,"Do pass",15,0,3,0,18
1132342,871203,2019-05-23,Assembly,"AB 136 Quirk-Silva Assembly Third Reading Amend By QUIRK-SILVA Set #1",69,0,11,0,80
1132342,874446,2019-05-29,Assembly,"AB 136 Quirk-Silva Assembly Third Reading",76,0,4,0,80
1132342,888114,2019-06-26,Senate,"Do pass as amended, but first amend, and re-refer to the Committee on [Appropriations]",7,0,0,0,7
1132342,891210,2019-09-03,Senate,"Assembly 3rd Reading AB136 Quirk-Silva By McGuire",40,0,0,0,40
1132342,891211,2019-09-05,Assembly,"AB 136 Quirk-Silva Concurrence in Senate Amendments",77,0,2,0,79
1132348,816017,2019-03-04,Assembly,"Do pass as amended and be re-referred to the Committee on [Appropriations]",9,0,2,0,11
1132348,866211,2019-05-16,Assembly,"Do pass as amended",13,0,5,0,18
1132348,871293,2019-05-23,Assembly,"AB 133 Quirk-Silva Assembly Third Reading",77,0,3,0,80
1132348,885024,2019-06-19,Senate,"Do pass as amended, but first amend, and re-refer to the Committee on [Appropriations]",6,0,1,0,7
1132348,890647,2019-07-08,Senate,"Placed on suspense file",7,0,0,0,7
1132348,890648,2019-08-30,Senate,"Do pass",7,0,0,0,7
1132348,890649,2019-09-09,Senate,"Special Consent AB133",40,0,0,0,40
1132348,890650,2019-09-10,Assembly,"AB 133 Quirk-Silva Concurrence in Senate Amendments",78,0,1,0,79
1132351,830320,2019-03-26,Assembly,"Do pass and be re-referred to the Committee on [Appropriations]",6,0,3,0,9
1132351,866330,2019-05-16,Assembly,"Do pass as amended",14,1,3,0,18
1132351,874650,2019-05-29,Assembly,"AB 134 Bloom Assembly Third Reading",59,0,21,0,80
1132356,819818,2019-03-12,Assembly,"Do pass and be re-referred to the Committee on [Appropriations]",7,1,0,0,8
1132356,865939,2019-05-16,Assembly,"Do pass",18,0,0,0,18
1132356,874610,2019-05-29,Assembly,"AB 135 Cervantes Assembly Third Reading",75,1,4,0,80
1132356,891193,2019-07-02,Senate,"Do pass, but first be re-referred to the Committee on [Appropriations]",3,0,4,0,7
1132356,891194,2019-07-02,Senate,"[First] hearing set for [07-02-2019]: Failed passage in Committee. Reconsideration granted",7,0,0,0,7
1132605,824895,2019-03-19,Assembly,"Do pass",7,1,0,0,8
1132605,831553,2019-03-28,Assembly,"AB 137 Cooper Assembly Third Reading",63,3,14,0,80
1132605,848387,2019-03-19,Assembly,Noes:,0,1,0,0,1
1132605,892843,2019-07-09,Senate,"Do pass as amended, but first amend, and re-refer to the Committee on [Appropriations] with the recommendation: To Consent Calendar",8,0,1,0,9
1132605,892844,2019-08-12,Senate,"Placed on suspense file",7,0,0,0,7
1132606,841638,2019-04-09,Assembly,"Do pass and be re-referred to the Committee on [Revenue and Taxation]",8,6,1,0,15
1132666,830607,2019-03-27,Senate,"Do pass, but first be re-referred to the Committee on [Appropriations] with the recommendation: To Consent Calendar",7,0,0,0,7
1132666,838635,2019-04-08,Senate,"Placed on suspense file",6,0,0,0,6
1132677,820025,2019-03-12,Senate,"Do pass, but first be re-referred to the Committee on [Appropriations]",14,0,2,0,16
1132677,838627,2019-04-08,Senate,"Do pass",6,0,0,0,6
1132677,849038,2019-04-22,Senate,"Senate 3rd Reading SB53 Wilk et al. Urgency Clause",38,0,0,0,38
1132677,892200,2019-07-10,Assembly,"Do pass and be re-referred to the Committee on [Appropriations]",21,0,0,0,21
1132677,896108,2019-04-08,Senate,Result,14,0,0,0,14
1132942,815365,2019-03-05,Assembly,"Do pass and be re-referred to the Committee on [Appropriations]",8,2,2,0,12
1132953,852790,2019-04-24,Assembly,"Do pass and be re-referred to the Committee on [Appropriations]",8,0,0,0,8
1132953,866422,2019-05-16,Assembly,"Do pass",18,0,0,0,18
1132953,871138,2019-05-23,Assembly,"AB 139 Quirk-Silva Assembly Third Reading",77,0,3,0,80
1132953,892397,2019-07-02,Senate,"Do pass as amended, but first amend, and re-refer to the Committee on [Appropriations]",11,0,0,0,11
1132953,892398,2019-08-12,Senate,"Placed on suspense file",7,0,0,0,7
1132953,892399,2019-08-30,Senate,"Do pass as amended",7,0,0,0,7
1132953,892400,2019-09-10,Senate,"Assembly 3rd Reading AB139 Quirk-Silva By Beall",40,0,0,0,40
1132953,892401,2019-09-11,Assembly,"AB 139 Quirk-Silva Concurrence in Senate Amendments",79,0,0,0,79
1132964,825958,2019-03-20,Senate,"Do pass, but first be re-referred to the Committee on [Appropriations]",5,0,2,0,7
1132964,863142,2019-05-13,Senate,"Placed on suspense file",6,0,0,0,6
1132964,865761,2019-05-16,Senate,"Do pass",4,2,0,0,6
1132964,874448,2019-05-29,Senate,"Senate 3rd Reading SB54 Allen et al",28,8,2,0,38
1132964,891714,2019-07-08,Assembly,"Do pass as amended and be re-referred to the Committee on [Appropriations]",7,3,1,0,11
1132964,891715,2019-08-30,Assembly,"Do pass",12,4,2,0,18
1132964,891716,2019-09-06,Assembly,"SB 54 Allen Senate Third Reading By Gonzalez Amendment Set #1",38,16,25,0,79
1132964,891717,2019-09-11,Assembly,"Do pass",6,2,3,0,11
1132964,978063,2020-09-01,Assembly,"SB 54 Allen Senate Third Reading By Gonzalez",37,18,24,0,79
1133069,833031,2019-03-26,Senate,"Do pass as amended, but first amend, and re-refer to the Committee on [Appropriations]",5,1,1,0,7
1133069,848762,2019-04-22,Senate,"Placed on suspense file",6,0,0,0,6
1133069,865538,2019-05-16,Senate,"Do pass as amended",4,2,0,0,6
1133069,871549,2019-05-23,Senate,"Senate 3rd Reading SB55 Jackson et al",26,10,2,0,38
1133070,833107,2019-04-01,Assembly,"Be re-referred to the Committee on [Local Government]",10,0,2,0,12
1133070,852970,2019-04-24,Assembly,"Do pass and be re-referred to the Committee on [Appropriations]",8,0,0,0,8
1133616,902196,2020-01-13,Assembly,"Do pass. To Consent Calendar",15,0,0,0,15
1133616,903563,2020-01-17,Assembly,"AB 145 Frazier Consent Calendar Second Day",72,0,8,0,80
1133618,839897,2019-04-08,Assembly,"Do pass and be re-referred to the Committee on [Appropriations]",11,0,0,0,11
1133622,852822,2019-04-24,Assembly,"Do pass and be re-referred to the Committee on [Appropriations] with recommendation: To Consent Calendar",8,0,0,0,8
1133622,856743,2019-05-01,Assembly,"Do pass. To Consent Calendar",18,0,0,0,18
1133622,862106,2019-05-09,Assembly,"AB 143 Quirk-Silva Consent Calendar Second Day Regular Session",76,0,4,0,80
1133622,877660,2019-06-04,Senate,"Do pass as amended, but first amend, and re-refer to the Committee on [Environmental Quality]",9,1,1,0,11
1133622,884636,2019-06-19,Senate,"Do pass, but first be re-referred to the Committee on [Appropriations]",7,0,0,0,7
1133622,889290,2019-07-01,Senate,"Placed on suspense file",7,0,0,0,7
1133622,892355,2019-08-30,Senate,"Do pass as amended",7,0,0,0,7
1133622,892356,2019-09-05,Senate,"Assembly 3rd Reading AB143 Quirk-Silva et al. By Beall Urgency Clause",39,1,0,0,40
1133622,892357,2019-09-09,Assembly,"AB 143 Quirk-Silva Concurrence - Urgency Added",79,0,0,0,79
1133626,819910,2019-03-12,Assembly,"Do pass and be re-referred to the Committee on [Appropriations]",5,2,2,0,9
1133626,865946,2019-05-16,Assembly,"Do pass as amended",11,6,1,0,18
1133626,872289,2019-05-24,Assembly,"AB 142 Cristina Garcia Third Reading Urgency",54,17,9,0,80
1133626,884865,2019-06-19,Senate,"Do pass as amended, but first amend, and re-refer to the Committee on [Governance and Finance]",5,0,2,0,7
1133626,890932,2019-07-10,Senate,"Do pass as amended, but first amend, and re-refer to the Committee on [Appropriations]",5,0,2,0,7
1133626,890933,2019-08-19,Senate,"Placed on suspense file",5,0,2,0,7
1133626,890934,2019-08-30,Senate,"Do pass",5,2,0,0,7
1133626,890935,2019-09-04,Senate,"Assembly 3rd Reading AB142 Cristina Garcia By Durazo Urgency Clause",28,10,2,0,40
1133626,890936,2019-09-09,Assembly,"AB 142 Cristina Garcia Concurrence in Senate Amendments",55,19,5,0,79
1133848,903141,2020-01-15,Assembly,"Do pass and be re-referred to the Committee on [Appropriations]",6,0,1,0,7
1133848,905342,2020-01-23,Assembly,"Do pass",18,0,0,0,18
1133848,912017,2020-01-30,Assembly,"AB 150 Cooper Assembly Third Reading",75,0,5,0,80
1133851,783474,2019-01-17,Assembly,"Be adopted. To third reading",7,0,4,0,11
1133851,783740,2019-01-18,Assembly,"AJR 1 DALY Assembly Third Reading",68,0,12,0,80
1133851,797224,2019-02-11,Senate,"Assembly 3rd Reading AJR1 Daly et al. By Umberg",37,0,1,0,38
1133851,803892,2019-02-19,Assembly,"AJR 1 Daly Concurrence in Senate Amendments",62,0,18,0,80
1133851,896447,2019-01-18,Assembly,"Bill Votes",7,0,0,0,7
1133854,788177,2019-01-29,Assembly,"Do pass as amended and be re-referred to the Committee on [Appropriations]",16,0,4,0,20
1133854,792287,2019-02-04,Assembly,"Do pass. To Consent Calendar",15,0,2,0,17
1133854,795431,2019-02-07,Assembly,"AB 149 Cooper Consent Calendar Second Day",77,0,3,0,80
1133854,803973,2019-02-19,Senate,"Do pass, but first be re-referred to the Committee on [Appropriations]",9,0,0,0,9
1133854,805254,2019-02-20,Senate,"Do pass",6,0,0,0,6
1133854,808204,2019-02-25,Senate,"Assembly 3rd Reading AB149 Cooper et al. By Pan Urgency Clause",35,0,3,0,38
1133854,811640,2019-02-28,Assembly,"AB 149 Cooper Concurrence in Senate Amendments",76,0,4,0,80
1133856,809161,2019-02-25,Assembly,"Do pass and be re-referred to the Committee on [Appropriations]",11,0,0,0,11
1133856,815320,2019-03-06,Assembly,"Do pass as amended",11,0,7,0,18
1133856,822094,2019-03-14,Assembly,"AB 147 Burke Third Reading Urgency",69,0,11,0,80
1133856,830346,2019-03-27,Senate,"Do pass, but first be re-referred to the Committee on [Appropriations]",7,0,0,0,7
1133856,836744,2019-04-04,Senate,"Assembly 3rd Reading AB147 Burke et al. By McGuire Urgency Clause",36,0,2,0,38
1133856,838567,2019-04-08,Assembly,"AB 147 Burke Concurrence in Senate Amendments",71,0,9,0,80
1133931,822252,2019-03-12,Senate,"Do pass as amended, but first amend, and re-refer to the Committee on [Appropriations]",10,4,2,0,16
1133931,848838,2019-04-22,Senate,"Placed on suspense file",6,0,0,0,6
1133931,865978,2019-05-16,Senate,"Do pass",5,1,0,0,6
1133931,868565,2019-05-21,Senate,"Senate 3rd Reading SB58 Wiener et al",29,6,3,0,38
1133931,890909,2019-07-10,Assembly,"Do pass and be re-referred to the Committee on [Appropriations]",11,5,5,0,21
1133931,890910,2019-08-30,Assembly,"Do pass as amended",13,4,1,0,18
1133931,893932,2019-09-14,Assembly,"SB 58 Wiener Senate Third Reading By Santiago",29,35,15,0,79
1133932,901398,2020-01-07,Senate,"Do pass, but first be re-referred to the Committee on [Transportation]",1,3,1,0,5
1133933,827067,2019-03-20,Senate,"Do pass as amended, but first amend, and re-refer to the Committee on [Appropriations]",6,0,1,0,7
1133933,839630,2019-04-08,Senate,"Placed on suspense file",6,0,0,0,6
1133933,865528,2019-05-16,Senate,"Do pass as amended",6,0,0,0,6
1133933,870104,2019-05-22,Senate,"Senate 3rd Reading SB56 Roth et al",38,0,0,0,38
1135202,841710,2019-04-09,Senate,"Do pass, but first be re-referred to the Committee on [Environmental Quality]",10,1,1,0,12
1135202,851513,2019-04-24,Senate,"Do pass, but first be re-referred to the Committee on [Appropriations]",7,0,0,0,7
1135202,863183,2019-05-13,Senate,"Placed on suspense file",6,0,0,0,6
1135202,866257,2019-05-16,Senate,"Do pass as amended",5,0,1,0,6
1135202,868846,2019-05-21,Senate,"Senate 3rd Reading SB59 Allen",37,1,0,0,38
1135202,889210,2019-07-01,Assembly,"Do pass as amended and be re-referred to the Committee on [Communications and Conveyance]",13,0,2,0,15
1135202,891885,2019-07-10,Assembly,"Do pass and be re-referred to the Committee on [Appropriations]",10,1,2,0,13
1135232,829464,2019-03-26,Senate,"Do pass, but first be re-referred to the Committee on [Appropriations] with the recommendation: To Consent Calendar",8,0,0,0,8
1135232,848917,2019-04-22,Senate,"Consent Calendar SB60",38,0,0,0,38
1135232,877579,2019-06-04,Assembly,"Do pass and be re-referred to the Committee on [Appropriations] with recommendation: To Consent Calendar",11,0,1,0,12
1135232,884725,2019-06-19,Assembly,"Do pass. To Consent Calendar",17,0,1,0,18
1137254,834409,2019-04-02,Senate,"Do pass, but first be re-referred to the Committee on [Appropriations]",5,2,0,0,7
1137254,848888,2019-04-22,Senate,"Placed on suspense file",6,0,0,0,6
1137254,866429,2019-05-16,Senate,"Do pass as amended",4,2,0,0,6
1137254,869724,2019-05-22,Senate,"Senate 3rd Reading SB61 Portantino et al",27,10,1,0,38
1137254,887433,2019-06-25,Assembly,"Do pass and be re-referred to the Committee on [Appropriations]",5,2,1,0,8
1137254,892842,2019-08-30,Assembly,"Do pass as amended",13,5,0,0,18
1137254,893948,2019-09-13,Assembly,"SB 61 Portantino Senate Third Reading By Maienschein",55,22,2,0,79
1137254,894203,2019-09-13,Senate,"Unfinished Business SB61 Portantino",28,11,1,0,40
1137257,783787,2019-01-18,Senate,"Senate 3rd Reading SCR3 Bates et al",34,0,4,0,38
1137257,826738,2019-03-21,Assembly,"Be adopted. To Consent Calendar",11,0,1,0,12
1137257,831562,2019-03-28,Assembly,"SCR 3 Bates Consent Calendar Second Day Regular Session",72,0,8,0,80
1137260,823991,2019-03-12,Senate,"Do pass as amended, but first amend, and re-refer to the Committee on [Appropriations]",8,0,1,0,9
1137260,859750,2019-05-06,Senate,"Do pass",5,0,1,0,6
1137260,862189,2019-05-09,Senate,"Senate 3rd Reading SB62 Dodd",38,0,0,0,38
1137260,884164,2019-06-18,Assembly,"Do pass and be re-referred to the Committee on [Appropriations]",13,0,0,0,13
1137260,894064,2019-07-03,Assembly,"Do pass. To Consent Calendar",17,0,1,0,18
1137260,894065,2019-07-11,Assembly,"SB 62 Dodd Consent Calendar Second Day Regular Session",76,0,3,0,79
1137262,781715,2019-01-07,Senate,"W/O REF. TO FILE SR9 Atkins",38,0,2,0,40
1140131,830448,2019-03-26,Assembly,"Do pass and be re-referred to the Committee on [Labor and Employment]",10,1,0,0,11
1140131,853135,2019-04-24,Assembly,"Do pass as amended and be re-referred to the Committee on [Appropriations]",7,0,0,0,7
1140131,865656,2019-05-16,Assembly,"Do pass",18,0,0,0,18
1140131,869960,2019-05-22,Assembly,"AB 160 Voepel Assembly Third Reading",75,0,5,0,80
1140131,891437,2019-07-02,Senate,"Do pass, but first be re-referred to the Committee on [Veterans Affairs]",4,3,2,0,9
1140131,891438,2019-07-02,Senate,"[First] hearing set for [07-03-2019]: Failed passage in Committee. Reconsideration granted",9,0,0,0,9
1140134,854824,2019-04-23,Assembly,"Do pass as amended and be re-referred to the Committee on [Appropriations]",12,1,2,0,15
1140134,866524,2019-05-16,Assembly,"Do pass",14,2,2,0,18
1140134,870151,2019-05-22,Assembly,"AB 166 Gabriel Assembly Third Reading",63,8,9,0,80
1140134,884861,2019-06-19,Senate,"Do pass as amended, but first amend, and re-refer to the Committee on [Appropriations]",7,2,0,0,9
1140134,892744,2019-08-12,Senate,"Placed on suspense file",7,0,0,0,7
1140134,892745,2019-08-30,Senate,"Do pass as amended",5,2,0,0,7
1140134,892746,2019-09-10,Senate,"Assembly 3rd Reading AB166 Gabriel et al. By Bradford",31,8,1,0,40
1140134,892747,2019-09-11,Assembly,"AB 166 Gabriel Concurrence in Senate Amendments",64,8,7,0,79
1140134,895546,2019-09-10,Senate,Assembloes,5,8,0,0,13
1140136,822104,2019-03-13,Assembly,"Be adopted. To Consent Calendar",6,0,0,0,6
1140136,826716,2019-03-21,Assembly,"ACR 8 Weber Consent Calendar Second Day Regular Session",72,0,8,0,80
1140136,849713,2019-04-22,Senate,"Special Consent ACR8",38,0,0,0,38
1140140,828208,2019-03-25,Senate,"Do pass, but first be re-referred to the Committee on [Appropriations]",9,0,0,0,9
1140140,852904,2019-04-25,Senate,"Senate 3rd Reading SB64 Chang et al",37,0,1,0,38
1140140,887452,2019-06-25,Assembly,"Do pass and be re-referred to the Committee on [Appropriations] with recommendation: To Consent Calendar",19,0,0,0,19
1140140,892807,2019-08-14,Assembly,"Do pass as amended",18,0,0,0,18
1140140,892808,2019-09-03,Assembly,"SB 64 Chang Senate Third Reading By Kalra",76,0,3,0,79
1140140,892809,2019-09-04,Senate,"Unfinished Business SB64 Chang et al. Concurrence",40,0,0,0,40
1140142,825993,2019-03-19,Assembly,"Do pass as amended and be re-referred to the Committee on [Appropriations]",12,0,0,0,12
1140148,856849,2019-05-01,Senate,"Do pass, but first be re-referred to the Committee on [Appropriations]",7,0,0,0,7
1140148,863243,2019-05-13,Senate,"Placed on suspense file",6,0,0,0,6
1140148,866523,2019-05-16,Senate,"Do pass",6,0,0,0,6
1140148,871315,2019-05-23,Senate,"Special Consent SB63 Hertzberg et al",38,0,0,0,38
1140148,893013,2019-07-08,Assembly,"Do pass and be re-referred to the Committee on [Appropriations]",10,0,1,0,11
1140148,893014,2019-08-30,Assembly,"Do pass as amended",18,0,0,0,18
1140148,893015,2019-09-09,Assembly,"SB 63 Hertzberg Senate Third Reading By Maienschein",79,0,0,0,79
1140148,893016,2019-09-10,Senate,"Unfinished Business SB63 Hertzberg et al. Concurrence",40,0,0,0,40
1140154,902833,2020-01-14,Assembly,"Do pass as amended and be re-referred to the Committee on [Appropriations]",18,0,1,0,19
1140156,820032,2019-03-11,Assembly,"Do pass and be re-referred to the Committee on [Appropriations] with recommendation: To Consent Calendar",15,0,0,0,15
1140160,809229,2019-02-26,Assembly,"Do pass and be re-referred to the Committee on [Appropriations]",8,0,0,0,8
1140160,865630,2019-05-16,Assembly,"Do pass as amended",17,0,1,0,18
1140160,871510,2019-05-23,Assembly,"AB 165 Gabriel Assembly Third Reading",72,0,8,0,80
1140160,887431,2019-06-25,Senate,"Do pass, but first be re-referred to the Committee on [Appropriations]",6,0,1,0,7
1140160,893201,2019-07-08,Senate,"Placed on suspense file",7,0,0,0,7
1140162,851070,2019-04-23,Assembly,"Do pass and be re-referred to the Committee on [Appropriations]",6,0,2,0,8
1140162,865957,2019-05-16,Assembly,"Do pass",13,2,3,0,18
1140162,869911,2019-05-22,Assembly,"AB 163 Cristina Garcia Assembly Third Reading",60,5,15,0,80
1140162,891893,2019-07-08,Senate,"Do pass, but first be re-referred to the Committee on [Appropriations]",5,1,0,0,6
1140162,891894,2019-08-12,Senate,"Placed on suspense file",7,0,0,0,7
1140168,820009,2019-03-12,Assembly,"Do pass as amended, and be re-referred to the Committee on [Appropriations] with recommendation: To Consent Calendar",8,0,0,0,8
1140168,865799,2019-05-16,Assembly,"Do pass as amended",18,0,0,0,18
1140168,871305,2019-05-23,Assembly,"AB 164 Cervantes Assembly Third Reading",78,0,2,0,80
1140168,883736,2019-06-18,Senate,"Do pass, but first be re-referred to the Committee on [Appropriations] with the recommendation: To Consent Calendar",7,0,0,0,7
1140168,889239,2019-07-01,Senate,"Placed on suspense file",7,0,0,0,7
1140168,892691,2019-08-30,Senate,"Do pass",7,0,0,0,7
1140168,892692,2019-09-09,Senate,"Special Consent AB164",40,0,0,0,40
1140174,856735,2019-05-01,Assembly,"Do pass",8,0,5,0,13
1140174,862196,2019-05-09,Assembly,"AB 162 Kiley Assembly Third Reading",37,16,27,0,80
1140174,906423,2020-01-27,Assembly,"AB 162 Kiley Assembly Third Reading",34,11,35,0,80
1140177,833040,2019-03-25,Assembly,"Do pass as amended and be re-referred to the Committee on [Privacy and Consumer Protection]",6,3,2,0,11
1140177,851420,2019-04-23,Assembly,"Do pass as amended and be re-referred to the Committee on [Appropriations]",7,4,0,0,11
1140177,865782,2019-05-16,Assembly,"Do pass as amended",10,7,1,0,18
1140177,871222,2019-05-23,Assembly,"AB 161 Ting Assembly Third Reading",43,24,13,0,80
1140177,887960,2019-06-25,Senate,"Do pass as amended, but first amend, and re-refer to the Committee on [Environmental Quality]",7,2,0,0,9
1140177,890871,2019-07-03,Senate,"Do pass, but first be re-referred to the Committee on [Appropriations]",5,2,0,0,7
1140177,890872,2019-08-12,Senate,"Placed on suspense file",7,0,0,0,7
1140180,840240,2019-04-08,Assembly,"Do pass and be re-referred to the Committee on [Appropriations]",9,2,0,0,11
1140186,783421,2019-01-17,Assembly,"Be adopted. To third reading",7,0,4,0,11
1140186,803954,2019-02-19,Senate,"Assembly 3rd Reading ACR9 Kalra et al. By Archuleta",34,0,4,0,38
1140188,825950,2019-03-19,Assembly,"Be adopted. To Consent Calendar",12,0,0,0,12
1140188,827929,2019-03-25,Assembly,"AJR 2 Voepel Consent Calendar Second Day Regular Session",74,0,6,0,80
1140188,878562,2019-06-05,Senate,"Be adopted as amended, and be ordered to the Consent Calendar",7,0,0,0,7
1140188,882937,2019-06-17,Senate,"Consent Calendar AJR2",40,0,0,0,40
1140188,885898,2019-06-20,Assembly,"AJR 2 Voepel Concurrence in Senate Amendments",78,0,1,0,79
1141630,816496,2019-03-06,Assembly,"Do pass and be re-referred to the Committee on [Judiciary]",5,1,1,0,7
1141630,829120,2019-03-26,Assembly,"Do pass as amended",8,3,1,0,12
1141630,849082,2019-04-22,Assembly,"AB 170 Gonzalez Assembly Third Reading",49,17,14,0,80
1141630,880989,2019-06-12,Senate,"Do pass as amended, but first amend, and re-refer to the Committee on [Judiciary]",4,1,0,0,5
1141630,891774,2019-07-02,Senate,"Do pass",7,2,0,0,9
1141630,891775,2019-09-03,Senate,"Assembly 3rd Reading AB170 Gonzalez By Durazo",19,13,8,0,40
1141630,891776,2019-09-03,Senate,"Assembly 3rd Reading AB170 Gonzalez By Durazo Reconsider",40,0,0,0,40
1141630,893767,2019-09-12,Senate,"Do pass, but first be re-referred to the Committee on [Appropriations]",5,0,0,0,5
1141630,893911,2019-09-13,Assembly,"With recommendation: That Senate amendments be concurred in",4,2,1,0,7
1141630,893912,2019-09-14,Assembly,"AB 170 Gonzalez Concurrence in Senate Amendments",66,6,7,0,79
1141630,894135,2019-09-13,Senate,"Assembly 3rd Reading AB170 Gonzalez et al. By Mitchell",38,1,1,0,40
1141632,833693,2019-03-27,Assembly,"Do pass as amended and be re-referred to the Committee on [Appropriations]",8,0,0,0,8
1141632,866181,2019-05-16,Assembly,"Do pass as amended",18,0,0,0,18
1141632,871304,2019-05-23,Assembly,"AB 173 Chau Assembly Third Reading",77,0,3,0,80
1141632,892066,2019-07-02,Senate,"Do pass, but first be re-referred to the Committee on [Governance and Finance]",8,1,2,0,11
1141632,892067,2019-07-10,Senate,"Do pass, but first be re-referred to the Committee on [Appropriations]",6,1,0,0,7
1141632,892068,2019-08-12,Senate,"Placed on suspense file",7,0,0,0,7
1141632,892069,2019-08-30,Senate,"Do pass as amended",7,0,0,0,7
1141632,892070,2019-09-11,Senate,"Assembly 3rd Reading AB173 Chau et al. By McGuire",39,1,0,0,40
1141632,893652,2019-09-12,Assembly,"AB 173 Chau Concurrence in Senate Amendments",79,0,0,0,79
1141634,841674,2019-04-09,Assembly,"Do pass and be re-referred to the Committee on [Appropriations]",14,0,1,0,15
1141634,865817,2019-05-16,Assembly,"Do pass as amended",14,0,4,0,18
1141634,871121,2019-05-23,Assembly,"AB 174 Wood Assembly Third Reading",69,0,11,0,80
1141634,890961,2019-07-03,Senate,"Do pass, but first be re-referred to the Committee on [Appropriations]",7,0,2,0,9
1141634,890962,2019-09-04,Senate,"Assembly 3rd Reading AB174 Wood By Monning",35,1,4,0,40
1141634,890963,2019-09-06,Assembly,"With recommendation: That Senate amendments be concurred in",12,0,3,0,15
1141634,890964,2019-09-09,Assembly,"AB 174 Wood Concurrence in Senate Amendments",75,0,4,0,79
1141636,810689,2019-02-27,Senate,"Do pass, but first be re-referred to the Committee on [Appropriations]",8,0,1,0,9
1141636,836776,2019-04-04,Senate,"Senate 3rd Reading SB67 McGuire et al. Urgency Clause",32,4,2,0,38
1141636,878446,2019-06-05,Assembly,"Do pass and be re-referred to the Committee on [Business and Professions]",8,0,3,0,11
1141636,975333,2020-08-10,Assembly,"Do pass and be re-referred to the Committee on [Appropriations]",19,0,0,0,19
1141636,976082,2020-08-10,Assembly,"Do pass as amended and be re-referred to the Committee on [Appropriations]",19,0,0,0,19
1141636,976083,2020-08-18,Assembly,"Do pass. To Consent Calendar",18,0,0,0,18
1141636,978072,2020-08-30,Assembly,"SB 67 McGuire Third Reading Urgency By Wood",73,0,6,0,79
1141636,978073,2020-08-31,Senate,"Unfinished Business SB67 McGuire et al. Urgency Clause Concurrence",36,0,4,0,40
1141638,809400,2019-02-26,Assembly,"Do pass and be re-referred to the Committee on [Judiciary]",7,1,0,0,8
1141638,819945,2019-03-12,Assembly,"Do pass and be re-referred to the Committee on [Appropriations]",8,3,1,0,12
1141638,865546,2019-05-16,Assembly,"Do pass",14,3,1,0,18
1141638,870091,2019-05-22,Assembly,"AB 175 Gipson Assembly Third Reading",59,8,13,0,80
1141638,887464,2019-06-24,Senate,"Do pass as amended, but first amend, and re-refer to the Committee on [Judiciary]",5,1,0,0,6
1141638,893104,2019-07-09,Senate,"Do pass, but first be re-referred to the Committee on [Appropriations]",7,1,1,0,9
1141638,893105,2019-08-12,Senate,"Placed on suspense file",7,0,0,0,7
1141638,893106,2019-08-30,Senate,"Do pass as amended",5,2,0,0,7
1141638,893107,2019-09-04,Senate,"Assembly 3rd Reading AB175 Gipson et al. By Wiener",30,8,2,0,40
1141638,893108,2019-09-09,Assembly,"AB 175 Gipson Concurrence in Senate Amendments",61,10,8,0,79
1141641,841321,2019-04-09,Assembly,"Do pass and be re-referred to the Committee on [Education]",8,0,0,0,8
1141641,853106,2019-04-24,Assembly,"Do pass and be re-referred to the Committee on [Appropriations]",7,0,0,0,7
1141643,826060,2019-03-20,Senate,"Do pass as amended, but first amend, and re-refer to the Committee on [Appropriations] with the recommendation: To Consent Calendar",8,0,1,0,9
1141643,838480,2019-04-08,Senate,"Placed on suspense file",6,0,0,0,6
1141643,865827,2019-05-16,Senate,"Do pass",6,0,0,0,6
1141643,871214,2019-05-23,Senate,"Special Consent SB66",38,0,0,0,38
1141643,893418,2019-07-02,Assembly,"Do pass and be re-referred to the Committee on [Appropriations] with recommendation: To Consent Calendar",15,0,0,0,15
1141643,893419,2019-08-30,Assembly,"Do pass",18,0,0,0,18
1141645,860826,2019-05-01,Assembly,"Do pass as amended",7,0,1,0,8
1141645,863077,2019-05-13,Assembly,"AB 168 Aguiar-Curry Assembly Third Reading",76,0,4,0,80
1141645,891701,2019-07-02,Senate,"Do pass, but first be re-referred to the Committee on [Environmental Quality]",11,0,0,0,11
1141645,891702,2019-07-03,Senate,"Do pass, but first be re-referred to the Committee on [Governance and Finance]",7,0,0,0,7
1141645,891703,2019-07-10,Senate,"Do pass, but first be re-referred to the Committee on [Appropriations]",7,0,0,0,7
1141645,974966,2020-08-06,Senate,"That the measure be returned to Senate Floor for consideration. Ordered to third reading",10,0,1,0,11
1141645,978158,2020-08-31,Senate,"Assembly 3rd Reading AB168 Aguiar-Curry et al. By Wieckowski Urgency Clause",36,0,4,0,40
1141645,978159,2020-09-01,Assembly,"AB 168 AGUIAR-CURRY Concurrence - Urgency Added",72,0,7,0,79
1141647,842952,2019-04-10,Senate,"Do pass, but first be re-referred to the Committee on [Appropriations]",8,0,1,0,9
1141647,854221,2019-04-29,Senate,"Placed on suspense file",6,0,0,0,6
1141647,866348,2019-05-16,Senate,"Do pass",4,2,0,0,6
1141647,873812,2019-05-28,Senate,"Senate 3rd Reading SB65 Pan",30,7,1,0,38
1141647,891854,2019-07-09,Assembly,"Do pass and be re-referred to the Committee on [Appropriations] with recommendation: To Consent Calendar",15,0,0,0,15
1141649,810635,2019-02-26,Assembly,"Do pass as amended, and be re-referred to the Committee on [Appropriations] with recommendation: To Consent Calendar",8,0,0,0,8
1141649,826017,2019-03-20,Assembly,"Do pass. To Consent Calendar",13,0,5,0,18
1141649,831422,2019-03-28,Assembly,"AB 169 Lackey Consent Calendar Second Day",72,0,8,0,80
1141649,880265,2019-06-11,Senate,"Do pass, but first be re-referred to the Committee on [Appropriations] with the recommendation: To Consent Calendar",7,0,0,0,7
1141649,887082,2019-06-24,Senate,"Placed on suspense file",7,0,0,0,7
1141649,890457,2019-08-30,Senate,"Do pass as amended",7,0,0,0,7
1141649,890458,2019-09-04,Senate,"Assembly 3rd Reading AB169 Lackey et al. By Wilk",40,0,0,0,40
1141649,890459,2019-09-10,Assembly,"AB 169 Lackey Concurrence in Senate Amendments",79,0,0,0,79
1141650,816533,2019-03-06,Assembly,"Do pass and be re-referred to the Committee on [Judiciary]",6,0,1,0,7
1141650,829095,2019-03-26,Assembly,"Do pass and be re-referred to the Committee on [Appropriations]",9,2,1,0,12
1141650,865734,2019-05-16,Assembly,"Do pass as amended",14,0,4,0,18
1141650,871473,2019-05-23,Assembly,"AB 171 Gonzalez Assembly Third Reading",57,5,18,0,80
1141650,891485,2019-07-02,Senate,"Do pass, but first be re-referred to the Committee on [Labor, Public Employment and Retirement ]",7,2,0,0,9
1141650,891486,2019-07-10,Senate,"Do pass, but first be re-referred to the Committee on [Appropriations]",4,1,0,0,5
1141650,891487,2019-08-12,Senate,"Placed on suspense file",7,0,0,0,7
1141650,891488,2019-08-30,Senate,"Do pass",5,2,0,0,7
1141650,893940,2019-09-14,Assembly,"AB 171 Gonzalez Concurrence in Senate Amendments",58,12,9,0,79
1141650,894159,2019-09-13,Senate,"Assembly 3rd Reading AB171 Gonzalez et al. By Gonzalez",29,10,1,0,40
1144521,781987,2019-01-10,Assembly,"Be adopted. To third reading",11,0,0,0,11
1144521,792330,2019-02-04,Senate,"Special Consent ACR10 Weber et al",36,0,2,0,38
1144528,831342,2019-03-28,Assembly,"Be re-referred to the Committee on [Revenue and Taxation]",10,0,2,0,12
1144528,850219,2019-04-22,Assembly,"Do pass and be re-referred to the Committee on [Appropriations]",11,0,0,0,11
1144528,866504,2019-05-16,Assembly,"Do pass",18,0,0,0,18
1144528,870136,2019-05-22,Assembly,"AB 176 Cervantes Assembly Third Reading",77,0,3,0,80
1144528,893067,2019-07-10,Senate,"Do pass, but first be re-referred to the Committee on [Appropriations] with the recommendation: To Consent Calendar",7,0,0,0,7
1144528,893725,2019-09-12,Senate,"Assembly 3rd Reading AB176 Cervantes By Hueso",40,0,0,0,40
1144528,893962,2019-09-13,Assembly,"AB 176 Cervantes Concurrence in Senate Amendments",78,0,1,0,79
1144535,835657,2019-04-03,Assembly,"Do pass and be re-referred to the Committee on [Appropriations]",7,0,0,0,7
1144535,866478,2019-05-16,Assembly,"Do pass",18,0,0,0,18
1144535,873833,2019-05-28,Assembly,"AB 181 Rodriguez Assembly Third Reading",74,0,6,0,80
1144535,892299,2019-09-10,Senate,"Do pass, but first be re-referred to the Committee on [Appropriations]",6,0,1,0,7
1144535,893953,2019-09-13,Assembly,"With recommendation: That Senate amendments be concurred in",9,0,0,0,9
1144535,893954,2019-09-13,Assembly,"AB 181 Maienschein Concurrence in Senate Amendments",79,0,0,0,79
1144535,894128,2019-09-13,Senate,"Assembly 3rd Reading AB181 Maienschein By Atkins",40,0,0,0,40
1144543,824914,2019-03-19,Senate,"Do pass, but first be re-referred to the Committee on [Appropriations]",4,0,1,0,5
1144543,866900,2019-05-16,Senate,"Placed on suspense file",6,0,0,0,6
1144543,866901,2019-05-16,Senate,"Do pass as amended",5,0,1,0,6
1144543,875581,2019-05-30,Senate,"Senate 3rd Reading SB71 Leyva",35,0,3,0,38
1144543,890853,2019-07-03,Assembly,"Do pass and be re-referred to the Committee on [Appropriations]",7,0,0,0,7
1144543,890854,2019-08-28,Assembly,"Do pass. To Consent Calendar",17,0,1,0,18
1144543,890855,2019-09-11,Assembly,"SB 71 Leyva Senate Third Reading By Berman",76,0,3,0,79
1144543,893779,2019-09-12,Senate,"Unfinished Business SB71 Leyva Concurrence",39,0,1,0,40
1144550,854827,2019-04-24,Senate,"Do pass as amended, but first amend, and re-refer to the Committee on [Appropriations]",13,0,0,0,13
1144550,863087,2019-05-13,Senate,"Placed on suspense file",6,0,0,0,6
1144550,866224,2019-05-16,Senate,"Do pass",6,0,0,0,6
1144550,866225,2019-05-16,Senate,"[05-16-2019] set for [First] hearing: Reconsideration of favorable vote granted",6,0,0,0,6
1144550,866226,2019-05-16,Senate,"Do pass as amended",6,0,0,0,6
1144550,868648,2019-05-21,Senate,"Senate 3rd Reading SB70 Nielsen",38,0,0,0,38
1144550,887981,2019-06-26,Assembly,"Do pass as amended, and be re-referred to the Committee on [Appropriations] with recommendation: To Consent Calendar",14,0,1,0,15
1144550,892833,2019-08-14,Assembly,"Do pass as amended",18,0,0,0,18
1144550,892834,2019-09-10,Assembly,"SB 70 Nielsen Senate Third Reading By Bloom",79,0,0,0,79
1144550,892835,2019-09-11,Senate,"Unfinished Business SB70 Nielsen Concurrence",40,0,0,0,40
1144565,894224,2019-07-08,Assembly,"Be adopted. To Consent Calendar",11,0,1,0,12
1144565,894225,2019-08-12,Assembly,"HR 5 Choi Consent Calendar Second Day",77,0,2,0,79
1144572,850971,2019-04-22,Assembly,"Do pass and be re-referred to the Committee on [Appropriations]",14,0,1,0,15
1144572,857078,2019-05-01,Assembly,"Do pass. To Consent Calendar",18,0,0,0,18
1144572,873927,2019-05-28,Assembly,"AB 179 Reyes Assembly Third Reading",73,0,7,0,80
1144572,887704,2019-06-25,Senate,"Do pass, but first be re-referred to the Committee on [Judiciary]",13,0,0,0,13
1144572,890644,2019-07-09,Senate,"Do pass, but first be re-referred to the Committee on [Appropriations]",8,0,1,0,9
1144572,890645,2019-09-03,Senate,"Assembly 3rd Reading AB179 Reyes By Jones",40,0,0,0,40
1144572,890646,2019-09-05,Assembly,"AB 179 Reyes Concurrence in Senate Amendments",78,0,1,0,79
1144579,851315,2019-04-23,Assembly,"Do pass and be re-referred to the Committee on [Appropriations]",6,1,1,0,8
1144594,821265,2019-03-13,Assembly,"Do pass and be re-referred to the Committee on [Governmental Organization]",5,2,0,0,7
1144594,836750,2019-04-03,Assembly,"Do pass and be re-referred to the Committee on [Appropriations]",13,6,2,0,21
1144601,835922,2019-04-03,Senate,"Do pass, but first be re-referred to the Committee on [Appropriations]",7,0,0,0,7
1144601,852848,2019-04-25,Senate,"Senate 3rd Reading SB68 Galgiani",37,0,1,0,38
1144601,885298,2019-06-18,Assembly,"Do pass as amended, and be re-referred to the Committee on [Appropriations] with recommendation: To Consent Calendar",8,0,0,0,8
1144601,892701,2019-08-30,Assembly,"Do pass as amended",18,0,0,0,18
1144601,895150,2019-08-30,Assembly,06/18/19,8,0,0,0,8
1144601,978045,2020-08-30,Assembly,"SB 68 Galgiani Senate Third Reading By Holden",75,0,4,0,79
1144601,978046,2020-08-31,Senate,"Unfinished Business SB68 Galgiani Concurrence",39,0,1,0,40
1144609,842690,2019-04-09,Senate,"Do pass as amended, but first amend, and re-refer to the Committee on [Environmental Quality]",6,2,1,0,9
1144609,851522,2019-04-24,Senate,"Do pass as amended, but first amend, and re-refer to the Committee on [Appropriations]",5,0,2,0,7
1144609,863114,2019-05-13,Senate,"Placed on suspense file",6,0,0,0,6
1144609,865731,2019-05-16,Senate,"Do pass as amended",4,1,1,0,6
1144609,871356,2019-05-23,Senate,"Senate 3rd Reading SB69 Wiener et al",27,6,5,0,38
1144609,890794,2019-07-02,Assembly,"Do pass as amended and be re-referred to the Committee on [Natural Resources]",9,3,2,0,14
1144609,890795,2019-07-08,Assembly,"Do pass as amended and be re-referred to the Committee on [Appropriations]",8,2,1,0,11
1144609,896033,2019-05-16,Senate,Result,4,1,0,0,5
1144616,831595,2019-03-25,Assembly,"Do pass as amended",11,0,0,0,11
1144616,838601,2019-04-08,Assembly,"AB 178 Dahle Assembly Third Reading",72,0,8,0,80
1144616,883711,2019-06-18,Senate,"Do pass, but first be re-referred to the Committee on [Appropriations]",9,1,3,0,13
1144616,892230,2019-08-22,Senate,"Assembly 3rd Reading AB178 Dahle et al. By Dahle",33,4,3,0,40
1147459,842850,2019-04-11,Senate,"Senate 3rd Reading SB90 B. & F.R",27,9,2,0,38
1147459,885691,2019-06-20,Senate,"Unfinished Business SB90 B. & F.R. (Mitchell) Concurrence",40,0,0,0,40
1147459,885692,2019-06-20,Assembly,"SB 90 B. & F. R. Senate Third Reading By TING",79,0,0,0,79
1147459,895155,2019-06-20,Senate,"Unfinished Business SB90 B. & F.R. (Mitchell) Concurrenspan class=""statusLabel"">Noes",27,0,0,0,27
1147461,842642,2019-04-11,Senate,"Senate 3rd Reading SB121 B. & F.R",27,9,2,0,38
1147463,842740,2019-04-11,Senate,"Senate 3rd Reading SB124 B. & F.R",27,9,2,0,38
1147464,842950,2019-04-11,Senate,"Senate 3rd Reading SB80 B. & F.R",27,9,2,0,38
1147464,886078,2019-06-20,Senate,"Unfinished Business SB80 B. & F.R. (Mitchell) Concurrence",30,6,4,0,40
1147464,886079,2019-06-20,Assembly,"SB 80 B. & F. R. Senate Third Reading By TING",63,7,9,0,79
1147465,842915,2019-04-11,Senate,"Senate 3rd Reading SB78 B. & F.R",27,9,2,0,38
1147465,886972,2019-06-24,Senate,"Unfinished Business SB78 B. & F.R. (Mitchell) Concurrence",28,11,1,0,40
1147465,886973,2019-06-24,Assembly,"SB 78 B. & F. R. Senate Third Reading By TING",57,14,8,0,79
1147467,839853,2019-04-09,Assembly,"Do pass and be re-referred to the Committee on [Judiciary]",19,0,1,0,20
1147469,842901,2019-04-11,Senate,"Senate 3rd Reading SB98 B. & F.R",27,9,2,0,38
1147469,969404,2020-06-26,Assembly,"SB 98 B. & F. R. Senate Third Reading By TING",57,17,5,0,79
1147469,970000,2020-06-29,Senate,"Unfinished Business SB98 B. & F.R. (Mitchell) Concurrence",29,10,1,0,40
1147470,842743,2019-04-11,Senate,"Senate 3rd Reading SB114 B. & F.R",27,9,2,0,38
1147471,842859,2019-04-11,Senate,"Senate 3rd Reading SB89 B. & F.R",27,9,2,0,38
1147471,952455,2020-03-16,Senate,"Unfinished Business SB89 B. & F.R. (Mitchell) Concurrence",32,0,7,0,39
1147471,952456,2020-03-16,Assembly,"SB 89 B. & F. R. Senate Third Reading",69,0,11,0,80
1147472,842894,2019-04-11,Senate,"Senate 3rd Reading SB108 B. & F.R",27,9,2,0,38
1147474,842796,2019-04-11,Senate,"Senate 3rd Reading SB85 B. & F.R",27,9,2,0,38
1147474,882983,2019-06-17,Senate,"Unfinished Business SB85 B. & F.R. (Mitchell) Concurrence",28,11,1,0,40
1147474,882984,2019-06-17,Assembly,"SB 85 B. & F. R. Senate Third Reading By TING",55,19,5,0,79
1147474,894270,2019-06-17,Senate,"Unfinished Business SB85 B. & F.R. (M",27,11,0,0,38
1147475,851712,2019-04-23,Senate,"Do pass as amended, but first amend, and re-refer to the Committee on [Appropriations]",5,2,0,0,7
1147475,863141,2019-05-13,Senate,"Placed on suspense file",6,0,0,0,6
1147475,866243,2019-05-16,Senate,"Do pass",4,2,0,0,6
1147475,870215,2019-05-22,Senate,"Senate 3rd Reading SB120 Stern",24,11,3,0,38
1147477,842753,2019-04-11,Senate,"Senate 3rd Reading SB79 B. & F.R",27,9,2,0,38
1147477,887042,2019-06-24,Senate,"Unfinished Business SB79 B. & F.R. (Mitchell) Urgency Clause Concurrence",40,0,0,0,40
1147477,887043,2019-06-24,Assembly,"SB 79 B. & F. R. Third Reading Urgency By TING",78,0,1,0,79
1147477,889091,2019-06-24,Senate,"Unfinished Business SB79 B. & F.R. (Mitchell) Urgency Clause Concurren",27,0,0,0,27
1147478,841717,2019-04-10,Assembly,"Do pass and be re-referred to the Committee on [Appropriations]",9,4,0,0,13
1147479,833193,2019-03-25,Assembly,"Do pass as amended and be re-referred to the Committee on [Appropriations]",11,0,0,0,11
1147479,856836,2019-05-01,Assembly,"Do pass. To Consent Calendar",18,0,0,0,18
1147479,862258,2019-05-09,Assembly,"AB 187 Cristina Garcia Assembly Third Reading",75,0,5,0,80
1147479,884621,2019-06-19,Senate,"Do pass as amended, but first amend, and re-refer to the Committee on [Appropriations]",7,0,0,0,7
1147479,890399,2019-08-26,Senate,"Placed on suspense file",6,0,1,0,7
1147479,890400,2019-08-30,Senate,"Do pass as amended",7,0,0,0,7
1147479,890401,2019-09-10,Senate,"Assembly 3rd Reading AB187 Cristina Garcia By Dahle",40,0,0,0,40
1147479,890402,2019-09-11,Assembly,"AB 187 Cristina Garcia Concurrence in Senate Amendments",79,0,0,0,79
1147479,895165,2019-08-30,Senate,Date,6,0,0,0,6
1147481,842723,2019-04-11,Senate,"Senate 3rd Reading SB107 B. & F.R",27,9,2,0,38
1147482,783714,2019-01-18,Senate,"Senate 3rd Reading SR10 Hertzberg",34,0,4,0,38
1147483,842704,2019-04-11,Senate,"Senate 3rd Reading SB111 B. & F.R",27,9,2,0,38
1147485,842878,2019-04-11,Senate,"Senate 3rd Reading SB75 B. & F.R. (Mitchell)",27,9,2,0,38
1147485,887022,2019-06-24,Senate,"Unfinished Business SB75 B. & F.R. (Mitchell) Concurrence",31,7,2,0,40
1147485,887023,2019-06-24,Assembly,"SB 75 B. & F. R. Senate Third Reading By TING",62,14,3,0,79
1147486,825988,2019-03-20,Senate,"Do pass as amended",6,0,1,0,7
1147486,831486,2019-03-28,Senate,"Senate 3rd Reading SB128 Beall et al",25,8,5,0,38
1147486,893332,2019-07-03,Assembly,"Do pass as amended and be re-referred to the Committee on [Appropriations]",8,0,0,0,8
1147486,893333,2019-08-14,Assembly,"Do pass",18,0,0,0,18
1147486,893334,2019-08-22,Assembly,"SB 128 Beall Senate Third Reading By Gonzalez",76,0,3,0,79
1147486,893335,2019-08-28,Senate,"That the Assembly amendments be concurred in",7,0,0,0,7
1147486,893336,2019-09-03,Senate,"Unfinished Business SB128 Beall et al. Concurrence",39,0,1,0,40
1147487,842801,2019-04-11,Senate,"Senate 3rd Reading SB76 B. & F.R",27,9,2,0,38
1147487,883062,2019-06-17,Senate,"Unfinished Business SB76 B. & F.R. (Mitchell) Concurrence",39,0,1,0,40
1147487,883063,2019-06-17,Assembly,"SB 76 B. & F. R. Senate Third Reading By TING",75,0,4,0,79
1147489,842898,2019-04-11,Senate,"Senate 3rd Reading SB88 B. & F.R",27,9,2,0,38
1147491,852889,2019-04-24,Senate,"Do pass, but first be re-referred to the Committee on [Appropriations] with the recommendation: To Consent Calendar",7,0,0,0,7
1147491,866091,2019-05-16,Senate,"Consent Calendar SB99 Nielsen",37,0,1,0,38
1147491,884682,2019-06-19,Assembly,"Do pass as amended and be re-referred to the Committee on [Appropriations]",8,0,0,0,8
1147491,890371,2019-07-03,Assembly,"Do pass. To Consent Calendar",17,0,1,0,18
1147491,890372,2019-07-11,Assembly,"SB 99 Nielsen Consent Calendar Second Day Regular Session",76,0,3,0,79
1147491,890373,2019-08-12,Senate,"Unfinished Business SB99 Nielsen et al. Concurrence",39,0,1,0,40
1147493,842779,2019-04-11,Senate,"Senate 3rd Reading SB116 B. & F.R",27,9,2,0,38
1147493,969390,2020-06-26,Assembly,"SB 116 B. & F. R. Senate Third Reading By TING",73,1,5,0,79
1147493,970003,2020-06-29,Senate,"Unfinished Business SB116 B. & F.R. (Mitchell) Concurrence",30,9,1,0,40
1147495,853033,2019-04-24,Assembly,"Do pass and be re-referred to the Committee on [Appropriations] with recommendation: To Consent Calendar",8,0,0,0,8
1147495,865987,2019-05-16,Assembly,"Do pass",18,0,0,0,18
1147495,871280,2019-05-23,Assembly,"AB 195 Patterson Assembly Third Reading",77,0,3,0,80
1147495,974984,2020-08-07,Senate,"Do pass, but first be re-referred to the Committee on [Appropriations]",3,1,3,0,7
1147495,974985,2020-08-07,Senate,"[First] hearing set for [08-07-2020]: Failed passage in Committee. Reconsideration granted",7,0,0,0,7
1147498,802021,2019-02-15,Assembly,"Be adopted. To third reading",12,0,0,0,12
1147498,816571,2019-03-07,Senate,"Special Consent ACR12",37,0,1,0,38
1147499,842662,2019-04-11,Senate,"Senate 3rd Reading SB77 B. & F.R",27,9,2,0,38
1147499,882789,2019-06-17,Senate,"Unfinished Business SB77 B. & F.R. (Mitchell) Concurrence",32,4,4,0,40
1147499,882790,2019-06-17,Assembly,"SB 77 B. & F. R. Senate Third Reading By TING",63,9,7,0,79
1147500,825033,2019-03-13,Assembly,"Do pass as amended and be re-referred to the Committee on [Appropriations]",6,0,0,0,6
1147501,843443,2019-04-11,Senate,"Senate 3rd Reading SB110 B. & F.R",27,9,2,0,38
1147502,842776,2019-04-11,Senate,"Senate 3rd Reading SB115 B. & F.R",27,9,2,0,38
1147502,978164,2020-08-31,Senate,"Unfinished Business SB115 B. & F.R. (Mitchell) Concurrence",31,7,2,0,40
1147502,978165,2020-08-31,Assembly,"SB 115 B. & F. R. Senate Third Reading By TING",72,1,6,0,79
1147504,842760,2019-04-11,Senate,"Senate 3rd Reading SB87 B. & F.R",27,9,2,0,38
1147504,882970,2019-06-17,Senate,"Unfinished Business SB87 B. & F.R. (Mitchell) Concurrence",32,6,2,0,40
1147504,882971,2019-06-17,Assembly,"SB 87 B. & F. R. Senate Third Reading By TING Amend By FONG Set #1 Motion to Lay on the Table By CALDERON",51,18,10,0,79
1147504,882972,2019-06-17,Assembly,"SB 87 B. & F. R. Senate Third Reading By TING",59,17,3,0,79
1147505,843000,2019-04-11,Senate,"Senate 3rd Reading SB94 B. & F.R",27,9,2,0,38
1147505,882865,2019-06-17,Senate,"Unfinished Business SB94 B. & F.R. (Mitchell) Concurrence",34,3,3,0,40
1147505,882866,2019-06-17,Assembly,"SB 94 B. & F. R. Senate Third Reading By TING",59,17,3,0,79
1147506,842768,2019-04-11,Senate,"Senate 3rd Reading SB104 B. & F.R",27,9,2,0,38
1147506,887120,2019-06-24,Senate,"Unfinished Business SB104 B. & F.R. (Mitchell) Concurrence",28,11,1,0,40
1147506,887121,2019-06-24,Assembly,"SB 104 B. & F. R. Senate Third Reading By TING",56,17,6,0,79
1147508,842860,2019-04-11,Senate,"Senate 3rd Reading SB95 B. & F.R",27,9,2,0,38
1147508,883163,2019-06-17,Senate,"Unfinished Business SB95 B. & F.R. (Mitchell) Concurrence",40,0,0,0,40
1147508,883164,2019-06-17,Assembly,"SB 95 B. & F. R. Senate Third Reading By TING",76,0,3,0,79
1147509,842803,2019-04-11,Senate,"Senate 3rd Reading SB74 B. & F.R. (Mitchell)",27,9,2,0,38
1147509,966507,2020-06-15,Senate,"W/O REF. TO FILE SB74 Mitchell",29,11,0,0,40
1147509,966508,2020-06-15,Assembly,"SB 74 Mitchell Senate Third Reading By TING",61,15,3,0,79
1147510,842814,2019-04-11,Senate,"Senate 3rd Reading SB106 B. & F.R",27,9,2,0,38
1147510,886996,2019-06-24,Senate,"Unfinished Business SB106 B. & F.R. (Mitchell) Concurrence",30,9,1,0,40
1147510,886997,2019-06-24,Assembly,"SB 106 B. & F. R. Senate Third Reading By TING",73,0,6,0,79
1147512,842784,2019-04-11,Senate,"Senate 3rd Reading SB83 B. & F.R",27,9,2,0,38
1147512,882801,2019-06-17,Senate,"Unfinished Business SB83 B. & F.R. (Mitchell) Concurrence",29,10,1,0,40
1147512,882802,2019-06-17,Assembly,"SB 83 B. & F. R. Senate Third Reading By TING",63,11,5,0,79
1147513,825073,2019-03-13,Assembly,"Do pass as amended and be re-referred to the Committee on [Appropriations]",5,1,0,0,6
1147513,866072,2019-05-16,Assembly,"Do pass as amended",13,4,1,0,18
1147513,871271,2019-05-23,Assembly,"AB 197 Weber Assembly Third Reading",60,15,5,0,80
1147513,884846,2019-06-19,Senate,"Do pass, but first be re-referred to the Committee on [Appropriations]",7,0,0,0,7
1147513,889220,2019-07-01,Senate,"Placed on suspense file",7,0,0,0,7
1147513,892180,2019-08-30,Senate,"Do pass as amended",5,2,0,0,7
1147513,892181,2019-09-05,Senate,"Assembly 3rd Reading AB197 Weber et al. By Leyva",31,9,0,0,40
1147513,892182,2019-09-09,Assembly,"AB 197 Weber Concurrence in Senate Amendments",61,15,3,0,79
1147515,810454,2019-02-26,Assembly,"Do pass and be re-referred to the Committee on [Appropriations] with recommendation: To Consent Calendar",8,0,0,0,8
1147515,826200,2019-03-20,Assembly,"Do pass. To Consent Calendar",13,0,5,0,18
1147515,831356,2019-03-28,Assembly,"AB 189 Kamlager-Dove Consent Calendar Second Day Regular Session",72,0,8,0,80
1147515,883974,2019-06-18,Senate,"Do pass, but first be re-referred to the Committee on [Appropriations] with the recommendation: To Consent Calendar",7,0,0,0,7
1147515,889262,2019-07-01,Senate,"Placed on suspense file",7,0,0,0,7
1147515,891633,2019-08-30,Senate,"Do pass",7,0,0,0,7
1147515,891634,2019-09-10,Senate,"Assembly 3rd Reading AB189 Kamlager-Dove et al. By Mitchell",40,0,0,0,40
1147515,891635,2019-09-11,Assembly,"AB 189 Kamlager-Dove Concurrence in Senate Amendments",79,0,0,0,79
1147515,896015,2019-08-30,Senate,Date,7,0,0,0,7
1147516,842804,2019-04-11,Senate,"Senate 3rd Reading SB91 B. & F.R",27,9,2,0,38
1147517,842993,2019-04-11,Senate,"Senate 3rd Reading SB118 B. & F.R",27,9,2,0,38
1147517,974757,2020-08-03,Senate,"Unfinished Business SB118 B. & F.R. (Mitchell) Concurrence",26,12,2,0,40
1147517,974758,2020-08-03,Assembly,"SB 118 B. & F. R. Senate Third Reading By TING",53,16,10,0,79
1147519,841434,2019-04-09,Assembly,"Do pass and be re-referred to the Committee on [Appropriations]",8,0,0,0,8
1147520,842829,2019-04-11,Senate,"Senate 3rd Reading SB119 B. & F.R",27,9,2,0,38
1147520,974762,2020-08-03,Senate,"Unfinished Business SB119 B. & F.R. (Mitchell) Concurrence",27,12,1,0,40
1147520,974763,2020-08-03,Assembly,"SB 119 B. & F. R. Senate Third Reading By TING",61,8,10,0,79
1147521,825936,2019-03-20,Senate,"Do pass, but first be re-referred to the Committee on [Appropriations] with the recommendation: To Consent Calendar",8,0,1,0,9
1147521,849018,2019-04-22,Senate,"Consent Calendar SB129",38,0,0,0,38
1147521,887747,2019-06-25,Assembly,"Do pass and be re-referred to the Committee on [Appropriations] with recommendation: To Consent Calendar",15,0,0,0,15
1147521,890632,2019-07-10,Assembly,"Do pass. To Consent Calendar",16,0,2,0,18
1147521,890633,2019-08-15,Assembly,"SB 129 Pan Consent Calendar Second Day Regular Session",76,0,3,0,79
1147521,890634,2019-08-22,Senate,"Special Consent SB129",39,0,1,0,40
1147523,842991,2019-04-11,Senate,"Senate 3rd Reading SB122 B. & F.R",27,9,2,0,38
1147524,830582,2019-03-26,Assembly,"Do pass and be re-referred to the Committee on [Appropriations]",8,0,0,0,8
1147525,842907,2019-04-11,Senate,"Senate 3rd Reading SB105 B. & F.R",27,9,2,0,38
1147525,883076,2019-06-17,Senate,"Unfinished Business SB105 B. & F.R. (Mitchell) Concurrence",30,5,5,0,40
1147525,883077,2019-06-17,Assembly,"SB 105 B. & F. R. Senate Third Reading By TING",76,0,3,0,79
1147527,849921,2019-04-22,Assembly,"Do pass and be re-referred to the Committee on [Appropriations] with recommendation: To Consent Calendar",15,0,0,0,15
1147527,856870,2019-05-01,Assembly,"Do pass. To Consent Calendar",18,0,0,0,18
1147527,862132,2019-05-09,Assembly,"AB 185 Grayson Consent Calendar Second Day Regular Session",76,0,4,0,80
1147527,880299,2019-06-11,Senate,"Do pass as amended, but first amend, and re-refer to the Committee on [Appropriations]",9,2,1,0,12
1147527,889253,2019-07-01,Senate,"Placed on suspense file",7,0,0,0,7
1147527,893274,2019-08-30,Senate,"Do pass",6,1,0,0,7
1147527,893275,2019-09-05,Senate,"Assembly 3rd Reading AB185 Grayson et al. By Beall",34,4,2,0,40
1147527,893276,2019-09-09,Assembly,"AB 185 Grayson Concurrence in Senate Amendments",79,0,0,0,79
1147528,842783,2019-04-11,Senate,"Senate 3rd Reading SB82 B. & F.R",27,9,2,0,38
1147528,882909,2019-06-17,Senate,"Unfinished Business SB82 B. & F.R. (Mitchell) Concurrence",31,8,1,0,40
1147528,882910,2019-06-17,Assembly,"SB 82 B. & F. R. Senate Third Reading By TING",59,14,6,0,79
1147529,842818,2019-04-11,Senate,"Senate 3rd Reading SB102 B. & F.R",27,9,2,0,38
1147532,835524,2019-04-03,Assembly,"Do pass. To Consent Calendar",14,0,0,0,14
1147532,842886,2019-04-11,Assembly,"AB 188 Daly Consent Calendar Second Day Regular Session",72,0,8,0,80
1147532,881301,2019-06-12,Senate,"Do pass and be ordered to the Consent Calendar",13,0,0,0,13
1147532,885839,2019-06-20,Senate,"Consent Calendar AB188 Daly",40,0,0,0,40
1147532,888552,2019-06-27,Assembly,"AB 188 Daly Concurrence in Senate Amendments",72,0,7,0,79
1147533,850294,2019-04-23,Senate,"Do pass, but first be re-referred to the Committee on [Appropriations]",8,0,1,0,9
1147533,859555,2019-05-06,Senate,"Placed on suspense file",5,0,1,0,6
1147533,865670,2019-05-16,Senate,"Do pass",6,0,0,0,6
1147533,868643,2019-05-21,Senate,"Senate 3rd Reading SB130 Galgiani et al",38,0,0,0,38
1147533,887025,2019-06-24,Assembly,"Do pass as amended and be re-referred to the Committee on [Appropriations]",10,0,1,0,11
1147536,842981,2019-04-11,Senate,"Senate 3rd Reading SB97 B. & F.R",27,9,2,0,38
1147537,842823,2019-04-11,Senate,"Senate 3rd Reading SB112 B. & F.R",27,9,2,0,38
1147537,893659,2019-09-12,Assembly,"SB 112 B. & F. R. Senate Third Reading By TING",59,15,5,0,79
1147537,894191,2019-09-13,Senate,"Unfinished Business SB112 B. & F.R. (Mitchell) Concurrence",29,11,0,0,40
1147539,856022,2019-04-24,Senate,"Do pass as amended, but first amend, and re-refer to the Committee on [Appropriations]",7,0,0,0,7
1147539,863259,2019-05-13,Senate,"Placed on suspense file",6,0,0,0,6
1147539,866418,2019-05-16,Senate,"Do pass",6,0,0,0,6
1147539,871307,2019-05-23,Senate,"Special Consent SB86",38,0,0,0,38
1147539,882792,2019-06-17,Assembly,"Be re-referred to the Committee on [Environmental Safety and Toxic Materials]",11,0,1,0,12
1147539,974489,2020-07-30,Assembly,"Do pass and be re-referred to the Committee on [Appropriations]",7,2,0,0,9
1147539,976412,2020-08-20,Assembly,"Do pass",14,4,0,0,18
1147539,976736,2020-08-25,Assembly,"SB 86 Durazo Senate Third Reading By Friedman",58,13,8,0,79
1147539,978085,2020-08-30,Senate,"Unfinished Business SB86 Durazo et al. Concurrence",29,8,3,0,40
1147540,843030,2019-04-11,Senate,"Senate 3rd Reading SB92 B. & F.R",27,9,2,0,38
1147540,883090,2019-06-17,Senate,"Unfinished Business SB92 B. & F.R. (Mitchell) Concurrence",40,0,0,0,40
1147540,883091,2019-06-17,Assembly,"SB 92 B. & F. R. Senate Third Reading By TING",76,0,3,0,79
1147541,842902,2019-04-11,Senate,"Senate 3rd Reading SB101 B. & F.R",27,9,2,0,38
1147543,783792,2019-01-18,Assembly,"Be adopted. To third reading",9,2,0,0,11
1147543,784679,2019-01-22,Assembly,"HR 6 LIMÓN Assembly Third Reading",60,14,6,0,80
1147544,842670,2019-04-11,Senate,"Senate 3rd Reading SB100 B. & F.R",27,9,2,0,38
1147548,842813,2019-04-11,Senate,"Senate 3rd Reading SB93 B. & F.R",27,9,2,0,38
1147548,883183,2019-06-17,Senate,"Unfinished Business SB93 B. & F.R. (Mitchell) Concurrence",40,0,0,0,40
1147548,883184,2019-06-17,Assembly,"SB 93 B. & F. R. Senate Third Reading By TING",76,0,3,0,79
1147549,842873,2019-04-11,Senate,"Senate 3rd Reading SB96 B. & F.R",27,9,2,0,38
1147549,883084,2019-06-17,Assembly,"SB 96 B. & F. R. Third Reading Urgency By TING",56,14,9,0,79
1147549,886087,2019-06-20,Senate,"Unfinished Business SB96 B. & F.R. (Mitchell) Urgency Clause Concurrence",29,10,1,0,40
1147551,843001,2019-04-11,Senate,"Senate 3rd Reading SB81 B. & F.R",27,9,2,0,38
1147551,886004,2019-06-20,Senate,"Unfinished Business SB81 B. & F.R. (Mitchell) Concurrence",40,0,0,0,40
1147551,886005,2019-06-20,Assembly,"SB 81 B. & F. R. Senate Third Reading By TING",79,0,0,0,79
1147552,851425,2019-04-24,Assembly,"Do pass and be re-referred to the Committee on [Appropriations]",12,1,1,0,14
1147552,865759,2019-05-16,Assembly,"Do pass",14,1,3,0,18
1147552,871422,2019-05-23,Assembly,"AB 196 Gonzalez Assembly Third Reading",66,7,7,0,80
1147552,975535,2020-08-11,Senate,"Do pass, but first be re-referred to the Committee on [Appropriations]",3,1,1,0,5
1147552,976052,2020-08-17,Senate,"Placed on suspense file",7,0,0,0,7
1147552,976346,2020-08-20,Senate,"Do pass",5,2,0,0,7
1147554,833356,2019-03-27,Assembly,"Do pass as amended and be re-referred to the Committee on [Appropriations]",6,0,0,0,6
1147555,842830,2019-04-11,Senate,"Senate 3rd Reading SB113 B. & F.R",27,9,2,0,38
1147555,893832,2019-09-12,Assembly,"SB 113 B. & F. R. Senate Third Reading By TING",75,0,4,0,79
1147555,894142,2019-09-13,Senate,"Unfinished Business SB113 B. & F.R. (Mitchell) Concurrence",29,11,0,0,40
1147556,842909,2019-04-11,Senate,"Senate 3rd Reading SB84 B. & F.R",27,9,2,0,38
1147556,883527,2019-06-17,Senate,"Unfinished Business SB84 B. & F.R. (Mitchell) Concurrence",40,0,0,0,40
1147556,883528,2019-06-17,Assembly,"SB 84 B. & F. R. Senate Third Reading By TING",76,0,3,0,79
1147558,843026,2019-04-11,Senate,"Senate 3rd Reading SB117 B. & F.R",27,9,2,0,38
1147558,952446,2020-03-16,Senate,"Unfinished Business SB117 B. & F.R. (Mitchell) Concurrence",32,0,7,0,39
1147558,952447,2020-03-16,Assembly,"SB 117 B. & F. R. Senate Third Reading",69,0,11,0,80
1147559,843015,2019-04-11,Senate,"Senate 3rd Reading SB123 B. & F.R",27,9,2,0,38
1147560,804145,2019-02-19,Senate,"Do pass",7,0,0,0,7
1147560,806429,2019-02-21,Senate,"Senate 3rd Reading SB126 Leyva et al",34,2,2,0,38
1147560,809555,2019-02-26,Assembly,"Do pass",5,1,0,0,6
1147560,811735,2019-02-28,Assembly,"SB 126 Leyva Senate Third Reading By O'DONNELL",64,10,6,0,80
1147562,834038,2019-04-02,Senate,"Do pass, but first be re-referred to the Committee on [Appropriations]",3,0,2,0,5
1147562,848782,2019-04-22,Senate,"Placed on suspense file",6,0,0,0,6
1147562,865637,2019-05-16,Senate,"Do pass as amended",4,2,0,0,6
1147562,868826,2019-05-21,Senate,"Senate 3rd Reading SB72 Umberg et al",30,8,0,0,38
1147562,884887,2019-06-19,Assembly,"Do pass and be re-referred to the Committee on [Appropriations]",5,2,0,0,7
1147562,892317,2019-08-30,Assembly,"Do pass",14,4,0,0,18
1147562,892318,2019-09-09,Assembly,"SB 72 Umberg Senate Third Reading By Gonzalez",62,17,0,0,79
1147562,892319,2019-09-11,Senate,"Unfinished Business SB72 Umberg et al. Concurrence",30,10,0,0,40
1147563,842973,2019-04-11,Senate,"Senate 3rd Reading SB109 B. & F.R",27,9,2,0,38
1147563,893775,2019-09-12,Assembly,"SB 109 B. & F. R. Senate Third Reading By TING",63,12,4,0,79
1147563,894226,2019-09-13,Senate,"Unfinished Business SB109 B. & F.R. (Mitchell) Concurrence",29,10,1,0,40
1147564,790575,2019-01-31,Senate,"Senate 3rd Reading SCR4 Glazer",33,0,5,0,38
1147564,797126,2019-02-11,Assembly,"Be adopted. To Consent Calendar",10,0,1,0,11
1147564,801912,2019-02-15,Assembly,"SCR 4 Glazer Consent Calendar Second Day Regular Session",64,0,16,0,80
1147566,854445,2019-04-23,Senate,"Do pass as amended, but first amend, and re-refer to the Committee on [Appropriations]",9,3,0,0,12
1147566,863367,2019-05-13,Senate,"Placed on suspense file",6,0,0,0,6
1147566,866130,2019-05-16,Senate,"Do pass as amended",4,2,0,0,6
1147566,870937,2019-05-23,Senate,"Senate 3rd Reading SB127 Wiener et al",29,9,0,0,38
1147566,892788,2019-07-08,Assembly,"Do pass and be re-referred to the Committee on [Appropriations]",10,3,2,0,15
1147566,892789,2019-08-30,Assembly,"Do pass as amended",13,5,0,0,18
1147566,892790,2019-09-10,Assembly,"SB 127 Wiener Senate Third Reading By Boerner Horvath",58,17,4,0,79
1147566,892791,2019-09-11,Senate,"Unfinished Business SB127 Wiener et al. Concurrence",28,12,0,0,40
1147567,842857,2019-04-11,Senate,"Senate 3rd Reading SB103 B. & F.R",27,9,2,0,38
1147567,882927,2019-06-17,Assembly,"SB 103 B. & F. R. Senate Third Reading By TING",75,0,4,0,79
1147567,885971,2019-06-20,Senate,"Unfinished Business SB103 B. & F.R. (Mitchell) Concurrence",34,4,2,0,40
1151211,826796,2019-03-20,Assembly,"Do pass",18,0,3,0,21
1151211,831623,2019-03-28,Assembly,"AB 205 Daly Assembly Third Reading",73,0,7,0,80
1151211,880572,2019-06-11,Senate,"Do pass",14,0,2,0,16
1151211,886010,2019-06-20,Senate,"Special Consent AB205",40,0,0,0,40
1151211,888396,2019-06-27,Assembly,"AB 205 Daly Concurrence in Senate Amendments",70,0,9,0,79
1151251,844020,2019-04-10,Assembly,"Do pass as amended and be re-referred to the Committee on [Appropriations]",7,0,0,0,7
1151251,864912,2019-05-15,Assembly,"Do pass. To Consent Calendar",16,0,2,0,18
1151251,870255,2019-05-22,Assembly,"AB 201 Cervantes Consent Calendar Second Day",77,0,3,0,80
1151251,892991,2019-07-02,Senate,"Do pass as amended, but first amend, and re-refer to the Committee on [Appropriations]",4,1,0,0,5
1151251,892992,2019-09-11,Senate,"Assembly 3rd Reading AB201 Cervantes et al. By Allen",34,1,5,0,40
1151251,893897,2019-09-13,Assembly,"With recommendation: That Senate amendments be concurred in",7,0,0,0,7
1151251,893982,2019-09-13,Assembly,"AB 201 Cervantes Concurrence in Senate Amendments",72,1,6,0,79
1151265,834708,2019-04-03,Assembly,"Do pass and be re-referred to the Committee on [Appropriations] with recommendation: To Consent Calendar",14,0,0,0,14
1151265,851601,2019-04-24,Assembly,"Do pass. To Consent Calendar",18,0,0,0,18
1151265,858247,2019-05-02,Assembly,"AB 207 Daly Consent Calendar Second Day Regular Session",76,0,4,0,80
1151265,894011,2019-05-02,Assembly,Date,18,0,0,0,18
1151278,827115,2019-03-20,Assembly,"Do pass and be re-referred to the Committee on [Appropriations]",18,0,3,0,21
1151291,783590,2019-01-17,Assembly,"Be adopted. To third reading",7,0,4,0,11
1151291,804148,2019-02-19,Senate,"Special Consent ACR13 Chu et al",34,0,4,0,38
1151304,783388,2019-01-17,Assembly,"Be adopted. To third reading",7,0,4,0,11
1151332,825904,2019-03-19,Assembly,"Do pass and be re-referred to the Committee on [Appropriations]",15,0,0,0,15
1151332,866475,2019-05-16,Assembly,"Do pass as amended",13,0,5,0,18
1151332,871071,2019-05-23,Assembly,"AB 204 Wood Assembly Third Reading",76,0,4,0,80
1151332,891259,2019-07-10,Senate,"Do pass, but first be re-referred to the Committee on [Appropriations]",8,0,1,0,9
1151332,891260,2019-08-12,Senate,"Placed on suspense file",7,0,0,0,7
1151332,891261,2019-08-30,Senate,"Do pass",7,0,0,0,7
1151332,891262,2019-09-09,Senate,"Special Consent AB204",40,0,0,0,40
1151332,891263,2019-09-10,Assembly,"AB 204 Wood Concurrence in Senate Amendments",78,0,1,0,79
1151348,820068,2019-03-12,Assembly,"Do pass and be re-referred to the Committee on [Appropriations]",11,0,3,0,14
1151348,865691,2019-05-16,Assembly,"Do pass",16,1,1,0,18
1151348,871318,2019-05-23,Assembly,"AB 209 Limón Assembly Third Reading",69,1,10,0,80
1151348,892680,2019-07-09,Senate,"Do pass as amended, but first amend, and re-refer to the Committee on [Appropriations]",8,0,1,0,9
1151348,892681,2019-08-19,Senate,"Placed on suspense file",5,0,2,0,7
1151348,892682,2019-08-30,Senate,"Do pass",6,0,1,0,7
1151348,892683,2019-09-04,Senate,"Assembly 3rd Reading AB209 Limón et al. By Caballero",34,3,3,0,40
1151348,892684,2019-09-09,Assembly,"AB 209 Limón Concurrence in Senate Amendments",72,1,6,0,79
1151361,851509,2019-04-23,Senate,"Do pass, but first be re-referred to the Committee on [Appropriations]",4,1,2,0,7
1151361,859588,2019-05-06,Senate,"Placed on suspense file",5,0,1,0,6
1151361,866140,2019-05-16,Senate,"Do pass as amended",4,2,0,0,6
1151361,871186,2019-05-23,Senate,"Senate 3rd Reading SB132 Wiener",29,8,1,0,38
1151361,887642,2019-06-25,Assembly,"Do pass and be re-referred to the Committee on [Appropriations]",5,1,2,0,8
1151361,892773,2019-08-30,Assembly,"Do pass as amended",11,5,2,0,18
1151361,978154,2020-08-30,Assembly,"SB 132 Wiener Senate Third Reading By Mark Stone",52,15,12,0,79
1151361,978155,2020-08-31,Senate,"Unfinished Business SB132 Wiener et al. Concurrence",29,10,1,0,40
1151374,815274,2019-03-05,Assembly,"Be adopted as amended. To Consent Calendar",11,0,1,0,12
1151374,822098,2019-03-14,Assembly,"ACR 14 Limón Consent Calendar Second Day",72,0,8,0,80
1151374,836675,2019-04-04,Senate,"Special Consent ACR14",37,0,1,0,38
1151400,825163,2019-03-19,Assembly,"Do pass",12,0,0,0,12
1151400,831311,2019-03-28,Assembly,"AB 206 Chiu Assembly Third Reading",71,0,9,0,80
1151400,880389,2019-06-11,Senate,"Do pass, but first be re-referred to the Committee on [Environmental Quality]",9,0,0,0,9
1151400,884593,2019-06-19,Senate,"Do pass",7,0,0,0,7
1151400,892849,2019-08-12,Senate,"Assembly 3rd Reading AB206 Chiu et al. By Jackson",39,0,1,0,40
1151400,892850,2019-08-15,Assembly,"AB 206 Chiu Concurrence in Senate Amendments",76,0,3,0,79
1151400,895247,2019-08-12,Senate,Assembly,7,0,0,0,7
1151414,820352,2019-03-12,Assembly,"Do pass and be re-referred to the Committee on [Appropriations]",14,0,0,0,14
1151414,825992,2019-03-20,Assembly,"Do pass",13,0,5,0,18
1151414,828073,2019-03-25,Assembly,"AB 202 Mathis Assembly Third Reading",73,0,7,0,80
1151428,783786,2019-01-18,Senate,"Senate 3rd Reading SCR5 Bradford et al",34,0,4,0,38
1151428,795572,2019-02-07,Assembly,"Be adopted. To Consent Calendar",11,0,0,0,11
1151428,801928,2019-02-15,Assembly,"SCR 5 Bradford Consent Calendar Second Day Regular Session",64,0,16,0,80
1151441,816783,2019-03-06,Assembly,"Do pass and be re-referred to the Committee on [Appropriations]",7,0,0,0,7
1151441,866261,2019-05-16,Assembly,"Do pass as amended",17,0,1,0,18
1151441,871110,2019-05-23,Assembly,"AB 203 Salas Assembly Third Reading",76,0,4,0,80
1151441,885402,2019-06-19,Senate,"Do pass, but first be re-referred to the Committee on [Appropriations]",5,0,0,0,5
1151441,893348,2019-07-01,Senate,"Placed on suspense file",7,0,0,0,7
1151441,893349,2019-08-30,Senate,"Do pass",7,0,0,0,7
1151441,893350,2019-09-10,Senate,"Assembly 3rd Reading AB203 Salas et al. By Galgiani",40,0,0,0,40
1151441,893351,2019-09-11,Assembly,"AB 203 Salas Concurrence in Senate Amendments",79,0,0,0,79
1153444,831657,2019-03-27,Assembly,"Do pass as amended",8,0,0,0,8
1153444,838657,2019-04-08,Assembly,"AB 212 Bonta Assembly Third Reading",73,0,7,0,80
1153444,878637,2019-06-05,Senate,"Do pass",7,0,0,0,7
1153444,886082,2019-06-20,Senate,"Special Consent AB212",40,0,0,0,40
1153447,851216,2019-04-24,Senate,"Do pass, but first be re-referred to the Committee on [Appropriations]",4,1,0,0,5
1153447,859468,2019-05-06,Senate,"Placed on suspense file",5,0,1,0,6
1153447,865779,2019-05-16,Senate,"Do pass",4,2,0,0,6
1153450,829403,2019-03-26,Senate,"Do pass, but first be re-referred to the Committee on [Appropriations]",5,2,0,0,7
1153450,873907,2019-05-28,Senate,"Senate 3rd Reading SB136 Wiener et al",21,11,6,0,38
1153450,887563,2019-06-25,Assembly,"Do pass and be re-referred to the Committee on [Appropriations]",6,2,0,0,8
1153450,892668,2019-08-30,Assembly,"Do pass as amended",10,5,3,0,18
1153450,893796,2019-09-12,Assembly,"SB 136 Wiener Senate Third Reading By Kalra",41,37,1,0,79
1153450,894197,2019-09-13,Senate,"Unfinished Business SB136 Wiener",22,16,2,0,40
1153454,811272,2019-02-26,Assembly,"Do pass as amended, and be re-referred to the Committee on [Appropriations] with recommendation: To Consent Calendar",8,0,0,0,8
1153457,787534,2019-01-28,Senate,"Senate 3rd Reading SR11 Leyva et al",34,0,4,0,38
1153460,836689,2019-04-03,Assembly,"Do pass and be re-referred to the Committee on [Appropriations]",8,0,0,0,8
1153460,865727,2019-05-16,Assembly,"Do pass",18,0,0,0,18
1153460,871016,2019-05-23,Assembly,"AB 213 Reyes Assembly Third Reading",77,0,3,0,80
1153460,888135,2019-06-26,Senate,"Do pass, but first be re-referred to the Committee on [Appropriations]",7,0,0,0,7
1153460,892922,2019-08-19,Senate,"Placed on suspense file",5,0,2,0,7
1153463,829431,2019-03-26,Senate,"Do pass, but first be re-referred to the Committee on [Appropriations] with the recommendation: To Consent Calendar",12,0,0,0,12
1153463,848958,2019-04-22,Senate,"Placed on suspense file",6,0,0,0,6
1153463,865599,2019-05-16,Senate,"Do pass",6,0,0,0,6
1153463,870965,2019-05-23,Senate,"Special Consent SB137",38,0,0,0,38
1153463,889308,2019-07-01,Assembly,"Do pass and be re-referred to the Committee on [Appropriations] with recommendation: To Consent Calendar",15,0,0,0,15
1153463,892944,2019-08-30,Assembly,"Do pass as amended",18,0,0,0,18
1153463,892945,2019-09-09,Assembly,"SB 137 Dodd Senate Third Reading By Robert Rivas",79,0,0,0,79
1153463,892946,2019-09-10,Senate,"Unfinished Business SB137 Dodd Concurrence",40,0,0,0,40
1153467,839872,2019-04-09,Senate,"Do pass, but first be re-referred to the Committee on [Appropriations]",7,0,2,0,9
1153467,863067,2019-05-13,Senate,"Senate 3rd Reading SB134 Hertzberg",37,0,1,0,38
1153467,883756,2019-06-18,Assembly,"Do pass and be re-referred to the Committee on [Appropriations]",12,0,1,0,13
1153467,892827,2019-08-14,Assembly,"Do pass",18,0,0,0,18
1153467,892828,2019-08-19,Assembly,"SB 134 Hertzberg Senate Third Reading By Blanca Rubio",78,0,1,0,79
1153470,831196,2019-03-26,Assembly,"Do pass and be re-referred to the Committee on [Appropriations] with recommendation: To Consent Calendar",15,0,0,0,15
1153473,850224,2019-04-22,Assembly,"Do pass and be re-referred to the Committee on [Appropriations]",10,1,0,0,11
1153473,866234,2019-05-16,Assembly,"Do pass as amended",13,0,5,0,18
1153473,871115,2019-05-23,Assembly,"AB 211 Calderon Assembly Third Reading",78,0,2,0,80
1153473,881034,2019-06-12,Senate,"Do pass as amended, but first amend, and re-refer to the Committee on [Appropriations]",5,0,2,0,7
1153473,886954,2019-06-24,Senate,"Placed on suspense file",7,0,0,0,7
1153473,891070,2019-08-30,Senate,"Do pass as amended",7,0,0,0,7
1153473,891071,2019-09-04,Senate,"Assembly 3rd Reading AB211 Calderon et al. By McGuire",37,1,0,0,38
1153473,891072,2019-09-04,Senate,"Assembly 3rd Reading AB211 Calderon et al. By McGuire Reconsider",39,0,1,0,40
1153473,891073,2019-09-04,Senate,"Assembly 3rd Reading AB211 Calderon et al. By McGuire",39,0,0,0,39
1153473,891074,2019-09-09,Assembly,"AB 211 Calderon Concurrence in Senate Amendments",78,0,1,0,79
1153476,903164,2020-01-15,Assembly,"Do pass and be re-referred to the Committee on [Appropriations]",6,0,1,0,7
1153476,905375,2020-01-23,Assembly,"Do pass",18,0,0,0,18
1153476,906403,2020-01-27,Assembly,"AB 216 Weber Assembly Third Reading",76,0,4,0,80
1156634,830557,2019-03-26,Assembly,"Do pass as amended and be re-referred to the Committee on [Appropriations]",6,3,0,0,9
1156634,866323,2019-05-16,Assembly,"Do pass as amended",11,7,0,0,18
1156634,882916,2019-06-17,Assembly,"Do pass",7,0,4,0,11
1156689,835171,2019-03-27,Assembly,"Do pass as amended and be re-referred to the Committee on [Appropriations]",5,1,0,0,6
1156689,865712,2019-05-16,Assembly,"Do pass",10,5,3,0,18
1156744,819860,2019-03-12,Assembly,"Do pass",8,2,2,0,12
1156744,833206,2019-04-01,Assembly,"AB 218 Gonzalez Assembly Third Reading",64,3,13,0,80
1156744,834419,2019-03-12,Assembly,Noes:,0,2,2,0,4
1156744,892018,2019-07-02,Senate,"Do pass, but first be re-referred to the Committee on [Appropriations]",7,1,1,0,9
1156744,892019,2019-08-12,Senate,"Placed on suspense file",7,0,0,0,7
1156744,892020,2019-08-30,Senate,"Do pass as amended",5,1,1,0,7
1156744,893925,2019-09-14,Assembly,"AB 218 GONZALEZ Concurrence in Senate Amendments",0,0,0,0,0
1156744,894153,2019-09-13,Senate,"Assembly 3rd Reading AB218 Gonzalez et al. By Jackson",33,0,0,0,33
1156744,894364,2019-09-14,Senate,"Assembly 3rd Reading AB218 Gonzalez et al. By Jackson",33,0,7,0,40
1156799,873269,2019-04-30,Assembly,"Be adopted",6,2,5,0,13
1156799,873270,2019-04-30,Assembly,Reconsideration,7,0,6,0,13
1156910,856874,2019-05-01,Assembly,"Do pass",6,0,1,0,7
1156910,873899,2019-05-28,Assembly,"AB 220 Bonta Assembly Third Reading",70,0,10,0,80
1156910,893313,2019-07-02,Senate,"Do pass",5,0,0,0,5
1156910,893314,2019-09-10,Senate,"Assembly 3rd Reading AB220 Bonta et al. By Skinner",35,4,1,0,40
1156910,893315,2019-09-11,Assembly,"AB 220 Bonta Concurrence in Senate Amendments",72,1,6,0,79
1161043,834315,2019-04-02,Senate,"Do pass, but first be re-referred to the Committee on [Governance and Finance]",4,0,1,0,5
1161043,853142,2019-04-24,Senate,"Do pass as amended, but first amend, and re-refer to the Committee on [Appropriations]",5,2,0,0,7
1161043,863097,2019-05-13,Senate,"Placed on suspense file",6,0,0,0,6
1161043,866489,2019-05-16,Senate,"Do pass as amended",4,2,0,0,6
1161043,870055,2019-05-22,Senate,"Senate 3rd Reading SB139 Allen et al",29,7,2,0,38
1161043,884695,2019-06-19,Assembly,"Do pass and be re-referred to the Committee on [Local Government]",6,0,1,0,7
1161043,892640,2019-07-03,Assembly,"Do pass and be re-referred to the Committee on [Appropriations]",5,3,0,0,8
1161043,892641,2019-08-30,Assembly,"Do pass as amended",13,5,0,0,18
1161043,892642,2019-09-09,Assembly,"SB 139 Allen Senate Third Reading By Salas",61,17,1,0,79
1161043,892643,2019-09-11,Senate,"Unfinished Business SB139 Allen et al. Concurrence",30,10,0,0,40
1161062,841800,2019-04-09,Senate,"Do pass, but first be re-referred to the Committee on [Appropriations] with the recommendation: To Consent Calendar",12,0,0,0,12
1161062,849152,2019-04-22,Senate,"Placed on suspense file",6,0,0,0,6
1161263,851343,2019-04-24,Assembly,"Do pass and be re-referred to the Committee on [Appropriations] with recommendation: To Consent Calendar",14,0,0,0,14
1161263,856744,2019-05-01,Assembly,"Do pass. To Consent Calendar",18,0,0,0,18
1161263,862130,2019-05-09,Assembly,"AB 233 Cooley Consent Calendar Second Day Regular Session",76,0,4,0,80
1161269,838376,2019-04-08,Assembly,"Be re-referred to the Committee on [Health]",11,0,1,0,12
1161269,850158,2019-04-23,Assembly,"Do pass and be re-referred to the Committee on [Appropriations] with recommendation: To Consent Calendar",15,0,0,0,15
1161269,866093,2019-05-16,Assembly,"Do pass as amended",18,0,0,0,18
1161269,871415,2019-05-23,Assembly,"AB 232 Cervantes Assembly Third Reading",78,0,2,0,80
1161276,809245,2019-02-26,Assembly,"Be adopted. To third reading",7,1,0,0,8
1161276,811720,2019-02-28,Assembly,"AJR 4 Aguiar-Curry Assembly Third Reading",60,14,6,0,80
1161276,880266,2019-06-11,Senate,"Be adopted. Ordered to third reading",5,2,0,0,7
1161276,888402,2019-06-27,Senate,"Assembly 3rd Reading AJR4 Aguiar-Curry et al. By Dodd",27,7,6,0,40
1161282,902207,2020-01-13,Assembly,"Do pass and be re-referred to the Committee on [Appropriations] with recommendation: To Consent Calendar",15,0,0,0,15
1161289,833927,2019-03-25,Assembly,"Do pass and be re-referred to the Committee on [Appropriations]",3,8,0,0,11
1161295,842636,2019-04-09,Senate,"Do pass as amended, but first amend, and re-refer to the Committee on [Appropriations]",7,0,0,0,7
1161295,859514,2019-05-06,Senate,"Senate 3rd Reading SB141 Bates et al",38,0,0,0,38
1161295,880566,2019-06-11,Assembly,"Do pass and be re-referred to the Committee on [Appropriations] with recommendation: To Consent Calendar",8,0,0,0,8
1161295,884896,2019-06-19,Assembly,"Do pass. To Consent Calendar",17,0,1,0,18
1161295,893210,2019-08-12,Assembly,"SB 141 Bates Senate Third Reading By Lackey",76,0,3,0,79
1161295,893211,2019-08-22,Senate,"Special Consent SB141",39,0,1,0,40
1161302,836733,2019-04-02,Assembly,"Do pass as amended and be re-referred to the Committee on [Accountability and Administrative Review]",7,0,0,0,7
1161302,851698,2019-04-24,Assembly,"Do pass and be re-referred to the Committee on [Appropriations] with recommendation: To Consent Calendar",7,0,0,0,7
1161302,865771,2019-05-16,Assembly,"Do pass",18,0,0,0,18
1161302,873963,2019-05-28,Assembly,"AB 230 Brough Assembly Third Reading",75,0,5,0,80
1161302,887443,2019-06-25,Senate,"Do pass, but first be re-referred to the Committee on [Veterans Affairs] with the recommendation: To Consent Calendar",16,0,0,0,16
1161302,892814,2019-07-09,Senate,"Do pass, but first be re-referred to the Committee on [Appropriations] with the recommendation: To Consent Calendar",6,0,1,0,7
1161302,892815,2019-08-12,Senate,"Placed on suspense file",7,0,0,0,7
1161302,892816,2019-08-30,Senate,"Do pass as amended",7,0,0,0,7
1161302,892817,2019-09-10,Senate,"Assembly 3rd Reading AB230 Brough et al. By Umberg",40,0,0,0,40
1161302,892818,2019-09-11,Assembly,"AB 230 Brough Concurrence in Senate Amendments",79,0,0,0,79
1161302,894629,2019-08-30,Senate,Date,7,0,0,0,7
1161308,834219,2019-03-27,Senate,"Do pass as amended, but first amend, and re-refer to the Committee on [Appropriations]",7,0,0,0,7
1161308,848885,2019-04-22,Senate,"Placed on suspense file",6,0,0,0,6
1161308,865618,2019-05-16,Senate,"Do pass",6,0,0,0,6
1161308,870962,2019-05-23,Senate,"Special Consent SB138",38,0,0,0,38
1161308,886021,2019-06-19,Assembly,"Do pass and be re-referred to the Committee on [Appropriations] with recommendation: To Consent Calendar",7,0,0,0,7
1161308,894445,2019-05-16,Senate,Result,6,0,0,0,6
1161315,826046,2019-03-19,Assembly,"Do pass as amended and be re-referred to the Committee on [Business and Professions]",15,0,0,0,15
1161315,829186,2019-03-26,Assembly,"Do pass and be re-referred to the Committee on [Appropriations]",20,0,0,0,20
1161315,866217,2019-05-16,Assembly,"Do pass",18,0,0,0,18
1161315,869805,2019-05-22,Assembly,"AB 228 Aguiar-Curry Third Reading Urgency",77,0,3,0,80
1161315,881063,2019-06-12,Senate,"Do pass as amended, but first amend, and re-refer to the Committee on [Business, Professions and Economic Development]",8,0,1,0,9
1161315,887034,2019-06-24,Senate,"Do pass as amended, but first amend, and re-refer to the Committee on [Appropriations]",9,0,0,0,9
1161315,891698,2019-08-12,Senate,"Placed on suspense file",7,0,0,0,7
1161321,809946,2019-02-26,Assembly,"Do pass and be re-referred to the Committee on [Appropriations] with recommendation: To Consent Calendar",8,0,0,0,8
1161328,809127,2019-02-26,Assembly,"Do pass and be re-referred to the Committee on [Appropriations]",7,0,1,0,8
1161332,840672,2019-04-08,Assembly,"Do pass and be re-referred to the Committee on [Appropriations]",11,0,0,0,11
1163091,825130,2019-03-13,Assembly,"Do pass as amended and be re-referred to the Committee on [Appropriations]",6,0,0,0,6
1163091,865968,2019-05-16,Assembly,"Do pass",18,0,0,0,18
1163091,875476,2019-05-30,Assembly,"AB 236 Eduardo Garcia Assembly Third Reading",78,0,2,0,80
1163091,884766,2019-06-19,Senate,"Do pass, but first be re-referred to the Committee on [Appropriations] with the recommendation: To Consent Calendar",6,0,1,0,7
1163091,889258,2019-07-01,Senate,"Placed on suspense file",7,0,0,0,7
1163091,896188,2019-05-16,Assembly,Result,18,0,0,0,18
1163118,854831,2019-04-24,Assembly,"Do pass as amended and be re-referred to the Committee on [Appropriations]",12,0,3,0,15
1163118,866187,2019-05-16,Assembly,"Do pass",17,0,1,0,18
1163118,869974,2019-05-22,Assembly,"AB 235 Mayes Assembly Third Reading",59,2,19,0,80
1163148,839915,2019-04-09,Senate,"Do pass, but first be re-referred to the Committee on [Appropriations]",6,0,1,0,7
1163148,859593,2019-05-06,Senate,"Placed on suspense file",5,0,1,0,6
1163148,866380,2019-05-16,Senate,"Do pass as amended",4,2,0,0,6
1163148,873850,2019-05-28,Senate,"Senate 3rd Reading SB145 Wiener",25,3,10,0,38
1163148,892787,2019-07-09,Assembly,"Do pass as amended and be re-referred to the Committee on [Appropriations]",6,2,0,0,8
1163148,976451,2020-08-20,Assembly,"Do pass",10,6,2,0,18
1163148,977733,2020-08-31,Senate,"Unfinished Business SB145 Wiener Concurrence",23,10,7,0,40
1163148,977734,2020-08-31,Assembly,"SB 145 Wiener Senate Third Reading By Kamlager",41,25,13,0,79
1163208,885590,2019-06-19,Assembly,"Be adopted and re-referred to the Committee on [Appropriations]",4,0,3,0,7
1163208,891098,2019-08-14,Assembly,"Be adopted",13,4,1,0,18
1163208,891099,2019-08-22,Assembly,"ACA 4 Mullin Assembly Third Reading",58,13,8,0,79
1163208,968316,2020-06-23,Senate,"Be adopted, but first be re-referred to the Committee on [Appropriations]",4,1,0,0,5
1163208,968680,2020-06-24,Senate,"Be adopted",5,1,1,0,7
1163208,969399,2020-06-26,Assembly,"ACA 4 Mullin Concurrence in Senate Amendments",56,13,10,0,79
1163208,969756,2020-06-25,Senate,"Assembly 3rd Reading ACA4 Mullin et al. By Umberg",31,7,2,0,40
1163238,894091,2019-07-11,Assembly,"Be adopted. To third reading",11,0,1,0,12
1163294,815354,2019-03-05,Assembly,"Do pass and be re-referred to the Committee on [Appropriations]",11,0,1,0,12
1163294,826062,2019-03-20,Assembly,"Do pass. To Consent Calendar",13,0,5,0,18
1163294,831503,2019-03-28,Assembly,"AB 239 Salas Consent Calendar Second Day Regular Session",72,0,8,0,80
1163294,878424,2019-06-05,Senate,"Do pass, but first be re-referred to the Committee on [Appropriations] with the recommendation: To Consent Calendar",7,0,0,0,7
1163294,887057,2019-06-24,Senate,"Do pass",7,0,0,0,7
1163294,889229,2019-07-01,Senate,"Assembly 3rd Reading AB239 Salas By Hurtado",39,0,1,0,40
1163323,830484,2019-03-27,Senate,"Do pass, but first be re-referred to the Committee on [Judiciary]",4,1,0,0,5
1163323,841481,2019-04-09,Senate,"Do pass as amended, but first amend, and re-refer to the Committee on [Housing]",3,0,5,0,8
1163323,842638,2019-04-11,Senate,"[04-11-2019] hearing: Motion to Reconsider. [Reconsideration Granted.]",6,0,3,0,9
1163323,842639,2019-04-11,Senate,"Do pass as amended, but first amend, and re-refer to the Committee on [Housing]",6,1,2,0,9
1163323,850497,2019-04-22,Senate,"Do pass as amended, but first amend, and re-refer to the Committee on [Appropriations]",7,2,2,0,11
1163323,850498,2019-04-22,Senate,"[04-23-2019] set for [First] hearing: Reconsideration of favorable vote granted",11,0,0,0,11
1163323,850499,2019-04-22,Senate,"Do pass as amended, but first amend, and re-refer to the Committee on [Appropriations]",8,2,1,0,11
1163323,863042,2019-05-13,Senate,"Placed on suspense file",6,0,0,0,6
1163323,865909,2019-05-16,Senate,"Do pass",4,2,0,0,6
1163323,868729,2019-05-21,Senate,"Senate 3rd Reading SB142 Wiener et al",26,9,3,0,38
1163323,888560,2019-06-26,Assembly,"Do pass and be re-referred to the Committee on [Business and Professions]",6,0,1,0,7
1163323,891090,2019-07-02,Assembly,"Do pass as amended and be re-referred to the Committee on [Appropriations]",14,2,3,0,19
1163323,891091,2019-08-30,Assembly,"Do pass as amended",13,4,1,0,18
1163323,891092,2019-09-10,Assembly,"SB 142 Wiener Senate Third Reading By Wicks",57,13,9,0,79
1163323,891093,2019-09-11,Senate,"Unfinished Business SB142 Wiener et al. Concurrence",28,11,1,0,40
1163323,894845,2019-05-13,Senate,"Sen Approp",6,0,0,0,6
1163353,832987,2019-03-27,Senate,"Do pass as amended, but first amend, and re-refer to the Committee on [Appropriations]",7,0,0,0,7
1163353,849041,2019-04-22,Senate,"Placed on suspense file",6,0,0,0,6
1163353,865710,2019-05-16,Senate,"Do pass as amended",5,0,1,0,6
1163353,871458,2019-05-23,Senate,"Senate 3rd Reading SB148 Glazer et al",38,0,0,0,38
1163353,880412,2019-06-11,Assembly,"Do pass and be re-referred to the Committee on [Appropriations]",11,0,1,0,12
1163353,894840,2019-04-22,Senate,Result,6,0,0,0,6
1163384,851670,2019-04-23,Assembly,"Do pass and be re-referred to the Committee on [Appropriations]",8,0,0,0,8
1163384,866075,2019-05-16,Assembly,"Do pass",14,2,2,0,18
1163384,869883,2019-05-22,Assembly,"AB 243 Kamlager-Dove Assembly Third Reading",60,8,12,0,80
1163384,887650,2019-06-25,Senate,"Do pass, but first be re-referred to the Committee on [Appropriations]",5,1,1,0,7
1163384,891786,2019-08-12,Senate,"Placed on suspense file",7,0,0,0,7
1163384,894509,2019-05-22,Assembly,Date,14,8,0,0,22
1163414,829512,2019-03-26,Senate,"Do pass and be ordered to the Consent Calendar",12,0,0,0,12
1163414,836456,2019-04-04,Senate,"Consent Calendar SB146",37,0,1,0,38
1163414,975541,2020-08-11,Assembly,"Do pass as amended",8,0,0,0,8
1163414,978185,2020-08-30,Assembly,"SB 146 Beall Senate Third Reading By Mullin",75,0,4,0,79
1163414,978186,2020-08-31,Senate,"Unfinished Business SB146 Beall Concurrence",39,0,1,0,40
1163443,829510,2019-03-26,Senate,"Do pass and be ordered to the Consent Calendar",12,0,0,0,12
1163443,836922,2019-04-04,Senate,"Consent Calendar SB147",37,0,1,0,38
1163473,950966,2020-03-12,Assembly,"Be re-referred to the Committee on [Public Employment and Retirement]",7,2,3,0,12
1163473,957443,2020-05-05,Assembly,"Be adopted and re-referred to the Committee on [Appropriations]",6,1,0,0,7
1163473,962768,2020-06-03,Assembly,"Be adopted",11,5,2,0,18
1163473,965063,2020-06-10,Assembly,"ACA 5 Weber Assembly Third Reading",60,14,5,0,79
1163473,966968,2020-06-17,Senate,"Be adopted, but first be re-referred to the Committee on [Appropriations]",4,1,0,0,5
1163473,968313,2020-06-23,Senate,"Be adopted",5,2,0,0,7
1163473,968688,2020-06-24,Senate,"Assembly 3rd Reading ACA5 Weber et al. By Mitchell",30,10,0,0,40
1163504,854837,2019-04-23,Assembly,"Do pass as amended and be re-referred to the Committee on [Appropriations]",14,0,6,0,20
1163504,861639,2019-05-08,Assembly,"Do pass",13,1,4,0,18
1163504,863060,2019-05-13,Assembly,"AB 241 Kamlager-Dove Assembly Third Reading",64,5,11,0,80
1163504,893117,2019-07-08,Senate,"Do pass, but first be re-referred to the Committee on [Appropriations]",9,0,0,0,9
1163504,893118,2019-09-03,Senate,"Assembly 3rd Reading AB241 Kamlager-Dove et al. By Wiener",34,0,6,0,40
1163504,893119,2019-09-05,Assembly,"AB 241 Kamlager-Dove Concurrence in Senate Amendments",68,4,7,0,79
1163533,841767,2019-04-09,Assembly,"Do pass and be re-referred to the Committee on [Appropriations]",10,0,1,0,11
1163533,852411,2019-04-24,Assembly,"Do pass. To Consent Calendar",18,0,0,0,18
1163533,858125,2019-05-02,Assembly,"AB 240 Irwin Consent Calendar Second Day Regular Session",76,0,4,0,80
1163533,880673,2019-06-11,Senate,"Do pass, but first be re-referred to the Committee on [Governmental Organization]",7,0,0,0,7
1163533,893427,2019-07-09,Senate,"Do pass as amended, but first amend, and re-refer to the Committee on [Appropriations]",15,0,1,0,16
1163533,977182,2020-08-27,Senate,"Assembly 3rd Reading AB240 Irwin et al. By Archuleta",30,0,10,0,40
1163533,977904,2020-08-30,Assembly,"AB 240 Irwin Concurrence in Senate Amendments",75,0,4,0,79
1163562,850540,2019-04-22,Assembly,"Do pass and be re-referred to the Committee on [Appropriations]",15,0,0,0,15
1163562,905353,2020-01-23,Assembly,"Do pass",18,0,0,0,18
1163562,912036,2020-01-30,Assembly,"AB 238 Santiago Assembly Third Reading",76,0,4,0,80
1163562,974812,2020-08-04,Senate,"Do pass, but first be re-referred to the Committee on [Appropriations] with the recommendation: To Consent Calendar",14,0,1,0,15
1163562,975996,2020-08-17,Senate,"Placed on suspense file",7,0,0,0,7
1163593,850470,2019-04-23,Assembly,"Do pass as amended and be re-referred to the Committee on [Appropriations]",9,0,3,0,12
1163593,861542,2019-05-08,Assembly,"Do pass",14,0,4,0,18
1163593,863071,2019-05-13,Assembly,"AB 242 Kamlager-Dove Assembly Third Reading",64,3,13,0,80
1163593,887917,2019-06-25,Senate,"Do pass as amended, but first amend, and re-refer to the Committee on [Appropriations]",8,0,1,0,9
1163593,893377,2019-09-11,Senate,"Assembly 3rd Reading AB242 Kamlager-Dove et al. By Jackson",34,2,4,0,40
1163593,893753,2019-09-12,Assembly,"AB 242 Kamlager-Dove Concurrence in Senate Amendments",69,0,10,0,79
1163622,851334,2019-04-23,Senate,"Do pass, but first be re-referred to the Committee on [Appropriations]",5,2,0,0,7
1163622,859477,2019-05-06,Senate,"Placed on suspense file",5,0,1,0,6
1163622,866064,2019-05-16,Senate,"Do pass as amended",4,2,0,0,6
1163622,874480,2019-05-29,Senate,"Senate 3rd Reading SB144 Mitchell et al",26,8,4,0,38
1163652,828085,2019-03-25,Senate,"Do pass",9,0,0,0,9
1163652,838268,2019-04-08,Senate,"Senate 3rd Reading SB143 Skinner",38,0,0,0,38
1163652,880323,2019-06-11,Assembly,"Do pass as amended and be re-referred to the Committee on [Appropriations]",18,0,2,0,20
1163652,881529,2019-06-11,Assembly,"Do pass as amended",17,0,2,0,19
1163652,892028,2019-08-12,Assembly,"SB 143 Skinner Third Reading Urgency By Mayes",78,0,1,0,79
1163652,892029,2019-08-22,Senate,"Special Consent SB143 Skinner Urgency Clause",39,0,1,0,40
1167384,841806,2019-04-09,Senate,"Do pass, but first be re-referred to the Committee on [Appropriations]",10,1,1,0,12
1167384,863195,2019-05-13,Senate,"Placed on suspense file",6,0,0,0,6
1167435,841675,2019-04-10,Senate,"Do pass, but first be re-referred to the Committee on [Appropriations]",7,0,0,0,7
1167435,854804,2019-04-29,Senate,"Placed on suspense file",6,0,0,0,6
1167435,865758,2019-05-16,Senate,"Do pass",6,0,0,0,6
1167435,871112,2019-05-23,Senate,"Special Consent SB150",38,0,0,0,38
1167435,880458,2019-06-11,Assembly,"Do pass as amended and be re-referred to the Committee on [Appropriations]",11,0,1,0,12
1167435,891810,2019-08-30,Assembly,"Do pass as amended",18,0,0,0,18
1167435,891811,2019-09-09,Assembly,"SB 150 Beall Senate Third Reading By Maienschein",79,0,0,0,79
1167435,891812,2019-09-10,Senate,"Unfinished Business SB150 Beall et al. Concurrence",40,0,0,0,40
1167459,787485,2019-01-28,Assembly,"Be adopted. To third reading",11,0,0,0,11
1167459,804110,2019-02-19,Senate,"Special Consent ACR15",34,0,4,0,38
1167484,855985,2019-04-03,Assembly,"Do pass and be re-referred to the Committee on [Appropriations]",2,5,0,0,7
1167561,837319,2019-04-03,Assembly,"Do pass and be re-referred to the Committee on [Appropriations]",20,0,1,0,21
1167561,866281,2019-05-16,Assembly,"Do pass",18,0,0,0,18
1167561,870231,2019-05-22,Assembly,"AB 247 Dahle Third Reading Urgency",78,0,2,0,80
1167561,880833,2019-06-11,Senate,"Do pass, but first be re-referred to the Committee on [Appropriations]",14,0,2,0,16
1167561,889296,2019-07-01,Senate,"Placed on suspense file",7,0,0,0,7
1167585,824984,2019-03-19,Senate,"Do pass, but first be re-referred to the Committee on [Appropriations]",4,0,1,0,5
1167585,849200,2019-04-22,Senate,"Senate 3rd Reading SB151 Umberg",38,0,0,0,38
1167585,885013,2019-06-19,Assembly,"Do pass as amended, and be re-referred to the Committee on [Appropriations] with recommendation: To Consent Calendar",7,0,0,0,7
1167585,890846,2019-08-14,Assembly,"Do pass",18,0,0,0,18
1167585,890847,2019-09-03,Assembly,"SB 151 Umberg Senate Third Reading By Berman",77,0,2,0,79
1167611,826329,2019-03-20,Senate,"Be adopted, but first be re-referred to the Committee on [Appropriations] with recommendation: To Consent Calendar",6,0,1,0,7
1167611,849674,2019-04-22,Senate,"Consent Calendar SCR6",38,0,0,0,38
1167611,886483,2019-06-19,Assembly,"Be adopted, and re-refer to the Committee on [Appropriations] with recommendation: To Consent Calendar",7,0,0,0,7
1167636,836913,2019-04-02,Assembly,"Do pass as amended and be re-referred to the Committee on [Appropriations]",6,0,1,0,7
1167636,865786,2019-05-16,Assembly,"Do pass as amended",18,0,0,0,18
1167636,871514,2019-05-23,Assembly,"AB 245 Muratsuchi Assembly Third Reading",78,0,2,0,80
1167636,882846,2019-06-17,Senate,"Do pass, but first be re-referred to the Committee on [Governmental Organization]",8,0,1,0,9
1170156,787488,2019-01-28,Assembly,"Be adopted. To third reading",11,0,0,0,11
1170156,803987,2019-02-19,Senate,"Special Consent ACR16",34,0,4,0,38
1170171,826667,2019-03-21,Senate,"Senate 3rd Reading SCR7 Umberg et al",36,0,2,0,38
1170188,826067,2019-03-20,Senate,"Do pass, but first be re-referred to the Committee on [Appropriations]",8,0,1,0,9
1170188,838693,2019-04-08,Senate,"Placed on suspense file",6,0,0,0,6
1170188,866100,2019-05-16,Senate,"Do pass",6,0,0,0,6
1170188,870931,2019-05-23,Senate,"Special Consent SB154",38,0,0,0,38
1170188,880564,2019-06-11,Assembly,"Do pass and be re-referred to the Committee on [Appropriations] with recommendation: To Consent Calendar",14,0,1,0,15
1170188,892699,2019-08-30,Assembly,"Do pass",18,0,0,0,18
1170188,892700,2019-09-09,Assembly,"SB 154 Pan Senate Third Reading By Mayes",79,0,0,0,79
1170188,894843,2019-08-30,Assembly,"Do psLabel"">",14,0,0,0,14
1170205,831391,2019-03-27,Assembly,"Do pass and be re-referred to the Committee on [Health]",6,0,0,0,6
1170205,850376,2019-04-23,Assembly,"Do pass and be re-referred to the Committee on [Appropriations]",15,0,0,0,15
1170205,865725,2019-05-16,Assembly,"Do pass",18,0,0,0,18
1170205,871447,2019-05-23,Assembly,"AB 258 Jones-Sawyer Assembly Third Reading",78,0,2,0,80
1170205,893357,2019-07-03,Senate,"Do pass, but first be re-referred to the Committee on [Appropriations]",6,0,1,0,7
1170205,893358,2019-08-12,Senate,"Placed on suspense file",7,0,0,0,7
1170205,893359,2019-08-30,Senate,"Do pass as amended",7,0,0,0,7
1170205,893360,2019-09-10,Senate,"Assembly 3rd Reading AB258 Jones-Sawyer By Pan",40,0,0,0,40
1170205,893361,2019-09-11,Assembly,"AB 258 Jones-Sawyer Concurrence in Senate Amendments",79,0,0,0,79
1170223,854864,2019-04-24,Senate,"Do pass as amended, but first amend, and re-refer to the Committee on [Appropriations]",9,0,0,0,9
1170223,867709,2019-05-20,Senate,"Senate 3rd Reading SB156 Nielsen et al",38,0,0,0,38
1170223,891105,2019-07-02,Assembly,"Do pass as amended and be re-referred to the Committee on [Appropriations]",15,0,0,0,15
1170223,891106,2019-08-14,Assembly,"Do pass",18,0,0,0,18
1170223,891107,2019-09-10,Assembly,"SB 156 Nielsen Senate Third Reading By Gallagher",79,0,0,0,79
1170223,891108,2019-09-11,Senate,"Unfinished Business SB156 Nielsen et al. Concurrence",40,0,0,0,40
1170238,842672,2019-04-08,Senate,"Do pass as amended, but first amend, and re-refer to the Committee on [Health]",6,0,3,0,9
1170238,853097,2019-04-24,Senate,"Do pass as amended, but first amend, and re-refer to the Committee on [Appropriations]",7,0,2,0,9
1170238,863026,2019-05-13,Senate,"Placed on suspense file",6,0,0,0,6
1170238,865813,2019-05-16,Senate,"Do pass as amended",4,1,1,0,6
1170238,868838,2019-05-21,Senate,"Senate 3rd Reading SB159 Wiener et al",35,1,2,0,38
1170238,887554,2019-06-25,Assembly,"Do pass as amended and be re-referred to the Committee on [Health]",17,0,2,0,19
1170238,892040,2019-07-09,Assembly,"Do pass as amended and be re-referred to the Committee on [Appropriations]",13,0,2,0,15
1170238,892041,2019-08-30,Assembly,"Do pass as amended",17,0,1,0,18
1170238,892042,2019-09-10,Assembly,"SB 159 Wiener Senate Third Reading By Gipson",78,0,1,0,79
1170238,892043,2019-09-11,Senate,"Unfinished Business SB159 Wiener et al. Concurrence",38,0,2,0,40
1170253,833167,2019-03-25,Assembly,"Do pass as amended and be re-referred to the Committee on [Appropriations]",10,1,0,0,11
1170269,848983,2019-04-22,Senate,"Do pass, but first be re-referred to the Committee on [Appropriations]",4,0,0,0,4
1170269,859417,2019-05-06,Senate,"Placed on suspense file",5,0,1,0,6
1170269,866030,2019-05-16,Senate,"Do pass as amended",6,0,0,0,6
1170269,870212,2019-05-22,Senate,"Senate 3rd Reading SB153 Wilk et al",35,0,3,0,38
1170269,890374,2019-07-03,Assembly,"Do pass and be re-referred to the Committee on [Appropriations]",11,0,0,0,11
1170269,890375,2019-08-30,Assembly,"Do pass",17,1,0,0,18
1170269,890376,2019-09-10,Assembly,"SB 153 Wilk Senate Third Reading By Aguiar-Curry",76,1,2,0,79
1170269,890377,2019-09-11,Senate,"Unfinished Business SB153 Wilk et al. Concurrence",40,0,0,0,40
1170287,834380,2019-04-01,Assembly,"Do pass and be re-referred to the Committee on [Appropriations]",15,0,0,0,15
1170303,828186,2019-03-25,Assembly,"Be re-referred to the Committee on [Health]",12,0,0,0,12
1170303,850517,2019-04-23,Assembly,"Do pass as amended, and be re-referred to the Committee on [Appropriations] with recommendation: To Consent Calendar",15,0,0,0,15
1170303,861507,2019-05-08,Assembly,"Do pass. To Consent Calendar",18,0,0,0,18
1170303,866172,2019-05-16,Assembly,"AB 254 Quirk-Silva Consent Calendar Second Day",74,0,6,0,80
1170320,829910,2019-03-25,Assembly,"Do pass and be re-referred to the Committee on [Appropriations] with recommendation: To Consent Calendar",11,0,0,0,11
1170320,834728,2019-04-03,Assembly,"Do pass. To Consent Calendar",17,0,1,0,18
1170320,842749,2019-04-11,Assembly,"AB 255 Limón Consent Calendar Second Day Regular Session",72,0,8,0,80
1170320,880490,2019-06-11,Senate,"Do pass, but first be re-referred to the Committee on [Appropriations] with the recommendation: To Consent Calendar",8,0,1,0,9
1170320,889277,2019-07-01,Senate,"Consent Calendar AB255",39,0,1,0,40
1170337,787324,2019-01-28,Senate,"Senate 3rd Reading SR12 Jackson",31,1,6,0,38
1170354,851461,2019-04-24,Senate,"Do pass",7,0,0,0,7
1170354,858011,2019-05-02,Senate,"Senate 3rd Reading SB158 Allen",38,0,0,0,38
1170354,969997,2020-06-29,Assembly,"Be re-referred to the Committee on [Elections and Redistricting]",7,0,5,0,12
1170354,973994,2020-07-27,Assembly,"Do pass as amended",7,0,0,0,7
1170354,976615,2020-08-24,Assembly,"SB 158 Allen Third Reading Urgency By Kamlager",65,0,14,0,79
1170354,978067,2020-08-30,Senate,"Unfinished Business SB158 Allen Urgency Clause Concurrence",35,3,2,0,40
1170369,856228,2019-04-24,Senate,"Do pass as amended, but first amend, and re-refer to the Committee on [Appropriations]",13,0,0,0,13
1170369,867717,2019-05-20,Senate,"Senate 3rd Reading SB155 Bradford",32,4,2,0,38
1170369,888196,2019-06-26,Assembly,"Do pass and be re-referred to the Committee on [Natural Resources]",12,0,3,0,15
1170369,893006,2019-07-08,Assembly,"Do pass as amended and be re-referred to the Committee on [Appropriations]",11,0,0,0,11
1170369,893007,2019-08-28,Assembly,"Do pass",17,0,1,0,18
1170369,893008,2019-09-03,Assembly,"SB 155 Bradford Senate Third Reading By Quirk",76,0,3,0,79
1170369,893009,2019-09-05,Senate,"Unfinished Business SB155 Bradford Concurrence",39,0,1,0,40
1170386,819793,2019-03-11,Assembly,"Do pass and be re-referred to the Committee on [Appropriations] with recommendation: To Consent Calendar",15,0,0,0,15
1170386,865789,2019-05-16,Assembly,"Do pass",18,0,0,0,18
1170386,870172,2019-05-22,Assembly,"AB 252 Daly Assembly Third Reading",78,0,2,0,80
1170386,880365,2019-06-11,Senate,"Do pass, but first be re-referred to the Committee on [Appropriations] with the recommendation: To Consent Calendar",11,0,1,0,12
1170386,887073,2019-06-24,Senate,"Do pass",7,0,0,0,7
1170386,892426,2019-07-11,Senate,"Special Consent AB252",39,0,1,0,40
1170403,839998,2019-04-08,Assembly,"Do pass and be re-referred to the Committee on [Appropriations]",8,2,1,0,11
1170420,792448,2019-02-04,Senate,"Senate 3rd Reading SR13 Durazo et al",36,0,2,0,38
1170435,835425,2019-04-02,Assembly,"Do pass and be re-referred to the Committee on [Privacy and Consumer Protection]",12,0,0,0,12
1170435,855849,2019-04-30,Assembly,"Do pass. To Consent Calendar",11,0,0,0,11
1170435,862254,2019-05-09,Assembly,"AB 253 Mark Stone Consent Calendar Second Day Regular Session",76,0,4,0,80
1170435,892659,2019-07-02,Senate,"Do pass, but first be re-referred to the Committee on [Appropriations] with the recommendation: To Consent Calendar",9,0,0,0,9
1170435,892660,2019-08-12,Senate,"Placed on suspense file",7,0,0,0,7
1170435,892661,2019-08-30,Senate,"Do pass",7,0,0,0,7
1170435,892662,2019-09-09,Senate,"Assembly 3rd Reading AB253 Mark Stone By Beall",40,0,0,0,40
1170435,892663,2019-09-11,Assembly,"With recommendation: That Senate amendments be concurred in",11,0,1,0,12
1170435,893690,2019-09-12,Assembly,"AB 253 Mark Stone Concurrence in Senate Amendments",79,0,0,0,79
1170450,831902,2019-03-27,Assembly,"Do pass. To Consent Calendar",10,0,1,0,11
1170450,836679,2019-04-04,Assembly,"AB 256 Aguiar-Curry Consent Calendar Second Day Regular Session",75,0,5,0,80
1170450,893390,2019-07-09,Senate,"Do pass, but first be re-referred to the Committee on [Appropriations] with the recommendation: To Consent Calendar",8,0,1,0,9
1170450,893391,2019-09-09,Senate,"Assembly 3rd Reading AB256 Aguiar-Curry By Nielsen",40,0,0,0,40
1170450,893824,2019-09-12,Assembly,"With recommendation: That Senate amendments be concurred in",13,0,1,0,14
1170450,893936,2019-09-13,Assembly,"AB 256 Aguiar-Curry Concurrence in Senate Amendments",78,0,1,0,79
1170450,894772,2019-09-09,Senate,Date,8,0,0,0,8
1172681,820061,2019-03-12,Assembly,"Do pass and be re-referred to the Committee on [Appropriations]",9,3,2,0,14
1172681,841742,2019-04-10,Assembly,"Do pass",12,3,3,0,18
1172681,852949,2019-04-25,Assembly,"AB 273 Gonzalez Assembly Third Reading",51,19,10,0,80
1172681,880578,2019-06-11,Senate,"Do pass, but first be re-referred to the Committee on [Appropriations]",6,2,1,0,9
1172681,891972,2019-08-12,Senate,"Assembly 3rd Reading AB273 Gonzalez By Stern",30,9,1,0,40
1172691,829242,2019-03-25,Assembly,"Do pass and be re-referred to the Committee on [Appropriations]",11,1,3,0,15
1172701,835464,2019-04-03,Assembly,"Do pass and be re-referred to the Committee on [Appropriations]",7,0,0,0,7
1172701,866089,2019-05-16,Assembly,"Do pass",16,0,2,0,18
1172701,873904,2019-05-28,Assembly,"AB 271 Cooper Assembly Third Reading",68,0,12,0,80
1172701,884859,2019-06-19,Senate,"Do pass, but first be re-referred to the Committee on [Appropriations] with the recommendation: To Consent Calendar",5,0,0,0,5
1172701,893745,2019-07-01,Senate,"Placed on suspense file",7,0,0,0,7
1172701,893746,2019-08-30,Senate,"Do pass",7,0,0,0,7
1172701,893747,2019-09-09,Senate,"Special Consent AB271",40,0,0,0,40
1172712,829153,2019-03-26,Senate,"Do pass, but first be re-referred to the Committee on [Appropriations]",2,1,4,0,7
1172712,829154,2019-03-26,Senate,"[First] hearing set for [03-26-2019]: Failed passage in Committee. Reconsideration granted",7,0,0,0,7
1172712,902840,2020-01-14,Senate,"Do pass, but first be re-referred to the Committee on [Appropriations]",2,4,1,0,7
1172732,829176,2019-03-19,Assembly,"Do pass as amended and be re-referred to the Committee on [Appropriations]",13,0,2,0,15
1172732,841683,2019-04-10,Assembly,"Do pass",17,0,1,0,18
1172732,858029,2019-05-02,Assembly,"AB 262 Gloria Assembly Third Reading",71,0,9,0,80
1172732,884869,2019-06-19,Senate,"Do pass, but first be re-referred to the Committee on [Appropriations]",9,0,0,0,9
1172732,890967,2019-09-03,Senate,"Assembly 3rd Reading AB262 Gloria et al. By Pan",39,0,1,0,40
1172732,890968,2019-09-05,Assembly,"AB 262 Gloria Concurrence in Senate Amendments",75,0,4,0,79
1172744,830945,2019-03-26,Assembly,"Do pass and be re-referred to the Committee on [Appropriations]",8,0,0,0,8
1172754,829201,2019-03-26,Senate,"Do pass and be ordered to the Consent Calendar",7,0,0,0,7
1172754,836465,2019-04-04,Senate,"Consent Calendar SB164 McGuire",37,0,1,0,38
1172754,880499,2019-06-11,Assembly,"Do pass. To Consent Calendar",8,0,0,0,8
1172754,883075,2019-06-17,Assembly,"SB 164 McGuire Consent Calendar Second Day Regular Session",75,0,4,0,79
1172754,892257,2019-07-11,Senate,"Special Consent SB164",39,0,1,0,40
1172775,861322,2019-05-06,Assembly,"Do pass and be re-referred to the Committee on [Appropriations]",9,0,2,0,11
1172785,838401,2019-04-03,Senate,"Do pass as amended, but first amend, and re-refer to the Committee on [Human Services]",8,0,1,0,9
1172785,850243,2019-04-22,Senate,"Do pass, but first be re-referred to the Committee on [Appropriations]",6,0,0,0,6
1172785,859529,2019-05-06,Senate,"Placed on suspense file",5,0,1,0,6
1172785,865842,2019-05-16,Senate,"Do pass as amended",4,2,0,0,6
1172785,869970,2019-05-22,Senate,"Senate 3rd Reading SB163 Portantino",32,1,5,0,38
1172785,887609,2019-06-25,Assembly,"Do pass as amended and be re-referred to the Committee on [Appropriations]",11,0,4,0,15
1172785,892901,2019-08-30,Assembly,"Do pass as amended",14,3,1,0,18
1172785,892902,2019-09-09,Assembly,"SB 163 Portantino Senate Third Reading By Nazarian",66,4,9,0,79
1172785,892903,2019-09-11,Senate,"Unfinished Business SB163 Portantino et al. Concurrence",40,0,0,0,40
1172798,839963,2019-04-09,Senate,"Do pass, but first be re-referred to the Committee on [Appropriations]",16,0,0,0,16
1172798,848929,2019-04-22,Senate,"Placed on suspense file",6,0,0,0,6
1172798,865714,2019-05-16,Senate,"Do pass",6,0,0,0,6
1172798,871476,2019-05-23,Senate,"Special Consent SB160",38,0,0,0,38
1172798,893542,2019-07-10,Assembly,"Do pass and be re-referred to the Committee on [Appropriations] with recommendation: To Consent Calendar",19,0,2,0,21
1172798,893543,2019-08-30,Assembly,"Do pass as amended",17,0,1,0,18
1172798,893544,2019-09-10,Assembly,"SB 160 Jackson Senate Third Reading By Limón",78,0,1,0,79
1172798,893545,2019-09-11,Senate,"Unfinished Business SB160 Jackson et al. Concurrence",40,0,0,0,40
1172808,825185,2019-03-18,Assembly,"Do pass and be re-referred to the Committee on [Appropriations]",9,0,2,0,11
1172808,866472,2019-05-16,Assembly,"Do pass",16,0,2,0,18
1172808,871693,2019-05-23,Assembly,"AB 263 Burke Assembly Third Reading",71,1,8,0,80
1172808,887909,2019-06-26,Senate,"Do pass as amended, but first amend, and re-refer to the Committee on [Appropriations]",7,0,0,0,7
1172808,893458,2019-08-26,Senate,"Assembly 3rd Reading AB263 Burke By McGuire",39,0,1,0,40
1172808,893459,2019-09-03,Assembly,"AB 263 Burke Concurrence in Senate Amendments",73,0,6,0,79
1172818,842936,2019-04-10,Assembly,"Do pass and be re-referred to the Committee on [Appropriations] with recommendation: To Consent Calendar",6,0,0,0,6
1172818,857918,2019-05-02,Assembly,"AB 272 Muratsuchi Assembly Third Reading",72,0,8,0,80
1172818,878548,2019-06-05,Senate,"Do pass and be ordered to the Consent Calendar",7,0,0,0,7
1172818,882957,2019-06-17,Senate,"Consent Calendar AB272",40,0,0,0,40
1172839,842924,2019-04-10,Senate,"Do pass, but first be re-referred to the Committee on [Appropriations]",7,0,0,0,7
1172839,854299,2019-04-29,Senate,"Placed on suspense file",6,0,0,0,6
1172839,865664,2019-05-16,Senate,"Do pass",6,0,0,0,6
1172839,869820,2019-05-22,Senate,"Senate 3rd Reading SB162 Galgiani",38,0,0,0,38
1172839,975011,2020-08-04,Assembly,"Do pass and be re-referred to the Committee on [Appropriations] with recommendation: To Consent Calendar",15,0,0,0,15
1172851,839679,2019-04-08,Senate,"Senate 3rd Reading SCR8 Hertzberg et al",38,0,0,0,38
1172851,854194,2019-04-29,Assembly,"Be adopted. To third reading",10,0,2,0,12
1172857,826372,2019-03-20,Assembly,"Do pass and be re-referred to the Committee on [Arts, Entertainment, Sports, Tourism, and Internet Media] with recommendation: To Consent Calendar",7,0,0,0,7
1172857,841509,2019-04-10,Assembly,"Do pass and be re-referred to the Committee on [Appropriations]",7,0,0,0,7
1172857,851624,2019-04-24,Assembly,"Do pass. To Consent Calendar",18,0,0,0,18
1172857,858183,2019-05-02,Assembly,"AB 267 Chu Consent Calendar Second Day Regular Session",76,0,4,0,80
1172857,881060,2019-06-12,Senate,"Do pass as amended, but first amend, and re-refer to the Committee on [Appropriations]",5,0,0,0,5
1172857,891552,2019-08-26,Senate,"Assembly 3rd Reading AB267 Chu By Allen",39,0,1,0,40
1172857,891553,2019-08-30,Assembly,"AB 267 Chu Concurrence in Senate Amendments",75,0,4,0,79
1172857,895645,2019-08-26,Senate,"Assembly class=""statusCell"">",5,0,0,0,5
1172878,787487,2019-01-28,Assembly,"Be adopted. To third reading",11,0,0,0,11
1172888,830770,2019-03-27,Assembly,"Do pass and be re-referred to the Committee on [Appropriations]",5,2,0,0,7
1177461,821626,2019-03-12,Assembly,"Do pass and be re-referred to the Committee on [Appropriations]",7,0,1,0,8
1177461,866031,2019-05-16,Assembly,"Do pass as amended",13,0,5,0,18
1177461,874675,2019-05-29,Assembly,"AB 283 Chu Assembly Third Reading",75,3,2,0,80
1177461,890336,2019-07-08,Senate,"Do pass, but first be re-referred to the Committee on [Appropriations]",5,1,0,0,6
1177461,890337,2019-08-12,Senate,"Placed on suspense file",7,0,0,0,7
1177461,890338,2019-08-30,Senate,"Do pass as amended",5,2,0,0,7
1177461,890339,2019-09-11,Senate,"Assembly 3rd Reading AB283 Chu By Portantino",29,11,0,0,40
1177461,893781,2019-09-12,Assembly,"AB 283 Chu Concurrence in Senate Amendments",62,12,5,0,79
1177464,856878,2019-04-30,Senate,"Do pass and be ordered to the Consent Calendar",9,0,0,0,9
1177464,873825,2019-05-28,Senate,"Senate 3rd Reading SB176 Jackson",32,4,2,0,38
1177464,892897,2019-07-09,Assembly,"Do pass as amended and be re-referred to the Committee on [Appropriations]",7,0,5,0,12
1177464,892898,2019-08-30,Assembly,"Do pass as amended",12,3,3,0,18
1177464,892899,2019-09-10,Assembly,"SB 176 Jackson Senate Third Reading By Mark Stone",50,9,20,0,79
1177464,892900,2019-09-11,Senate,"Unfinished Business SB176 Jackson Concurrence",31,6,3,0,40
1177469,852881,2019-04-23,Assembly,"Do pass as amended and be re-referred to the Committee on [Appropriations]",7,0,0,0,7
1177469,866423,2019-05-16,Assembly,"Do pass as amended",18,0,0,0,18
1177469,871343,2019-05-23,Assembly,"AB 275 Ramos Assembly Third Reading",78,0,2,0,80
1177469,890355,2019-07-09,Senate,"Do pass, but first be re-referred to the Committee on [Appropriations] with the recommendation: To Consent Calendar",15,0,1,0,16
1177469,976182,2020-08-19,Senate,"Placed on suspense file",7,0,0,0,7
1177469,976508,2020-08-20,Senate,"Do pass",7,0,0,0,7
1177469,978068,2020-08-30,Senate,"Assembly 3rd Reading AB275 Ramos et al. By Hertzberg",39,0,1,0,40
1177469,978069,2020-08-30,Assembly,"AB 275 Ramos Concurrence in Senate Amendments",75,0,4,0,79
1177483,855256,2019-04-24,Assembly,"Do pass as amended and be re-referred to the Committee on [Appropriations]",15,1,5,0,21
1177483,905406,2020-01-23,Assembly,"Do pass as amended",13,0,5,0,18
1177483,912020,2020-01-30,Assembly,"AB 291 Chu Assembly Third Reading",76,0,4,0,80
1177488,826739,2019-03-20,Senate,"Do pass as amended, but first amend, and re-refer to the Committee on [Natural Resources and Water]",5,2,0,0,7
1177488,839905,2019-04-09,Senate,"Do pass as amended, but first amend, and re-refer to the Committee on [Appropriations]",7,2,0,0,9
1177488,859601,2019-05-06,Senate,"Placed on suspense file",5,0,1,0,6
1177488,865983,2019-05-16,Senate,"Do pass as amended",4,2,0,0,6
1177488,871590,2019-05-23,Senate,"Senate 3rd Reading SB168 Wieckowski et al",29,9,0,0,38
1177488,887052,2019-06-24,Assembly,"Do pass as amended and be re-referred to the Committee on [Appropriations]",7,2,2,0,11
1177488,894592,2019-05-23,Senate,05/16/19,4,9,0,0,13
1177493,852103,2019-04-23,Senate,"Be adopted, but first be re-referred to the Committee on [Appropriations] with recommendation: To Consent Calendar",12,0,0,0,12
1177493,862194,2019-05-09,Senate,"Consent Calendar SCR11",38,0,0,0,38
1177493,894109,2019-07-08,Assembly,"Be adopted. To Consent Calendar",15,0,0,0,15
1177493,894110,2019-07-11,Assembly,"SCR 11 Chang Consent Calendar Second Day Regular Session",76,0,3,0,79
1177499,825926,2019-03-19,Assembly,"Do pass and be re-referred to the Committee on [Appropriations]",11,2,2,0,15
1177499,866393,2019-05-16,Assembly,"Do pass as amended",12,3,3,0,18
1177499,869705,2019-05-22,Assembly,"AB 290 Wood Assembly Third Reading",46,15,19,0,80
1177499,892052,2019-07-03,Senate,"Do pass as amended, but first amend, and re-refer to the Committee on [Appropriations]",5,3,1,0,9
1177499,892053,2019-08-12,Senate,"Placed on suspense file",7,0,0,0,7
1177499,892054,2019-08-30,Senate,"Do pass as amended",5,2,0,0,7
1177499,892055,2019-09-09,Senate,"Assembly 3rd Reading AB290 Wood et al. By Leyva",21,13,6,0,40
1177499,892056,2019-09-10,Assembly,"AB 290 Wood Concurrence in Senate Amendments",47,20,12,0,79
1177503,830596,2019-03-27,Senate,"Do pass, but first be re-referred to the Committee on [Judiciary]",4,1,0,0,5
1177503,835298,2019-04-02,Senate,"Do pass as amended, but first amend, and re-refer to the Committee on [Appropriations]",7,1,0,0,8
1177503,849024,2019-04-22,Senate,"Placed on suspense file",6,0,0,0,6
1177503,866202,2019-05-16,Senate,"Do pass",4,2,0,0,6
1177503,869779,2019-05-22,Senate,"Senate 3rd Reading SB171 Jackson",28,9,1,0,38
1177503,888528,2019-06-26,Assembly,"Do pass and be re-referred to the Committee on [Judiciary]",5,2,0,0,7
1177503,893422,2019-07-02,Assembly,"Do pass as amended and be re-referred to the Committee on [Appropriations]",9,3,0,0,12
1177503,894265,2019-05-16,Senate,Result,4,2,0,0,6
1177508,797102,2019-02-11,Senate,"Senate 3rd Reading SCR10 Pan",37,0,1,0,38
1177508,806352,2019-02-21,Assembly,"Be adopted. To Consent Calendar",12,0,0,0,12
1177508,811716,2019-02-28,Assembly,"SCR 10 Pan Consent Calendar Second Day Regular Session",75,0,5,0,80
1177514,836007,2019-04-03,Assembly,"Do pass and be re-referred to the Committee on [Appropriations] with recommendation: To Consent Calendar",14,0,0,0,14
1177514,856969,2019-05-01,Assembly,"Do pass. To Consent Calendar",18,0,0,0,18
1177514,862149,2019-05-09,Assembly,"AB 295 Daly Consent Calendar Second Day Regular Session",76,0,4,0,80
1177514,888217,2019-06-26,Senate,"Do pass as amended",13,0,0,0,13
1177514,893290,2019-08-12,Senate,"Assembly 3rd Reading AB295 Daly et al. By Roth",39,0,1,0,40
1177514,893291,2019-08-21,Assembly,"With recommendation: That Senate amendments be concurred in",12,0,2,0,14
1177514,893292,2019-08-22,Assembly,"AB 295 Daly Concurrence in Senate Amendments",76,0,3,0,79
1177514,894806,2019-08-22,Assembly,"Noes Count",12,0,0,0,12
1177517,819943,2019-03-12,Assembly,"Do pass and be re-referred to the Committee on [Appropriations]",7,1,0,0,8
1177522,840037,2019-04-08,Assembly,"Do pass and be re-referred to the Committee on [Business and Professions]",10,1,0,0,11
1177522,850086,2019-04-23,Assembly,"Do pass and be re-referred to the Committee on [Appropriations]",16,1,3,0,20
1177528,819822,2019-03-12,Senate,"Do pass, but first be re-referred to the Committee on [Appropriations]",13,1,2,0,16
1177528,863178,2019-05-13,Senate,"Senate 3rd Reading SB169 Jackson",30,2,6,0,38
1177528,890699,2019-07-10,Assembly,"Do pass and be re-referred to the Committee on [Appropriations]",8,5,8,0,21
1177532,830366,2019-03-26,Assembly,"Do pass as amended and be re-referred to the Committee on [Local Government]",8,0,1,0,9
1177532,841720,2019-04-10,Assembly,"Do pass and be re-referred to the Committee on [Appropriations]",8,0,0,0,8
1177538,834556,2019-04-03,Senate,"Do pass, but first be re-referred to the Committee on [Appropriations]",7,0,0,0,7
1177538,859411,2019-05-06,Senate,"Do pass",5,0,1,0,6
1177538,862251,2019-05-09,Senate,"Senate 3rd Reading SB166 Wiener et al",38,0,0,0,38
1177538,891094,2019-07-02,Assembly,"Do pass as amended and be re-referred to the Committee on [Appropriations]",7,0,2,0,9
1177545,821015,2019-03-11,Senate,"Do pass as amended, but first amend, and re-refer to the Committee on [Appropriations]",6,0,0,0,6
1177545,848967,2019-04-22,Senate,"Senate 3rd Reading SB173 Dodd",38,0,0,0,38
1177545,883807,2019-06-18,Assembly,"Do pass and be re-referred to the Committee on [Appropriations] with recommendation: To Consent Calendar",8,0,0,0,8
1177545,888036,2019-06-26,Assembly,"Do pass. To Consent Calendar",15,0,3,0,18
1177545,891883,2019-07-05,Assembly,"SB 173 Dodd Consent Calendar Second Day Regular Session",70,0,9,0,79
1177545,891884,2019-07-08,Senate,"Unfinished Business SB173 Dodd et al. Concurrence",39,0,1,0,40
1177547,795539,2019-02-07,Senate,"Senate 3rd Reading SCR9 Pan",36,0,2,0,38
1177547,858155,2019-05-02,Assembly,"Be adopted. To Consent Calendar",9,0,3,0,12
1177547,862296,2019-05-09,Assembly,"SCR 9 Pan Consent Calendar Second Day Regular Session",76,0,4,0,80
1177557,894025,2019-08-26,Assembly,"Be adopted. To third reading",11,0,1,0,12
1177561,829260,2019-03-25,Assembly,"Do pass and be re-referred to the Committee on [Natural Resources]",11,2,2,0,15
1177561,838420,2019-04-08,Assembly,"Do pass and be re-referred to the Committee on [Appropriations]",8,3,0,0,11
1177561,866273,2019-05-16,Assembly,"Do pass",13,5,0,0,18
1177561,870030,2019-05-22,Assembly,"AB 285 Friedman Assembly Third Reading",59,18,3,0,80
1177561,880586,2019-06-11,Senate,"Do pass, but first be re-referred to the Committee on [Environmental Quality]",8,3,1,0,12
1177561,884758,2019-06-19,Senate,"Do pass as amended, but first amend, and re-refer to the Committee on [Appropriations]",5,2,0,0,7
1177561,892093,2019-07-08,Senate,"Placed on suspense file",7,0,0,0,7
1177561,892094,2019-08-30,Senate,"Do pass as amended",5,2,0,0,7
1177561,892095,2019-09-04,Senate,"Assembly 3rd Reading AB285 Friedman et al. By Allen",28,12,0,0,40
1177561,892096,2019-09-09,Assembly,"AB 285 Friedman Concurrence in Senate Amendments",61,18,0,0,79
1177567,841658,2019-04-10,Assembly,"Do pass and be re-referred to the Committee on [Judiciary]",7,0,0,0,7
1177567,850448,2019-04-23,Assembly,"Do pass as amended, and be re-referred to the Committee on [Appropriations] with recommendation: To Consent Calendar",12,0,0,0,12
1177567,866415,2019-05-16,Assembly,"Do pass",18,0,0,0,18
1177567,871345,2019-05-23,Assembly,"AB 289 Fong Assembly Third Reading",78,0,2,0,80
1177567,893197,2019-07-02,Senate,"Do pass, but first be re-referred to the Committee on [Governmental Organization]",2,6,1,0,9
1177567,893198,2019-07-02,Senate,"[First] hearing set for [07-03-2019]: Failed passage in Committee. Reconsideration granted",9,0,0,0,9
1177571,829551,2019-03-26,Assembly,"Do pass and be re-referred to the Committee on [Appropriations]",14,0,0,0,14
1177577,901321,2020-01-06,Assembly,"Be re-referred to the Committee on [Education]",12,0,0,0,12
1177577,903154,2020-01-15,Assembly,"Do pass and be re-referred to the Committee on [Appropriations]",6,0,1,0,7
1177577,905409,2020-01-23,Assembly,"Do pass",18,0,0,0,18
1177577,906368,2020-01-27,Assembly,"AB 276 Friedman Assembly Third Reading",74,0,6,0,80
1177577,974271,2020-07-29,Senate,"Do pass, but first be re-referred to the Committee on [Appropriations] with the recommendation: To Consent Calendar",7,0,0,0,7
1177577,975828,2020-08-13,Senate,"Placed on suspense file",7,0,0,0,7
1177577,976482,2020-08-20,Senate,"Do pass",7,0,0,0,7
1177577,977295,2020-08-28,Senate,"Special Consent AB276",39,0,1,0,40
1177577,977454,2020-08-30,Assembly,"With recommendation: That Senate amendments be concurred in",11,0,0,0,11
1177577,977976,2020-08-30,Assembly,"AB 276 Friedman Concurrence in Senate Amendments",75,0,4,0,79
1177583,820006,2019-03-12,Assembly,"Do pass and be re-referred to the Committee on [Appropriations]",8,0,0,0,8
1177583,835506,2019-04-03,Assembly,"Do pass",17,0,1,0,18
1177583,849004,2019-04-22,Assembly,"AB 294 Rodriguez Assembly Third Reading",78,0,2,0,80
1177583,880317,2019-06-11,Senate,"Do pass as amended, but first amend, and re-refer to the Committee on [Appropriations]",7,0,0,0,7
1177583,889260,2019-07-01,Senate,"Placed on suspense file",7,0,0,0,7
1177583,891673,2019-08-30,Senate,"Do pass",7,0,0,0,7
1177583,891674,2019-09-10,Senate,"Assembly 3rd Reading AB294 Rodriguez et al. By Caballero",40,0,0,0,40
1177583,891675,2019-09-11,Assembly,"AB 294 Rodriguez Concurrence in Senate Amendments",79,0,0,0,79
1177587,825061,2019-03-13,Assembly,"Do pass as amended and be re-referred to the Committee on [Appropriations]",6,0,0,0,6
1177599,836566,2019-03-27,Senate,"Do pass as amended, but first amend, and re-refer to the Committee on [Appropriations]",13,0,0,0,13
1177599,853113,2019-04-25,Senate,"Senate 3rd Reading SB167 Dodd et al",37,0,1,0,38
1177599,893373,2019-07-10,Assembly,"Do pass and be re-referred to the Committee on [Appropriations] with recommendation: To Consent Calendar",15,0,0,0,15
1177599,893374,2019-08-21,Assembly,"Do pass. To Consent Calendar",17,0,1,0,18
1177599,893375,2019-09-05,Assembly,"SB 167 Dodd Senate Third Reading By Quirk",79,0,0,0,79
1177599,893376,2019-09-06,Senate,"Unfinished Business SB167 Dodd et al. Concurrence",39,0,1,0,40
1177601,851373,2019-04-24,Senate,"Do pass, but first be re-referred to the Committee on [Appropriations]",7,0,0,0,7
1177601,863048,2019-05-13,Senate,"Placed on suspense file",6,0,0,0,6
1177601,866035,2019-05-16,Senate,"Do pass as amended",6,0,0,0,6
1177601,873846,2019-05-28,Senate,"Senate 3rd Reading SB174 Leyva",38,0,0,0,38
1177601,883933,2019-06-18,Assembly,"Do pass and be re-referred to the Committee on [Education] with recommendation: To Consent Calendar",8,0,0,0,8
1177601,891693,2019-07-10,Assembly,"Do pass and be re-referred to the Committee on [Appropriations] with recommendation: To Consent Calendar",7,0,0,0,7
1177607,821550,2019-03-13,Assembly,"Do pass as amended, and be re-referred to the Committee on [Appropriations] with recommendation: To Consent Calendar",7,0,0,0,7
1177607,825976,2019-03-20,Assembly,"Do pass. To Consent Calendar",13,0,5,0,18
1177607,831407,2019-03-28,Assembly,"AB 299 Salas Consent Calendar Second Day Regular Session",72,0,8,0,80
1177607,877698,2019-06-04,Senate,"Do pass, but first be re-referred to the Committee on [Appropriations] with the recommendation: To Consent Calendar",5,0,0,0,5
1177607,889237,2019-07-01,Senate,"Consent Calendar AB299",39,0,1,0,40
1177617,831288,2019-03-27,Senate,"Do pass, but first be re-referred to the Committee on [Appropriations]",9,0,0,0,9
1177617,849377,2019-04-22,Senate,"Placed on suspense file",6,0,0,0,6
1177617,866437,2019-05-16,Senate,"Do pass",6,0,0,0,6
1177617,871661,2019-05-23,Senate,"Special Consent SB165",38,0,0,0,38
1177617,893386,2019-07-02,Assembly,"Do pass and be re-referred to the Committee on [Appropriations] with recommendation: To Consent Calendar",15,0,0,0,15
1177617,893387,2019-08-14,Assembly,"Do pass",18,0,0,0,18
1177617,893388,2019-09-10,Assembly,"SB 165 Atkins Senate Third Reading By Bonta",79,0,0,0,79
1177617,893389,2019-09-11,Senate,"Unfinished Business SB165 Atkins et al. Concurrence",40,0,0,0,40
1177623,857283,2019-04-30,Senate,"Do pass as amended",9,0,0,0,9
1177623,859465,2019-05-06,Senate,"Senate 3rd Reading SB180 Chang",38,0,0,0,38
1177623,887549,2019-06-25,Assembly,"Do pass. To Consent Calendar",11,0,0,0,11
1177623,893437,2019-07-05,Assembly,"SB 180 Chang Consent Calendar Second Day Regular Session",70,0,9,0,79
1177625,829412,2019-03-25,Assembly,"Do pass and be re-referred to the Committee on [Appropriations] with recommendation: To Consent Calendar",11,0,0,0,11
1177625,851667,2019-04-24,Assembly,"Do pass. To Consent Calendar",18,0,0,0,18
1177625,858213,2019-05-02,Assembly,"AB 293 Eduardo Garcia Consent Calendar Second Day Regular Session",76,0,4,0,80
1177625,878260,2019-06-05,Senate,"Do pass, but first be re-referred to the Committee on [Appropriations]",7,0,0,0,7
1177625,892741,2019-07-05,Senate,"Assembly 3rd Reading AB293 Eduardo Garcia By Allen",30,0,10,0,40
1177632,818571,2019-03-11,Assembly,"Be adopted. To Consent Calendar",9,0,3,0,12
1177632,822145,2019-03-14,Assembly,"HR 11 Reyes Consent Calendar Second Day Regular Session",72,0,8,0,80
1177638,842756,2019-04-08,Assembly,"Do pass as amended and be re-referred to the Committee on [Appropriations]",10,1,0,0,11
1177638,849949,2019-04-22,Assembly,"Do pass as amended and be re-referred to the Committee on [Appropriations]",10,1,0,0,11
1177638,865914,2019-05-16,Assembly,"Do pass",17,0,1,0,18
1177638,874584,2019-05-29,Assembly,"AB 296 Cooley Assembly Third Reading By MAYES",75,1,4,0,80
1177638,890771,2019-07-03,Senate,"Do pass as amended, but first amend, and re-refer to the Committee on [Governance and Finance]",7,0,0,0,7
1177638,890772,2019-08-12,Senate,"Placed on suspense file",7,0,0,0,7
1177638,890773,2019-09-05,Senate,"Assembly 3rd Reading AB296 Cooley et al. By Stern",34,5,1,0,40
1177638,890774,2019-09-09,Assembly,"AB 296 Cooley Concurrence in Senate Amendments",74,1,4,0,79
1177638,893463,2019-07-10,Senate,"Do pass as amended, but first amend, and re-refer to the Committee on [Appropriations]",6,1,0,0,7
1177638,893464,2019-08-30,Senate,"Do pass as amended",6,1,0,0,7
1177638,894428,2019-08-12,Senate,Result,6,1,0,0,7
1177642,830561,2019-03-27,Senate,"Do pass, but first be re-referred to the Committee on [Judiciary]",5,0,0,0,5
1177642,841690,2019-04-09,Senate,"Do pass, but first be re-referred to the Committee on [Appropriations] with the recommendation: To Consent Calendar",8,0,0,0,8
1177642,849022,2019-04-22,Senate,"Placed on suspense file",6,0,0,0,6
1177642,865836,2019-05-16,Senate,"Do pass",6,0,0,0,6
1177642,871135,2019-05-23,Senate,"Special Consent SB179",38,0,0,0,38
1177642,887996,2019-06-26,Assembly,"Do pass and be re-referred to the Committee on [Judiciary]",7,0,0,0,7
1177642,892379,2019-07-09,Assembly,"Do pass and be re-referred to the Committee on [Appropriations]",12,0,0,0,12
1177642,892380,2019-08-30,Assembly,"Do pass",18,0,0,0,18
1177642,978090,2020-08-30,Assembly,"SB 179 Nielsen Senate Third Reading By Rodriguez",74,0,5,0,79
1177646,894079,2019-08-15,Senate,"Senate 3rd Reading SR14 Chang",38,0,2,0,40
1177652,838637,2019-04-02,Senate,"Do pass as amended, but first amend, and re-refer to the Committee on [Appropriations]",6,0,1,0,7
1177652,850061,2019-04-22,Senate,"Do pass as amended, but first amend, and re-refer to the Committee on [Appropriations]",5,1,0,0,6
1177652,863131,2019-05-13,Senate,"Placed on suspense file",6,0,0,0,6
1177652,865910,2019-05-16,Senate,"Do pass",4,2,0,0,6
1177652,869915,2019-05-22,Senate,"Senate 3rd Reading SB172 Portantino et al",26,9,3,0,38
1177652,887436,2019-06-25,Assembly,"Do pass and be re-referred to the Committee on [Human Services]",5,2,1,0,8
1177652,891654,2019-07-02,Assembly,"Do pass and be re-referred to the Committee on [Appropriations]",6,2,0,0,8
1177652,891655,2019-08-30,Assembly,"Do pass as amended",13,4,1,0,18
1177652,891656,2019-09-11,Assembly,"SB 172 Portantino Senate Third Reading By Gabriel",52,22,5,0,79
1177652,893589,2019-09-12,Senate,"Unfinished Business SB172 Portantino et al. Concurrence",26,12,2,0,40
1177656,842714,2019-04-10,Senate,"Do pass, but first be re-referred to the Committee on [Governance and Finance]",6,1,2,0,9
1177656,853141,2019-04-24,Senate,"Do pass, but first be re-referred to the Committee on [Appropriations]",4,2,1,0,7
1177656,863267,2019-05-13,Senate,"Placed on suspense file",6,0,0,0,6
1177656,866067,2019-05-16,Senate,"Do pass",4,2,0,0,6
1177656,903145,2020-01-15,Senate,"Do pass, but first be re-referred to the Committee on [Appropriations]",7,0,1,0,8
1177656,906439,2020-01-27,Senate,"Senate 3rd Reading SB175 Pan",39,0,0,0,39
1177667,885726,2019-06-19,Assembly,"Be adopted and re-referred to the Committee on [Appropriations]",6,1,0,0,7
1177667,893660,2019-07-10,Assembly,"Be adopted",12,3,3,0,18
1177667,893661,2019-09-05,Assembly,"ACA 6 McCarty Assembly Third Reading",54,19,6,0,79
1177667,967400,2020-06-18,Senate,"Be adopted, but first be re-referred to the Committee on [Appropriations]",4,1,0,0,5
1177667,968317,2020-06-23,Senate,"Be adopted",5,1,1,0,7
1177667,968683,2020-06-24,Senate,"Assembly 3rd Reading ACA6 McCarty et al. By Bradford",28,9,3,0,40
1177671,820574,2019-03-11,Assembly,"Be adopted. To Consent Calendar",15,0,0,0,15
1177671,822393,2019-03-14,Assembly,"ACR 17 Irwin Consent Calendar Second Day Regular Session",72,0,8,0,80
1177671,880938,2019-06-11,Senate,"Be adopted, but first be re-referred to the Committee on [Appropriations]",10,0,2,0,12
1177671,893591,2019-07-11,Senate,"Assembly 3rd Reading ACR17 Irwin et al. By Stern",39,0,1,0,40
1177671,893592,2019-07-11,Assembly,"ACR 17 IRWIN Concurrence in Senate Amendments",77,0,2,0,79
1177682,820034,2019-03-12,Assembly,"Do pass and be re-referred to the Committee on [Water, Parks, and Wildlife] with recommendation: To Consent Calendar",7,0,2,0,9
1177682,840041,2019-04-09,Assembly,"Do pass and be re-referred to the Committee on [Appropriations]",14,0,0,0,14
1177682,851598,2019-04-24,Assembly,"Do pass",18,0,0,0,18
1177682,859577,2019-05-06,Assembly,"AB 292 Quirk Assembly Third Reading",76,0,4,0,80
1177682,884800,2019-06-19,Senate,"Do pass, but first be re-referred to the Committee on [Natural Resources and Water]",7,0,0,0,7
1177682,891686,2019-07-09,Senate,"Do pass, but first be re-referred to the Committee on [Appropriations]",8,0,1,0,9
1177696,829327,2019-03-25,Assembly,"Do pass and be re-referred to the Committee on [Appropriations]",11,0,0,0,11
1177696,866124,2019-05-16,Assembly,"Do pass",17,0,1,0,18
1177696,869819,2019-05-22,Assembly,"AB 278 McCarty Assembly Third Reading",76,0,4,0,80
1177696,891178,2019-07-09,Senate,"Do pass as amended, but first amend, and re-refer to the Committee on [Appropriations]",7,1,1,0,9
1177696,891179,2019-08-19,Senate,"Placed on suspense file",5,0,2,0,7
1177696,891180,2019-08-30,Senate,"Do pass",6,1,0,0,7
1177696,891181,2019-09-04,Senate,"Assembly 3rd Reading AB278 McCarty et al. By Durazo",37,3,0,0,40
1177696,891182,2019-09-09,Assembly,"AB 278 McCarty Concurrence in Senate Amendments",78,0,1,0,79
1180141,821246,2019-03-12,Assembly,"Do pass and be re-referred to the Committee on [Appropriations]",7,0,1,0,8
1180146,825068,2019-03-19,Assembly,"Do pass as amended and be re-referred to the Committee on [Public Safety]",10,2,0,0,12
1180146,850528,2019-04-23,Assembly,"Do pass and be re-referred to the Committee on [Appropriations]",7,0,1,0,8
1180146,865783,2019-05-16,Assembly,"Do pass as amended",16,1,1,0,18
1180146,871211,2019-05-23,Assembly,"AB 310 Santiago Assembly Third Reading",72,0,8,0,80
1180152,850384,2019-04-23,Assembly,"Do pass",7,0,0,0,7
1180152,863061,2019-05-13,Assembly,"AB 309 Maienschein Assembly Third Reading",76,0,4,0,80
1180152,887569,2019-06-25,Senate,"Do pass as amended, but first amend, and re-refer to the Committee on [Appropriations] with the recommendation: To Consent Calendar",13,0,0,0,13
1180152,892940,2019-08-22,Senate,"Special Consent AB309",39,0,1,0,40
1180152,892941,2019-08-26,Assembly,"AB 309 Maienschein Concurrence in Senate Amendments",77,0,2,0,79
1180157,830686,2019-03-27,Assembly,"Do pass and be re-referred to the Committee on [Appropriations]",7,0,0,0,7
1180162,825000,2019-03-19,Assembly,"Do pass and be re-referred to the Committee on [Appropriations]",8,0,0,0,8
1180162,865763,2019-05-16,Assembly,"Do pass as amended",17,1,0,0,18
1180162,871022,2019-05-23,Assembly,"AB 300 Chu Assembly Third Reading",74,3,3,0,80
1180162,893076,2019-07-02,Senate,"Do pass as amended, but first amend, and re-refer to the Committee on [Appropriations]",6,0,1,0,7
1180162,893077,2019-08-19,Senate,"Placed on suspense file",5,0,2,0,7
1180168,843685,2019-04-10,Assembly,"Do pass and be re-referred to the Committee on [Appropriations]",8,0,0,0,8
1180168,851735,2019-04-24,Assembly,"Do pass. To Consent Calendar",18,0,0,0,18
1180168,858235,2019-05-02,Assembly,"AB 305 Nazarian Consent Calendar Second Day Regular Session",76,0,4,0,80
1180168,884690,2019-06-19,Senate,"Do pass, but first be re-referred to the Committee on [Appropriations]",6,0,1,0,7
1180168,889320,2019-07-01,Senate,"Do pass",7,0,0,0,7
1180168,894167,2019-08-22,Senate,"Assembly 3rd Reading AB305 Nazarian By Stern",39,0,1,0,40
1180179,834659,2019-04-02,Assembly,"Do pass and be re-referred to the Committee on [Appropriations]",10,0,2,0,12
1180179,866184,2019-05-16,Assembly,"Do pass",15,1,2,0,18
1180179,871053,2019-05-23,Assembly,"AB 302 Berman Assembly Third Reading",60,8,12,0,80
1180179,884678,2019-06-19,Senate,"Do pass as amended, but first amend, and re-refer to the Committee on [Judiciary]",7,0,0,0,7
1180179,891877,2019-07-09,Senate,"Do pass as amended, but first amend, and re-refer to the Committee on [Appropriations]",7,1,1,0,9
1180179,891878,2019-08-19,Senate,"Placed on suspense file",5,0,2,0,7
1180179,891879,2019-08-30,Senate,"Do pass as amended",5,2,0,0,7
1180183,839931,2019-04-08,Assembly,"Do pass and be re-referred to the Committee on [Appropriations]",10,1,0,0,11
1180183,865660,2019-05-16,Assembly,"Do pass",18,0,0,0,18
1180183,869832,2019-05-22,Assembly,"AB 308 Muratsuchi Assembly Third Reading",77,0,3,0,80
1180183,881117,2019-06-12,Senate,"Do pass as amended, but first amend, and re-refer to the Committee on [Veterans Affairs]",6,0,1,0,7
1180183,888166,2019-06-25,Senate,"Do pass, but first be re-referred to the Committee on [Appropriations]",6,0,1,0,7
1180183,892775,2019-07-08,Senate,"Placed on suspense file",7,0,0,0,7
1180183,892776,2019-08-30,Senate,"Do pass",7,0,0,0,7
1180183,892777,2019-09-10,Senate,"Assembly 3rd Reading AB308 Muratsuchi et al. By Archuleta",40,0,0,0,40
1180183,892778,2019-09-11,Assembly,"AB 308 Muratsuchi Concurrence in Senate Amendments",78,0,1,0,79
1180183,895913,2019-09-10,Senate,"Assembly 3rd Reading AB308 Muratsuchi et al. BusCell"">",7,0,0,0,7
1180188,830407,2019-03-26,Assembly,"Do pass and be re-referred to the Committee on [Appropriations]",8,0,0,0,8
1180188,866282,2019-05-16,Assembly,"Do pass as amended",16,1,1,0,18
1180188,871456,2019-05-23,Assembly,"AB 307 Reyes Assembly Third Reading",74,0,6,0,80
1180188,887561,2019-06-24,Senate,"Do pass, but first be re-referred to the Committee on [Housing]",6,0,0,0,6
1180188,890455,2019-07-02,Senate,"Do pass, but first be re-referred to the Committee on [Appropriations]",10,0,1,0,11
1180188,890456,2019-08-12,Senate,"Placed on suspense file",7,0,0,0,7
1180199,848088,2019-04-09,Assembly,"Do pass as amended, and be re-referred to the Committee on [Appropriations] with recommendation: To Consent Calendar",8,0,0,0,8
1180199,866090,2019-05-16,Assembly,"Do pass",18,0,0,0,18
1180199,870227,2019-05-22,Assembly,"AB 303 Cervantes Assembly Third Reading",78,0,2,0,80
1180199,883762,2019-06-18,Senate,"Do pass, but first be re-referred to the Committee on [Appropriations]",7,0,0,0,7
1180199,889256,2019-07-01,Senate,"Placed on suspense file",7,0,0,0,7
1180199,892369,2019-08-30,Senate,"Do pass as amended",7,0,0,0,7
1180199,892370,2019-09-05,Senate,"Assembly 3rd Reading AB303 Cervantes By Stern",39,0,1,0,40
1180199,892371,2019-09-09,Assembly,"AB 303 Cervantes Concurrence in Senate Amendments",79,0,0,0,79
1180204,842805,2019-04-10,Senate,"Do pass, but first be re-referred to the Committee on [Rules]",6,1,0,0,7
1180204,850372,2019-04-22,Senate,"Do pass as amended, but first amend, and re-refer to the Committee on [Appropriations]",8,3,0,0,11
1180204,866128,2019-05-16,Senate,"Placed on suspense file",6,0,0,0,6
1180204,866129,2019-05-16,Senate,"Do pass",4,2,0,0,6
1180204,874462,2019-05-29,Senate,"Senate 3rd Reading SB182 Jackson",27,9,2,0,38
1180204,892758,2019-07-03,Assembly,"Do pass and be re-referred to the Committee on [Local Government]",7,0,1,0,8
1180204,892759,2019-07-10,Assembly,"Do pass and be re-referred to the Committee on [Appropriations]",6,1,1,0,8
1180204,892760,2019-08-30,Assembly,"Do pass as amended",13,5,0,0,18
1180204,892761,2019-09-06,Assembly,"SB 182 Jackson Senate Third Reading By AGUIAR-CURRY Amendment Set #1",53,13,13,0,79
1180204,892762,2019-09-10,Assembly,"SB 182 Jackson Senate Third Reading By Aguiar-Curry",66,10,3,0,79
1180204,893882,2019-09-13,Senate,"That the Assembly amendments be taken up for consideration",10,0,1,0,11
1180204,978016,2020-08-31,Senate,"Unfinished Business SB182 Jackson et al. Concurrence",32,5,3,0,40
1180204,978017,2020-08-31,Assembly,"SB 182 Jackson Senate Third Reading By Wood",70,1,8,0,79
1180210,851541,2019-04-23,Assembly,"Do pass and be re-referred to the Committee on [Appropriations] with recommendation: To Consent Calendar",8,0,0,0,8
1180215,819772,2019-03-12,Assembly,"Do pass and be re-referred to the Committee on [Appropriations] with recommendation: To Consent Calendar",8,0,0,0,8
1180215,865773,2019-05-16,Assembly,"Do pass",18,0,0,0,18
1180215,873917,2019-05-28,Assembly,"AB 304 Jones-Sawyer Assembly Third Reading",75,0,5,0,80
1180215,887531,2019-06-25,Senate,"Do pass, but first be re-referred to the Committee on [Appropriations] with the recommendation: To Consent Calendar",7,0,0,0,7
1180215,892351,2019-07-08,Senate,"Placed on suspense file",7,0,0,0,7
1180215,892352,2019-08-30,Senate,"Do pass",7,0,0,0,7
1180215,892353,2019-09-09,Senate,"Special Consent AB304",40,0,0,0,40
1182047,833056,2019-03-26,Assembly,"Do pass as amended and be re-referred to the Committee on [Appropriations]",8,0,0,0,8
1182047,866512,2019-05-16,Assembly,"Do pass as amended",13,0,5,0,18
1182047,871157,2019-05-23,Assembly,"AB 324 Aguiar-Curry Assembly Third Reading",76,0,4,0,80
1182047,887994,2019-06-26,Senate,"Do pass, but first be re-referred to the Committee on [Human Services]",7,0,0,0,7
1182047,891161,2019-07-08,Senate,"Do pass, but first be re-referred to the Committee on [Appropriations]",6,0,0,0,6
1182047,891162,2019-08-12,Senate,"Placed on suspense file",7,0,0,0,7
1182052,841479,2019-04-09,Senate,"Do pass",8,0,0,0,8
1182052,858208,2019-05-02,Senate,"Senate 3rd Reading SB187 Wieckowski",38,0,0,0,38
1182052,886992,2019-06-24,Assembly,"Do pass and be re-referred to the Committee on [Judiciary] with recommendation: To Consent Calendar",12,0,0,0,12
1182052,893343,2019-07-02,Assembly,"Do pass. To Consent Calendar",12,0,0,0,12
1182052,893344,2019-08-30,Assembly,"SB 187 Wieckowski Senate Third Reading By Mayes",74,0,5,0,79
1182056,820725,2019-03-11,Assembly,"Do pass and be re-referred to the Committee on [Appropriations]",15,0,0,0,15
1182056,866347,2019-05-16,Assembly,"Do pass as amended",18,0,0,0,18
1182056,871610,2019-05-23,Assembly,"AB 317 Diep Assembly Third Reading",78,0,2,0,80
1182056,893264,2019-07-09,Senate,"Do pass, but first be re-referred to the Committee on [Appropriations]",13,0,0,0,13
1182056,893265,2019-09-04,Senate,"Assembly 3rd Reading AB317 Diep et al. By Jones",40,0,0,0,40
1182056,893266,2019-09-09,Assembly,"AB 317 Diep Concurrence in Senate Amendments",79,0,0,0,79
1182061,842710,2019-04-10,Senate,"Do pass as amended, but first amend, and re-refer to the Committee on [Appropriations]",7,0,0,0,7
1182061,859560,2019-05-06,Senate,"Placed on suspense file",5,0,1,0,6
1182061,865683,2019-05-16,Senate,"Do pass as amended",6,0,0,0,6
1182061,868716,2019-05-21,Senate,"Senate 3rd Reading SB189 Monning et al",38,0,0,0,38
1182061,893370,2019-07-10,Assembly,"Do pass and be re-referred to the Committee on [Appropriations]",8,0,0,0,8
1182061,895850,2019-05-06,Senate,Result,5,0,0,0,5
1182066,835811,2019-04-03,Assembly,"Do pass and be re-referred to the Committee on [Appropriations]",5,2,0,0,7
1182066,866277,2019-05-16,Assembly,"Do pass",13,4,1,0,18
1182066,871587,2019-05-23,Assembly,"AB 314 Bonta Assembly Third Reading",58,16,6,0,80
1182066,887939,2019-06-26,Senate,"Do pass, but first be re-referred to the Committee on [Appropriations]",4,1,0,0,5
1182066,891945,2019-07-08,Senate,"Placed on suspense file",7,0,0,0,7
1182066,891946,2019-08-30,Senate,"Do pass",5,2,0,0,7
1182066,891947,2019-09-11,Senate,"Assembly 3rd Reading AB314 Bonta By Monning",27,11,2,0,40
1182066,893633,2019-09-12,Assembly,"AB 314 Bonta Concurrence in Senate Amendments",64,12,3,0,79
1182070,902834,2020-01-14,Assembly,"Do pass as amended. To Consent Calendar",11,0,0,0,11
1182070,902835,2020-01-14,Assembly,"Do pass and be re-referred to the Committee on [Privacy and Consumer Protection] with recommendation: To Consent Calendar",11,0,0,0,11
1182070,906404,2020-01-27,Assembly,"AB 325 Ramos Consent Calendar Second Day",76,0,4,0,80
1182075,839983,2019-04-08,Assembly,"Do pass and be re-referred to the Committee on [Appropriations]",15,0,0,0,15
1182075,905400,2020-01-23,Assembly,"Do pass as amended",17,1,0,0,18
1182075,912035,2020-01-30,Assembly,"AB 326 Muratsuchi Assembly Third Reading",73,0,7,0,80
1182075,974809,2020-08-04,Senate,"Do pass as amended, but first amend, and re-refer to the Committee on [Appropriations]",9,4,2,0,15
1182075,976005,2020-08-17,Senate,"Placed on suspense file",7,0,0,0,7
1182075,976440,2020-08-20,Senate,"Do pass as amended",4,2,1,0,7
1182080,829282,2019-03-26,Senate,"Do pass, but first be re-referred to the Committee on [Appropriations]",7,0,1,0,8
1182080,848811,2019-04-22,Senate,"Senate 3rd Reading SB188 Mitchell et al",37,0,1,0,38
1182080,877728,2019-06-04,Assembly,"Do pass and be re-referred to the Committee on [Appropriations]",10,0,2,0,12
1182080,884546,2019-06-19,Assembly,"Do pass",15,0,3,0,18
1182080,888439,2019-06-27,Assembly,"SB 188 Mitchell Senate Third Reading By Kamlager-Dove",69,0,10,0,79
1182084,828180,2019-03-25,Senate,"Do pass, but first be re-referred to the Committee on [Agriculture]",9,0,0,0,9
1182084,833605,2019-04-02,Senate,"Do pass, but first be re-referred to the Committee on [Appropriations]",4,0,0,0,4
1182084,854247,2019-04-29,Senate,"Placed on suspense file",6,0,0,0,6
1182084,866295,2019-05-16,Senate,"Do pass",6,0,0,0,6
1182084,869730,2019-05-22,Senate,"Senate 3rd Reading SB185 McGuire",37,0,1,0,38
1182084,883811,2019-06-18,Assembly,"Do pass and be re-referred to the Committee on [Agriculture]",18,0,1,0,19
1182084,892110,2019-07-03,Assembly,"Do pass and be re-referred to the Committee on [Appropriations]",10,0,1,0,11
1182084,892111,2019-08-14,Assembly,"Do pass",18,0,0,0,18
1182084,892112,2019-09-10,Assembly,"SB 185 McGuire Senate Third Reading By Wood",78,0,1,0,79
1182084,892113,2019-09-11,Senate,"Unfinished Business SB185 McGuire et al. Concurrence",38,0,2,0,40
1182084,894803,2019-05-16,Senate,"Sen Appropri",6,0,0,0,6
1182084,895305,2019-09-10,Assembly,08/14/19,18,0,0,0,18
1182093,820239,2019-03-12,Senate,"Do pass, but first be re-referred to the Committee on [Natural Resources and Water]",15,0,1,0,16
1182093,839896,2019-04-09,Senate,"Do pass as amended, but first amend, and re-refer to the Committee on [Appropriations] with the recommendation: To Consent Calendar",9,0,0,0,9
1182093,859463,2019-05-06,Senate,"Placed on suspense file",5,0,1,0,6
1182093,866435,2019-05-16,Senate,"Do pass",6,0,0,0,6
1182093,871684,2019-05-23,Senate,"Special Consent SB190",38,0,0,0,38
1182093,887927,2019-04-09,Senate,"Do pass as amended, but first amend, and re-refer to the Committee on [Appropriations] with the recomme",15,0,0,0,15
1182093,887928,2019-06-26,Assembly,"Do pass and be re-referred to the Committee on [Natural Resources] with recommendation: To Consent Calendar",19,0,2,0,21
1182093,891251,2019-07-08,Assembly,"Do pass as amended and be re-referred to the Committee on [Appropriations]",11,0,0,0,11
1182093,891252,2019-08-30,Assembly,"Do pass as amended",18,0,0,0,18
1182093,891253,2019-09-10,Assembly,"SB 190 Dodd Senate Third Reading By Wood",79,0,0,0,79
1182093,891254,2019-09-11,Senate,"Unfinished Business SB190 Dodd et al. Concurrence",40,0,0,0,40
1182098,819921,2019-03-11,Assembly,"Do pass and be re-referred to the Committee on [Appropriations] with recommendation: To Consent Calendar",15,0,0,0,15
1182098,866046,2019-05-16,Assembly,"Do pass",18,0,0,0,18
1182098,870114,2019-05-22,Assembly,"AB 313 Frazier Assembly Third Reading",78,0,2,0,80
1182107,856018,2019-04-29,Assembly,"Do pass",28,0,3,0,31
1182107,905413,2020-01-23,Assembly,"AB 323 Daly Assembly Third Reading",77,0,3,0,80
1182107,975547,2020-08-11,Senate,"Do pass, but first be re-referred to the Committee on [Appropriations]",5,0,0,0,5
1182107,976008,2020-08-17,Senate,"Placed on suspense file",7,0,0,0,7
1182107,976359,2020-08-20,Senate,"Do pass as amended",7,0,0,0,7
1182107,977928,2020-08-30,Senate,"Assembly 3rd Reading AB323 Blanca Rubio et al. By McGuire",39,0,1,0,40
1182107,977929,2020-08-31,Assembly,"AB 323 Blanca Rubio Concurrence in Senate Amendments",71,4,4,0,79
1182112,841522,2019-04-09,Assembly,"Do pass and be re-referred to the Committee on [Appropriations] with recommendation: To Consent Calendar",15,0,0,0,15
1182117,825036,2019-03-13,Assembly,"Do pass as amended and be re-referred to the Committee on [Appropriations]",7,0,0,0,7
1182117,905362,2020-01-23,Assembly,"Do pass as amended",18,0,0,0,18
1182121,834234,2019-04-02,Senate,"Do pass, but first be re-referred to the Committee on [Appropriations]",7,0,0,0,7
1182121,853001,2019-04-25,Senate,"Senate 3rd Reading SB192 Hertzberg",37,0,1,0,38
1182121,880319,2019-06-11,Assembly,"Do pass and be re-referred to the Committee on [Appropriations]",7,0,1,0,8
1182121,884898,2019-06-19,Assembly,"Do pass",16,0,2,0,18
1182121,893235,2019-08-15,Assembly,"SB 192 Hertzberg Senate Third Reading By Kamlager-Dove",63,5,11,0,79
1182126,820029,2019-03-12,Assembly,"Do pass and be re-referred to the Committee on [Appropriations] with recommendation: To Consent Calendar",7,0,2,0,9
1182126,838362,2019-03-12,Assembly,"Do pass and be re-referred to the Committee on [Appropriations] with recommendation: T",0,0,2,0,2
1182126,865772,2019-05-16,Assembly,"Do pass as amended",18,0,0,0,18
1182126,871109,2019-05-23,Assembly,"AB 320 Quirk Assembly Third Reading",78,0,2,0,80
1182126,888136,2019-06-26,Senate,"Do pass, but first be re-referred to the Committee on [Appropriations] with the recommendation: To Consent Calendar",8,0,1,0,9
1182126,888512,2019-06-26,Senate,"Do pass, but first be re-referred to the Committee on [Education] with the recommendation: To Consent Calendar",8,0,1,0,9
1182126,892007,2019-07-10,Senate,"Do pass, but first be re-referred to the Committee on [Appropriations] with the recommendation: To Consent Calendar",7,0,0,0,7
1182126,892008,2019-08-12,Senate,"Placed on suspense file",7,0,0,0,7
1182126,892009,2019-08-30,Senate,"Do pass",7,0,0,0,7
1182126,892010,2019-09-09,Senate,"Special Consent AB320",40,0,0,0,40
1182130,830541,2019-03-27,Senate,"Do pass, but first be re-referred to the Committee on [Appropriations]",5,0,0,0,5
1182130,838522,2019-04-08,Senate,"Placed on suspense file",6,0,0,0,6
1182130,866145,2019-05-16,Senate,"Do pass as amended",6,0,0,0,6
1182130,868713,2019-05-21,Senate,"Senate 3rd Reading SB184 Moorlach et al",38,0,0,0,38
1182130,887902,2019-06-26,Assembly,"Do pass and be re-referred to the Committee on [Appropriations] with recommendation: To Consent Calendar",7,0,0,0,7
1182130,892183,2019-08-30,Assembly,"Do pass as amended",18,0,0,0,18
1182130,892184,2019-09-09,Assembly,"SB 184 Moorlach Senate Third Reading By Cooley",79,0,0,0,79
1182130,892185,2019-09-10,Senate,"Unfinished Business SB184 Moorlach et al. Concurrence",40,0,0,0,40
1182135,840521,2019-04-08,Assembly,"Do pass and be re-referred to the Committee on [Appropriations]",9,1,1,0,11
1182135,852352,2019-04-24,Assembly,"Do pass",18,0,0,0,18
1182135,858141,2019-05-02,Assembly,"AB 321 Patterson Assembly Third Reading",72,1,7,0,80
1182135,881205,2019-06-12,Senate,"Do pass as amended, but first amend, and re-refer to the Committee on [Appropriations]",6,0,1,0,7
1182135,892534,2019-08-19,Senate,"Assembly 3rd Reading AB321 Patterson By Borgeas",39,0,1,0,40
1182135,892535,2019-08-22,Assembly,"AB 321 Patterson Concurrence in Senate Amendments",73,1,5,0,79
1182140,795577,2019-02-07,Assembly,"Be adopted. To third reading",11,0,0,0,11
1182140,816761,2019-03-07,Senate,"Special Consent ACR19 Weber et al",37,0,1,0,38
1182144,826724,2019-03-19,Assembly,"Do pass as amended and be re-referred to the Committee on [Appropriations]",15,0,0,0,15
1182149,901322,2020-01-06,Assembly,"Be re-referred to the Committee on [Local Government]",12,0,0,0,12
1182153,827982,2019-03-19,Assembly,"Do pass as amended and be re-referred to the Committee on [Appropriations]",13,2,0,0,15
1182153,866063,2019-05-16,Assembly,"Do pass as amended",13,4,1,0,18
1182153,871246,2019-05-23,Assembly,"AB 318 Chu Assembly Third Reading",61,16,3,0,80
1182153,893534,2019-07-03,Senate,"Do pass, but first be re-referred to the Committee on [Appropriations]",7,1,1,0,9
1182153,893535,2019-08-19,Senate,"Placed on suspense file",5,0,2,0,7
1182153,893536,2019-08-30,Senate,"Do pass as amended",5,2,0,0,7
1182153,893537,2019-09-04,Senate,"Assembly 3rd Reading AB318 Chu By Pan",29,11,0,0,40
1182153,893538,2019-09-09,Assembly,"AB 318 Chu Concurrence in Senate Amendments",63,15,1,0,79
1182153,894464,2019-08-19,Senate,Result,7,1,0,0,8
1184884,825055,2019-03-13,Assembly,"Do pass as amended and be re-referred to the Committee on [Appropriations]",5,1,0,0,6
1184884,865715,2019-05-16,Assembly,"Do pass",13,5,0,0,18
1184884,871499,2019-05-23,Assembly,"AB 331 Medina Assembly Third Reading",63,8,9,0,80
1184884,888098,2019-06-26,Senate,"Do pass as amended, but first amend, and re-refer to the Committee on [Appropriations]",4,0,3,0,7
1184884,892848,2019-08-12,Senate,"Placed on suspense file",7,0,0,0,7
1184884,976417,2020-08-20,Senate,"Do pass as amended",5,1,1,0,7
1184884,977857,2020-08-31,Senate,"Assembly 3rd Reading AB331 Medina et al. By Durazo",33,4,3,0,40
1184884,977858,2020-08-31,Assembly,"AB 331 MEDINA Concurrence in Senate Amendments",62,12,5,0,79
1184885,841621,2019-04-09,Assembly,"Do pass as amended and be re-referred to the Committee on [Appropriations]",9,2,1,0,12
1184885,851632,2019-04-24,Assembly,"Do pass",13,4,1,0,18
1184885,870208,2019-05-22,Assembly,"AB 330 Gabriel Assembly Third Reading",64,10,6,0,80
1184885,884714,2019-06-18,Senate,"Do pass, but first be re-referred to the Committee on [Appropriations]",7,0,2,0,9
1184885,891795,2019-08-12,Senate,"Assembly 3rd Reading AB330 Gabriel et al. By Glazer",30,7,3,0,40
1184886,820408,2019-03-12,Assembly,"Do pass",10,1,1,0,12
1184886,826666,2019-03-21,Assembly,"AB 327 Maienschein Assembly Third Reading",71,1,8,0,80
1184886,877780,2019-06-04,Senate,"Do pass",9,0,0,0,9
1184886,886104,2019-06-20,Senate,"Special Consent AB327",40,0,0,0,40
1184889,851076,2019-04-22,Assembly,"Do pass. To Consent Calendar",15,0,0,0,15
1184889,854997,2019-04-29,Assembly,"AB 335 Eduardo Garcia Consent Calendar Second Day Regular Session",76,0,4,0,80
1184889,880588,2019-06-11,Senate,"Do pass and be ordered to the Consent Calendar",11,0,1,0,12
1184889,882955,2019-06-17,Senate,"Consent Calendar AB335",40,0,0,0,40
1184890,832514,2019-03-26,Senate,"Do pass as amended, but first amend, and re-refer to the Committee on [Business, Professions and Economic Development]",7,0,0,0,7
1184890,838524,2019-04-08,Senate,"Do pass, but first be re-referred to the Committee on [Appropriations]",9,0,0,0,9
1184890,848919,2019-04-22,Senate,"Placed on suspense file",6,0,0,0,6
1184890,866254,2019-05-16,Senate,"Do pass as amended",6,0,0,0,6
1184890,871035,2019-05-23,Senate,"Senate 3rd Reading SB193 Nielsen",38,0,0,0,38
1184890,887584,2019-06-25,Assembly,"Do pass and be re-referred to the Committee on [Business and Professions]",7,1,0,0,8
1184890,892591,2019-07-09,Assembly,"Do pass and be re-referred to the Committee on [Appropriations]",18,1,0,0,19
1184891,820030,2019-03-12,Assembly,"Do pass. To Consent Calendar",11,0,1,0,12
1184891,823857,2019-03-18,Assembly,"AB 328 Maienschein Consent Calendar Second Day",76,0,4,0,80
1184891,877832,2019-06-04,Senate,"Do pass and be ordered to the Consent Calendar",9,0,0,0,9
1184891,883419,2019-06-17,Senate,"Consent Calendar AB328",40,0,0,0,40
1184892,829459,2019-03-26,Assembly,"Do pass and be re-referred to the Committee on [Appropriations]",5,0,3,0,8
1184892,866007,2019-05-16,Assembly,"Do pass as amended",16,1,1,0,18
1184892,871475,2019-05-23,Assembly,"AB 340 Irwin Assembly Third Reading",66,1,13,0,80
1184892,893322,2019-07-09,Senate,"Do pass, but first be re-referred to the Committee on [Appropriations]",7,0,0,0,7
1184892,893323,2019-08-12,Senate,"Placed on suspense file",7,0,0,0,7
1184892,893324,2019-08-30,Senate,"Do pass as amended",7,0,0,0,7
1184892,893325,2019-09-09,Senate,"Assembly 3rd Reading AB340 Irwin et al. By Stern",40,0,0,0,40
1184892,893326,2019-09-10,Assembly,"AB 340 Irwin Concurrence in Senate Amendments",74,0,5,0,79
1184892,896510,2019-09-09,Senate,"Assembly 3rd Reading AB340 Irwi",7,0,0,0,7
1184893,816690,2019-03-06,Assembly,"Do pass and be re-referred to the Committee on [Appropriations]",7,0,0,0,7
1184893,866463,2019-05-16,Assembly,"Do pass as amended",13,0,5,0,18
1184893,871669,2019-05-23,Assembly,"AB 333 Eggman Assembly Third Reading",78,0,2,0,80
1184893,888375,2019-06-26,Senate,"Do pass, but first be re-referred to the Committee on [Judiciary] with the recommendation: To Consent Calendar",5,0,0,0,5
1184893,890546,2019-07-09,Senate,"Do pass, but first be re-referred to the Committee on [Appropriations]",7,1,1,0,9
1184893,890547,2019-08-12,Senate,"Placed on suspense file",7,0,0,0,7
1184893,890548,2019-08-30,Senate,"Do pass as amended",5,2,0,0,7
1184893,890549,2019-09-04,Senate,"Assembly 3rd Reading AB333 Eggman et al",31,8,1,0,40
1184893,890550,2019-09-10,Assembly,"AB 333 Eggman Concurrence in Senate Amendments",61,17,1,0,79
1184896,819876,2019-03-12,Assembly,"Be adopted. To third reading",6,1,1,0,8
1184896,823875,2019-03-18,Assembly,"AJR 5 Jones-Sawyer Assembly Third Reading",54,21,5,0,80
1184896,880297,2019-06-11,Senate,"Be adopted. Ordered to third reading",5,2,0,0,7
1184896,890595,2019-08-12,Senate,"Assembly 3rd Reading AJR5 Jones-Sawyer et al. By Skinner",29,9,2,0,40
1184897,829308,2019-03-26,Assembly,"Do pass and be re-referred to the Committee on [Appropriations] with recommendation: To Consent Calendar",8,0,0,0,8
1184897,865692,2019-05-16,Assembly,"Do pass",18,0,0,0,18
1184897,874102,2019-05-28,Assembly,"AB 332 Lackey Assembly Third Reading",76,0,4,0,80
1184897,893285,2019-07-09,Senate,"Do pass, but first be re-referred to the Committee on [Appropriations] with the recommendation: To Consent Calendar",7,0,0,0,7
1184897,893286,2019-08-15,Senate,"Consent Calendar AB332",37,0,3,0,40
1184897,893287,2019-08-19,Assembly,"AB 332 Lackey Concurrence in Senate Amendments",77,0,2,0,79
1184897,895169,2019-08-15,Senate,Result,37,0,0,0,37
1184898,851262,2019-04-24,Senate,"Do pass, but first be re-referred to the Committee on [Appropriations]",13,0,0,0,13
1184898,863036,2019-05-13,Senate,"Placed on suspense file",6,0,0,0,6
1184898,865666,2019-05-16,Senate,"Do pass",6,0,0,0,6
1184898,871480,2019-05-23,Senate,"Special Consent SB199",38,0,0,0,38
1184898,890346,2019-07-10,Assembly,"Do pass and be re-referred to the Committee on [Appropriations] with recommendation: To Consent Calendar",15,0,0,0,15
1184898,890347,2019-08-30,Assembly,"Do pass",18,0,0,0,18
1184898,890348,2019-09-09,Assembly,"SB 199 Hill Senate Third Reading By Holden",79,0,0,0,79
1184898,890349,2019-09-11,Senate,"Unfinished Business SB199 Hill Concurrence",40,0,0,0,40
1184899,821529,2019-03-13,Assembly,"Do pass. To Consent Calendar",7,0,0,0,7
1184899,826769,2019-03-21,Assembly,"AB 334 Obernolte Consent Calendar Second Day",72,0,8,0,80
1184899,861321,2019-05-07,Senate,"Do pass and be ordered to the Consent Calendar",5,0,0,0,5
1184899,863028,2019-05-13,Senate,"Consent Calendar AB334 Obernolte",37,0,1,0,38
1184900,826074,2019-03-20,Senate,"Do pass, but first be re-referred to the Committee on [Natural Resources and Water]",5,0,2,0,7
1184900,850228,2019-04-23,Senate,"Do pass as amended, but first amend, and re-refer to the Committee on [Appropriations]",6,0,3,0,9
1184900,863210,2019-05-13,Senate,"Placed on suspense file",6,0,0,0,6
1184900,866374,2019-05-16,Senate,"Do pass as amended",4,2,0,0,6
1184900,869975,2019-05-22,Senate,"Senate 3rd Reading SB200 Monning et al",37,1,0,0,38
1184900,890543,2019-07-02,Assembly,"Do pass as amended",8,1,0,0,9
1184900,890544,2019-07-05,Assembly,"SB 200 Monning Third Reading Urgency By GARCIA, E",68,0,11,0,79
1184900,890545,2019-07-08,Senate,"Unfinished Business SB200 Monning et al. Urgency Clause Concurrence",38,1,1,0,40
1184902,851194,2019-04-23,Assembly,"Do pass and be re-referred to the Committee on [Appropriations]",7,0,1,0,8
1184902,865642,2019-05-16,Assembly,"Do pass",18,0,0,0,18
1184902,871055,2019-05-23,Assembly,"AB 329 Rodriguez Assembly Third Reading",72,0,8,0,80
1184903,903142,2020-01-15,Senate,"Do pass, but first be re-referred to the Committee on [Appropriations]",12,0,0,0,12
1184903,905392,2020-01-23,Senate,"Senate 3rd Reading SB203 Bradford",37,0,2,0,39
1184903,974972,2020-08-05,Assembly,"Do pass and be re-referred to the Committee on [Appropriations]",6,1,1,0,8
1184903,976330,2020-08-20,Assembly,"Do pass",13,3,2,0,18
1184903,977914,2020-08-30,Assembly,"SB 203 Bradford Senate Third Reading By Kamlager",54,13,12,0,79
1184903,977915,2020-08-31,Senate,"Unfinished Business SB203 Bradford et al. Concurrence",32,2,6,0,40
1184904,839753,2019-04-02,Senate,"Do pass as amended, but first amend, and re-refer to the Committee on [Judiciary]",4,0,0,0,4
1184904,851215,2019-04-23,Senate,"Do pass as amended, but first amend, and re-refer to the Committee on [Appropriations]",9,0,0,0,9
1184904,868918,2019-05-21,Senate,"Senate 3rd Reading SB202 Wilk et al",38,0,0,0,38
1184904,887539,2019-06-25,Assembly,"Do pass as amended and be re-referred to the Committee on [Agriculture]",12,0,0,0,12
1184904,893362,2019-07-03,Assembly,"Do pass as amended and be re-referred to the Committee on [Appropriations]",11,0,0,0,11
1184904,893363,2019-08-30,Assembly,"Do pass",18,0,0,0,18
1184904,893364,2019-09-10,Assembly,"SB 202 Wilk Senate Third Reading By Bloom",79,0,0,0,79
1184904,893365,2019-09-11,Senate,"Unfinished Business SB202 Wilk et al. Concurrence",40,0,0,0,40
1184905,824449,2019-03-12,Assembly,"Do pass as amended, and be re-referred to the Committee on [Appropriations] with recommendation: To Consent Calendar",7,0,1,0,8
1184906,829405,2019-03-26,Senate,"Do pass, but first be re-referred to the Committee on [Appropriations]",2,3,2,0,7
1184910,829447,2019-03-26,Senate,"Do pass, but first be re-referred to the Committee on [Appropriations] with the recommendation: To Consent Calendar",12,0,0,0,12
1184910,838662,2019-04-08,Senate,"Do pass",6,0,0,0,6
1184910,848774,2019-04-22,Senate,"Senate 3rd Reading SB197 Beall et al",38,0,0,0,38
1184910,889313,2019-07-01,Assembly,"Do pass and be re-referred to the Committee on [Appropriations] with recommendation: To Consent Calendar",15,0,0,0,15
1184910,893081,2019-08-14,Assembly,"Do pass",18,0,0,0,18
1184910,893082,2019-09-05,Assembly,"SB 197 Beall Senate Third Reading By Frazier",79,0,0,0,79
1184911,859770,2019-05-01,Senate,"Do pass as amended, but first amend, and re-refer to the Committee on [Appropriations]",7,0,0,0,7
1184911,863124,2019-05-13,Senate,"Placed on suspense file",6,0,0,0,6
1184911,866252,2019-05-16,Senate,"Do pass",6,0,0,0,6
1184911,871044,2019-05-23,Senate,"Special Consent SB196",38,0,0,0,38
1184911,890554,2019-07-08,Assembly,"Do pass and be re-referred to the Committee on [Appropriations]",10,0,1,0,11
1184911,890555,2019-08-30,Assembly,"Do pass as amended",18,0,0,0,18
1184911,890556,2019-09-10,Assembly,"SB 196 Beall Senate Third Reading By Petrie-Norris",79,0,0,0,79
1184911,890557,2019-09-11,Senate,"Unfinished Business SB196 Beall et al. Concurrence",40,0,0,0,40
1184912,795560,2019-02-07,Senate,"Senate 3rd Reading SR15 Mitchell et al",37,0,1,0,38
1184913,792450,2019-02-04,Assembly,"Be adopted. To third reading",9,0,2,0,11
1184915,902217,2020-01-13,Senate,"Do pass, but first be re-referred to the Committee on [Judiciary]",2,4,3,0,9
1184915,902218,2020-01-13,Senate,"[01-13-2020] hearing: Motion to Reconsider. [Reconsideration Granted.]",9,0,0,0,9
1184915,903562,2020-01-13,Senate,"[Second] hearing set for [01-17-2020]: Failed passage in Committee. Reconsideration granted",9,0,0,0,9
1184916,829334,2019-03-26,Assembly,"Do pass and be re-referred to the Committee on [Appropriations]",14,0,0,0,14
1184917,821694,2019-03-12,Assembly,"Do pass and be re-referred to the Committee on [Appropriations]",7,0,1,0,8
1184917,866492,2019-05-16,Assembly,"Do pass as amended",18,0,0,0,18
1184917,871563,2019-05-23,Assembly,"AB 337 Quirk-Silva Assembly Third Reading",78,0,2,0,80
1184917,887755,2019-06-24,Senate,"Do pass, but first be re-referred to the Committee on [Appropriations] with the recommendation: To Consent Calendar",6,0,0,0,6
1184917,893839,2019-08-12,Senate,"Placed on suspense file",7,0,0,0,7
1184918,830672,2019-03-27,Assembly,"Do pass as amended and be re-referred to the Committee on [Appropriations]",7,1,0,0,8
1184918,866200,2019-05-16,Assembly,"Do pass as amended",14,3,1,0,18
1184918,871621,2019-05-23,Assembly,"AB 338 Chu Assembly Third Reading",60,13,7,0,80
1184918,885334,2019-06-18,Senate,"Do pass, but first be re-referred to the Committee on [Appropriations]",7,2,2,0,11
1184918,893445,2019-07-01,Senate,"Placed on suspense file",7,0,0,0,7
1184918,893446,2019-08-30,Senate,"Do pass as amended",5,2,0,0,7
1184918,893447,2019-09-04,Senate,"Assembly 3rd Reading AB338 Chu et al. By Leyva",28,7,5,0,40
1184918,893448,2019-09-09,Assembly,"AB 338 Chu Concurrence in Senate Amendments",62,15,2,0,79
1184919,820056,2019-03-12,Assembly,"Do pass and be re-referred to the Committee on [Appropriations]",8,0,0,0,8
1184919,866014,2019-05-16,Assembly,"Do pass",17,1,0,0,18
1184919,870142,2019-05-22,Assembly,"AB 339 Irwin Assembly Third Reading",68,1,11,0,80
1184919,883760,2019-06-18,Senate,"Do pass, but first be re-referred to the Committee on [Appropriations]",5,1,1,0,7
1184919,889240,2019-07-01,Senate,"Placed on suspense file",7,0,0,0,7
1184919,890366,2019-08-30,Senate,"Do pass as amended",7,0,0,0,7
1184919,890367,2019-09-09,Senate,"Assembly 3rd Reading AB339 Irwin et al. By Stern",34,4,2,0,40
1184919,890368,2019-09-10,Assembly,"AB 339 Irwin Concurrence in Senate Amendments",72,0,7,0,79
1188438,842252,2019-04-09,Assembly,"Do pass as amended, and be re-referred to the Committee on [Appropriations] with recommendation: To Consent Calendar",12,0,0,0,12
1188439,851243,2019-04-23,Assembly,"Do pass and be re-referred to the Committee on [Appropriations] with recommendation: To Consent Calendar",8,0,0,0,8
1188441,801994,2019-02-15,Assembly,"Be adopted. To Consent Calendar",12,0,0,0,12
1188441,806276,2019-02-21,Assembly,"ACR 20 Luz Rivas Consent Calendar Second Day",74,0,6,0,80
1188441,818672,2019-03-11,Senate,"Special Consent ACR20 Luz Rivas et al",37,0,1,0,38
1188442,833102,2019-03-27,Assembly,"Do pass as amended and be re-referred to the Committee on [Appropriations]",6,1,0,0,7
1188444,826721,2019-03-20,Senate,"Do pass as amended, but first amend, and re-refer to the Committee on [Transportation]",5,2,0,0,7
1188444,850067,2019-04-23,Senate,"Do pass as amended, but first amend, and re-refer to the Committee on [Appropriations]",8,3,1,0,12
1188444,866286,2019-05-16,Senate,"Placed on suspense file",6,0,0,0,6
1188444,866287,2019-05-16,Senate,"Do pass as amended",4,2,0,0,6
1188444,874507,2019-05-29,Senate,"Senate 3rd Reading SB210 Leyva",27,10,1,0,38
1188444,889261,2019-07-01,Assembly,"Do pass and be re-referred to the Committee on [Natural Resources]",12,2,1,0,15
1188444,890389,2019-07-08,Assembly,"Do pass and be re-referred to the Committee on [Appropriations]",8,3,0,0,11
1188444,890390,2019-08-30,Assembly,"Do pass as amended",13,4,1,0,18
1188444,890391,2019-09-10,Assembly,"SB 210 Leyva Senate Third Reading By Eduardo Garcia",51,19,9,0,79
1188444,893663,2019-09-12,Senate,"That the Assembly amendments be concurred in",5,2,0,0,7
1188444,894149,2019-09-13,Senate,"Unfinished Business SB210 Leyva et al. Concurrence",28,11,1,0,40
1188450,835454,2019-04-03,Assembly,"Do pass and be re-referred to the Committee on [Appropriations]",7,0,0,0,7
1188450,865917,2019-05-16,Assembly,"Do pass",18,0,0,0,18
1188450,870196,2019-05-22,Assembly,"AB 365 Cristina Garcia Assembly Third Reading",78,0,2,0,80
1188450,887962,2019-06-26,Senate,"Do pass, but first be re-referred to the Committee on [Appropriations] with the recommendation: To Consent Calendar",5,0,0,0,5
1188450,891355,2019-07-08,Senate,"Placed on suspense file",7,0,0,0,7
1188450,891356,2019-08-30,Senate,"Do pass as amended",7,0,0,0,7
1188450,891357,2019-09-04,Senate,"Assembly 3rd Reading AB365 Cristina Garcia By Beall",40,0,0,0,40
1188450,891358,2019-09-09,Assembly,"AB 365 Cristina Garcia Concurrence in Senate Amendments",79,0,0,0,79
1188450,894063,2019-07-08,Senate,Result,5,0,0,0,5
1188453,821538,2019-03-12,Senate,"Do pass as amended, but first amend, and re-refer to the Committee on [Appropriations]",6,0,3,0,9
1188453,859537,2019-05-06,Senate,"Placed on suspense file",5,0,1,0,6
1188453,866167,2019-05-16,Senate,"Do pass as amended",5,1,0,0,6
1188453,871470,2019-05-23,Senate,"Senate 3rd Reading SB204 Dodd et al",37,0,1,0,38
1188453,894529,2019-05-23,Senate,Date,5,0,0,0,5
1188454,829434,2019-03-26,Senate,"Do pass, but first be re-referred to the Committee on [Energy, Utilities and Communications]",13,1,2,0,16
1188454,851638,2019-04-24,Senate,"Do pass, but first be re-referred to the Committee on [Appropriations]",13,0,0,0,13
1188454,859410,2019-05-06,Senate,"Placed on suspense file",5,0,1,0,6
1188454,866300,2019-05-16,Senate,"Do pass",6,0,0,0,6
1188454,871063,2019-05-23,Senate,"Special Consent SB209",38,0,0,0,38
1188454,887970,2019-06-26,Assembly,"Do pass and be re-referred to the Committee on [Utilities and Energy]",19,0,2,0,21
1188454,893028,2019-07-10,Assembly,"Do pass and be re-referred to the Committee on [Appropriations] with recommendation: To Consent Calendar",15,0,0,0,15
1188454,893029,2019-08-30,Assembly,"Do pass as amended",18,0,0,0,18
1188454,893030,2019-09-09,Assembly,"SB 209 Dodd Senate Third Reading By Mayes",79,0,0,0,79
1188454,893031,2019-09-11,Senate,"Unfinished Business SB209 Dodd Concurrence",40,0,0,0,40
1188458,850510,2019-04-22,Assembly,"Do pass and be re-referred to the Committee on [Appropriations]",11,0,0,0,11
1188458,866247,2019-05-16,Assembly,"Do pass as amended",18,0,0,0,18
1188458,871596,2019-05-23,Assembly,"AB 357 Nazarian Assembly Third Reading",78,0,2,0,80
1188458,887935,2019-06-26,Senate,"Do pass, but first be re-referred to the Committee on [Appropriations]",7,0,0,0,7
1188458,891273,2019-07-08,Senate,"Placed on suspense file",7,0,0,0,7
1188458,891274,2019-08-30,Senate,"Do pass",7,0,0,0,7
1188458,891275,2019-09-09,Senate,"Special Consent AB357",40,0,0,0,40
1188458,891276,2019-09-10,Assembly,"AB 357 Nazarian Concurrence in Senate Amendments",79,0,0,0,79
1188458,894905,2019-08-30,Senate,Date,7,0,0,0,7
1188460,902841,2020-01-14,Assembly,"Do pass as amended and be re-referred to the Committee on [Appropriations]",8,0,0,0,8
1188461,825911,2019-03-19,Assembly,"Do pass and be re-referred to the Committee on [Public Safety]",11,4,0,0,15
1188461,850208,2019-04-23,Assembly,"Do pass as amended",6,2,0,0,8
1188461,871046,2019-05-23,Assembly,"AB 362 Eggman Assembly Third Reading",44,26,10,0,80
1188461,894543,2019-04-23,Assembly,Result,6,2,0,0,8
1188463,831402,2019-03-25,Assembly,"Do pass as amended and be re-referred to the Committee on [Appropriations]",11,0,0,0,11
1188464,830540,2019-03-27,Senate,"Do pass, but first be re-referred to the Committee on [Judiciary]",9,1,3,0,13
1188464,841517,2019-04-09,Senate,"Do pass as amended, but first amend, and re-refer to the Committee on [Appropriations]",8,0,0,0,8
1188464,863111,2019-05-13,Senate,"Senate 3rd Reading SB208 Hueso et al",32,5,1,0,38
1188464,884702,2019-06-19,Assembly,"Do pass and be re-referred to the Committee on [Privacy and Consumer Protection]",10,2,1,0,13
1188464,887361,2019-04-09,Senate,"Do pass as amended, but first amend, and re-refer to the Committee on [Apn style=""font-weight: bold"" title=""No Votes Recorded"">No Votes Recorded:",9,1,0,0,10
1188464,887654,2019-06-25,Assembly,"Do pass and be re-referred to the Committee on [Appropriations]",10,0,1,0,11
1188464,893354,2019-07-10,Assembly,"Do pass",13,2,3,0,18
1188464,893355,2019-09-09,Assembly,"SB 208 Hueso Senate Third Reading By Gabriel",69,0,10,0,79
1188464,893356,2019-09-11,Senate,"Unfinished Business SB208 Hueso et al. Concurrence",35,4,1,0,40
1188466,841812,2019-04-09,Senate,"Do pass, but first be re-referred to the Committee on [Appropriations]",12,0,0,0,12
1188466,848945,2019-04-22,Senate,"Placed on suspense file",6,0,0,0,6
1188466,865627,2019-05-16,Senate,"Do pass",6,0,0,0,6
1188466,871005,2019-05-23,Senate,"Special Consent SB211",38,0,0,0,38
1188466,890725,2019-07-08,Assembly,"Do pass and be re-referred to the Committee on [Appropriations]",15,0,0,0,15
1188466,890726,2019-08-30,Assembly,"Do pass",18,0,0,0,18
1188466,890727,2019-09-09,Assembly,"SB 211 Beall Senate Third Reading By Quirk-Silva",76,2,1,0,79
1188466,890728,2019-09-11,Senate,"Unfinished Business SB211 Beall et al. Concurrence",35,4,1,0,40
1188467,829148,2019-03-25,Assembly,"Do pass and be re-referred to the Committee on [Appropriations]",8,0,3,0,11
1188467,865974,2019-05-16,Assembly,"Do pass",13,1,4,0,18
1188467,867030,2019-05-16,Assembly,"Do pass as amended",13,1,4,0,18
1188467,875550,2019-05-30,Assembly,"AB 352 Eduardo Garcia Assembly Third Reading",63,0,17,0,80
1188469,826389,2019-03-20,Senate,"Do pass as amended, but first amend, and re-refer to the Committee on [Environmental Quality]",7,0,0,0,7
1188469,835268,2019-04-03,Senate,"Do pass, but first be re-referred to the Committee on [Appropriations]",7,0,0,0,7
1188469,849016,2019-04-22,Senate,"Placed on suspense file",6,0,0,0,6
1188469,866065,2019-05-16,Senate,"Do pass as amended",5,1,0,0,6
1188469,868937,2019-05-21,Senate,"Senate 3rd Reading SB205 Hertzberg",38,0,0,0,38
1188469,885009,2019-06-18,Assembly,"Do pass and be re-referred to the Committee on [Local Government]",7,0,1,0,8
1188469,892592,2019-07-10,Assembly,"Do pass as amended and be re-referred to the Committee on [Appropriations]",8,0,0,0,8
1188469,892593,2019-08-30,Assembly,"Do pass",18,0,0,0,18
1188469,892594,2019-09-09,Assembly,"SB 205 Hertzberg Senate Third Reading By Wood",78,0,1,0,79
1188469,892595,2019-09-11,Senate,"Unfinished Business SB205 Hertzberg Concurrence",40,0,0,0,40
1188470,836755,2019-04-03,Senate,"Do pass as amended, but first amend, and re-refer to the Committee on [Appropriations]",8,0,1,0,9
1188470,854820,2019-04-29,Senate,"Placed on suspense file",6,0,0,0,6
1188470,866043,2019-05-16,Senate,"Do pass",6,0,0,0,6
1188470,868728,2019-05-21,Senate,"Senate 3rd Reading SB207 Hurtado et al",38,0,0,0,38
1188470,892394,2019-07-09,Assembly,"Do pass and be re-referred to the Committee on [Appropriations] with recommendation: To Consent Calendar",15,0,0,0,15
1188470,894839,2019-04-29,Senate,Result,6,0,0,0,6
1188470,905359,2020-01-23,Assembly,"Do pass as amended",13,5,0,0,18
1188470,913598,2020-02-03,Assembly,"SB 207 Hurtado Third Reading Urgency By Gonzalez",60,12,8,0,80
1188470,917117,2020-02-06,Senate,"Unfinished Business SB207 Hurtado et al. Urgency Clause Concurrence",28,9,2,0,39
1188472,825518,2019-03-13,Assembly,"Do pass as amended and be re-referred to the Committee on [Appropriations]",5,1,0,0,6
1188472,866103,2019-05-16,Assembly,"Do pass",14,4,0,0,18
1188472,870144,2019-05-22,Assembly,"AB 354 Quirk-Silva Assembly Third Reading",63,11,6,0,80
1188472,881094,2019-06-12,Senate,"Do pass, but first be re-referred to the Committee on [Appropriations]",7,0,0,0,7
1188472,887080,2019-06-24,Senate,"Placed on suspense file",7,0,0,0,7
1188472,891348,2019-08-30,Senate,"Do pass",5,2,0,0,7
1188472,891349,2019-09-09,Senate,"Assembly 3rd Reading AB354 Quirk-Silva et al. By Rubio",31,9,0,0,40
1188472,891350,2019-09-10,Assembly,"AB 354 Quirk-Silva Concurrence in Senate Amendments",67,10,2,0,79
1188472,894813,2019-09-09,Senate,"Assembly 3rd Reading AB354",5,9,0,0,14
1188473,841686,2019-04-08,Assembly,"Do pass as amended and be re-referred to the Committee on [Appropriations]",8,3,0,0,11
1188473,865762,2019-05-16,Assembly,"Do pass",13,5,0,0,18
1188473,870101,2019-05-22,Assembly,"AB 342 Muratsuchi Assembly Third Reading",51,19,10,0,80
1188473,880467,2019-06-11,Senate,"Do pass, but first be re-referred to the Committee on [Appropriations]",6,2,1,0,9
1188473,887056,2019-06-24,Senate,"Do pass",5,1,1,0,7
1188473,892601,2019-09-04,Senate,"Assembly 3rd Reading AB342 Muratsuchi et al. By Jackson",23,9,8,0,40
1188473,892602,2019-09-09,Assembly,"AB 342 Muratsuchi Concurrence in Senate Amendments",59,19,1,0,79
1188477,835938,2019-04-03,Assembly,"Do pass and be re-referred to the Committee on [Appropriations]",7,0,0,0,7
1188477,841779,2019-04-10,Assembly,"Do pass. To Consent Calendar",17,0,1,0,18
1188477,853701,2019-04-25,Assembly,"AB 355 Daly Consent Calendar Second Day Regular Session",76,0,4,0,80
1188477,881396,2019-06-12,Senate,"Do pass, but first be re-referred to the Committee on [Judiciary]",4,1,0,0,5
1188477,893679,2019-07-02,Senate,"Do pass, but first be re-referred to the Committee on [Appropriations]",7,2,0,0,9
1188477,893680,2019-08-12,Senate,"Placed on suspense file",7,0,0,0,7
1188477,893681,2019-08-30,Senate,"Do pass",5,2,0,0,7
1188477,893682,2019-09-05,Senate,"Assembly 3rd Reading AB355 Daly et al. By Umberg",30,10,0,0,40
1188479,797295,2019-02-11,Senate,"Senate 3rd Reading SCR12 Bradford et al",37,0,1,0,38
1188479,806402,2019-02-21,Assembly,"Be adopted. To Consent Calendar",12,0,0,0,12
1188479,811731,2019-02-28,Assembly,"SCR 12 Bradford Consent Calendar Second Day Regular Session",75,0,5,0,80
1188480,853422,2019-04-24,Assembly,"Do pass and be re-referred to the Committee on [Appropriations] with recommendation: To Consent Calendar",8,0,0,0,8
1188480,861976,2019-05-08,Assembly,"Do pass. To Consent Calendar",18,0,0,0,18
1188480,866115,2019-05-16,Assembly,"AB 349 Choi Consent Calendar Second Day Regular Session",74,0,6,0,80
1188480,883883,2019-06-18,Senate,"Do pass, but first be re-referred to the Committee on [Appropriations] with the recommendation: To Consent Calendar",11,0,0,0,11
1188480,891417,2019-07-01,Senate,"Placed on suspense file",7,0,0,0,7
1188483,850089,2019-04-23,Senate,"Do pass, but first be re-referred to the Committee on [Appropriations]",3,1,1,0,5
1188483,873965,2019-05-28,Senate,"Senate 3rd Reading SB212 Allen",28,8,2,0,38
1188483,892923,2019-07-03,Assembly,"Do pass as amended and be re-referred to the Committee on [Appropriations]",6,0,1,0,7
1188483,892924,2019-08-14,Assembly,"Do pass",13,5,0,0,18
1188483,892925,2019-09-09,Assembly,"SB 212 Allen Senate Third Reading By Chiu",56,18,5,0,79
1188483,892926,2019-09-11,Senate,"Unfinished Business SB212 Allen et al. Concurrence",29,9,2,0,40
1188485,856038,2019-04-29,Assembly,"Do pass. To Consent Calendar",11,0,0,0,11
1188485,859618,2019-05-06,Assembly,"AB 353 Muratsuchi Consent Calendar Second Day Regular Session",77,0,3,0,80
1188487,853193,2019-04-24,Assembly,"Do pass and be re-referred to the Committee on [Appropriations]",7,0,1,0,8
1188487,866240,2019-05-16,Assembly,"Do pass",14,3,1,0,18
1188487,870017,2019-05-22,Assembly,"AB 344 Calderon Assembly Third Reading",67,1,12,0,80
1188487,880913,2019-06-10,Senate,"Do pass, but first be re-referred to the Committee on [Appropriations]",5,0,1,0,6
1188487,889300,2019-07-01,Senate,"Placed on suspense file",7,0,0,0,7
1188487,893433,2019-08-30,Senate,"Do pass",6,0,1,0,7
1188487,893434,2019-09-04,Senate,"Assembly 3rd Reading AB344 Calderon By Beall",38,0,2,0,40
1188488,841487,2019-04-09,Assembly,"Do pass and be re-referred to the Committee on [Appropriations]",10,0,1,0,11
1188488,852369,2019-04-24,Assembly,"Do pass. To Consent Calendar",18,0,0,0,18
1188488,858128,2019-05-02,Assembly,"AB 361 Voepel Consent Calendar Second Day Regular Session",76,0,4,0,80
1188488,880839,2019-06-11,Senate,"Do pass, but first be re-referred to the Committee on [Appropriations] with the recommendation: To Consent Calendar",7,0,0,0,7
1188488,889224,2019-07-01,Senate,"Consent Calendar AB361",39,0,1,0,40
1188490,826004,2019-03-19,Assembly,"Do pass",10,2,0,0,12
1188490,831506,2019-03-28,Assembly,"AB 356 Santiago Assembly Third Reading",60,7,13,0,80
1188490,881036,2019-06-12,Senate,"Do pass",7,0,0,0,7
1188490,891866,2019-07-08,Senate,"Assembly 3rd Reading AB356 Santiago By Durazo",32,6,2,0,40
1188490,891867,2019-08-15,Assembly,"AB 356 Santiago Concurrence in Senate Amendments",65,7,7,0,79
1188490,894421,2019-07-08,Senate,"Assembly 3rd Reading AB356 San",7,6,0,0,13
1188491,801930,2019-02-15,Assembly,"Be adopted. To third reading",12,0,0,0,12
1188491,818691,2019-03-11,Senate,"Special Consent ACR21",37,0,1,0,38
1188492,840013,2019-04-03,Senate,"Do pass as amended, but first amend, and re-refer to the Committee on [Appropriations]",7,0,0,0,7
1188492,859594,2019-05-06,Senate,"Placed on suspense file",5,0,1,0,6
1188492,865657,2019-05-16,Senate,"Do pass as amended",4,2,0,0,6
1188492,869947,2019-05-22,Senate,"Senate 3rd Reading SB206 Skinner et al",31,5,2,0,38
1188492,887538,2019-06-25,Assembly,"Do pass and be re-referred to the Committee on [Higher Education]",5,0,2,0,7
1188492,890513,2019-07-09,Assembly,"Do pass as amended and be re-referred to the Committee on [Appropriations]",11,0,1,0,12
1188492,890514,2019-08-30,Assembly,"Do pass as amended",15,1,2,0,18
1188492,890515,2019-09-09,Assembly,"SB 206 Skinner Senate Third Reading By Kamlager-Dove",73,0,6,0,79
1188492,890516,2019-09-11,Senate,"Unfinished Business SB206 Skinner et al. Concurrence",39,0,1,0,40
1188536,851595,2019-04-24,Assembly,"Do pass",14,0,0,0,14
1188536,854817,2019-04-29,Assembly,"AB 346 Cooper Assembly Third Reading",75,0,5,0,80
1188536,880971,2019-06-12,Senate,"Do pass, but first be re-referred to the Committee on [Appropriations]",5,0,0,0,5
1188536,887051,2019-06-24,Senate,"Placed on suspense file",7,0,0,0,7
1188536,892855,2019-08-30,Senate,"Do pass",6,0,1,0,7
1188536,892856,2019-09-05,Senate,"Assembly 3rd Reading AB346 Cooper By Hill",39,0,1,0,40
1189002,853120,2019-04-22,Assembly,"Do pass as amended and be re-referred to the Committee on [Appropriations]",7,3,1,0,11
1189002,905352,2020-01-23,Assembly,"Do pass as amended",10,5,3,0,18
1189002,906419,2020-01-27,Assembly,"AB 345 Muratsuchi Assembly Third Reading",42,30,8,0,80
1189002,974893,2020-08-05,Senate,"Do pass as amended, but first amend, and re-refer to the Committee on [Appropriations]",4,5,0,0,9
1189002,974894,2020-08-05,Senate,"[08-05-2020] hearing: Motion to Reconsider. [Reconsideration Granted.]",5,3,1,0,9
1191054,841446,2019-04-09,Assembly,"Do pass and be re-referred to the Committee on [Appropriations]",13,1,1,0,15
1191054,852052,2019-04-24,Assembly,"Do pass",18,0,0,0,18
1191054,858214,2019-05-02,Assembly,"AB 377 Eduardo Garcia Third Reading Urgency",74,0,6,0,80
1191054,884596,2019-06-19,Senate,"Do pass, but first be re-referred to the Committee on [Appropriations]",7,2,0,0,9
1191054,893026,2019-09-05,Senate,"Assembly 3rd Reading AB377 Eduardo Garcia By Hurtado Urgency Clause",30,8,2,0,40
1191054,893027,2019-09-09,Assembly,"AB 377 Eduardo Garcia Concurrence in Senate Amendments",74,3,2,0,79
1191068,836647,2019-04-02,Assembly,"Do pass as amended, and be re-referred to the Committee on [Transportation] with recommendation: To Consent Calendar",7,0,0,0,7
1191068,849015,2019-04-22,Assembly,"Do pass and be re-referred to the Committee on [Appropriations] with recommendation: To Consent Calendar",15,0,0,0,15
1191082,835020,2019-04-02,Assembly,"Do pass and be re-referred to the Committee on [Appropriations]",8,2,2,0,12
1191082,865988,2019-05-16,Assembly,"Do pass",14,4,0,0,18
1191082,871342,2019-05-23,Assembly,"AB 369 Weber Assembly Third Reading",69,3,8,0,80
1191082,881099,2019-06-12,Senate,"Do pass, but first be re-referred to the Committee on [Appropriations]",5,1,1,0,7
1191082,886950,2019-06-24,Senate,"Placed on suspense file",7,0,0,0,7
1191082,892006,2019-08-30,Senate,"Do pass",5,2,0,0,7
1191110,842718,2019-04-09,Assembly,"Do pass as amended and be re-referred to the Committee on [Appropriations]",13,3,4,0,20
1191110,865668,2019-05-16,Assembly,"Do pass as amended",11,4,3,0,18
1191110,874634,2019-05-29,Assembly,"AB 387 Gabriel Assembly Third Reading",53,18,9,0,80
1191110,890580,2019-07-08,Senate,"Do pass, but first be re-referred to the Committee on [Appropriations]",9,0,0,0,9
1191110,890581,2019-08-19,Senate,"Placed on suspense file",5,0,2,0,7
1191124,851054,2019-04-23,Assembly,"Do pass",7,0,0,0,7
1191124,858169,2019-05-02,Assembly,"AB 379 Maienschein Assembly Third Reading",77,0,3,0,80
1191124,891519,2019-07-10,Senate,"Do pass and be ordered to the Consent Calendar",8,0,1,0,9
1191124,891520,2019-08-15,Senate,"Consent Calendar AB379",37,0,3,0,40
1191138,836741,2019-04-03,Assembly,"Do pass and be re-referred to the Committee on [Judiciary]",6,0,1,0,7
1191138,850472,2019-04-23,Assembly,"Do pass as amended and be re-referred to the Committee on [Appropriations]",9,3,0,0,12
1191138,865760,2019-05-16,Assembly,"Do pass",13,4,1,0,18
1191138,871306,2019-05-23,Assembly,"AB 378 Limón Assembly Third Reading",60,17,3,0,80
1191138,888176,2019-06-26,Senate,"Do pass as amended, but first amend, and re-refer to the Committee on [Judiciary]",4,1,0,0,5
1191138,888997,2019-04-23,Assembly,"Do pass as amended and be re-referred to the Committee on [Appropr",6,0,0,0,6
1191138,892621,2019-07-09,Senate,"Do pass, but first be re-referred to the Committee on [Appropriations]",7,1,1,0,9
1191138,892622,2019-08-19,Senate,"Do pass",4,1,2,0,7
1191138,892623,2019-09-05,Senate,"Assembly 3rd Reading AB378 Limón et al. By Mitchell",29,10,1,0,40
1191138,893696,2019-09-12,Assembly,"With recommendation: That Senate amendments be concurred in",7,0,0,0,7
1191138,893942,2019-09-13,Assembly,"AB 378 Limón Concurrence in Senate Amendments",63,16,0,0,79
1191138,894518,2019-09-05,Senate,A,4,1,0,0,5
1191152,829483,2019-03-25,Assembly,"Do pass and be re-referred to the Committee on [Appropriations]",11,0,0,0,11
1191152,865793,2019-05-16,Assembly,"Do pass",18,0,0,0,18
1191152,875488,2019-05-30,Assembly,"AB 386 Eduardo Garcia Assembly Third Reading",77,0,3,0,80
1191152,893227,2019-07-02,Senate,"Do pass, but first be re-referred to the Committee on [Energy, Utilities and Communications]",9,1,1,0,11
1191152,893228,2019-07-10,Senate,"Do pass as amended, but first amend, and re-refer to the Committee on [Appropriations]",11,1,1,0,13
1191152,893229,2019-08-19,Senate,"Placed on suspense file",5,0,2,0,7
1191152,893230,2019-08-30,Senate,"Do pass",6,1,0,0,7
1191152,893231,2019-09-04,Senate,"Assembly 3rd Reading AB386 Eduardo Garcia By Hueso",36,2,2,0,40
1191152,893232,2019-09-09,Assembly,"AB 386 Eduardo Garcia Concurrence in Senate Amendments",79,0,0,0,79
1191180,830377,2019-03-25,Assembly,"Do pass as amended and be re-referred to the Committee on [Appropriations]",10,0,1,0,11
1191194,830558,2019-03-26,Assembly,"Do pass and be re-referred to the Committee on [Privacy and Consumer Protection]",10,3,2,0,15
1191194,851438,2019-04-23,Assembly,"Do pass and be re-referred to the Committee on [Appropriations]",9,2,0,0,11
1191194,856979,2019-05-01,Assembly,"Do pass",13,5,0,0,18
1191194,874411,2019-05-29,Assembly,"AB 384 Chau Assembly Third Reading",57,15,8,0,80
1191194,892142,2019-07-03,Senate,"Do pass, but first be re-referred to the Committee on [Judiciary]",7,1,1,0,9
1191194,892143,2019-07-09,Senate,"Do pass, but first be re-referred to the Committee on [Appropriations]",6,1,2,0,9
1191194,892144,2019-08-12,Senate,"Placed on suspense file",7,0,0,0,7
1191208,828658,2019-03-25,Assembly,"Do pass and be re-referred to the Committee on [Appropriations]",14,0,1,0,15
1191222,826034,2019-03-19,Assembly,"Do pass as amended and be re-referred to the Committee on [Appropriations]",12,0,0,0,12
1191222,835470,2019-04-03,Assembly,"Do pass. To Consent Calendar",17,0,1,0,18
1191222,842791,2019-04-11,Assembly,"AB 381 Reyes Consent Calendar Second Day Regular Session",72,0,8,0,80
1191222,878618,2019-06-05,Senate,"Do pass, but first be re-referred to the Committee on [Appropriations] with the recommendation: To Consent Calendar",7,0,0,0,7
1191222,889259,2019-07-01,Senate,"Consent Calendar AB381",39,0,1,0,40
1191236,819907,2019-03-11,Assembly,"Do pass and be re-referred to the Committee on [Accountability and Administrative Review]",14,0,1,0,15
1191236,841672,2019-04-10,Assembly,"Do pass and be re-referred to the Committee on [Appropriations] with recommendation: To Consent Calendar",7,0,0,0,7
1191236,894510,2019-04-10,Assembly,03/11/19,14,0,0,0,14
1191250,893036,2019-07-11,Assembly,"Be adopted. To third reading",11,0,1,0,12
1191250,893037,2019-08-30,Senate,"Special Consent ACR22",37,0,3,0,40
1191264,843728,2019-04-09,Assembly,"Do pass as amended and be re-referred to the Committee on [Health]",20,0,0,0,20
1191278,851508,2019-04-24,Assembly,"Do pass and be re-referred to the Committee on [Appropriations] with recommendation: To Consent Calendar",7,0,0,0,7
1191278,865802,2019-05-16,Assembly,"Do pass",18,0,0,0,18
1191278,870149,2019-05-22,Assembly,"AB 372 Voepel Assembly Third Reading",77,0,3,0,80
1191278,884819,2019-06-19,Senate,"Do pass, but first be re-referred to the Committee on [Appropriations] with the recommendation: To Consent Calendar",5,0,0,0,5
1191278,889255,2019-07-01,Senate,"Placed on suspense file",7,0,0,0,7
1191278,891574,2019-08-30,Senate,"Do pass",7,0,0,0,7
1191278,891575,2019-09-09,Senate,"Special Consent AB372",40,0,0,0,40
1191306,850516,2019-04-22,Assembly,"Do pass and be re-referred to the Committee on [Appropriations]",9,0,3,0,12
1191306,865669,2019-05-16,Assembly,"Do pass as amended",13,4,1,0,18
1191306,873889,2019-05-28,Assembly,"AB 376 Mark Stone Assembly Third Reading",59,15,6,0,80
1191306,884783,2019-06-19,Senate,"Do pass as amended, but first amend, and re-refer to the Committee on [Judiciary]",4,1,2,0,7
1191306,892130,2019-07-09,Senate,"Do pass, but first be re-referred to the Committee on [Appropriations]",7,1,1,0,9
1191306,892131,2019-08-12,Senate,"Placed on suspense file",7,0,0,0,7
1191306,976376,2020-08-20,Senate,"Do pass as amended",5,2,0,0,7
1191306,977323,2020-08-28,Senate,"Assembly 3rd Reading AB376 Mark Stone et al. By Mitchell",29,9,2,0,40
1191306,978121,2020-08-30,Assembly,"AB 376 Mark Stone Concurrence in Senate Amendments",57,15,7,0,79
1191334,849048,2019-04-09,Assembly,"Do pass as amended and be re-referred to the Committee on [Appropriations]",15,0,0,0,15
1191348,828019,2019-03-19,Assembly,"Do pass as amended and be re-referred to the Committee on [Appropriations]",15,0,0,0,15
1191348,866633,2019-05-16,Assembly,"Do pass as amended",18,0,0,0,18
1191348,871477,2019-05-23,Assembly,"AB 388 Limón Assembly Third Reading",78,0,2,0,80
1191348,884563,2019-06-19,Senate,"Do pass as amended, but first amend, and re-refer to the Committee on [Appropriations] with the recommendation: To Consent Calendar",9,0,0,0,9
1191348,893073,2019-07-08,Senate,"Placed on suspense file",7,0,0,0,7
1191362,841347,2019-04-09,Assembly,"Do pass and be re-referred to the Committee on [Appropriations]",10,0,1,0,11
1191362,866213,2019-05-16,Assembly,"Do pass",18,0,0,0,18
1191362,871462,2019-05-23,Assembly,"AB 368 Quirk-Silva Assembly Third Reading",76,0,4,0,80
1191362,887930,2019-06-25,Senate,"Do pass, but first be re-referred to the Committee on [Appropriations]",5,0,2,0,7
1191362,893449,2019-07-08,Senate,"Placed on suspense file",7,0,0,0,7
1191362,893450,2019-08-30,Senate,"Do pass as amended",5,0,2,0,7
1191362,893451,2019-09-10,Senate,"Assembly 3rd Reading AB368 Quirk-Silva et al. By Archuleta",36,0,4,0,40
1191362,893452,2019-09-10,Assembly,"AB 368 QUIRK-SILVA Concurrence in Senate Amendments",79,0,0,0,79
1191376,819759,2019-03-12,Assembly,"Do pass and be re-referred to the Committee on [Appropriations]",14,0,0,0,14
1193486,795567,2019-02-07,Assembly,"Be adopted. To Consent Calendar",11,0,0,0,11
1193486,801950,2019-02-15,Assembly,"ACR 23 Lackey Consent Calendar Second Day",64,0,16,0,80
1193486,817302,2019-03-07,Senate,"Special Consent ACR23",37,0,1,0,38
1194041,833043,2019-03-25,Assembly,"Do pass as amended and be re-referred to the Committee on [Appropriations]",10,1,0,0,11
1194041,841719,2019-04-10,Assembly,"Do pass",17,0,1,0,18
1194041,848953,2019-04-22,Assembly,"AB 394 Obernolte Assembly Third Reading",73,1,6,0,80
1194041,878544,2019-06-05,Senate,"Do pass as amended, but first amend, and re-refer to the Committee on [Natural Resources and Water]",4,0,3,0,7
1194041,893001,2019-07-09,Senate,"Do pass as amended, but first amend, and re-refer to the Committee on [Appropriations]",8,0,1,0,9
1194041,893002,2019-08-26,Senate,"Placed on suspense file",6,0,1,0,7
1194041,893003,2019-08-30,Senate,"Do pass",7,0,0,0,7
1194041,893004,2019-09-10,Senate,"Assembly 3rd Reading AB394 Obernolte et al. By Portantino",39,0,1,0,40
1194041,893005,2019-09-11,Assembly,"AB 394 Obernolte Concurrence in Senate Amendments",76,1,2,0,79
1194048,842959,2019-04-10,Assembly,"Do pass and be re-referred to the Committee on [Appropriations] with recommendation: To Consent Calendar",6,0,0,0,6
1194048,851636,2019-04-24,Assembly,"Do pass. To Consent Calendar",18,0,0,0,18
1194048,857944,2019-05-02,Assembly,"AB 398 Chu Consent Calendar Second Day Regular Session",76,0,4,0,80
1194055,851460,2019-04-23,Senate,"Do pass as amended, but first amend, and re-refer to the Committee on [Appropriations] with the recommendation: To Consent Calendar",9,0,0,0,9
1194055,863035,2019-05-13,Senate,"Placed on suspense file",6,0,0,0,6
1194055,865945,2019-05-16,Senate,"Do pass",5,0,1,0,6
1194055,868913,2019-05-21,Senate,"Senate 3rd Reading SB218 Bradford",30,6,2,0,38
1194055,888386,2019-06-26,Assembly,"Do pass and be re-referred to the Committee on [Judiciary]",6,0,1,0,7
1194055,892434,2019-07-09,Assembly,"Do pass as amended and be re-referred to the Committee on [Appropriations]",9,3,0,0,12
1194055,892435,2019-08-30,Assembly,"Do pass as amended",13,4,1,0,18
1194055,893899,2019-09-14,Assembly,"SB 218 Bradford Senate Third Reading By JONES-SAWYER",50,17,12,0,79
1194055,894215,2019-09-13,Senate,"Unfinished Business SB218 Bradford",33,0,0,0,33
1194055,894392,2019-09-14,Senate,"Unfinished Business SB218 Bradford",33,0,7,0,40
1194062,826038,2019-03-19,Assembly,"Do pass as amended, and be re-referred to the Committee on [Appropriations] with recommendation: To Consent Calendar",8,0,0,0,8
1194062,865864,2019-05-16,Assembly,"Do pass as amended",18,0,0,0,18
1194062,871538,2019-05-23,Assembly,"AB 397 Chau Assembly Third Reading",78,0,2,0,80
1194062,891781,2019-07-09,Senate,"Do pass as amended, but first amend, and re-refer to the Committee on [Appropriations]",7,0,0,0,7
1194062,891782,2019-08-12,Senate,"Placed on suspense file",7,0,0,0,7
1194062,891783,2019-08-30,Senate,"Do pass as amended",7,0,0,0,7
1194062,891784,2019-09-05,Senate,"Assembly 3rd Reading AB397 Chau et al. By Bates",40,0,0,0,40
1194062,891785,2019-09-09,Assembly,"AB 397 Chau Concurrence in Senate Amendments",79,0,0,0,79
1194071,841669,2019-04-10,Assembly,"Do pass and be re-referred to the Committee on [Appropriations]",8,0,0,0,8
1194071,866861,2019-05-16,Assembly,"Do pass",18,0,0,0,18
1194071,870188,2019-05-22,Assembly,"AB 393 Nazarian Assembly Third Reading",78,0,2,0,80
1194071,884188,2019-06-18,Senate,"Do pass, but first be re-referred to the Committee on [Appropriations] with the recommendation: To Consent Calendar",11,0,0,0,11
1194071,891931,2019-07-01,Senate,"Placed on suspense file",7,0,0,0,7
1194071,894867,2019-04-10,Assembly,"Asm Housing and C",8,0,0,0,8
1194078,829064,2019-03-25,Assembly,"Be re-referred to the Committee on [Public Safety]",12,0,0,0,12
1194078,850053,2019-04-23,Assembly,"Do pass and be re-referred to the Committee on [Appropriations]",7,0,1,0,8
1194078,861546,2019-05-08,Assembly,"Do pass",18,0,0,0,18
1194078,863235,2019-05-13,Assembly,"AB 391 Voepel Assembly Third Reading",73,1,6,0,80
1194078,883714,2019-06-18,Senate,"Do pass as amended, but first amend, and re-refer to the Committee on [Appropriations]",5,0,2,0,7
1194078,893405,2019-08-30,Senate,"Special Consent AB391",37,0,3,0,40
1194078,893406,2019-09-05,Assembly,"AB 391 Voepel Concurrence in Senate Amendments",77,1,1,0,79
1194086,841496,2019-04-09,Assembly,"Do pass and be re-referred to the Committee on [Rules]",6,2,0,0,8
1194086,874539,2019-05-29,Assembly,"AB 392 Weber Assembly Third Reading",68,0,12,0,80
1194086,883830,2019-06-18,Senate,"Do pass",6,0,1,0,7
1194086,892396,2019-07-08,Senate,"Assembly 3rd Reading AB392 Weber et al. By Mitchell",34,3,3,0,40
1194092,820021,2019-03-12,Assembly,"Do pass and be re-referred to the Committee on [Appropriations]",5,0,4,0,9
1194092,865953,2019-05-16,Assembly,"Do pass",13,1,4,0,18
1194092,870119,2019-05-22,Assembly,"AB 402 Quirk Assembly Third Reading",65,0,15,0,80
1194092,893225,2019-07-03,Senate,"Do pass, but first be re-referred to the Committee on [Appropriations]",5,0,2,0,7
1194092,893226,2019-08-12,Senate,"Placed on suspense file",7,0,0,0,7
1194092,894773,2019-05-16,Assembly,"Asm Appro",13,1,0,0,14
1194108,805257,2019-02-20,Assembly,"Be adopted. To third reading",7,0,0,0,7
1194108,836751,2019-04-04,Senate,"Special Consent ACR25",37,0,1,0,38
1194115,834139,2019-04-02,Assembly,"Do pass and be re-referred to the Committee on [Appropriations]",20,0,0,0,20
1194115,841491,2019-04-10,Assembly,"Do pass. To Consent Calendar",17,0,1,0,18
1194115,852962,2019-04-25,Assembly,"AB 404 Mark Stone Consent Calendar Second Day Regular Session",76,0,4,0,80
1194115,876894,2019-06-03,Senate,"Do pass, but first be re-referred to the Committee on [Appropriations]",9,0,0,0,9
1194115,886977,2019-06-24,Senate,"Placed on suspense file",7,0,0,0,7
1194115,891412,2019-08-30,Senate,"Do pass",7,0,0,0,7
1194115,891413,2019-09-05,Senate,"Assembly 3rd Reading AB404 Mark Stone et al. By Hill",39,0,1,0,40
1194121,836945,2019-04-03,Assembly,"Do pass and be re-referred to the Committee on [Judiciary]",5,1,1,0,7
1194121,850704,2019-04-23,Assembly,"Do pass and be re-referred to the Committee on [Appropriations]",9,3,0,0,12
1194121,866637,2019-05-16,Assembly,"Do pass as amended",13,4,1,0,18
1194121,871588,2019-05-23,Assembly,"AB 403 Kalra Assembly Third Reading",42,27,11,0,80
1194121,892036,2019-07-09,Senate,"Do pass, but first be re-referred to the Committee on [Appropriations]",7,1,1,0,9
1194121,892037,2019-08-12,Senate,"Placed on suspense file",7,0,0,0,7
1194121,892038,2019-08-30,Senate,"Do pass",5,2,0,0,7
1194121,892039,2019-09-09,Senate,"Assembly 3rd Reading AB403 Kalra By Jackson",28,12,0,0,40
1194128,856948,2019-05-01,Senate,"Do pass as amended, but first amend, and re-refer to the Committee on [Appropriations]",9,0,0,0,9
1194128,863176,2019-05-13,Senate,"Placed on suspense file",6,0,0,0,6
1194128,866113,2019-05-16,Senate,"Do pass as amended",6,0,0,0,6
1194128,871077,2019-05-23,Senate,"Senate 3rd Reading SB214 Dodd Urgency Clause",38,0,0,0,38
1194128,891571,2019-07-09,Assembly,"Do pass as amended, and be re-referred to the Committee on [Appropriations] with recommendation: To Consent Calendar",15,0,0,0,15
1194128,976429,2020-08-20,Assembly,"Do pass as amended",13,0,5,0,18
1194128,978180,2020-08-30,Assembly,"SB 214 Dodd Third Reading Urgency By Wood",75,0,4,0,79
1194128,978181,2020-08-31,Senate,"Unfinished Business SB214 Dodd Urgency Clause Concurrence",39,0,1,0,40
1194138,835476,2019-04-03,Senate,"Do pass, but first be re-referred to the Committee on [Transportation] with the recommendation: To Consent Calendar",7,0,0,0,7
1194138,850482,2019-04-23,Senate,"Do pass, but first be re-referred to the Committee on [Appropriations] with the recommendation: To Consent Calendar",12,0,0,0,12
1194138,859433,2019-05-06,Senate,"Placed on suspense file",5,0,1,0,6
1194138,865894,2019-05-16,Senate,"Do pass",6,0,0,0,6
1194138,871037,2019-05-23,Senate,"Special Consent SB216",38,0,0,0,38
1194138,889292,2019-07-01,Assembly,"Do pass and be re-referred to the Committee on [Natural Resources] with recommendation: To Consent Calendar",15,0,0,0,15
1194138,892300,2019-07-08,Assembly,"Do pass as amended and be re-referred to the Committee on [Appropriations]",11,0,0,0,11
1194138,896111,2019-05-23,Senate,Result,38,0,0,0,38
1194145,832209,2019-03-12,Assembly,"Do pass and be re-referred to the Committee on [Appropriations]",2,5,1,0,8
1194145,832210,2019-03-19,Assembly,Reconsideration,8,0,0,0,8
1194145,902816,2020-01-14,Assembly,"Do pass and be re-referred to the Committee on [Appropriations]",3,5,0,0,8
1194166,825131,2019-03-13,Assembly,"Do pass as amended and be re-referred to the Committee on [Appropriations]",5,0,1,0,6
1194174,841385,2019-04-09,Assembly,"Do pass and be re-referred to the Committee on [Public Safety]",8,0,0,0,8
1194174,850680,2019-04-23,Assembly,"Do pass and be re-referred to the Committee on [Appropriations] with recommendation: To Consent Calendar",8,0,0,0,8
1194181,803977,2019-02-19,Senate,"Senate 3rd Reading SR16 Rubio et al",34,0,4,0,38
1194188,806280,2019-02-21,Assembly,"Be adopted. To third reading",12,0,0,0,12
1194188,818965,2019-03-11,Senate,"Special Consent ACR24",37,0,1,0,38
1194201,841763,2019-04-10,Senate,"Do pass, but first be re-referred to the Committee on [Appropriations]",7,0,0,0,7
1194201,854380,2019-04-29,Senate,"Placed on suspense file",6,0,0,0,6
1194201,866251,2019-05-16,Senate,"Do pass as amended",6,0,0,0,6
1194201,871351,2019-05-23,Senate,"Senate 3rd Reading SB217 Portantino et al",38,0,0,0,38
1194201,969988,2020-06-29,Assembly,"Be re-referred to the Committee on [Health]",7,0,5,0,12
1196160,839690,2019-04-08,Assembly,"Do pass and be re-referred to the Committee on [Public Safety]",13,1,1,0,15
1196166,819851,2019-03-12,Assembly,"Do pass and be re-referred to the Committee on [Appropriations] with recommendation: To Consent Calendar",8,0,0,0,8
1196166,865833,2019-05-16,Assembly,"Do pass",18,0,0,0,18
1196166,873964,2019-05-28,Assembly,"AB 425 Cooley Third Reading Urgency By IRWIN",76,0,4,0,80
1196166,887418,2019-06-25,Senate,"Do pass, but first be re-referred to the Committee on [Appropriations] with the recommendation: To Consent Calendar",7,0,0,0,7
1196166,891629,2019-07-08,Senate,"Placed on suspense file",7,0,0,0,7
1196169,839779,2019-04-08,Assembly,"Do pass and be re-referred to the Committee on [Appropriations]",8,2,1,0,11
1196169,866146,2019-05-16,Assembly,"Do pass as amended",14,3,1,0,18
1196169,873827,2019-05-28,Assembly,"AB 423 Gloria Assembly Third Reading",56,14,10,0,80
1196169,888079,2019-06-26,Senate,"Do pass, but first be re-referred to the Committee on [Environmental Quality]",5,0,2,0,7
1196169,891542,2019-07-03,Senate,"Do pass as amended, but first amend, and re-refer to the Committee on [Appropriations]",5,2,0,0,7
1196169,891543,2019-08-19,Senate,"Placed on suspense file",5,0,2,0,7
1196169,891544,2019-08-30,Senate,"Do pass as amended",5,2,0,0,7
1196169,891545,2019-09-11,Senate,"Assembly 3rd Reading AB423 Gloria By McGuire",29,11,0,0,40
1196169,893724,2019-09-12,Assembly,"AB 423 Gloria Concurrence in Senate Amendments",63,14,2,0,79
1196174,821326,2019-03-13,Assembly,"Do pass and be re-referred to the Committee on [Appropriations]",6,0,0,0,6
1196174,865566,2019-05-16,Assembly,"Do pass",18,0,0,0,18
1196174,873880,2019-05-28,Assembly,"AB 428 Medina Assembly Third Reading",76,0,4,0,80
1196174,881101,2019-06-12,Senate,"Do pass, but first be re-referred to the Committee on [Appropriations]",7,0,0,0,7
1196174,887049,2019-06-24,Senate,"Placed on suspense file",7,0,0,0,7
1196179,840295,2019-04-08,Senate,"Do pass, but first be re-referred to the Committee on [Appropriations] with the recommendation: To Consent Calendar",6,0,0,0,6
1196179,849792,2019-04-22,Senate,"Placed on suspense file",6,0,0,0,6
1196179,866416,2019-05-16,Senate,"Do pass as amended",6,0,0,0,6
1196179,870961,2019-05-23,Senate,"Senate 3rd Reading SB219 Wilk et al",38,0,0,0,38
1196179,893828,2019-07-02,Assembly,"Do pass as amended and be re-referred to the Committee on [Appropriations]",8,0,0,0,8
1196184,860803,2019-05-06,Assembly,"Do pass and be re-referred to the Committee on [Appropriations]",9,0,2,0,11
1196188,826025,2019-03-20,Senate,"Do pass, but first be re-referred to the Committee on [Judiciary]",6,0,1,0,7
1196188,829301,2019-03-26,Senate,"Do pass",7,1,0,0,8
1196188,831350,2019-03-28,Senate,"Senate 3rd Reading SB223 Hill et al",29,4,5,0,38
1196188,886019,2019-06-19,Assembly,"Do pass and be re-referred to the Committee on [Judiciary]",5,2,0,0,7
1196188,887520,2019-06-25,Assembly,"Do pass as amended",7,3,2,0,12
1196188,891171,2019-08-26,Assembly,"SB 223 Hill Senate Third Reading By Smith",43,22,14,0,79
1196188,891172,2019-08-30,Senate,"Unfinished Business SB223 Hill et al. Concurrence",28,7,5,0,40
1196188,894820,2019-08-26,Assembly,06/25/19,7,22,0,0,29
1196191,841820,2019-04-09,Assembly,"Do pass as amended and be re-referred to the Committee on [Business and Professions]",14,1,0,0,15
1196191,850583,2019-04-23,Assembly,"Do pass and be re-referred to the Committee on [Appropriations]",20,0,0,0,20
1196191,861986,2019-05-08,Assembly,"Do pass",18,0,0,0,18
1196191,868072,2019-05-20,Assembly,"AB 407 Santiago Assembly Third Reading",74,2,4,0,80
1196191,887107,2019-06-24,Senate,"Do pass as amended, but first amend, and re-refer to the Committee on [Appropriations]",8,1,0,0,9
1196191,890607,2019-08-12,Senate,"Placed on suspense file",7,0,0,0,7
1196197,842763,2019-04-09,Senate,"Do pass as amended",5,2,0,0,7
1196197,858098,2019-05-02,Senate,"Senate 3rd Reading SB233 Wiener et al",28,10,0,0,38
1196197,880443,2019-06-11,Assembly,"Do pass as amended",8,0,0,0,8
1196197,889242,2019-07-01,Assembly,"SB 233 Wiener Senate Third Reading By Kamlager-Dove",54,13,12,0,79
1196197,892256,2019-07-08,Senate,"Unfinished Business SB233 Wiener et al. Concurrence",30,9,1,0,40
1196203,831802,2019-03-27,Assembly,"Do pass and be re-referred to the Committee on [Appropriations] with recommendation: To Consent Calendar",10,0,1,0,11
1196203,867037,2019-05-16,Assembly,"Do pass",18,0,0,0,18
1196203,870275,2019-05-22,Assembly,"AB 419 AGRI. Assembly Third Reading By EGGMAN",78,0,2,0,80
1196203,894184,2019-07-02,Senate,"Do pass, but first be re-referred to the Committee on [Appropriations]",5,0,0,0,5
1196203,894185,2019-08-12,Senate,"Do pass",7,0,0,0,7
1196203,894186,2019-08-22,Senate,"Special Consent AB419 AGRI",39,0,1,0,40
1196203,894187,2019-08-26,Assembly,"AB 419 AGRI. Concurrence in Senate Amendments By EGGMAN",77,0,2,0,79
1196210,830465,2019-03-27,Senate,"Do pass, but first be re-referred to the Committee on [Judiciary]",4,0,1,0,5
1196210,841472,2019-04-09,Senate,"Do pass, but first be re-referred to the Committee on [Appropriations]",7,0,1,0,8
1196210,852875,2019-04-25,Senate,"Senate 3rd Reading SB229 Hertzberg",31,6,1,0,38
1196210,881026,2019-06-12,Assembly,"Do pass and be re-referred to the Committee on [Judiciary]",5,0,2,0,7
1196210,887544,2019-06-25,Assembly,"Do pass and be re-referred to the Committee on [Appropriations]",9,2,1,0,12
1196210,892451,2019-08-21,Assembly,"Do pass",13,4,1,0,18
1196210,892452,2019-09-03,Assembly,"SB 229 Hertzberg Senate Third Reading By Carrillo",58,13,8,0,79
1196210,892453,2019-09-04,Senate,"Unfinished Business SB229 Hertzberg Concurrence",31,9,0,0,40
1196215,819814,2019-03-12,Assembly,"Do pass",11,0,1,0,12
1196215,822281,2019-03-14,Assembly,"AB 424 Gabriel Assembly Third Reading",72,0,8,0,80
1196219,841668,2019-04-09,Assembly,"Do pass and be re-referred to the Committee on [Appropriations]",11,1,3,0,15
1196219,866126,2019-05-16,Assembly,"Do pass as amended",13,5,0,0,18
1196219,874601,2019-05-29,Assembly,"AB 414 Bonta Assembly Third Reading",55,18,7,0,80
1196219,890745,2019-07-10,Senate,"Do pass as amended, but first amend, and re-refer to the Committee on [Appropriations]",7,1,1,0,9
1196219,890746,2019-07-10,Senate,"Do pass, but first be re-referred to the Committee on [Health] with the recommendation: To Consent Calendar",7,0,0,0,7
1196219,890747,2019-09-09,Senate,"Assembly 3rd Reading AB414 Bonta By Pan",37,1,2,0,40
1196219,890748,2019-09-11,Assembly,"With recommendation: That Senate amendments be concurred in",13,0,2,0,15
1196219,893772,2019-09-12,Assembly,"AB 414 Bonta Concurrence in Senate Amendments",71,0,8,0,79
1196225,841741,2019-04-09,Senate,"Do pass, but first be re-referred to the Committee on [Appropriations]",7,0,1,0,8
1196225,859554,2019-05-06,Senate,"Senate 3rd Reading SB222 Hill et al",33,1,4,0,38
1196225,890775,2019-07-02,Assembly,"Do pass and be re-referred to the Committee on [Appropriations]",11,0,1,0,12
1196225,890776,2019-08-14,Assembly,"Do pass",17,0,1,0,18
1196225,893964,2019-09-13,Assembly,"SB 222 Hill Senate Third Reading By Gloria",76,0,3,0,79
1196225,894196,2019-09-13,Senate,"Unfinished Business SB222 Hill",36,0,0,0,36
1196225,894361,2019-09-14,Senate,"Unfinished Business SB222 Hill",36,0,4,0,40
1196229,830517,2019-03-27,Assembly,"Do pass and be re-referred to the Committee on [Local Government]",6,0,2,0,8
1196229,835335,2019-04-03,Assembly,"Do pass and be re-referred to the Committee on [Appropriations]",8,0,0,0,8
1196229,865774,2019-05-16,Assembly,"Do pass",14,0,4,0,18
1196229,869905,2019-05-22,Assembly,"AB 411 Mark Stone Assembly Third Reading",72,0,8,0,80
1196229,881059,2019-06-12,Senate,"Do pass, but first be re-referred to the Committee on [Housing]",5,1,1,0,7
1196229,892116,2019-07-02,Senate,"Do pass, but first be re-referred to the Committee on [Appropriations]",8,1,2,0,11
1196229,892117,2019-08-12,Senate,"Placed on suspense file",7,0,0,0,7
1196229,892118,2019-08-30,Senate,"Do pass",5,1,1,0,7
1196229,892119,2019-09-11,Senate,"Assembly 3rd Reading AB411 Mark Stone By Monning",30,9,1,0,40
1196229,893651,2019-09-12,Assembly,"AB 411 Mark Stone Concurrence in Senate Amendments",72,0,7,0,79
1196241,829653,2019-03-25,Assembly,"Do pass and be re-referred to the Committee on [Veterans Affairs]",14,0,1,0,15
1196241,841981,2019-04-09,Assembly,"Do pass and be re-referred to the Committee on [Appropriations]",10,0,1,0,11
1196241,905356,2020-01-23,Assembly,"Do pass as amended",18,0,0,0,18
1196241,906374,2020-01-27,Assembly,"AB 408 Frazier Assembly Third Reading",78,0,2,0,80
1196241,974824,2020-08-04,Senate,"Do pass, but first be re-referred to the Committee on [Appropriations] with the recommendation: To Consent Calendar",14,0,1,0,15
1196241,977279,2020-08-28,Senate,"Consent Calendar AB408",39,0,1,0,40
1196246,851721,2019-04-24,Assembly,"Do pass and be re-referred to the Committee on [Appropriations] with recommendation: To Consent Calendar",14,0,0,0,14
1196246,866378,2019-05-16,Assembly,"Do pass",18,0,0,0,18
1196246,871493,2019-05-23,Assembly,"AB 406 Limón Assembly Third Reading",77,0,3,0,80
1196246,884693,2019-06-19,Senate,"Do pass as amended, but first amend, and re-refer to the Committee on [Appropriations] with the recommendation: To Consent Calendar",5,0,0,0,5
1196246,889287,2019-07-01,Senate,"Placed on suspense file",7,0,0,0,7
1196246,891146,2019-08-30,Senate,"Do pass",7,0,0,0,7
1196246,891147,2019-09-09,Senate,"Special Consent AB406",40,0,0,0,40
1196246,891148,2019-09-10,Assembly,"AB 406 Limón Concurrence in Senate Amendments",79,0,0,0,79
1196246,894398,2019-08-30,Senate,Result,7,0,0,0,7
1196250,851489,2019-04-22,Senate,"Do pass as amended, but first amend, and re-refer to the Committee on [Appropriations] with the recommendation: To Consent Calendar",6,0,0,0,6
1196250,863255,2019-05-13,Senate,"Placed on suspense file",6,0,0,0,6
1196250,865721,2019-05-16,Senate,"Do pass",6,0,0,0,6
1196250,871530,2019-05-23,Senate,"Special Consent SB228",38,0,0,0,38
1196250,887748,2019-06-25,Assembly,"Do pass and be re-referred to the Committee on [Human Services]",7,0,0,0,7
1196250,892651,2019-07-02,Assembly,"Do pass and be re-referred to the Committee on [Appropriations] with recommendation: To Consent Calendar",8,0,0,0,8
1196250,892652,2019-08-30,Assembly,"Do pass as amended",18,0,0,0,18
1196250,892653,2019-09-09,Assembly,"SB 228 Jackson Senate Third Reading By Reyes",79,0,0,0,79
1196250,892654,2019-09-10,Senate,"Unfinished Business SB228 Jackson et al. Concurrence",40,0,0,0,40
1196256,819898,2019-03-12,Assembly,"Do pass",8,3,1,0,12
1196256,848940,2019-04-22,Assembly,"AB 418 Kalra Assembly Third Reading",53,23,4,0,80
1196256,889188,2019-03-12,Assembly,Noes:,0,3,1,0,4
1196256,891882,2019-07-02,Senate,"Do pass",7,2,0,0,9
1196261,860919,2019-05-06,Assembly,"Do pass and be re-referred to the Committee on [Appropriations]",10,0,1,0,11
1196266,826958,2019-03-12,Assembly,"Do pass as amended and be re-referred to the Committee on [Appropriations]",6,0,2,0,8
1196266,866452,2019-05-16,Assembly,"Do pass as amended",15,0,3,0,18
1196266,871688,2019-05-23,Assembly,"AB 426 Maienschein Assembly Third Reading",71,0,9,0,80
1196266,892610,2019-07-08,Senate,"Do pass as amended, but first amend, and re-refer to the Committee on [Appropriations]",6,0,0,0,6
1196266,892611,2019-08-12,Senate,"Placed on suspense file",7,0,0,0,7
1196266,892612,2019-08-30,Senate,"Do pass as amended",5,1,1,0,7
1196266,892613,2019-09-04,Senate,"Assembly 3rd Reading AB426 Maienschein By Wiener",39,0,1,0,40
1196266,892614,2019-09-09,Assembly,"AB 426 Maienschein Concurrence in Senate Amendments",74,0,5,0,79
1196266,895045,2019-08-12,Senate,Result,6,0,0,0,6
1196272,820164,2019-03-11,Senate,"Do pass, but first be re-referred to the Committee on [Judiciary]",6,0,0,0,6
1196272,835584,2019-04-02,Senate,"Do pass as amended, but first amend, and re-refer to the Committee on [Appropriations] with the recommendation: To Consent Calendar",8,0,0,0,8
1196272,859445,2019-05-06,Senate,"Senate 3rd Reading SB234 Skinner",38,0,0,0,38
1196272,883986,2019-06-18,Assembly,"Do pass and be re-referred to the Committee on [Judiciary] with recommendation: To Consent Calendar",8,0,0,0,8
1196272,887597,2019-06-25,Assembly,"Do pass and be re-referred to the Committee on [Appropriations] with recommendation: To Consent Calendar",12,0,0,0,12
1196272,892736,2019-08-14,Assembly,"Do pass",18,0,0,0,18
1196272,892737,2019-08-19,Assembly,"SB 234 Skinner Senate Third Reading By BAUER-KAHAN",77,0,2,0,79
1196272,892738,2019-08-22,Senate,"Unfinished Business SB234 Skinner Concurrence",39,0,1,0,40
1196278,838574,2019-04-02,Senate,"Do pass as amended, but first amend, and re-refer to the Committee on [Appropriations]",7,0,0,0,7
1196278,858228,2019-05-02,Senate,"Senate 3rd Reading SB224 Grove et al",37,1,0,0,38
1196278,880272,2019-06-11,Assembly,"Do pass and be re-referred to the Committee on [Appropriations]",7,0,1,0,8
1196278,888058,2019-06-26,Assembly,"Do pass",15,0,3,0,18
1196278,889305,2019-07-01,Assembly,"SB 224 Grove Senate Third Reading By PATTERSON",71,0,8,0,79
1196281,829281,2019-03-26,Assembly,"Do pass and be re-referred to the Committee on [Appropriations]",20,0,0,0,20
1196281,835210,2019-04-03,Assembly,"Do pass. To Consent Calendar",17,0,1,0,18
1196281,842757,2019-04-11,Assembly,"AB 420 Lackey Consent Calendar Second Day Regular Session",72,0,8,0,80
1196281,877030,2019-06-03,Senate,"Do pass as amended, but first amend, and re-refer to the Committee on [Appropriations]",9,0,0,0,9
1196281,890517,2019-08-12,Senate,"Placed on suspense file",7,0,0,0,7
1196281,890518,2019-08-30,Senate,"Do pass",7,0,0,0,7
1196281,890519,2019-09-05,Senate,"Assembly 3rd Reading AB420 Lackey et al. By Hertzberg Urgency Clause",39,0,1,0,40
1196281,890520,2019-09-09,Assembly,"AB 420 Lackey Concurrence in Senate Amendments",79,0,0,0,79
1196288,820822,2019-03-12,Assembly,"Do pass and be re-referred to the Committee on [Appropriations]",5,1,3,0,9
1196292,842712,2019-04-10,Assembly,"Do pass and be re-referred to the Committee on [Public Safety]",5,1,0,0,6
1196292,850292,2019-04-23,Assembly,"Do pass",7,0,1,0,8
1196292,862263,2019-05-09,Assembly,"AB 413 Jones-Sawyer Assembly Third Reading",65,4,11,0,80
1196292,878558,2019-06-05,Senate,"Do pass, but first be re-referred to the Committee on [Public Safety]",6,0,1,0,7
1196292,883705,2019-06-18,Senate,"Do pass",4,0,3,0,7
1196292,892630,2019-08-19,Senate,"Assembly 3rd Reading AB413 Jones-Sawyer et al. By Bradford",34,2,4,0,40
1196292,892631,2019-08-26,Assembly,"AB 413 Jones-Sawyer Concurrence in Senate Amendments",66,4,9,0,79
1196295,850422,2019-04-22,Assembly,"Do pass and be re-referred to the Committee on [Appropriations]",10,1,0,0,11
1196300,842816,2019-04-10,Senate,"Do pass, but first be re-referred to the Committee on [Appropriations]",6,2,1,0,9
1196300,862105,2019-05-09,Senate,"Senate 3rd Reading SB227 Leyva et al",22,13,3,0,38
1196300,887407,2019-06-25,Assembly,"Do pass as amended and be re-referred to the Committee on [Appropriations]",10,3,2,0,15
1196300,891600,2019-07-10,Assembly,"Do pass",12,3,3,0,18
1196300,891601,2019-09-03,Assembly,"SB 227 Leyva Senate Third Reading By Smith",53,17,9,0,79
1196300,891602,2019-09-04,Senate,"Unfinished Business SB227 Leyva et al. Concurrence",25,10,5,0,40
1196305,834231,2019-04-02,Senate,"Do pass, but first be re-referred to the Committee on [Appropriations]",5,2,0,0,7
1196305,858191,2019-05-02,Senate,"Senate 3rd Reading SB220 Hill et al",26,10,2,0,38
1196305,880307,2019-06-11,Assembly,"Do pass and be re-referred to the Committee on [Appropriations]",6,2,0,0,8
1196305,884736,2019-06-19,Assembly,"Do pass",12,5,1,0,18
1196309,819926,2019-03-12,Assembly,"Do pass and be re-referred to the Committee on [Appropriations] with recommendation: To Consent Calendar",8,0,0,0,8
1196309,865906,2019-05-16,Assembly,"Do pass",17,1,0,0,18
1196309,870167,2019-05-22,Assembly,"AB 415 Maienschein Assembly Third Reading",73,0,7,0,80
1196309,883904,2019-06-18,Senate,"Do pass, but first be re-referred to the Committee on [Appropriations] with the recommendation: To Consent Calendar",7,0,0,0,7
1196309,891478,2019-07-01,Senate,"Placed on suspense file",7,0,0,0,7
1196309,891479,2019-08-30,Senate,"Do pass",7,0,0,0,7
1196309,891480,2019-09-10,Senate,"Assembly 3rd Reading AB415 Maienschein et al. By Beall",40,0,0,0,40
1196309,891481,2019-09-11,Assembly,"AB 415 Maienschein Concurrence in Senate Amendments",77,0,2,0,79
1196313,854805,2019-04-22,Assembly,"Do pass as amended and be re-referred to the Committee on [Appropriations]",9,1,1,0,11
1196313,864770,2019-05-15,Assembly,"Do pass",16,0,2,0,18
1196313,867703,2019-05-20,Assembly,"AB 430 Gallagher Assembly Third Reading",70,1,9,0,80
1196313,884073,2019-06-18,Senate,"Do pass as amended, but first amend, and re-refer to the Committee on [Environmental Quality]",10,0,1,0,11
1196313,892891,2019-07-03,Senate,"Do pass as amended, but first amend, and re-refer to the Committee on [Governance and Finance]",5,1,1,0,7
1196313,892892,2019-07-10,Senate,"Do pass as amended, but first amend, and re-refer to the Committee on [Appropriations]",7,0,0,0,7
1196313,892893,2019-09-03,Senate,"Assembly 3rd Reading AB430 Gallagher et al. By Nielsen",33,1,6,0,40
1196313,892894,2019-09-05,Assembly,"AB 430 Gallagher Concurrence in Senate Amendments",78,1,0,0,79
1196317,831978,2019-03-27,Assembly,"Do pass and be re-referred to the Committee on [Appropriations]",10,0,1,0,11
1196317,866337,2019-05-16,Assembly,"Do pass as amended",18,0,0,0,18
1196317,873952,2019-05-28,Assembly,"AB 417 Arambula Assembly Third Reading",73,0,7,0,80
1196317,884129,2019-06-18,Senate,"Do pass, but first be re-referred to the Committee on [Appropriations] with the recommendation: To Consent Calendar",5,0,0,0,5
1196317,892164,2019-07-01,Senate,"Placed on suspense file",7,0,0,0,7
1196317,892165,2019-08-30,Senate,"Do pass",7,0,0,0,7
1196317,892166,2019-09-09,Senate,"Special Consent AB417",40,0,0,0,40
1196321,840928,2019-04-09,Senate,"Do pass, but first be re-referred to the Committee on [Rules]",8,0,1,0,9
1196321,852081,2019-04-24,Senate,"Do pass as amended, but first amend, and re-refer to the Committee on [Appropriations]",6,0,1,0,7
1196321,863252,2019-05-13,Senate,"Placed on suspense file",6,0,0,0,6
1196321,866332,2019-05-16,Senate,"Do pass as amended",6,0,0,0,6
1196321,871364,2019-05-23,Senate,"Senate 3rd Reading SB226 Nielsen",38,0,0,0,38
1196321,887191,2019-06-24,Assembly,"Do pass as amended and be re-referred to the Committee on [Water, Parks, and Wildlife]",10,0,1,0,11
1196321,893199,2019-07-02,Assembly,"Do pass as amended and be re-referred to the Committee on [Appropriations]",13,0,1,0,14
1196321,894523,2019-05-16,Senate,Result,6,0,0,0,6
1196325,829633,2019-03-25,Assembly,"Do pass and be re-referred to the Committee on [Appropriations]",14,0,1,0,15
1196325,842510,2019-04-10,Assembly,"Do pass. To Consent Calendar",17,0,1,0,18
1196325,853307,2019-04-25,Assembly,"AB 422 Frazier Consent Calendar Second Day Regular Session",76,0,4,0,80
1196330,831569,2019-03-25,Assembly,"Do pass as amended and be re-referred to the Committee on [Appropriations]",11,0,0,0,11
1196330,866044,2019-05-16,Assembly,"Do pass",18,0,0,0,18
1196330,871559,2019-05-23,Assembly,"AB 409 Limón Assembly Third Reading",76,0,4,0,80
1196330,887412,2019-06-25,Senate,"Do pass as amended, but first amend, and re-refer to the Committee on [Agriculture]",9,0,0,0,9
1196330,893416,2019-07-02,Senate,"Do pass, but first be re-referred to the Committee on [Appropriations] with the recommendation: To Consent Calendar",5,0,0,0,5
1196330,893417,2019-08-19,Senate,"Placed on suspense file",5,0,2,0,7
1196334,854349,2019-04-23,Senate,"Do pass as amended, but first amend, and re-refer to the Committee on [Appropriations]",7,0,0,0,7
1196334,863058,2019-05-13,Senate,"Placed on suspense file",6,0,0,0,6
1196334,866394,2019-05-16,Senate,"Do pass",6,0,0,0,6
1196334,873894,2019-05-28,Senate,"Senate 3rd Reading SB230 Caballero et al",38,0,0,0,38
1196334,887606,2019-06-25,Assembly,"Do pass as amended and be re-referred to the Committee on [Appropriations]",8,0,0,0,8
1196334,890704,2019-08-30,Assembly,"Do pass as amended",18,0,0,0,18
1196334,890705,2019-09-09,Assembly,"SB 230 Caballero Senate Third Reading By Gipson",79,0,0,0,79
1196334,890706,2019-09-11,Senate,"Unfinished Business SB230 Caballero et al. Concurrence",40,0,0,0,40
1196338,826676,2019-03-20,Senate,"Do pass as amended",7,0,0,0,7
1196338,836762,2019-04-04,Senate,"Senate 3rd Reading SB232 Dodd et al",37,0,1,0,38
1196338,877700,2019-06-04,Assembly,"Do pass. To Consent Calendar",8,0,1,0,9
1196338,879794,2019-06-10,Assembly,"SB 232 Dodd Consent Calendar Second Day Regular Session",75,0,5,0,80
1196338,891236,2019-09-03,Assembly,"SB 232 Dodd Senate Third Reading By Cristina Garcia",77,0,2,0,79
1196338,891237,2019-09-04,Senate,"Unfinished Business SB232 Dodd et al. Concurrence",40,0,0,0,40
1196344,836854,2019-04-03,Assembly,"Do pass and be re-referred to the Committee on [Appropriations]",20,0,1,0,21
1196344,866745,2019-05-16,Assembly,"Do pass",18,0,0,0,18
1196344,869962,2019-05-22,Assembly,"AB 429 Nazarian Assembly Third Reading",77,1,2,0,80
1196344,880865,2019-06-11,Senate,"Do pass, but first be re-referred to the Committee on [Appropriations]",14,0,2,0,16
1196344,889298,2019-07-01,Senate,"Placed on suspense file",7,0,0,0,7
1196344,893524,2019-08-30,Senate,"Do pass as amended",7,0,0,0,7
1196349,829140,2019-03-26,Senate,"Do pass",7,1,0,0,8
1196349,836601,2019-04-04,Senate,"Senate 3rd Reading SB225 Durazo",28,9,1,0,38
1196349,877593,2019-06-04,Assembly,"Do pass",7,2,3,0,12
1196349,891533,2019-09-09,Assembly,"SB 225 Durazo Senate Third Reading By Chiu",51,21,7,0,79
1196352,834149,2019-04-02,Senate,"Do pass, but first be re-referred to the Committee on [Appropriations] with the recommendation: To Consent Calendar",6,0,1,0,7
1196352,848879,2019-04-22,Senate,"Placed on suspense file",6,0,0,0,6
1196365,834227,2019-04-01,Assembly,"Do pass and be re-referred to the Committee on [Appropriations] with recommendation: To Consent Calendar",12,0,0,0,12
1196365,841665,2019-04-10,Assembly,"Do pass. To Consent Calendar",17,0,1,0,18
1196365,853630,2019-04-25,Assembly,"AB 412 Quirk-Silva Consent Calendar Second Day Regular Session",76,0,4,0,80
1196365,878393,2019-06-05,Senate,"Do pass, but first be re-referred to the Committee on [Appropriations]",7,0,0,0,7
1196365,893518,2019-08-26,Senate,"Assembly 3rd Reading AB412 Quirk-Silva et al. By Caballero",39,0,1,0,40
1196365,893519,2019-08-30,Assembly,"AB 412 Quirk-Silva Concurrence in Senate Amendments",75,0,4,0,79
1199482,852877,2019-04-24,Assembly,"Do pass as amended and be re-referred to the Committee on [Appropriations]",7,1,0,0,8
1199482,866010,2019-05-16,Assembly,"Do pass",14,4,0,0,18
1199482,873854,2019-05-28,Assembly,"AB 437 Wood Assembly Third Reading",58,16,6,0,80
1199482,892108,2019-07-02,Senate,"Do pass, but first be re-referred to the Committee on [Appropriations]",9,1,1,0,11
1199482,892109,2019-08-12,Senate,"Placed on suspense file",7,0,0,0,7
1199489,853611,2019-04-24,Assembly,"Do pass as amended and be re-referred to the Committee on [Appropriations]",8,0,0,0,8
1199489,866009,2019-05-16,Assembly,"Do pass as amended",18,0,0,0,18
1199489,874618,2019-05-29,Assembly,"AB 434 Daly Assembly Third Reading",77,0,3,0,80
1199489,893933,2019-04-24,Assembly,"Asm Housing and Community Development",8,0,0,0,8
1199489,974965,2020-08-06,Senate,"Do pass, but first be re-referred to the Committee on [Appropriations]",11,0,0,0,11
1199489,976029,2020-08-17,Senate,"Placed on suspense file",7,0,0,0,7
1199489,976329,2020-08-20,Senate,"Do pass as amended",7,0,0,0,7
1199489,977482,2020-08-31,Assembly,"With recommendation: That Senate amendments be concurred in",8,0,0,0,8
1199489,977923,2020-08-30,Senate,"Assembly 3rd Reading AB434 Daly By Skinner",39,0,1,0,40
1199489,977924,2020-08-31,Assembly,"AB 434 DALY Concurrence in Senate Amendments",75,0,4,0,79
1199491,824942,2019-03-19,Assembly,"Do pass and be re-referred to the Committee on [Human Services] with recommendation: To Consent Calendar",8,0,0,0,8
1199491,839764,2019-04-09,Assembly,"Do pass. To Consent Calendar",8,0,0,0,8
1199491,852670,2019-04-25,Assembly,"AB 439 Mark Stone Consent Calendar Second Day Regular Session",76,0,4,0,80
1199491,880337,2019-06-11,Senate,"Do pass, but first be re-referred to the Committee on [Human Services] with the recommendation: To Consent Calendar",7,0,0,0,7
1199491,887502,2019-06-24,Senate,"Do pass",6,0,0,0,6
1199491,892596,2019-07-11,Senate,"Special Consent AB439 Mark Stone Urgency Clause",39,0,1,0,40
1199498,840199,2019-04-09,Assembly,"Do pass as amended and be re-referred to the Committee on [Education]",8,0,0,0,8
1199498,853094,2019-04-24,Assembly,"Do pass as amended and be re-referred to the Committee on [Appropriations]",7,0,0,0,7
1199498,865788,2019-05-16,Assembly,"Do pass",18,0,0,0,18
1199498,873849,2019-05-28,Assembly,"AB 452 Mullin Assembly Third Reading",74,0,6,0,80
1199503,853298,2019-04-24,Senate,"Do pass, but first be re-referred to the Committee on [Appropriations]",7,3,3,0,13
1199503,863223,2019-05-13,Senate,"Placed on suspense file",6,0,0,0,6
1199503,905384,2020-01-23,Senate,"Do pass",7,0,0,0,7
1199503,906427,2020-01-27,Senate,"Senate 3rd Reading SB254 Hertzberg",39,0,0,0,39
1199506,826442,2019-03-20,Assembly,"Do pass and be re-referred to the Committee on [Appropriations]",5,0,2,0,7
1199506,841745,2019-04-10,Assembly,"Do pass",12,0,6,0,18
1199506,853689,2019-04-25,Assembly,"AB 457 Quirk Assembly Third Reading",59,9,12,0,80
1199506,881196,2019-06-12,Senate,"Do pass, but first be re-referred to the Committee on [Appropriations]",4,1,0,0,5
1199509,856904,2019-05-01,Senate,"Do pass, but first be re-referred to the Committee on [Appropriations]",6,0,1,0,7
1199509,863051,2019-05-13,Senate,"Placed on suspense file",6,0,0,0,6
1199509,865964,2019-05-16,Senate,"Do pass as amended",6,0,0,0,6
1199509,873838,2019-05-28,Senate,"Senate 3rd Reading SB248 Glazer et al",37,0,1,0,38
1199509,893059,2019-07-08,Assembly,"Do pass and be re-referred to the Committee on [Appropriations]",9,1,1,0,11
1199509,894786,2019-05-13,Senate,Result,6,0,0,0,6
1199512,835212,2019-04-02,Senate,"Do pass, but first be re-referred to the Committee on [Appropriations]",10,0,1,0,11
1199512,852820,2019-04-25,Senate,"Senate 3rd Reading SB235 Dodd",36,0,2,0,38
1199512,884562,2019-06-19,Assembly,"Do pass and be re-referred to the Committee on [Local Government]",8,0,0,0,8
1199512,892702,2019-07-03,Assembly,"Do pass and be re-referred to the Committee on [Appropriations]",7,0,1,0,8
1199512,892703,2019-08-14,Assembly,"Do pass",18,0,0,0,18
1199512,893950,2019-09-13,Assembly,"SB 235 Dodd Senate Third Reading By Aguiar-Curry",79,0,0,0,79
1199512,894182,2019-09-13,Senate,"Unfinished Business SB235 Dodd",40,0,0,0,40
1199515,841667,2019-04-10,Assembly,"Do pass and be re-referred to the Committee on [Appropriations]",6,0,1,0,7
1199515,851218,2019-04-24,Assembly,"Do pass",18,0,0,0,18
1199515,854841,2019-04-29,Assembly,"AB 467 Boerner Horvath Assembly Third Reading",74,0,6,0,80
1199515,880375,2019-06-11,Senate,"Do pass, but first be re-referred to the Committee on [Appropriations]",7,0,2,0,9
1199515,893180,2019-08-19,Senate,"Assembly 3rd Reading AB467 Boerner Horvath et a By Leyva",37,0,3,0,40
1199515,893181,2019-08-22,Assembly,"AB 467 Boerner Horvath Concurrence in Senate Amendments",72,0,7,0,79
1199519,830458,2019-03-26,Assembly,"Do pass and be re-referred to the Committee on [Appropriations]",15,0,0,0,15
1199519,835042,2019-04-03,Assembly,"Do pass",17,0,1,0,18
1199519,871465,2019-05-23,Assembly,"AB 451 Arambula Assembly Third Reading",78,0,2,0,80
1199519,888014,2019-06-26,Senate,"Do pass as amended, but first amend, and re-refer to the Committee on [Appropriations]",9,0,0,0,9
1199527,835285,2019-04-03,Assembly,"Do pass and be re-referred to the Committee on [Appropriations]",7,0,0,0,7
1199527,849040,2019-04-22,Assembly,"AB 462 Rodriguez Assembly Third Reading",75,0,5,0,80
1199534,830410,2019-03-27,Assembly,"Do pass and be re-referred to the Committee on [Appropriations]",6,0,1,0,7
1199534,842395,2019-04-10,Assembly,"Do pass. To Consent Calendar",17,0,1,0,18
1199534,852720,2019-04-25,Assembly,"AB 456 Chiu Consent Calendar Second Day Regular Session",76,0,4,0,80
1199534,880349,2019-06-11,Senate,"Do pass, but first be re-referred to the Committee on [Appropriations] with the recommendation: To Consent Calendar",9,0,0,0,9
1199534,887061,2019-06-24,Senate,"Placed on suspense file",7,0,0,0,7
1199534,893515,2019-08-30,Senate,"Do pass as amended",7,0,0,0,7
1199534,893516,2019-09-04,Senate,"Assembly 3rd Reading AB456 Chiu et al. By Beall",40,0,0,0,40
1199534,893517,2019-09-09,Assembly,"AB 456 Chiu Concurrence in Senate Amendments",79,0,0,0,79
1199536,890893,2019-07-08,Assembly,"Be adopted. To third reading",7,3,1,0,11
1199536,890894,2019-09-03,Assembly,"AJR 7 Gloria Assembly Third Reading",50,15,14,0,79
1199539,845540,2019-04-10,Senate,"Do pass and be ordered to the Consent Calendar",7,0,0,0,7
1199539,853116,2019-04-25,Senate,"Consent Calendar SB251 B. & F.I. (Bradford)",37,0,1,0,38
1199539,886924,2019-06-24,Assembly,"Do pass. To Consent Calendar",12,0,0,0,12
1199539,889233,2019-07-01,Assembly,"SB 251 B. & F.I. Consent Calendar Second Day",77,0,2,0,79
1199539,892859,2019-07-11,Senate,"Special Consent SB251 B. & F.I",39,0,1,0,40
1199551,830968,2019-03-27,Assembly,"Do pass and be re-referred to the Committee on [Appropriations] with recommendation: To Consent Calendar",7,0,0,0,7
1199551,835004,2019-04-03,Assembly,"Do pass",17,0,1,0,18
1199551,853511,2019-04-25,Assembly,"AB 469 Petrie-Norris Assembly Third Reading",75,0,5,0,80
1199551,880681,2019-06-11,Senate,"Do pass, but first be re-referred to the Committee on [Appropriations]",14,0,2,0,16
1199551,891980,2019-07-01,Senate,"Placed on suspense file",7,0,0,0,7
1199551,891981,2019-08-30,Senate,"Do pass",7,0,0,0,7
1199551,891982,2019-09-04,Senate,"Assembly 3rd Reading AB469 Petrie-Norris By Glazer",40,0,0,0,40
1199551,891983,2019-09-09,Assembly,"AB 469 Petrie-Norris Concurrence in Senate Amendments",79,0,0,0,79
1199557,841604,2019-04-09,Assembly,"Do pass and be re-referred to the Committee on [Appropriations] with recommendation: To Consent Calendar",8,0,0,0,8
1199557,851644,2019-04-24,Assembly,"Do pass. To Consent Calendar",18,0,0,0,18
1199557,857950,2019-05-02,Assembly,"AB 447 Patterson Consent Calendar Second Day Regular Session",76,0,4,0,80
1199557,880308,2019-06-10,Senate,"Do pass, but first be re-referred to the Committee on [Appropriations]",5,0,1,0,6
1199557,889248,2019-07-01,Senate,"Placed on suspense file",7,0,0,0,7
1199560,829794,2019-03-26,Assembly,"Do pass and be re-referred to the Committee on [Appropriations]",8,3,3,0,14
1199560,866120,2019-05-16,Assembly,"Do pass as amended",13,5,0,0,18
1199560,871195,2019-05-23,Assembly,"AB 454 Kalra Assembly Third Reading",55,21,4,0,80
1199560,893182,2019-07-09,Senate,"Do pass, but first be re-referred to the Committee on [Appropriations]",6,1,2,0,9
1199560,893183,2019-09-03,Senate,"Assembly 3rd Reading AB454 Kalra By Skinner",29,9,2,0,40
1199564,826064,2019-03-19,Assembly,"Do pass and be re-referred to the Committee on [Appropriations]",11,1,0,0,12
1199564,865838,2019-05-16,Assembly,"Do pass",15,3,0,0,18
1199564,869985,2019-05-22,Assembly,"AB 463 Cervantes Assembly Third Reading",62,12,6,0,80
1199564,891548,2019-07-03,Senate,"Do pass, but first be re-referred to the Committee on [Appropriations]",7,0,0,0,7
1199564,891549,2019-08-12,Senate,"Placed on suspense file",7,0,0,0,7
1199564,891550,2019-08-30,Senate,"Do pass",5,2,0,0,7
1199564,891551,2019-09-05,Senate,"Assembly 3rd Reading AB463 Cervantes By McGuire",30,10,0,0,40
1199568,840127,2019-04-09,Assembly,"Do pass as amended and be re-referred to the Committee on [Appropriations]",20,0,0,0,20
1199568,851228,2019-04-24,Assembly,"Do pass. To Consent Calendar",18,0,0,0,18
1199568,858205,2019-05-02,Assembly,"AB 458 Nazarian Consent Calendar Second Day Regular Session",76,0,4,0,80
1199568,879812,2019-06-10,Senate,"Do pass, but first be re-referred to the Committee on [Appropriations]",9,0,0,0,9
1199568,892240,2019-07-08,Senate,"Do pass",7,0,0,0,7
1199568,892241,2019-09-03,Senate,"Assembly 3rd Reading AB458 Nazarian et al. By Glazer",40,0,0,0,40
1199568,892242,2019-09-05,Assembly,"AB 458 Nazarian Concurrence in Senate Amendments",78,1,0,0,79
1199568,896131,2019-09-03,Senate,"Assembly 3rd Reading AB458 Nazarian et al. By Gl>",7,0,0,0,7
1199572,825150,2019-03-19,Assembly,"Do pass and be re-referred to the Committee on [Human Services] with recommendation: To Consent Calendar",12,0,0,0,12
1199572,840380,2019-04-09,Assembly,"Do pass. To Consent Calendar",8,0,0,0,8
1199572,852901,2019-04-25,Assembly,"AB 465 Eggman Consent Calendar Second Day Regular Session",76,0,4,0,80
1199572,880940,2019-06-10,Senate,"Do pass, but first be re-referred to the Committee on [Judiciary]",5,0,1,0,6
1199572,884745,2019-06-18,Senate,"Do pass and be ordered to the Consent Calendar",9,0,0,0,9
1199572,890382,2019-09-11,Senate,"Do pass, but first be re-referred to the Committee on [Judiciary]",6,0,1,0,7
1199572,890383,2019-09-11,Senate,"Do pass",8,0,1,0,9
1199572,974629,2020-07-31,Senate,"Do pass and be ordered to the Consent Calendar",7,0,0,0,7
1199572,976612,2020-08-24,Senate,"Assembly 3rd Reading AB465 Eggman et al. By Rubio",40,0,0,0,40
1199572,977783,2020-08-31,Assembly,"AB 465 EGGMAN Concurrence in Senate Amendments",76,0,3,0,79
1199580,829366,2019-03-26,Assembly,"Do pass as amended and be re-referred to the Committee on [Appropriations]",11,1,2,0,14
1199583,902228,2020-01-13,Assembly,"Do pass and be re-referred to the Committee on [Appropriations]",11,0,0,0,11
1199583,905360,2020-01-23,Assembly,"Do pass",18,0,0,0,18
1199583,906412,2020-01-27,Assembly,"AB 464 Cristina Garcia Assembly Third Reading",78,0,2,0,80
1199586,835163,2019-04-03,Senate,"Do pass, but first be re-referred to the Committee on [Appropriations] with the recommendation: To Consent Calendar",6,0,1,0,7
1199586,853180,2019-04-25,Senate,"Consent Calendar SB242",37,0,1,0,38
1199586,884585,2019-06-19,Assembly,"Do pass and be re-referred to the Committee on [Appropriations] with recommendation: To Consent Calendar",8,0,0,0,8
1199586,888095,2019-06-26,Assembly,"Do pass. To Consent Calendar",15,0,3,0,18
1199586,893495,2019-07-05,Assembly,"SB 242 Roth Consent Calendar Second Day Regular Session",70,0,9,0,79
1199588,826781,2019-03-20,Assembly,"Do pass and be re-referred to the Committee on [Appropriations]",18,0,3,0,21
1199588,835084,2019-04-03,Assembly,"Do pass. To Consent Calendar",17,0,1,0,18
1199588,842884,2019-04-11,Assembly,"AB 436 Aguiar-Curry Consent Calendar Second Day Regular Session",72,0,8,0,80
1199588,887551,2019-06-25,Senate,"Do pass, but first be re-referred to the Committee on [Appropriations]",16,0,0,0,16
1199588,892536,2019-08-12,Senate,"Assembly 3rd Reading AB436 Aguiar-Curry et al. By Dodd",39,0,1,0,40
1199588,892537,2019-08-15,Assembly,"AB 436 Aguiar-Curry Concurrence in Senate Amendments",76,0,3,0,79
1199591,852727,2019-04-24,Senate,"Do pass as amended, but first amend, and re-refer to the Committee on [Appropriations]",7,0,0,0,7
1199591,863032,2019-05-13,Senate,"Placed on suspense file",6,0,0,0,6
1199594,829110,2019-03-26,Assembly,"Do pass and be re-referred to the Committee on [Appropriations]",14,0,0,0,14
1199598,829123,2019-03-25,Assembly,"Do pass and be re-referred to the Committee on [Appropriations]",11,0,0,0,11
1199600,829188,2019-03-25,Assembly,"Do pass and be re-referred to the Committee on [Appropriations]",14,0,1,0,15
1199600,866392,2019-05-16,Assembly,"Do pass",18,0,0,0,18
1199600,871665,2019-05-23,Assembly,"AB 449 Gallagher Assembly Third Reading",78,0,2,0,80
1199600,890526,2019-07-09,Senate,"Do pass, but first be re-referred to the Committee on [Appropriations]",12,1,0,0,13
1199600,890527,2019-08-12,Senate,"Placed on suspense file",7,0,0,0,7
1199600,890528,2019-08-30,Senate,"Do pass",7,0,0,0,7
1199600,890529,2019-09-04,Senate,"Assembly 3rd Reading AB449 Gallagher et al. By Nielsen",39,1,0,0,40
1199604,841677,2019-04-10,Assembly,"Do pass and be re-referred to the Committee on [Judiciary]",8,0,0,0,8
1199604,850514,2019-04-23,Assembly,"Do pass and be re-referred to the Committee on [Appropriations] with recommendation: To Consent Calendar",12,0,0,0,12
1199604,861541,2019-05-08,Assembly,"Do pass. To Consent Calendar",18,0,0,0,18
1199604,866182,2019-05-16,Assembly,"AB 446 Choi Consent Calendar Second Day Regular Session",74,0,6,0,80
1199607,841353,2019-04-10,Senate,"Do pass, but first be re-referred to the Committee on [Natural Resources and Water]",11,1,1,0,13
1199607,850622,2019-04-23,Senate,"Do pass as amended, but first amend, and re-refer to the Committee on [Appropriations]",9,0,0,0,9
1199607,863263,2019-05-13,Senate,"Placed on suspense file",6,0,0,0,6
1199607,866131,2019-05-16,Senate,"Do pass",6,0,0,0,6
1199607,868766,2019-05-21,Senate,"Senate 3rd Reading SB247 Dodd",37,0,1,0,38
1199607,888222,2019-06-26,Assembly,"Do pass as amended and be re-referred to the Committee on [Natural Resources]",14,0,1,0,15
1199607,892721,2019-07-08,Assembly,"Do pass as amended and be re-referred to the Committee on [Appropriations]",11,0,0,0,11
1199607,892722,2019-08-30,Assembly,"Do pass as amended",18,0,0,0,18
1199607,892723,2019-09-09,Assembly,"SB 247 Dodd Senate Third Reading By Wood",77,0,2,0,79
1199607,892724,2019-09-11,Senate,"Unfinished Business SB247 Dodd Concurrence",40,0,0,0,40
1199608,836885,2019-04-02,Assembly,"Do pass as amended and be re-referred to the Committee on [Accountability and Administrative Review]",11,0,0,0,11
1199608,852056,2019-04-24,Assembly,"Do pass and be re-referred to the Committee on [Appropriations]",4,0,3,0,7
1199612,839771,2019-04-09,Senate,"Do pass, but first be re-referred to the Committee on [Appropriations]",16,0,0,0,16
1199612,849457,2019-04-22,Senate,"Placed on suspense file",6,0,0,0,6
1199612,865600,2019-05-16,Senate,"Do pass as amended",6,0,0,0,6
1199612,868778,2019-05-21,Senate,"Senate 3rd Reading SB237 Hertzberg",38,0,0,0,38
1199612,888075,2019-06-25,Assembly,"Do pass and be re-referred to the Committee on [Accountability and Administrative Review]",12,0,0,0,12
1199612,890681,2019-07-03,Assembly,"Do pass and be re-referred to the Committee on [Appropriations] with recommendation: To Consent Calendar",7,0,0,0,7
1199615,825153,2019-03-19,Assembly,"Do pass and be re-referred to the Committee on [Appropriations]",12,0,0,0,12
1199615,834817,2019-04-03,Assembly,"Do pass. To Consent Calendar",17,0,1,0,18
1199615,843574,2019-04-11,Assembly,"AB 473 Maienschein Consent Calendar Second Day Regular Session",72,0,8,0,80
1199615,878065,2019-06-04,Senate,"Do pass, but first be re-referred to the Committee on [Appropriations] with the recommendation: To Consent Calendar",9,0,0,0,9
1199615,893995,2019-07-01,Senate,"Consent Calendar AB473",39,0,1,0,40
1199615,893996,2019-07-08,Assembly,"AB 473 Maienschein Concurrence in Senate Amendments",77,0,2,0,79
1199615,895780,2019-04-11,Assembly,"Bill Votes",17,0,0,0,17
1199619,855658,2019-04-30,Senate,"Do pass, but first be re-referred to the Committee on [Governance and Finance]",11,0,0,0,11
1199619,857801,2019-05-01,Senate,"Do pass as amended, but first amend, and re-refer to the Committee on [Appropriations]",7,0,0,0,7
1199619,863121,2019-05-13,Senate,"Placed on suspense file",6,0,0,0,6
1199624,851676,2019-04-24,Senate,"Do pass, but first be re-referred to the Committee on [Appropriations]",1,4,0,0,5
1199624,851677,2019-04-24,Senate,"[First] hearing set for [04-24-2019]: Failed passage in Committee. Reconsideration granted",5,0,0,0,5
1199628,830388,2019-03-26,Assembly,"Do pass and be re-referred to the Committee on [Appropriations] with recommendation: To Consent Calendar",8,0,0,0,8
1199629,830335,2019-03-27,Senate,"Do pass as amended, but first amend, and re-refer to the Committee on [Appropriations]",7,0,0,0,7
1199629,858014,2019-05-02,Senate,"Senate 3rd Reading SB249 Nielsen Urgency Clause",38,0,0,0,38
1199629,892982,2019-07-03,Assembly,"Do pass and be re-referred to the Committee on [Appropriations] with recommendation: To Consent Calendar",8,0,0,0,8
1199629,892983,2019-08-14,Assembly,"Do pass",18,0,0,0,18
1199629,892984,2019-09-05,Assembly,"SB 249 Nielsen Third Reading Urgency By Gallagher",79,0,0,0,79
1199629,895394,2019-05-02,Senate,Date,7,0,0,0,7
1199632,836749,2019-03-19,Assembly,"Do pass and be re-referred to the Committee on [Appropriations]",3,5,0,0,8
1199636,831522,2019-03-27,Assembly,"Do pass and be re-referred to the Committee on [Appropriations]",10,0,1,0,11
1199636,841691,2019-04-10,Assembly,"Do pass. To Consent Calendar",17,0,1,0,18
1199636,852923,2019-04-25,Assembly,"AB 450 Irwin Consent Calendar Second Day Regular Session",76,0,4,0,80
1199636,883890,2019-06-18,Senate,"Do pass as amended, but first amend, and re-refer to the Committee on [Appropriations]",5,0,0,0,5
1199636,892305,2019-08-26,Senate,"Assembly 3rd Reading AB450 Arambula et al. By Hurtado",39,0,1,0,40
1199636,892306,2019-08-30,Assembly,"AB 450 Arambula Concurrence in Senate Amendments",75,0,4,0,79
1199636,894218,2019-04-25,Assembly,"Bill Votes",17,0,0,0,17
1199636,894571,2019-04-10,Assembly,03/27/19,10,0,0,0,10
1199639,839944,2019-04-09,Senate,"Do pass, but first be re-referred to the Committee on [Appropriations] with the recommendation: To Consent Calendar",7,0,0,0,7
1199639,848928,2019-04-22,Senate,"Placed on suspense file",6,0,0,0,6
1199639,866410,2019-05-16,Senate,"Do pass",6,0,0,0,6
1199639,871442,2019-05-23,Senate,"Special Consent SB239",38,0,0,0,38
1199639,887448,2019-06-25,Assembly,"Do pass. To Consent Calendar",8,0,0,0,8
1199639,895037,2019-05-23,Senate,Date,6,0,0,0,6
1199642,853300,2019-04-24,Senate,"Do pass as amended, but first amend, and re-refer to the Committee on [Appropriations]",13,0,0,0,13
1199642,863461,2019-05-13,Senate,"Do pass",6,0,0,0,6
1199642,867720,2019-05-20,Senate,"Senate 3rd Reading SB240 Dodd",38,0,0,0,38
1199642,890856,2019-07-10,Assembly,"Do pass as amended, and be re-referred to the Committee on [Appropriations] with recommendation: To Consent Calendar",14,0,0,0,14
1199642,890857,2019-08-14,Assembly,"Do pass",18,0,0,0,18
1199642,890858,2019-08-22,Assembly,"SB 240 Dodd Third Reading Urgency By Daly",75,0,4,0,79
1199642,890859,2019-08-30,Senate,"Special Consent SB240 Dodd Urgency Clause",37,0,3,0,40
1199645,835251,2019-04-02,Assembly,"Do pass as amended, and be re-referred to the Committee on [Appropriations] with recommendation: To Consent Calendar",15,0,0,0,15
1199645,852622,2019-04-24,Assembly,"Do pass. To Consent Calendar",18,0,0,0,18
1199645,858185,2019-05-02,Assembly,"AB 453 Chau Consent Calendar Second Day Regular Session",76,0,4,0,80
1199645,878605,2019-06-05,Senate,"Do pass, but first be re-referred to the Committee on [Appropriations] with the recommendation: To Consent Calendar",9,0,0,0,9
1199645,889249,2019-07-01,Senate,"Consent Calendar AB453",39,0,1,0,40
1199650,833186,2019-03-26,Assembly,"Do pass as amended and be re-referred to the Committee on [Appropriations]",7,1,0,0,8
1199650,841766,2019-04-10,Assembly,"Do pass",17,0,1,0,18
1199650,862086,2019-05-09,Assembly,"AB 433 Ramos Assembly Third Reading",73,1,6,0,80
1199650,887620,2019-06-25,Senate,"Do pass, but first be re-referred to the Committee on [Appropriations]",7,0,0,0,7
1199650,891104,2019-09-03,Senate,"Assembly 3rd Reading AB433 Ramos By Archuleta",40,0,0,0,40
1199653,828446,2019-03-25,Senate,"Do pass, but first be re-referred to the Committee on [Veterans Affairs]",9,0,0,0,9
1199653,839862,2019-04-09,Senate,"Do pass, but first be re-referred to the Committee on [Appropriations]",7,0,0,0,7
1199653,862152,2019-05-09,Senate,"Senate 3rd Reading SB245 Chang et al",37,1,0,0,38
1199653,887668,2019-06-25,Assembly,"Do pass and be re-referred to the Committee on [Appropriations]",19,0,0,0,19
1199653,894060,2019-07-03,Assembly,"Do pass. To Consent Calendar",17,0,1,0,18
1199653,894061,2019-07-11,Assembly,"SB 245 Chang Consent Calendar Second Day Regular Session",76,0,3,0,79
1199653,894062,2019-08-15,Senate,"Unfinished Business SB245 Chang et al. Concurrence",37,0,3,0,40
1199660,886091,2019-06-19,Assembly,"Be adopted and re-referred to the Committee on [Appropriations]",4,1,2,0,7
1199660,890394,2019-08-14,Assembly,"Be adopted",13,4,1,0,18
1199660,890395,2019-08-26,Assembly,"ACA 8 Low Assembly Third Reading",57,16,6,0,79
1199666,825013,2019-03-19,Senate,"Do pass, but first be re-referred to the Committee on [Natural Resources and Water]",4,0,0,0,4
1199666,850290,2019-04-23,Senate,"Do pass as amended, but first amend, and re-refer to the Committee on [Appropriations]",9,0,0,0,9
1199666,863110,2019-05-13,Senate,"Placed on suspense file",6,0,0,0,6
1199666,866068,2019-05-16,Senate,"Do pass",6,0,0,0,6
1199666,871090,2019-05-23,Senate,"Special Consent SB253",38,0,0,0,38
1199666,886947,2019-06-24,Assembly,"Do pass and be re-referred to the Committee on [Agriculture]",11,0,0,0,11
1199666,891569,2019-07-03,Assembly,"Do pass as amended and be re-referred to the Committee on [Appropriations]",10,0,1,0,11
1199669,832203,2019-03-27,Assembly,"Do pass and be re-referred to the Committee on [Appropriations] with recommendation: To Consent Calendar",10,0,1,0,11
1199669,866458,2019-05-16,Assembly,"Do pass",18,0,0,0,18
1199669,873806,2019-05-28,Assembly,"AB 466 AGRI. Assembly Third Reading By EGGMAN",76,0,4,0,80
1199669,891974,2019-07-02,Senate,"Do pass, but first be re-referred to the Committee on [Appropriations] with the recommendation: To Consent Calendar",5,0,0,0,5
1199669,891975,2019-08-26,Senate,"Consent Calendar AB466 AGRI. (Eggman) By Caballero",39,0,1,0,40
1199669,891976,2019-09-05,Assembly,"AB 466 AGRI. Concurrence in Senate Amendments By EGGMAN",78,0,1,0,79
1200902,834177,2019-04-02,Senate,"Do pass, but first be re-referred to the Committee on [Appropriations] with the recommendation: To Consent Calendar",6,0,1,0,7
1200902,848970,2019-04-22,Senate,"Placed on suspense file",6,0,0,0,6
1200902,866204,2019-05-16,Senate,"Do pass as amended",6,0,0,0,6
1200902,873734,2019-05-28,Senate,"Senate 3rd Reading SB269 Bradford et al",38,0,0,0,38
1200902,892711,2019-07-09,Assembly,"Do pass as amended, and be re-referred to the Committee on [Appropriations] with recommendation: To Consent Calendar",8,0,0,0,8
1200902,892712,2019-08-30,Assembly,"Do pass as amended",18,0,0,0,18
1200902,892713,2019-09-09,Assembly,"SB 269 Bradford Senate Third Reading By Weber",79,0,0,0,79
1200902,892714,2019-09-10,Senate,"Unfinished Business SB269 Bradford et al. Concurrence",40,0,0,0,40
1200904,839973,2019-04-03,Senate,"Do pass as amended, but first amend, and re-refer to the Committee on [Appropriations]",7,0,0,0,7
1200904,854822,2019-04-29,Senate,"Placed on suspense file",6,0,0,0,6
1200904,865885,2019-05-16,Senate,"Do pass as amended",6,0,0,0,6
1200904,868780,2019-05-21,Senate,"Senate 3rd Reading SB265 Hertzberg et al. Urgency Clause",38,0,0,0,38
1200904,886509,2019-06-19,Assembly,"Do pass and be re-referred to the Committee on [Appropriations]",7,0,0,0,7
1200904,893539,2019-08-30,Assembly,"Do pass as amended",18,0,0,0,18
1200904,893540,2019-09-09,Assembly,"SB 265 Hertzberg Third Reading Urgency By McCarty",79,0,0,0,79
1200904,893541,2019-09-10,Senate,"Unfinished Business SB265 Hertzberg et al. Urgency Clause Concurrence",40,0,0,0,40
1200907,825051,2019-03-19,Assembly,"Do pass",6,2,0,0,8
1200907,848896,2019-04-22,Assembly,"AB 484 Jones-Sawyer Assembly Third Reading",45,28,7,0,80
1200907,877691,2019-06-04,Senate,"Do pass",5,1,1,0,7
1200907,891628,2019-09-11,Senate,"Assembly 3rd Reading AB484 Jones-Sawyer By Wiener",25,15,0,0,40
1200909,834271,2019-04-02,Assembly,"Do pass. To Consent Calendar",20,0,0,0,20
1200909,863157,2019-05-13,Assembly,"AB 496 Low Assembly Third Reading",74,0,6,0,80
1200909,879891,2019-06-10,Senate,"Do pass and be ordered to the Consent Calendar",9,0,0,0,9
1200909,892881,2019-09-10,Senate,"Assembly 3rd Reading AB496 Low By Glazer",40,0,0,0,40
1200909,892882,2019-09-11,Assembly,"AB 496 Low Concurrence in Senate Amendments",78,0,1,0,79
1200913,840445,2019-04-09,Senate,"Do pass, but first be re-referred to the Committee on [Appropriations] with the recommendation: To Consent Calendar",7,0,0,0,7
1200913,848912,2019-04-22,Senate,"Placed on suspense file",6,0,0,0,6
1200913,865545,2019-05-16,Senate,"Do pass as amended",6,0,0,0,6
1200913,871471,2019-05-23,Senate,"Senate 3rd Reading SB259 Nielsen",38,0,0,0,38
1200913,887579,2019-06-25,Assembly,"Do pass and be re-referred to the Committee on [Appropriations] with recommendation: To Consent Calendar",8,0,0,0,8
1200913,892733,2019-07-10,Assembly,"Do pass. To Consent Calendar",16,0,2,0,18
1200913,892734,2019-08-15,Assembly,"SB 259 Nielsen Consent Calendar Second Day Regular Session",76,0,3,0,79
1200913,892735,2019-08-22,Senate,"Special Consent SB259",39,0,1,0,40
1200917,833477,2019-03-27,Assembly,"Do pass as amended and be re-referred to the Committee on [Appropriations]",5,0,1,0,6
1200917,866342,2019-05-16,Assembly,"Do pass as amended",14,2,2,0,18
1200917,873901,2019-05-28,Assembly,"AB 493 Gloria Assembly Third Reading",61,0,19,0,80
1200917,892151,2019-07-10,Senate,"Do pass, but first be re-referred to the Committee on [Appropriations]",6,0,1,0,7
1200917,892152,2019-08-12,Senate,"Placed on suspense file",7,0,0,0,7
1200917,892153,2019-08-30,Senate,"Do pass",5,1,1,0,7
1200917,892154,2019-09-10,Senate,"Assembly 3rd Reading AB493 Gloria et al. By Wiener",31,0,9,0,40
1200917,892155,2019-09-11,Assembly,"AB 493 Gloria Concurrence in Senate Amendments",64,3,12,0,79
1200920,829584,2019-03-26,Assembly,"Do pass and be re-referred to the Committee on [Appropriations]",17,3,0,0,20
1200920,866195,2019-05-16,Assembly,"Do pass",15,3,0,0,18
1200920,870036,2019-05-22,Assembly,"AB 476 Blanca Rubio Assembly Third Reading",66,10,4,0,80
1200920,883210,2019-06-17,Senate,"Do pass, but first be re-referred to the Committee on [Appropriations]",8,0,1,0,9
1200920,889304,2019-07-01,Senate,"Placed on suspense file",7,0,0,0,7
1200920,892086,2019-08-30,Senate,"Do pass",6,1,0,0,7
1200920,892087,2019-09-10,Senate,"Assembly 3rd Reading AB476 Blanca Rubio By Pan",34,4,2,0,40
1200920,892088,2019-09-11,Assembly,"AB 476 Blanca Rubio Concurrence in Senate Amendments",70,7,2,0,79
1200925,830451,2019-03-27,Senate,"Do pass, but first be re-referred to the Committee on [Appropriations]",4,0,1,0,5
1200925,838474,2019-04-08,Senate,"Placed on suspense file",6,0,0,0,6
1200925,866442,2019-05-16,Senate,"Do pass as amended",4,1,1,0,6
1200925,868847,2019-05-21,Senate,"Senate 3rd Reading SB266 Leyva",31,4,3,0,38
1200925,888146,2019-06-26,Assembly,"Do pass and be re-referred to the Committee on [Appropriations]",7,0,0,0,7
1200925,891938,2019-08-30,Assembly,"Do pass as amended",18,0,0,0,18
1200925,891939,2019-09-11,Assembly,"SB 266 Leyva Senate Third Reading By Cervantes",73,0,6,0,79
1200925,893635,2019-09-12,Senate,"Unfinished Business SB266 Leyva Concurrence",32,7,1,0,40
1200929,829192,2019-03-26,Assembly,"Do pass and be re-referred to the Committee on [Appropriations]",14,0,0,0,14
1200929,866001,2019-05-16,Assembly,"Do pass",18,0,0,0,18
1200929,870145,2019-05-22,Assembly,"AB 489 Mark Stone Assembly Third Reading",78,0,2,0,80
1200929,891238,2019-07-09,Senate,"Do pass, but first be re-referred to the Committee on [Appropriations] with the recommendation: To Consent Calendar",8,0,1,0,9
1200929,891239,2019-08-19,Senate,"Placed on suspense file",5,0,2,0,7
1200929,891240,2019-08-30,Senate,"Do pass",7,0,0,0,7
1200929,891241,2019-09-09,Senate,"Special Consent AB489",40,0,0,0,40
1200929,891242,2019-09-10,Assembly,"AB 489 Mark Stone Concurrence in Senate Amendments",79,0,0,0,79
1200929,895327,2019-08-30,Senate,Result,5,0,0,0,5
1200933,842923,2019-04-10,Assembly,"Do pass and be re-referred to the Committee on [Appropriations]",6,2,0,0,8
1200933,851440,2019-04-24,Assembly,"Do pass",14,4,0,0,18
1200933,858023,2019-05-02,Assembly,"AB 485 Medina Assembly Third Reading",58,17,5,0,80
1200933,888072,2019-06-26,Senate,"Do pass, but first be re-referred to the Committee on [Appropriations]",6,0,1,0,7
1200933,893042,2019-09-03,Senate,"Assembly 3rd Reading AB485 Medina By McGuire",29,11,0,0,40
1200933,893043,2019-09-05,Assembly,"AB 485 Medina Concurrence in Senate Amendments",62,16,1,0,79
1200942,855014,2019-04-24,Assembly,"Do pass as amended and be re-referred to the Committee on [Appropriations]",17,1,3,0,21
1200944,829145,2019-03-26,Senate,"Do pass, but first be re-referred to the Committee on [Appropriations]",15,0,1,0,16
1200944,838347,2019-04-08,Senate,"Placed on suspense file",6,0,0,0,6
1200944,865641,2019-05-16,Senate,"Do pass",6,0,0,0,6
1200944,871142,2019-05-23,Senate,"Special Consent SB264",38,0,0,0,38
1200944,888083,2019-06-26,Assembly,"Do pass and be re-referred to the Committee on [Appropriations]",19,0,2,0,21
1200949,839817,2019-04-09,Senate,"Do pass, but first be re-referred to the Committee on [Appropriations] with the recommendation: To Consent Calendar",7,0,0,0,7
1200949,858272,2019-05-02,Senate,"Consent Calendar SB257",38,0,0,0,38
1200949,880495,2019-06-11,Assembly,"Do pass and be re-referred to the Committee on [Appropriations] with recommendation: To Consent Calendar",8,0,0,0,8
1200955,841840,2019-04-09,Assembly,"Do pass and be re-referred to the Committee on [Appropriations]",14,0,0,0,14
1200955,852291,2019-04-24,Assembly,"Do pass. To Consent Calendar",18,0,0,0,18
1200955,858092,2019-05-02,Assembly,"AB 487 Gallagher Consent Calendar Second Day Regular Session",76,0,4,0,80
1200955,880633,2019-06-11,Senate,"Do pass, but first be re-referred to the Committee on [Appropriations] with the recommendation: To Consent Calendar",8,0,1,0,9
1200955,893892,2019-07-01,Senate,"Consent Calendar AB487",39,0,1,0,40
1200958,840163,2019-04-08,Senate,"Do pass, but first be re-referred to the Committee on [Appropriations]",5,1,0,0,6
1200958,849819,2019-04-22,Senate,"Placed on suspense file",6,0,0,0,6
1200958,865673,2019-05-16,Senate,"Do pass",4,2,0,0,6
1200958,868665,2019-05-21,Senate,"Senate 3rd Reading SB268 Wiener et al",30,6,2,0,38
1200958,885792,2019-06-20,Assembly,"Be re-referred to the Committee on [Elections and Redistricting]",9,0,3,0,12
1200958,891075,2019-07-03,Assembly,"Do pass as amended and be re-referred to the Committee on [Appropriations]",4,1,2,0,7
1200958,891076,2019-08-30,Assembly,"Do pass as amended",12,5,1,0,18
1200958,891077,2019-09-09,Assembly,"SB 268 Wiener Senate Third Reading By Mark Stone",45,25,9,0,79
1200958,893789,2019-09-12,Senate,"That the Assembly amendments be concurred in",4,1,0,0,5
1200958,894201,2019-09-13,Senate,"Unfinished Business SB268 Wiener et al. Concurrence",25,12,3,0,40
1200960,830461,2019-03-26,Assembly,"Do pass and be re-referred to the Committee on [Appropriations]",8,0,0,0,8
1200960,842401,2019-04-10,Assembly,"Do pass",14,0,4,0,18
1200960,849855,2019-04-22,Assembly,"AB 494 Berman Third Reading Urgency",74,0,6,0,80
1200960,880888,2019-06-10,Senate,"Do pass, but first be re-referred to the Committee on [Appropriations] with the recommendation: To Consent Calendar",5,0,1,0,6
1200960,889288,2019-07-01,Senate,"Consent Calendar AB494 Berman Urgency Clause",39,0,1,0,40
1200967,836212,2019-04-03,Senate,"Do pass, but first be re-referred to the Committee on [Appropriations]",8,0,1,0,9
1200967,848870,2019-04-22,Senate,"Placed on suspense file",6,0,0,0,6
1200967,865984,2019-05-16,Senate,"Do pass",4,2,0,0,6
1200967,868777,2019-05-21,Senate,"Senate 3rd Reading SB260 Hurtado",31,3,4,0,38
1200967,887552,2019-06-25,Assembly,"Do pass and be re-referred to the Committee on [Appropriations]",14,0,1,0,15
1200967,891065,2019-08-30,Assembly,"Do pass",16,0,2,0,18
1200967,891066,2019-09-10,Assembly,"SB 260 Hurtado Senate Third Reading By Bonta",76,0,3,0,79
1200967,891067,2019-09-11,Senate,"Unfinished Business SB260 Hurtado Concurrence",32,2,6,0,40
1200970,852992,2019-04-24,Assembly,"Do pass and be re-referred to the Committee on [Appropriations] with recommendation: To Consent Calendar",19,0,2,0,21
1200970,865852,2019-05-16,Assembly,"Do pass",18,0,0,0,18
1200970,870165,2019-05-22,Assembly,"AB 477 Cervantes Assembly Third Reading",78,0,2,0,80
1200970,880351,2019-06-11,Senate,"Do pass, but first be re-referred to the Committee on [Appropriations]",14,0,2,0,16
1200970,891801,2019-08-12,Senate,"Assembly 3rd Reading AB477 Cervantes By Dodd",39,0,1,0,40
1200970,891802,2019-08-15,Assembly,"AB 477 Cervantes Concurrence in Senate Amendments",76,0,3,0,79
1200974,856927,2019-05-01,Senate,"Do pass, but first be re-referred to the Committee on [Appropriations]",7,0,0,0,7
1200974,863212,2019-05-13,Senate,"Placed on suspense file",6,0,0,0,6
1200976,832990,2019-03-27,Senate,"Do pass as amended, but first amend, and re-refer to the Committee on [Appropriations]",12,0,1,0,13
1200976,848972,2019-04-22,Senate,"Placed on suspense file",6,0,0,0,6
1200976,865663,2019-05-16,Senate,"Do pass as amended",6,0,0,0,6
1200976,868916,2019-05-21,Senate,"Senate 3rd Reading SB255 Bradford",38,0,0,0,38
1200976,887901,2019-06-26,Assembly,"Do pass as amended and be re-referred to the Committee on [Appropriations]",13,0,2,0,15
1200976,893501,2019-08-30,Assembly,"Do pass as amended",17,0,1,0,18
1200976,893502,2019-09-09,Assembly,"SB 255 Bradford Senate Third Reading By Eggman",70,0,9,0,79
1200976,893503,2019-09-10,Senate,"Unfinished Business SB255 Bradford Concurrence",40,0,0,0,40
1200980,852313,2019-04-23,Senate,"Do pass, but first be re-referred to the Committee on [Appropriations] with the recommendation: To Consent Calendar",12,0,0,0,12
1200980,862180,2019-05-09,Senate,"Consent Calendar SB267",38,0,0,0,38
1200980,890971,2019-07-01,Assembly,"Do pass and be re-referred to the Committee on [Appropriations] with recommendation: To Consent Calendar",15,0,0,0,15
1200980,890972,2019-08-14,Assembly,"Do pass",18,0,0,0,18
1200980,890973,2019-09-03,Assembly,"SB 267 Wieckowski Senate Third Reading By Fong",77,0,2,0,79
1200980,890974,2019-09-04,Senate,"Unfinished Business SB267 Wieckowski Concurrence",40,0,0,0,40
1200986,835874,2019-03-27,Assembly,"Do pass as amended and be re-referred to the Committee on [Appropriations]",5,0,1,0,6
1200986,865671,2019-05-16,Assembly,"Do pass as amended",14,4,0,0,18
1200986,871443,2019-05-23,Assembly,"AB 479 Nazarian Assembly Third Reading",63,12,5,0,80
1200986,890637,2019-07-03,Senate,"Do pass, but first be re-referred to the Committee on [Appropriations]",7,0,0,0,7
1200992,841375,2019-04-10,Assembly,"Do pass and be re-referred to the Committee on [Appropriations]",8,0,5,0,13
1200992,865944,2019-05-16,Assembly,"Do pass",13,0,5,0,18
1200992,873877,2019-05-28,Assembly,"AB 497 Santiago Third Reading Urgency",66,0,14,0,80
1200992,883965,2019-06-18,Senate,"Do pass, but first be re-referred to the Committee on [Appropriations]",12,0,1,0,13
1200992,889246,2019-07-01,Senate,"Do pass",7,0,0,0,7
1200992,892689,2019-08-26,Senate,"Assembly 3rd Reading AB497 Santiago By Rubio Urgency Clause",38,0,2,0,40
1200992,892690,2019-08-30,Assembly,"AB 497 Santiago Concurrence in Senate Amendments",66,0,13,0,79
1200992,894898,2019-07-01,Senate,Date,12,0,0,0,12
1200996,841825,2019-04-10,Assembly,"Do pass and be re-referred to the Committee on [Appropriations]",13,0,0,0,13
1200996,852279,2019-04-24,Assembly,"Do pass. To Consent Calendar",18,0,0,0,18
1200996,858090,2019-05-02,Assembly,"AB 488 Aguiar-Curry Consent Calendar Second Day Regular Session",76,0,4,0,80
1200996,884537,2019-06-18,Senate,"Do pass, but first be re-referred to the Committee on [Appropriations]",13,0,0,0,13
1200996,893735,2019-08-26,Senate,"Assembly 3rd Reading AB488 Aguiar-Curry et al. By McGuire",39,0,1,0,40
1200996,893736,2019-08-30,Assembly,"AB 488 Aguiar-Curry Concurrence in Senate Amendments",75,0,4,0,79
1201002,902836,2020-01-14,Assembly,"Do pass and be re-referred to the Committee on [Health]",5,0,4,0,9
1201002,903564,2020-01-17,Assembly,"Do pass and be re-referred to the Committee on [Appropriations]",7,0,8,0,15
1201005,830358,2019-03-25,Senate,"Do pass as amended, but first amend, and re-refer to the Committee on [Appropriations]",6,0,0,0,6
1201005,849023,2019-04-22,Senate,"Placed on suspense file",6,0,0,0,6
1201005,865937,2019-05-16,Senate,"Do pass as amended",5,1,0,0,6
1201005,868698,2019-05-21,Senate,"Senate 3rd Reading SB258 Hertzberg et al",37,0,1,0,38
1201005,890882,2019-07-03,Assembly,"Do pass as amended and be re-referred to the Committee on [Appropriations]",8,0,0,0,8
1201008,853136,2019-04-23,Assembly,"Do pass as amended and be re-referred to the Committee on [Appropriations]",7,0,0,0,7
1201012,829478,2019-03-26,Senate,"Do pass, but first be re-referred to the Committee on [Appropriations]",8,1,0,0,9
1201012,838434,2019-04-08,Senate,"Do pass",4,1,1,0,6
1201012,848749,2019-04-22,Senate,"Senate 3rd Reading SB262 McGuire",35,2,1,0,38
1201012,883900,2019-06-18,Assembly,"Do pass and be re-referred to the Committee on [Natural Resources]",13,0,0,0,13
1201012,890590,2019-07-08,Assembly,"Do pass as amended and be re-referred to the Committee on [Appropriations]",11,0,0,0,11
1201012,890591,2019-08-30,Assembly,"Do pass as amended",16,1,1,0,18
1201012,890592,2019-09-11,Assembly,"SB 262 McGuire Senate Third Reading By Mark Stone",77,1,1,0,79
1201012,893792,2019-09-12,Senate,"Unfinished Business SB262 McGuire Concurrence",38,2,0,0,40
1201018,835455,2019-04-02,Assembly,"Do pass and be re-referred to the Committee on [Health]",7,0,0,0,7
1201018,850223,2019-04-23,Assembly,"Do pass and be re-referred to the Committee on [Appropriations]",15,0,0,0,15
1201018,866148,2019-05-16,Assembly,"Do pass",18,0,0,0,18
1201018,870125,2019-05-22,Assembly,"AB 480 Salas Assembly Third Reading",78,0,2,0,80
1201018,880630,2019-06-10,Senate,"Do pass, but first be re-referred to the Committee on [Health]",5,0,1,0,6
1201018,892195,2019-07-03,Senate,"Do pass, but first be re-referred to the Committee on [Appropriations]",8,0,1,0,9
1201018,892196,2019-08-12,Senate,"Placed on suspense file",7,0,0,0,7
1201021,839800,2019-04-03,Assembly,"Do pass as amended and be re-referred to the Committee on [Appropriations]",14,0,1,0,15
1202955,830225,2019-03-26,Assembly,"Do pass as amended. To Consent Calendar",12,0,0,0,12
1202955,836866,2019-04-04,Assembly,"AB 558 Petrie-Norris Consent Calendar Second Day",75,0,5,0,80
1202955,892313,2019-07-02,Senate,"Do pass, but first be re-referred to the Committee on [Veterans Affairs] with the recommendation: To Consent Calendar",9,0,0,0,9
1202955,892314,2019-07-09,Senate,"Do pass",6,0,1,0,7
1202955,892315,2019-08-22,Senate,"Special Consent AB558",39,0,1,0,40
1202955,892316,2019-08-26,Assembly,"AB 558 Petrie-Norris Concurrence in Senate Amendments",76,0,3,0,79
1202956,826001,2019-03-19,Assembly,"Do pass and be re-referred to the Committee on [Appropriations]",11,1,0,0,12
1202959,835939,2019-04-03,Assembly,"Do pass and be re-referred to the Committee on [Appropriations]",5,0,2,0,7
1202959,866206,2019-05-16,Assembly,"Do pass",14,3,1,0,18
1202959,871377,2019-05-23,Assembly,"AB 529 Ramos Assembly Third Reading",67,7,6,0,80
1202959,888330,2019-06-26,Senate,"Do pass, but first be re-referred to the Committee on [Appropriations]",4,0,1,0,5
1202959,892247,2019-07-08,Senate,"Placed on suspense file",7,0,0,0,7
1202959,892248,2019-08-30,Senate,"Do pass",5,2,0,0,7
1202961,831113,2019-03-27,Senate,"Do pass, but first be re-referred to the Committee on [Appropriations] with the recommendation: To Consent Calendar",7,0,0,0,7
1202961,839678,2019-04-08,Senate,"Placed on suspense file",6,0,0,0,6
1202961,866383,2019-05-16,Senate,"Do pass",6,0,0,0,6
1202961,871656,2019-05-23,Senate,"Special Consent SB287",38,0,0,0,38
1202961,885347,2019-06-19,Assembly,"Do pass and be re-referred to the Committee on [Appropriations] with recommendation: To Consent Calendar",8,0,0,0,8
1202961,893415,2019-04-08,Senate,Result,6,0,0,0,6
1202964,840291,2019-04-09,Assembly,"Do pass and be re-referred to the Committee on [Appropriations]",19,0,1,0,20
1202964,851853,2019-04-24,Assembly,"Do pass",18,0,0,0,18
1202964,858091,2019-05-02,Assembly,"AB 528 Low Third Reading Urgency",77,0,3,0,80
1202964,892553,2019-07-01,Senate,"Do pass as amended, but first amend, and re-refer to the Committee on [Rules]",8,0,1,0,9
1202964,892554,2019-08-12,Senate,"Placed on suspense file",7,0,0,0,7
1202964,892555,2019-08-30,Senate,"Do pass",7,0,0,0,7
1202964,892556,2019-09-10,Senate,"Assembly 3rd Reading AB528 Low By Pan",38,1,1,0,40
1202964,893889,2019-09-13,Assembly,"With recommendation: That Senate amendments be concurred in",19,0,0,0,19
1202964,893963,2019-09-13,Assembly,"AB 528 Low Concurrence in Senate Amendments",79,0,0,0,79
1202966,850522,2019-04-22,Assembly,"Do pass and be re-referred to the Committee on [Appropriations]",12,0,3,0,15
1202966,856826,2019-05-01,Assembly,"Do pass. To Consent Calendar",18,0,0,0,18
1202966,863063,2019-05-13,Assembly,"AB 516 Chiu Assembly Third Reading",49,11,20,0,80
1202966,887618,2019-06-25,Senate,"Do pass as amended, but first amend, and re-refer to the Committee on [Public Safety]",9,2,2,0,13
1202966,892754,2019-07-09,Senate,"Do pass, but first be re-referred to the Committee on [Appropriations]",4,2,1,0,7
1202966,892755,2019-08-12,Senate,"Placed on suspense file",7,0,0,0,7
1202969,902227,2020-01-13,Assembly,"Do pass as amended and be re-referred to the Committee on [Appropriations]",7,2,2,0,11
1202971,859642,2019-04-30,Senate,"Do pass as amended",9,0,0,0,9
1202971,863135,2019-05-13,Senate,"Senate 3rd Reading SB274 Dodd",31,5,2,0,38
1202971,890582,2019-07-03,Assembly,"Do pass as amended",8,0,0,0,8
1202971,890583,2019-09-03,Assembly,"SB 274 Dodd Senate Third Reading By Limón",74,0,5,0,79
1202971,890584,2019-09-04,Senate,"Unfinished Business SB274 Dodd et al. Concurrence",40,0,0,0,40
1202975,855977,2019-04-10,Senate,"Do pass as amended, but first amend, and re-refer to the Committee on [Appropriations]",11,0,2,0,13
1202975,863188,2019-05-13,Senate,"Placed on suspense file",6,0,0,0,6
1202975,866297,2019-05-16,Senate,"Do pass as amended",4,2,0,0,6
1202975,871460,2019-05-23,Senate,"Senate 3rd Reading SB288 Wiener et al",38,0,0,0,38
1202975,887028,2019-06-24,Assembly,"Be re-referred to the Committee on [Elections and Redistricting]",12,0,0,0,12
1202975,893267,2019-07-03,Assembly,"Do pass as amended",4,0,3,0,7
1202975,974940,2020-08-06,Assembly,"Do pass as amended and be re-referred to the Committee on [Appropriations]",7,1,3,0,11
1202975,976333,2020-08-20,Assembly,"Do pass",16,2,0,0,18
1202975,977938,2020-08-30,Assembly,"SB 288 Wiener Senate Third Reading By Friedman",65,3,11,0,79
1202975,977939,2020-08-31,Senate,"Unfinished Business SB288 Wiener et al. Concurrence",32,5,3,0,40
1202978,835891,2019-04-03,Assembly,"Do pass and be re-referred to the Committee on [Aging and Long-Term Care]",13,1,0,0,14
1202978,850024,2019-04-23,Assembly,"Do pass and be re-referred to the Committee on [Appropriations]",7,0,0,0,7
1202978,866048,2019-05-16,Assembly,"Do pass",17,1,0,0,18
1202978,869849,2019-05-22,Assembly,"AB 567 Calderon Assembly Third Reading",73,2,5,0,80
1202978,881087,2019-06-12,Senate,"Do pass as amended, but first amend, and re-refer to the Committee on [Health]",9,2,2,0,13
1202978,888143,2019-06-26,Senate,"Do pass, but first be re-referred to the Committee on [Appropriations]",8,1,0,0,9
1202978,892002,2019-07-08,Senate,"Placed on suspense file",7,0,0,0,7
1202978,892003,2019-08-30,Senate,"Do pass",5,1,1,0,7
1202978,892004,2019-09-05,Senate,"Assembly 3rd Reading AB567 Calderon By Archuleta",31,7,2,0,40
1202978,892005,2019-09-09,Assembly,"AB 567 Calderon Concurrence in Senate Amendments",69,7,3,0,79
1202980,852536,2019-04-24,Senate,"Do pass, but first be re-referred to the Committee on [Appropriations]",5,0,0,0,5
1202980,862361,2019-05-09,Senate,"Senate 3rd Reading SB271 Wiener",38,0,0,0,38
1202980,888200,2019-06-26,Assembly,"Do pass and be re-referred to the Committee on [Appropriations] with recommendation: To Consent Calendar",14,0,0,0,14
1202980,894164,2019-07-10,Assembly,"Do pass. To Consent Calendar",16,0,2,0,18
1202980,894165,2019-08-15,Assembly,"SB 271 Wiener Consent Calendar Second Day Regular Session",76,0,3,0,79
1202980,894166,2019-08-22,Senate,"Special Consent SB271",39,0,1,0,40
1202983,835505,2019-04-02,Senate,"Do pass, but first be re-referred to the Committee on [Public Safety]",11,0,0,0,11
1202983,851329,2019-04-23,Senate,"Do pass, but first be re-referred to the Committee on [Appropriations] with the recommendation: To Consent Calendar",7,0,0,0,7
1202983,859602,2019-05-06,Senate,"Placed on suspense file",5,0,1,0,6
1202983,866428,2019-05-16,Senate,"Do pass as amended",6,0,0,0,6
1202983,868842,2019-05-21,Senate,"Senate 3rd Reading SB282 Beall",38,0,0,0,38
1202983,887491,2019-06-25,Assembly,"Do pass and be re-referred to the Committee on [Housing and Community Development]",7,0,1,0,8
1202983,892934,2019-07-03,Assembly,"Do pass and be re-referred to the Committee on [Appropriations]",8,0,0,0,8
1202984,830991,2019-03-26,Assembly,"Do pass and be re-referred to the Committee on [Appropriations] with recommendation: To Consent Calendar",8,0,0,0,8
1202984,866479,2019-05-16,Assembly,"Do pass as amended",18,0,0,0,18
1202984,870925,2019-05-23,Assembly,"AB 531 Friedman Assembly Third Reading",77,0,3,0,80
1202984,887736,2019-06-24,Senate,"Do pass, but first be re-referred to the Committee on [Judiciary] with the recommendation: To Consent Calendar",6,0,0,0,6
1202984,893822,2019-07-09,Senate,"Do pass, but first be re-referred to the Committee on [Appropriations] with the recommendation: To Consent Calendar",8,0,1,0,9
1202984,893823,2019-08-12,Senate,"Placed on suspense file",7,0,0,0,7
1202988,901161,2019-04-01,Assembly,"Do pass and be re-referred to the Committee on [Appropriations]",4,11,0,0,15
1202990,833761,2019-04-01,Senate,"Do pass, but first be re-referred to the Committee on [Appropriations]",9,0,0,0,9
1202990,857973,2019-05-02,Senate,"Senate 3rd Reading SB275 Pan",38,0,0,0,38
1202990,969996,2020-06-29,Assembly,"Be re-referred to the Committee on [Labor and Employment]",7,0,5,0,12
1202990,974306,2020-07-29,Assembly,"Do pass and be re-referred to the Committee on [Appropriations]",6,1,0,0,7
1202990,976447,2020-08-20,Assembly,"Do pass as amended",12,4,2,0,18
1202990,977981,2020-08-31,Senate,"Unfinished Business SB275 Pan et al. Concurrence",31,8,1,0,40
1202990,977982,2020-08-31,Assembly,"SB 275 Pan Senate Third Reading By Gonzalez",66,0,13,0,79
1202994,850424,2019-04-22,Senate,"Do pass, but first be re-referred to the Committee on [Appropriations]",6,0,0,0,6
1202994,859551,2019-05-06,Senate,"Placed on suspense file",5,0,1,0,6
1202994,866402,2019-05-16,Senate,"Do pass as amended",6,0,0,0,6
1202994,868910,2019-05-21,Senate,"Senate 3rd Reading SB285 Wiener et al",38,0,0,0,38
1202994,890777,2019-07-02,Assembly,"Do pass as amended and be re-referred to the Committee on [Appropriations]",7,0,1,0,8
1202994,895350,2019-05-06,Senate,Result,5,0,0,0,5
1202997,825892,2019-03-19,Assembly,"Do pass and be re-referred to the Committee on [Appropriations]",12,0,0,0,12
1202999,833859,2019-04-01,Assembly,"Do pass and be re-referred to the Committee on [Appropriations]",8,3,1,0,12
1202999,866058,2019-05-16,Assembly,"Do pass",13,5,0,0,18
1202999,871162,2019-05-23,Assembly,"AB 539 Limón Assembly Third Reading",60,4,16,0,80
1202999,888128,2019-06-26,Senate,"Do pass as amended, but first amend, and re-refer to the Committee on [Judiciary]",6,0,1,0,7
1202999,891138,2019-07-09,Senate,"Do pass, but first be re-referred to the Committee on [Appropriations]",7,1,1,0,9
1202999,891139,2019-08-19,Senate,"Placed on suspense file",5,0,2,0,7
1202999,891140,2019-08-30,Senate,"Do pass as amended",5,1,1,0,7
1202999,893910,2019-09-13,Assembly,"AB 539 Limón Concurrence in Senate Amendments",61,8,10,0,79
1202999,894195,2019-09-13,Senate,"Assembly 3rd Reading AB539 Limón et al. By Mitchell",30,5,5,0,40
1203002,829400,2019-03-26,Assembly,"Do pass and be re-referred to the Committee on [Appropriations]",12,0,2,0,14
1203002,865825,2019-05-16,Assembly,"Do pass",15,0,3,0,18
1203002,870164,2019-05-22,Assembly,"AB 556 Carrillo Assembly Third Reading",69,2,9,0,80
1203002,880498,2019-06-11,Senate,"Do pass, but first be re-referred to the Committee on [Appropriations]",8,0,1,0,9
1203002,887083,2019-06-24,Senate,"Placed on suspense file",7,0,0,0,7
1203002,891722,2019-08-30,Senate,"Do pass as amended",7,0,0,0,7
1203002,891723,2019-09-05,Senate,"Assembly 3rd Reading AB556 Carrillo et al. By Jones",40,0,0,0,40
1203002,891724,2019-09-09,Assembly,"AB 556 Carrillo Concurrence in Senate Amendments",72,0,7,0,79
1203002,896107,2019-06-24,Senate,Result,8,0,0,0,8
1203003,830532,2019-03-26,Assembly,"Do pass as amended and be re-referred to the Committee on [Appropriations]",15,0,0,0,15
1203003,841374,2019-04-10,Assembly,"Do pass. To Consent Calendar",17,0,1,0,18
1203003,852896,2019-04-25,Assembly,"AB 565 Maienschein Consent Calendar Second Day Regular Session",76,0,4,0,80
1203003,878497,2019-06-05,Senate,"Do pass as amended, but first amend, and re-refer to the Committee on [Appropriations]",9,0,0,0,9
1203003,887081,2019-06-24,Senate,"Placed on suspense file",7,0,0,0,7
1203007,850349,2019-04-22,Assembly,"Do pass and be re-referred to the Committee on [Appropriations]",11,0,0,0,11
1203008,851223,2019-04-23,Assembly,"Do pass and be re-referred to the Committee on [Appropriations]",8,0,0,0,8
1203016,833154,2019-03-26,Assembly,"Do pass as amended and be re-referred to the Committee on [Appropriations]",15,0,0,0,15
1203016,866386,2019-05-16,Assembly,"Do pass as amended",13,0,5,0,18
1203016,871463,2019-05-23,Assembly,"AB 512 Ting Assembly Third Reading",68,2,10,0,80
1203016,892156,2019-07-10,Senate,"Do pass, but first be re-referred to the Committee on [Appropriations]",7,1,1,0,9
1203016,892157,2019-08-12,Senate,"Placed on suspense file",7,0,0,0,7
1203016,892158,2019-08-30,Senate,"Do pass as amended",5,1,1,0,7
1203016,892159,2019-09-04,Senate,"Assembly 3rd Reading AB512 Ting et al. By Hurtado",31,8,1,0,40
1203016,892160,2019-09-09,Assembly,"AB 512 Ting Concurrence in Senate Amendments",72,4,3,0,79
1203020,852950,2019-04-24,Assembly,"Do pass and be re-referred to the Committee on [Appropriations]",6,1,0,0,7
1203020,861521,2019-05-08,Assembly,"Do pass",13,4,1,0,18
1203020,863068,2019-05-13,Assembly,"AB 547 Gonzalez Assembly Third Reading",57,13,10,0,80
1203020,881096,2019-06-12,Senate,"Do pass, but first be re-referred to the Committee on [Appropriations]",4,0,1,0,5
1203020,891992,2019-09-11,Senate,"Assembly 3rd Reading AB547 Gonzalez et al. By Durazo",32,1,7,0,40
1203020,893634,2019-09-12,Assembly,"AB 547 Gonzalez Concurrence in Senate Amendments",62,6,11,0,79
1203020,894305,2019-05-13,Assembly,"Bill Votes",13,13,0,0,26
1203023,853551,2019-04-23,Assembly,"Do pass as amended, and be re-referred to the Committee on [Appropriations] with recommendation: To Consent Calendar",15,0,0,0,15
1203023,866412,2019-05-16,Assembly,"Do pass as amended",13,0,5,0,18
1203023,871671,2019-05-23,Assembly,"AB 515 Mathis Assembly Third Reading",76,0,4,0,80
1203023,891586,2019-07-10,Senate,"Do pass, but first be re-referred to the Committee on [Appropriations] with the recommendation: To Consent Calendar",8,0,1,0,9
1203023,891587,2019-08-12,Senate,"Placed on suspense file",7,0,0,0,7
1203023,891588,2019-08-30,Senate,"Do pass",7,0,0,0,7
1203023,977944,2020-08-30,Senate,"Assembly 3rd Reading AB515 Mathis By Bates",39,0,1,0,40
1203025,829077,2019-03-26,Assembly,"Do pass and be re-referred to the Committee on [Appropriations]",14,0,0,0,14
1203027,851560,2019-04-23,Assembly,"Do pass and be re-referred to the Committee on [Appropriations]",15,0,0,0,15
1203032,830586,2019-03-27,Assembly,"Do pass and be re-referred to the Committee on [Appropriations] with recommendation: To Consent Calendar",7,0,0,0,7
1203032,852216,2019-04-24,Assembly,"Do pass. To Consent Calendar",18,0,0,0,18
1203032,858035,2019-05-02,Assembly,"AB 566 Berman Consent Calendar Second Day Regular Session",76,0,4,0,80
1203032,877819,2019-06-04,Senate,"Do pass, but first be re-referred to the Committee on [Appropriations] with the recommendation: To Consent Calendar",5,0,0,0,5
1203032,893891,2019-07-01,Senate,"Consent Calendar AB566",39,0,1,0,40
1203036,834813,2019-04-02,Assembly,"Do pass",12,0,0,0,12
1203036,838263,2019-04-08,Assembly,"AB 514 Medina Assembly Third Reading",72,0,8,0,80
1203036,878585,2019-06-05,Senate,"Do pass",7,0,0,0,7
1203036,888398,2019-06-27,Senate,"Assembly 3rd Reading AB514 Medina By Durazo",36,0,4,0,40
1203040,829999,2019-03-26,Assembly,"Do pass and be re-referred to the Committee on [Appropriations] with recommendation: To Consent Calendar",8,0,0,0,8
1203040,834718,2019-04-03,Assembly,"Do pass",17,0,1,0,18
1203040,849362,2019-04-22,Assembly,"AB 551 Brough Assembly Third Reading",76,0,4,0,80
1203040,884223,2019-06-18,Senate,"Do pass as amended, but first amend, and re-refer to the Committee on [Appropriations]",7,0,0,0,7
1203040,891218,2019-09-05,Senate,"Assembly 3rd Reading AB551 Brough et al. By Bates",40,0,0,0,40
1203040,891219,2019-09-10,Assembly,"AB 551 Brough Concurrence in Senate Amendments",79,0,0,0,79
1203041,830450,2019-03-27,Assembly,"Do pass and be re-referred to the Committee on [Appropriations]",7,0,0,0,7
1203041,851671,2019-04-24,Assembly,"Do pass. To Consent Calendar",18,0,0,0,18
1203041,858227,2019-05-02,Assembly,"AB 504 Berman Consent Calendar Second Day Regular Session",76,0,4,0,80
1203041,883960,2019-06-18,Senate,"Do pass as amended, but first amend, and re-refer to the Committee on [Appropriations]",5,0,0,0,5
1203041,891684,2019-08-22,Senate,"Assembly 3rd Reading AB504 Berman By Nielsen",39,0,1,0,40
1203041,891685,2019-08-26,Assembly,"AB 504 Berman Concurrence in Senate Amendments",77,0,2,0,79
1203041,894420,2019-08-22,Senate,"Assembly 3rd Reading AB504 Berll"">",5,0,0,0,5
1203051,902806,2020-01-14,Senate,"Do pass, but first be re-referred to the Committee on [Appropriations] with the recommendation: To Consent Calendar",9,0,3,0,12
1203051,906397,2020-01-27,Senate,"Special Consent SB278 Beall",38,0,1,0,39
1203055,826435,2019-03-20,Assembly,"Do pass and be re-referred to the Committee on [Appropriations]",6,0,1,0,7
1203055,834756,2019-04-03,Assembly,"Do pass",13,4,1,0,18
1203055,859406,2019-05-06,Assembly,"AB 520 Kalra Assembly Third Reading",56,12,12,0,80
1203055,881032,2019-06-12,Senate,"Do pass, but first be re-referred to the Committee on [Appropriations]",4,1,0,0,5
1203055,892954,2019-09-04,Senate,"Assembly 3rd Reading AB520 Kalra By Gonzalez",29,10,1,0,40
1203055,892955,2019-09-09,Assembly,"AB 520 Kalra Concurrence in Senate Amendments",59,14,6,0,79
1203055,894809,2019-09-04,Senate,"Assembly 3rd Reading AB520 Kalra By Gonzale",4,10,0,0,14
1203058,829207,2019-03-26,Senate,"Do pass, but first be re-referred to the Committee on [Appropriations] with the recommendation: To Consent Calendar",7,0,0,0,7
1203058,848939,2019-04-22,Senate,"Consent Calendar SB283",38,0,0,0,38
1203058,880534,2019-06-11,Assembly,"Do pass and be re-referred to the Committee on [Appropriations]",4,1,3,0,8
1203060,806169,2019-02-21,Assembly,"Be adopted. To third reading",12,0,0,0,12
1203060,818966,2019-03-11,Senate,"Special Consent ACR27",37,0,1,0,38
1203063,852969,2019-04-23,Senate,"Do pass as amended, but first amend, and re-refer to the Committee on [Appropriations]",7,0,0,0,7
1203063,863262,2019-05-13,Senate,"Placed on suspense file",6,0,0,0,6
1203063,865577,2019-05-16,Senate,"Do pass as amended",6,0,0,0,6
1203063,873879,2019-05-28,Senate,"Senate 3rd Reading SB273 Rubio et al",36,0,2,0,38
1203063,893128,2019-07-09,Assembly,"Do pass as amended and be re-referred to the Committee on [Appropriations]",8,0,0,0,8
1203063,893129,2019-08-30,Assembly,"Do pass as amended",18,0,0,0,18
1203063,893130,2019-09-10,Assembly,"SB 273 Rubio Senate Third Reading By RUBIO",78,0,1,0,79
1203063,893131,2019-09-11,Senate,"Unfinished Business SB273 Rubio et al. Concurrence",40,0,0,0,40
1203065,841662,2019-04-09,Assembly,"Do pass and be re-referred to the Committee on [Appropriations]",15,0,0,0,15
1203065,866094,2019-05-16,Assembly,"Do pass as amended",13,0,5,0,18
1203065,871496,2019-05-23,Assembly,"AB 526 Petrie-Norris Assembly Third Reading",78,0,2,0,80
1203065,887932,2019-06-26,Senate,"Do pass as amended, but first amend, and re-refer to the Committee on [Appropriations] with the recommendation: To Consent Calendar",8,0,1,0,9
1203065,892521,2019-08-12,Senate,"Placed on suspense file",7,0,0,0,7
1203069,851226,2019-04-23,Senate,"Do pass, but first be re-referred to the Committee on [Appropriations] with the recommendation: To Consent Calendar",12,0,0,0,12
1203069,862109,2019-05-09,Senate,"Consent Calendar SB277",38,0,0,0,38
1203069,892580,2019-07-08,Assembly,"Do pass and be re-referred to the Committee on [Appropriations]",12,0,3,0,15
1203069,892581,2019-08-30,Assembly,"Do pass as amended",15,1,2,0,18
1203069,892582,2019-09-10,Assembly,"SB 277 Beall Senate Third Reading By Frazier",70,0,9,0,79
1203069,892583,2019-09-11,Senate,"Unfinished Business SB277 Beall et al. Concurrence",37,1,2,0,40
1203074,852699,2019-04-24,Assembly,"Do pass and be re-referred to the Committee on [Privacy and Consumer Protection]",9,2,2,0,13
1203074,855925,2019-04-30,Assembly,"Do pass",9,0,2,0,11
1203074,873861,2019-05-28,Assembly,"AB 523 Irwin Assembly Third Reading",61,10,9,0,80
1203074,888942,2019-04-30,Assembly,Do,9,0,2,0,11
1203074,890392,2019-07-02,Senate,"Do pass as amended, but first amend, and re-refer to the Committee on [Judiciary]",10,0,3,0,13
1203074,890393,2019-07-09,Senate,"Do pass, but first be re-referred to the Committee on [Appropriations]",7,0,2,0,9
1203078,833183,2019-03-27,Assembly,"Do pass as amended, and be re-referred to the Committee on [Higher Education] with recommendation: To Consent Calendar",6,0,0,0,6
1203078,851596,2019-04-24,Assembly,"Do pass. To Consent Calendar",18,0,0,0,18
1203078,858231,2019-05-02,Assembly,"AB 543 Smith Consent Calendar Second Day Regular Session",76,0,4,0,80
1203078,878582,2019-06-05,Senate,"Do pass as amended, but first amend, and re-refer to the Committee on [Appropriations] with the recommendation: To Consent Calendar",7,0,0,0,7
1203078,886926,2019-06-24,Senate,"Placed on suspense file",7,0,0,0,7
1203078,891277,2019-08-30,Senate,"Do pass",7,0,0,0,7
1203078,891278,2019-09-09,Senate,"Special Consent AB543",40,0,0,0,40
1203078,891279,2019-09-10,Assembly,"AB 543 Smith Concurrence in Senate Amendments",79,0,0,0,79
1203081,830590,2019-03-27,Senate,"Do pass as amended, but first amend, and re-refer to the Committee on [Governmental Organization]",4,2,1,0,7
1203081,839982,2019-04-09,Senate,"Do pass as amended, but first amend, and re-refer to the Committee on [Public Safety]",10,4,2,0,16
1203081,851590,2019-04-23,Senate,"Do pass, but first be re-referred to the Committee on [Appropriations]",4,2,1,0,7
1203081,904098,2020-01-21,Senate,"Do pass",5,2,0,0,7
1203081,906366,2020-01-27,Senate,"Senate 3rd Reading SB281 Wiener et al",27,11,1,0,39
1203084,834321,2019-04-02,Assembly,"Do pass and be re-referred to the Committee on [Appropriations]",19,0,1,0,20
1203084,841308,2019-04-10,Assembly,"Do pass. To Consent Calendar",17,0,1,0,18
1203084,852960,2019-04-25,Assembly,"AB 545 Low Consent Calendar Second Day Regular Session",76,0,4,0,80
1203084,879846,2019-06-10,Senate,"Do pass, but first be re-referred to the Committee on [Appropriations]",9,0,0,0,9
1203084,887079,2019-06-24,Senate,"Placed on suspense file",7,0,0,0,7
1203084,891393,2019-08-30,Senate,"Do pass as amended",7,0,0,0,7
1203084,891394,2019-09-11,Senate,"Assembly 3rd Reading AB545 Low et al. By Glazer",39,0,1,0,40
1203084,977913,2020-08-31,Assembly,"AB 545 Low Concurrence in Senate Amendments",76,0,3,0,79
1203087,831294,2019-03-27,Assembly,"Do pass and be re-referred to the Committee on [Appropriations] with recommendation: To Consent Calendar",6,0,0,0,6
1203087,841876,2019-04-10,Assembly,"Do pass",17,0,1,0,18
1203087,852977,2019-04-25,Assembly,"AB 525 Luz Rivas Assembly Third Reading",75,0,5,0,80
1203087,878688,2019-06-05,Senate,"Do pass, but first be re-referred to the Committee on [Appropriations] with the recommendation: To Consent Calendar",7,0,0,0,7
1203087,890682,2019-09-10,Senate,"Assembly 3rd Reading AB525 Luz Rivas By Leyva",40,0,0,0,40
1203087,890683,2019-09-11,Assembly,"AB 525 Luz Rivas Concurrence in Senate Amendments",79,0,0,0,79
1203087,893855,2019-04-25,Assembly,"Bill Votes",17,0,0,0,17
1203087,893856,2019-09-10,Senate,"Senate Floov class=""statusCellData"">",40,0,0,0,40
1203097,902825,2020-01-14,Assembly,"Do pass and be re-referred to the Committee on [Appropriations]",13,0,1,0,14
1203097,905430,2020-01-23,Assembly,"Do pass",17,0,1,0,18
1203097,906380,2020-01-27,Assembly,"AB 559 Arambula Assembly Third Reading",77,0,3,0,80
1203101,843851,2019-04-09,Assembly,"Do pass as amended",8,2,4,0,14
1203102,825034,2019-03-19,Assembly,"Do pass. To Consent Calendar",8,0,0,0,8
1203102,828117,2019-03-25,Assembly,"AB 524 Bigelow Consent Calendar Second Day",74,0,6,0,80
1203102,880331,2019-06-11,Senate,"Do pass, but first be re-referred to the Committee on [Rules]",7,0,0,0,7
1203102,891042,2019-07-01,Senate,"Placed on suspense file",7,0,0,0,7
1203102,891043,2019-08-30,Senate,"Do pass as amended",7,0,0,0,7
1203102,891044,2019-09-10,Senate,"Assembly 3rd Reading AB524 Bigelow et al. By Hill",40,0,0,0,40
1203102,891045,2019-09-11,Assembly,"AB 524 Bigelow Concurrence in Senate Amendments",79,0,0,0,79
1203102,894815,2019-08-30,Senate,Date,7,0,0,0,7
1203105,835757,2019-04-03,Assembly,"Do pass and be re-referred to the Committee on [Labor and Employment]",15,0,0,0,15
1203105,853046,2019-04-24,Assembly,"Do pass and be re-referred to the Committee on [Appropriations]",7,0,0,0,7
1203105,861530,2019-05-08,Assembly,"Do pass",15,2,1,0,18
1203105,863059,2019-05-13,Assembly,"AB 560 Santiago Assembly Third Reading",67,4,9,0,80
1203105,883924,2019-06-18,Senate,"Do pass, but first be re-referred to the Committee on [Labor, Public Employment and Retirement ]",11,2,0,0,13
1203105,888023,2019-06-26,Senate,"Do pass, but first be re-referred to the Committee on [Appropriations]",4,1,0,0,5
1203105,892014,2019-09-03,Senate,"Assembly 3rd Reading AB560 Santiago et al. By Hill",31,9,0,0,40
1203105,892015,2019-09-05,Assembly,"AB 560 Santiago Concurrence in Senate Amendments",71,0,8,0,79
1203110,829224,2019-03-26,Assembly,"Do pass and be re-referred to the Committee on [Veterans Affairs]",19,0,1,0,20
1203110,841770,2019-04-09,Assembly,"Do pass and be re-referred to the Committee on [Appropriations]",10,0,1,0,11
1203110,852354,2019-04-24,Assembly,"Do pass. To Consent Calendar",18,0,0,0,18
1203110,858089,2019-05-02,Assembly,"AB 498 Weber Consent Calendar Second Day Regular Session",76,0,4,0,80
1203110,884888,2019-06-19,Senate,"Do pass, but first be re-referred to the Committee on [Veterans Affairs]",6,0,1,0,7
1203110,888144,2019-06-25,Senate,"Do pass",6,0,1,0,7
1203110,892857,2019-07-11,Senate,"Special Consent AB498",39,0,1,0,40
1203110,892858,2019-08-22,Assembly,"AB 498 Weber Concurrence in Senate Amendments",75,0,4,0,79
1203121,841747,2019-04-09,Assembly,"Do pass and be re-referred to the Committee on [Public Safety]",11,1,0,0,12
1203121,850264,2019-04-23,Assembly,"Do pass and be re-referred to the Committee on [Appropriations]",7,0,1,0,8
1203121,866038,2019-05-16,Assembly,"Do pass",16,0,2,0,18
1203121,870120,2019-05-22,Assembly,"AB 521 Berman Assembly Third Reading",64,3,13,0,80
1203121,885023,2019-06-19,Senate,"Do pass, but first be re-referred to the Committee on [Public Safety]",7,0,0,0,7
1203121,890408,2019-07-09,Senate,"Do pass, but first be re-referred to the Committee on [Appropriations]",5,1,1,0,7
1203121,890409,2019-08-12,Senate,"Placed on suspense file",7,0,0,0,7
1203121,890410,2019-08-30,Senate,"Do pass",5,1,1,0,7
1203121,890411,2019-09-09,Senate,"Assembly 3rd Reading AB521 Berman et al. By Skinner",31,6,3,0,40
1203121,890412,2019-09-10,Assembly,"AB 521 Berman Concurrence in Senate Amendments",71,2,6,0,79
1203121,894880,2019-08-30,Senate,Result,7,0,0,0,7
1203125,836177,2019-04-03,Assembly,"Do pass as amended, and be re-referred to the Committee on [Appropriations] with recommendation: To Consent Calendar",14,0,0,0,14
1203125,852290,2019-04-24,Assembly,"Do pass. To Consent Calendar",18,0,0,0,18
1203125,858088,2019-05-02,Assembly,"AB 548 Rodriguez Consent Calendar Second Day Regular Session",76,0,4,0,80
1203125,888324,2019-06-26,Senate,"Do pass, but first be re-referred to the Committee on [Appropriations]",13,0,0,0,13
1203125,894051,2019-08-15,Senate,"Assembly 3rd Reading AB548 Rodriguez et al. By Rubio",37,0,3,0,40
1203126,841592,2019-04-09,Assembly,"Do pass and be re-referred to the Committee on [Agriculture] with recommendation: To Consent Calendar",8,0,0,0,8
1203126,853117,2019-04-25,Assembly,"Do pass and be re-referred to the Committee on [Appropriations] with recommendation: To Consent Calendar",11,0,0,0,11
1203126,893826,2019-04-25,Assembly,04/09/19,8,0,0,0,8
1203129,830357,2019-03-26,Assembly,"Do pass and be re-referred to the Committee on [Appropriations]",11,0,0,0,11
1203129,865662,2019-05-16,Assembly,"Do pass",18,0,0,0,18
1203129,870998,2019-05-23,Assembly,"AB 550 Flora Assembly Third Reading",78,0,2,0,80
1203129,887924,2019-06-25,Senate,"Do pass, but first be re-referred to the Committee on [Appropriations]",6,0,1,0,7
1203129,892375,2019-08-12,Senate,"Placed on suspense file",7,0,0,0,7
1203129,892376,2019-08-30,Senate,"Do pass as amended",7,0,0,0,7
1203129,892377,2019-09-09,Senate,"Assembly 3rd Reading AB550 Flora et al. By Hill",40,0,0,0,40
1203129,892378,2019-09-10,Assembly,"AB 550 Flora Concurrence in Senate Amendments",79,0,0,0,79
1203129,894066,2019-09-09,Senate,NVR,7,0,0,0,7
1203130,829216,2019-03-25,Senate,"Do pass as amended, but first amend, and re-refer to the Committee on [Housing]",5,1,0,0,6
1203130,850477,2019-04-22,Senate,"Do pass, but first be re-referred to the Committee on [Appropriations]",11,0,0,0,11
1203130,859428,2019-05-06,Senate,"Placed on suspense file",5,0,1,0,6
1203130,866270,2019-05-16,Senate,"Do pass",6,0,0,0,6
1203130,871472,2019-05-23,Senate,"Special Consent SB280",38,0,0,0,38
1203130,887462,2019-06-25,Assembly,"Do pass and be re-referred to the Committee on [Housing and Community Development]",7,0,0,0,7
1203130,892336,2019-07-03,Assembly,"Do pass and be re-referred to the Committee on [Appropriations] with recommendation: To Consent Calendar",8,0,0,0,8
1203130,892337,2019-08-30,Assembly,"Do pass",18,0,0,0,18
1203130,892338,2019-09-10,Assembly,"SB 280 Jackson Senate Third Reading By Friedman",78,0,1,0,79
1203130,892339,2019-09-11,Senate,"Unfinished Business SB280 Jackson et al. Concurrence",40,0,0,0,40
1203135,901323,2020-01-06,Assembly,"Be re-referred to the Committee on [Privacy and Consumer Protection]",12,0,0,0,12
1203135,902851,2020-01-14,Assembly,"Do pass and be re-referred to the Committee on [Appropriations]",11,0,0,0,11
1203135,905404,2020-01-23,Assembly,"Do pass",18,0,0,0,18
1203135,906384,2020-01-27,Assembly,"AB 499 Mayes Assembly Third Reading",78,0,2,0,80
1203135,975941,2020-08-14,Senate,"Do pass, but first be re-referred to the Committee on [Appropriations] with the recommendation: To Consent Calendar",16,0,0,0,16
1203135,976150,2020-08-19,Senate,"Placed on suspense file",7,0,0,0,7
1203135,976363,2020-08-20,Senate,"Do pass as amended",7,0,0,0,7
1203135,977309,2020-08-28,Senate,"Special Consent AB499",39,0,1,0,40
1203135,978120,2020-08-30,Assembly,"AB 499 Mayes Concurrence in Senate Amendments",75,0,4,0,79
1203138,831189,2019-03-27,Assembly,"Do pass and be re-referred to the Committee on [Appropriations] with recommendation: To Consent Calendar",7,0,0,0,7
1203138,866426,2019-05-16,Assembly,"Do pass as amended",13,0,5,0,18
1203138,871675,2019-05-23,Assembly,"AB 518 A & A.R. Assembly Third Reading By PETRIE-NORRIS",78,0,2,0,80
1203138,975952,2020-08-14,Senate,"Do pass, but first be re-referred to the Committee on [Appropriations]",12,2,2,0,16
1203138,976157,2020-08-19,Senate,"Placed on suspense file",7,0,0,0,7
1203138,976488,2020-08-20,Senate,"Do pass",5,2,0,0,7
1203138,976646,2020-08-24,Senate,"Assembly 3rd Reading AB518 Calderon et al. By Archuleta",30,8,2,0,40
1203138,976919,2020-08-26,Assembly,"AB 518 Calderon Concurrence in Senate Amendments",61,1,17,0,79
1203143,842895,2019-04-08,Assembly,"Do pass as amended and be re-referred to the Committee on [Appropriations]",8,3,0,0,11
1203143,866408,2019-05-16,Assembly,"Do pass",14,4,0,0,18
1203143,869946,2019-05-22,Assembly,"AB 552 Mark Stone Assembly Third Reading",63,12,5,0,80
1203143,887624,2019-06-25,Senate,"Do pass as amended, but first amend, and re-refer to the Committee on [Appropriations]",7,2,0,0,9
1203143,891462,2019-08-19,Senate,"Placed on suspense file",5,0,2,0,7
1203148,836761,2019-04-02,Assembly,"Do pass as amended and be re-referred to the Committee on [Appropriations]",9,1,5,0,15
1203148,851523,2019-04-24,Assembly,"Do pass",13,0,5,0,18
1203148,863128,2019-05-13,Assembly,"AB 506 Kalra Assembly Third Reading",64,2,14,0,80
1203148,888141,2019-06-26,Senate,"Do pass, but first be re-referred to the Committee on [Judiciary]",8,0,1,0,9
1203148,891061,2019-07-09,Senate,"Do pass, but first be re-referred to the Committee on [Appropriations]",8,0,1,0,9
1203148,891062,2019-09-11,Senate,"Assembly 3rd Reading AB506 Kalra By Pan",40,0,0,0,40
1203148,893787,2019-09-12,Assembly,"AB 506 Kalra Concurrence in Senate Amendments",71,0,8,0,79
1203153,852990,2019-04-24,Assembly,"Do pass as amended and be re-referred to the Committee on [Appropriations]",6,1,0,0,7
1203153,865807,2019-05-16,Assembly,"Do pass",12,5,1,0,18
1203157,841624,2019-04-09,Assembly,"Do pass and be re-referred to the Committee on [Appropriations]",11,3,1,0,15
1203158,825152,2019-03-19,Assembly,"Do pass and be re-referred to the Committee on [Appropriations] with recommendation: To Consent Calendar",8,0,0,0,8
1203162,842838,2019-04-10,Assembly,"Do pass as amended",8,0,0,0,8
1203162,852789,2019-04-25,Assembly,"AB 530 Aguiar-Curry Third Reading Urgency",76,0,4,0,80
1203162,884805,2019-06-19,Senate,"Do pass",6,0,1,0,7
1203162,888547,2019-06-27,Senate,"Assembly 3rd Reading AB530 Aguiar-Curry et al. By Dodd Urgency Clause",37,0,3,0,40
1203162,889272,2019-07-01,Assembly,"AB 530 Aguiar-Curry Concurrence Vote: Final Form",77,0,2,0,79
1203163,829617,2019-03-26,Senate,"Do pass, but first be re-referred to the Committee on [Appropriations]",5,1,1,0,7
1203163,858254,2019-05-02,Senate,"Senate 3rd Reading SB284 Beall et al",30,8,0,0,38
1203163,880314,2019-06-11,Assembly,"Do pass and be re-referred to the Committee on [Appropriations]",6,2,0,0,8
1203163,887922,2019-06-26,Assembly,"Do pass",11,4,3,0,18
1203163,892990,2019-09-03,Assembly,"SB 284 Beall Senate Third Reading By Weber",50,23,6,0,79
1203166,851663,2019-04-23,Senate,"Do pass, but first be re-referred to the Committee on [Appropriations] with the recommendation: To Consent Calendar",16,0,0,0,16
1203166,862167,2019-05-09,Senate,"Consent Calendar SB286 G.O",38,0,0,0,38
1203166,888228,2019-06-26,Assembly,"Do pass and be re-referred to the Committee on [Appropriations] with recommendation: To Consent Calendar",19,0,2,0,21
1203166,892487,2019-08-14,Assembly,"Do pass",18,0,0,0,18
1203166,892488,2019-09-09,Assembly,"Do pass",7,0,0,0,7
1203166,892489,2019-09-11,Assembly,"SB 286 Durazo Senate Third Reading By Carrillo",76,0,3,0,79
1203166,893791,2019-09-12,Senate,"That the Assembly amendments be concurred in",4,0,1,0,5
1203166,894221,2019-09-13,Senate,"Unfinished Business SB286 Durazo et al. Concurrence",38,0,2,0,40
1203169,851259,2019-04-23,Assembly,"Do pass and be re-referred to the Committee on [Appropriations] with recommendation: To Consent Calendar",19,0,1,0,20
1203171,826075,2019-03-19,Assembly,"Do pass and be re-referred to the Committee on [Education]",11,1,0,0,12
1203171,842751,2019-04-10,Assembly,"Do pass and be re-referred to the Committee on [Appropriations]",5,1,0,0,6
1203171,866517,2019-05-16,Assembly,"Do pass",15,1,2,0,18
1203171,871145,2019-05-23,Assembly,"AB 500 Gonzalez Assembly Third Reading",68,3,9,0,80
1203171,881038,2019-06-12,Senate,"Do pass, but first be re-referred to the Committee on [Appropriations]",6,0,1,0,7
1203171,886933,2019-06-24,Senate,"Placed on suspense file",7,0,0,0,7
1203171,891799,2019-08-30,Senate,"Do pass",5,1,1,0,7
1203171,891800,2019-09-04,Senate,"Assembly 3rd Reading AB500 Gonzalez By Leyva",35,2,3,0,40
1203175,854280,2019-04-24,Senate,"Do pass as amended, but first amend, and re-refer to the Committee on [Appropriations]",7,2,0,0,9
1203175,863140,2019-05-13,Senate,"Placed on suspense file",6,0,0,0,6
1203175,865891,2019-05-16,Senate,"Do pass as amended",4,2,0,0,6
1203175,870053,2019-05-22,Senate,"Senate 3rd Reading SB276 Pan et al",24,10,4,0,38
1203175,885916,2019-06-20,Assembly,"Do pass as amended and be re-referred to the Committee on [Appropriations]",9,2,4,0,15
1203175,890884,2019-08-30,Assembly,"Do pass",11,4,3,0,18
1203175,890885,2019-09-03,Assembly,"SB 276 Pan Senate Third Reading By GONZALEZ",48,19,12,0,79
1203175,890886,2019-09-04,Senate,"Unfinished Business SB276 Pan et al. Concurrence",28,11,1,0,40
1203178,851549,2019-04-23,Assembly,"Do pass and be re-referred to the Committee on [Appropriations]",9,2,1,0,12
1203178,866427,2019-05-16,Assembly,"Do pass",13,4,1,0,18
1203178,871386,2019-05-23,Assembly,"AB 540 Limón Assembly Third Reading",59,17,4,0,80
1203178,892715,2019-07-03,Senate,"Do pass, but first be re-referred to the Committee on [Appropriations]",5,1,1,0,7
1203178,892716,2019-08-12,Senate,"Placed on suspense file",7,0,0,0,7
1203178,892717,2019-08-30,Senate,"Do pass as amended",5,2,0,0,7
1203178,892718,2019-09-04,Senate,"Assembly 3rd Reading AB540 Limón By Gonzalez",29,11,0,0,40
1203178,892719,2019-09-09,Assembly,"AB 540 Limón Concurrence in Senate Amendments",61,15,3,0,79
1203181,902815,2020-01-14,Assembly,"Do pass",1,6,1,0,8
1203182,826688,2019-03-20,Assembly,"Do pass and be re-referred to the Committee on [Appropriations]",18,0,3,0,21
1203182,834684,2019-04-03,Assembly,"Do pass. To Consent Calendar",17,0,1,0,18
1203182,842822,2019-04-11,Assembly,"AB 546 Bigelow Consent Calendar Second Day Regular Session",72,0,8,0,80
1203182,880368,2019-06-11,Senate,"Do pass, but first be re-referred to the Committee on [Appropriations] with the recommendation: To Consent Calendar",14,0,2,0,16
1203186,829408,2019-03-26,Assembly,"Do pass and be re-referred to the Committee on [Appropriations]",8,0,0,0,8
1203186,841768,2019-04-10,Assembly,"Do pass",17,0,1,0,18
1203186,848920,2019-04-22,Assembly,"AB 538 Berman Assembly Third Reading",77,0,3,0,80
1203186,880569,2019-06-11,Senate,"Do pass as amended, but first amend, and re-refer to the Committee on [Appropriations]",7,0,0,0,7
1203186,887041,2019-06-24,Senate,"Placed on suspense file",7,0,0,0,7
1203186,891660,2019-08-30,Senate,"Do pass as amended",7,0,0,0,7
1203186,891661,2019-09-11,Senate,"Assembly 3rd Reading AB538 Berman et al. By Hill",40,0,0,0,40
1203186,893588,2019-09-12,Assembly,"AB 538 Berman Concurrence in Senate Amendments",77,0,2,0,79
1203190,841705,2019-04-09,Assembly,"Do pass as amended and be re-referred to the Committee on [Local Government]",6,3,0,0,9
1203190,852676,2019-04-24,Assembly,"Do pass as amended and be re-referred to the Committee on [Appropriations]",7,0,1,0,8
1203190,865728,2019-05-16,Assembly,"Do pass",13,4,1,0,18
1203190,871527,2019-05-23,Assembly,"AB 508 Chu Assembly Third Reading",58,18,4,0,80
1203190,893048,2019-07-03,Senate,"Do pass as amended, but first amend, and re-refer to the Committee on [Governance and Finance]",5,1,1,0,7
1203190,893049,2019-07-10,Senate,"Do pass, but first be re-referred to the Committee on [Appropriations]",5,0,2,0,7
1203190,893050,2019-09-03,Senate,"Assembly 3rd Reading AB508 Chu By Hertzberg",27,9,4,0,40
1203190,893051,2019-09-05,Assembly,"AB 508 Chu Concurrence in Senate Amendments",60,15,4,0,79
1205109,892327,2019-07-02,Assembly,"Be adopted, and re-refer to the Committee on [Appropriations] with recommendation: To Consent Calendar",15,0,0,0,15
1205109,892328,2019-08-21,Assembly,"Be adopted. To third reading",17,0,1,0,18
1205109,892330,2019-08-26,Assembly,"ACR 28 Gipson Assembly Third Reading",77,0,2,0,79
1205109,903136,2020-01-15,Senate,"Be adopted, but first be re-referred to the Committee on [Appropriations] with recommendation: To Consent Calendar",7,0,1,0,8
1205116,805235,2019-02-20,Assembly,"Be adopted. To third reading",7,0,0,0,7
1205123,830526,2019-03-27,Assembly,"Do pass and be re-referred to the Committee on [Appropriations]",4,2,1,0,7
1205123,865860,2019-05-16,Assembly,"Do pass as amended",13,5,0,0,18
1205123,871506,2019-05-23,Assembly,"AB 572 Kalra Assembly Third Reading",58,17,5,0,80
1205123,892915,2019-07-09,Senate,"Do pass as amended, but first amend, and re-refer to the Committee on [Public Safety]",12,2,2,0,16
1205123,892916,2019-08-19,Senate,"Placed on suspense file",5,0,2,0,7
1205130,853178,2019-04-24,Assembly,"Do pass as amended and be re-referred to the Committee on [Appropriations]",7,0,0,0,7
1205144,825260,2019-03-19,Assembly,"Do pass and be re-referred to the Committee on [Appropriations]",6,2,0,0,8
1205144,866027,2019-05-16,Assembly,"Do pass",13,5,0,0,18
1205144,871287,2019-05-23,Assembly,"AB 607 Carrillo Assembly Third Reading",53,22,5,0,80
1205144,893233,2019-07-02,Senate,"Do pass, but first be re-referred to the Committee on [Appropriations]",6,1,0,0,7
1205144,893234,2019-08-12,Senate,"Placed on suspense file",7,0,0,0,7
1205158,839772,2019-04-08,Assembly,"Do pass and be re-referred to the Committee on [Appropriations]",8,1,2,0,11
1205158,852315,2019-04-24,Assembly,"Do pass",13,5,0,0,18
1205158,858104,2019-05-02,Assembly,"AB 585 Limón Assembly Third Reading",44,18,18,0,80
1205158,880415,2019-06-11,Senate,"Do pass, but first be re-referred to the Committee on [Appropriations]",6,2,1,0,9
1205158,889263,2019-07-01,Senate,"Assembly 3rd Reading AB585 Limón By Monning",27,10,3,0,40
1205158,890540,2019-07-08,Assembly,"AB 585 Limón Concurrence in Senate Amendments",54,13,12,0,79
1205166,841796,2019-04-10,Senate,"Do pass, but first be re-referred to the Committee on [Veterans Affairs] with the recommendation: To Consent Calendar",12,0,1,0,13
1205166,851889,2019-04-23,Senate,"Do pass, but first be re-referred to the Committee on [Appropriations] with the recommendation: To Consent Calendar",6,0,1,0,7
1205166,862188,2019-05-09,Senate,"Consent Calendar SB292",38,0,0,0,38
1205166,957765,2020-05-07,Assembly,"Do pass and be re-referred to the Committee on [Appropriations]",14,0,0,0,14
1205166,976328,2020-08-20,Assembly,"Do pass as amended",18,0,0,0,18
1205170,827857,2019-03-25,Senate,"Do pass, but first be re-referred to the Committee on [Appropriations]",9,0,0,0,9
1205170,838264,2019-04-08,Senate,"Placed on suspense file",6,0,0,0,6
1205170,865654,2019-05-16,Senate,"Do pass",6,0,0,0,6
1205170,870907,2019-05-23,Senate,"Special Consent SB302",38,0,0,0,38
1205170,891668,2019-07-09,Assembly,"Do pass as amended, and be re-referred to the Committee on [Appropriations] with recommendation: To Consent Calendar",7,0,0,0,7
1205170,891669,2019-08-30,Assembly,"Do pass",18,0,0,0,18
1205178,843572,2019-04-10,Assembly,"Do pass",8,0,0,0,8
1205178,855448,2019-04-29,Assembly,"AB 591 Cristina Garcia Assembly Third Reading",72,0,8,0,80
1205178,881046,2019-06-12,Senate,"Do pass as amended, but first amend, and re-refer to the Committee on [Appropriations]",6,0,1,0,7
1205178,889215,2019-07-01,Senate,"Assembly 3rd Reading AB591 Cristina Garcia By Gonzalez",39,0,1,0,40
1205178,893992,2019-07-08,Assembly,"AB 591 Cristina Garcia Concurrence in Senate Amendments",77,0,2,0,79
1205185,806162,2019-02-21,Senate,"Senate 3rd Reading SCR14 Dodd et al",37,0,1,0,38
1205185,808077,2019-02-25,Assembly,"Be adopted. To Consent Calendar",10,0,2,0,12
1205185,811521,2019-02-28,Assembly,"SCR 14 Dodd Consent Calendar Second Day Regular Session",75,0,5,0,80
1205192,851540,2019-04-23,Assembly,"Do pass and be re-referred to the Committee on [Appropriations] with recommendation: To Consent Calendar",15,0,0,0,15
1205199,859013,2019-05-01,Assembly,"Do pass",6,2,0,0,8
1205199,874837,2019-05-29,Assembly,"AB 570 Aguiar-Curry Assembly Third Reading",52,20,8,0,80
1205199,893465,2019-07-10,Senate,"Do pass",5,2,0,0,7
1205199,974739,2020-08-03,Senate,"Do pass as amended, but first amend, and re-refer to the Committee on [Appropriations]",9,3,1,0,13
1205199,976007,2020-08-17,Senate,"Placed on suspense file",7,0,0,0,7
1205199,976494,2020-08-20,Senate,"Do pass as amended",5,2,0,0,7
1205207,852738,2019-04-24,Senate,"Do pass as amended",6,0,1,0,7
1205207,859590,2019-05-06,Senate,"Senate 3rd Reading SB293 Skinner",36,0,2,0,38
1205207,892411,2019-07-03,Assembly,"Do pass as amended",6,0,2,0,8
1205207,892412,2019-08-30,Assembly,"SB 293 Skinner Senate Third Reading By Wicks",51,11,17,0,79
1205207,892413,2019-09-03,Senate,"Unfinished Business SB293 Skinner Concurrence",33,2,5,0,40
1205213,853410,2019-04-25,Assembly,"Do pass as amended and be re-referred to the Committee on [Appropriations]",11,0,0,0,11
1205213,861668,2019-05-08,Assembly,"Do pass. To Consent Calendar",18,0,0,0,18
1205213,866484,2019-05-16,Assembly,"AB 590 Mathis Consent Calendar Second Day Regular Session",74,0,6,0,80
1205213,884003,2019-06-18,Senate,"Do pass, but first be re-referred to the Committee on [Appropriations] with the recommendation: To Consent Calendar",5,0,0,0,5
1205213,891619,2019-07-11,Senate,"Consent Calendar AB590",39,0,1,0,40
1205213,891620,2019-09-03,Senate,"Assembly 3rd Reading AB590 Mathis et al. By Dodd",40,0,0,0,40
1205213,891621,2019-09-09,Assembly,"AB 590 Mathis Concurrence in Senate Amendments",79,0,0,0,79
1205221,850471,2019-04-22,Assembly,"Do pass and be re-referred to the Committee on [Appropriations]",7,2,2,0,11
1205235,839929,2019-04-08,Assembly,"Do pass and be re-referred to the Committee on [Appropriations]",11,0,0,0,11
1205235,851639,2019-04-24,Assembly,"Do pass. To Consent Calendar",18,0,0,0,18
1205235,858200,2019-05-02,Assembly,"AB 608 Petrie-Norris Consent Calendar Second Day Regular Session",76,0,4,0,80
1205235,881084,2019-06-12,Senate,"Do pass, but first be re-referred to the Committee on [Appropriations] with the recommendation: To Consent Calendar",6,0,1,0,7
1205235,889270,2019-07-01,Senate,"Consent Calendar AB608",39,0,1,0,40
1205239,835182,2019-04-02,Assembly,"Do pass and be re-referred to the Committee on [Public Safety]",15,0,0,0,15
1205239,850034,2019-04-23,Assembly,"Do pass and be re-referred to the Committee on [Appropriations]",2,6,0,0,8
1205239,850035,2019-04-23,Assembly,Reconsideration,8,0,0,0,8
1205247,830473,2019-03-27,Assembly,"Do pass and be re-referred to the Committee on [Local Government]",8,0,0,0,8
1205247,841643,2019-04-10,Assembly,"Do pass as amended",8,0,0,0,8
1205247,852805,2019-04-25,Assembly,"AB 587 Friedman Assembly Third Reading",75,0,5,0,80
1205247,877611,2019-06-04,Senate,"Do pass, but first be re-referred to the Committee on [Governance and Finance] with the recommendation: To Consent Calendar",10,0,1,0,11
1205247,885996,2019-06-19,Senate,"Do pass as amended",6,0,1,0,7
1205247,892211,2019-09-10,Senate,"Assembly 3rd Reading AB587 Friedman et al. By Gonzalez",40,0,0,0,40
1205247,892212,2019-09-11,Assembly,"AB 587 Friedman Concurrence in Senate Amendments",79,0,0,0,79
1205261,835388,2019-04-02,Assembly,"Do pass and be re-referred to the Committee on [Labor and Employment]",11,0,0,0,11
1205261,853669,2019-04-24,Assembly,"Do pass and be re-referred to the Committee on [Appropriations] with recommendation: To Consent Calendar",7,0,0,0,7
1205261,865857,2019-05-16,Assembly,"Do pass as amended",13,0,5,0,18
1205261,871373,2019-05-23,Assembly,"AB 594 Salas Assembly Third Reading",78,0,2,0,80
1205261,890654,2019-07-09,Senate,"Do pass, but first be re-referred to the Committee on [Appropriations]",15,0,1,0,16
1205261,890655,2019-08-12,Senate,"Placed on suspense file",7,0,0,0,7
1205261,890656,2019-08-30,Senate,"Do pass as amended",7,0,0,0,7
1205261,890657,2019-09-06,Senate,"Assembly 3rd Reading AB594 Salas By Umberg",39,0,1,0,40
1205261,890658,2019-09-09,Assembly,"AB 594 Salas Concurrence in Senate Amendments",79,0,0,0,79
1205261,894801,2019-08-12,Senate,Date,15,0,0,0,15
1205268,859591,2019-05-01,Assembly,"Do pass as amended",7,0,0,0,7
1205268,863306,2019-05-13,Assembly,"AB 610 Obernolte Assembly Third Reading",66,2,12,0,80
1205268,888372,2019-06-26,Senate,"Do pass, but first be re-referred to the Committee on [Elections and Constitutional Amendments]",2,4,1,0,7
1205268,888373,2019-06-26,Senate,"[First] hearing set for [06-26-2019]: Failed passage in Committee. Reconsideration granted",7,0,0,0,7
1205288,825929,2019-03-19,Assembly,"Do pass",11,0,1,0,12
1205288,831432,2019-03-28,Assembly,"AB 595 Medina Assembly Third Reading",62,0,18,0,80
1205288,878500,2019-06-05,Senate,"Do pass, but first be re-referred to the Committee on [Public Safety]",7,0,0,0,7
1205288,891527,2019-08-12,Senate,"Assembly 3rd Reading AB595 Medina By Rubio",31,0,9,0,40
1205302,825050,2019-03-19,Assembly,"Do pass and be re-referred to the Committee on [Appropriations] with recommendation: To Consent Calendar",8,0,0,0,8
1205302,835662,2019-04-03,Assembly,"Do pass. To Consent Calendar",17,0,1,0,18
1205302,842919,2019-04-11,Assembly,"AB 611 Nazarian Consent Calendar Second Day Regular Session",72,0,8,0,80
1205302,877678,2019-06-04,Senate,"Do pass, but first be re-referred to the Committee on [Appropriations] with the recommendation: To Consent Calendar",7,0,0,0,7
1205302,887064,2019-06-24,Senate,"Placed on suspense file",7,0,0,0,7
1205302,890688,2019-08-30,Senate,"Do pass as amended",7,0,0,0,7
1205302,890689,2019-09-05,Senate,"Assembly 3rd Reading AB611 Nazarian et al. By Wilk",40,0,0,0,40
1205302,890690,2019-09-09,Assembly,"AB 611 Nazarian Concurrence in Senate Amendments",79,0,0,0,79
1205308,831052,2019-03-27,Senate,"Do pass, but first be re-referred to the Committee on [Appropriations]",7,0,0,0,7
1205308,838898,2019-04-08,Senate,"Placed on suspense file",6,0,0,0,6
1205308,865604,2019-05-16,Senate,"Do pass",6,0,0,0,6
1205308,870987,2019-05-23,Senate,"Special Consent SB294",38,0,0,0,38
1205308,891186,2019-07-08,Assembly,"Do pass and be re-referred to the Committee on [Appropriations]",9,0,2,0,11
1205308,891187,2019-08-30,Assembly,"Do pass",18,0,0,0,18
1205308,891188,2019-09-05,Assembly,"SB 294 Hill Senate Third Reading By Berman",79,0,0,0,79
1205308,891189,2019-09-06,Senate,"Unfinished Business SB294 Hill Concurrence",39,0,1,0,40
1205315,851098,2019-04-23,Senate,"Do pass, but first be re-referred to the Committee on [Appropriations]",5,0,0,0,5
1205315,863168,2019-05-13,Senate,"Senate 3rd Reading SB300 Umberg",37,0,1,0,38
1205315,969431,2020-06-26,Assembly,"SB 300 Umberg Senate Third Reading By BERMAN",57,16,6,0,79
1205315,969987,2020-06-29,Senate,"Unfinished Business SB300 Umberg Concurrence",29,8,3,0,40
1205323,840248,2019-04-08,Senate,"Do pass, but first be re-referred to the Committee on [Appropriations]",6,0,0,0,6
1205323,848846,2019-04-22,Senate,"Placed on suspense file",6,0,0,0,6
1205323,865661,2019-05-16,Senate,"Do pass as amended",6,0,0,0,6
1205323,870977,2019-05-23,Senate,"Senate 3rd Reading SB298 Caballero et al",38,0,0,0,38
1205323,890340,2019-07-02,Assembly,"Do pass as amended, and be re-referred to the Committee on [Appropriations] with recommendation: To Consent Calendar",8,0,0,0,8
1205323,894826,2019-04-22,Senate,Result,6,0,0,0,6
1205329,836933,2019-04-03,Senate,"Do pass as amended, but first amend, and re-refer to the Committee on [Veterans Affairs]",8,0,1,0,9
1205329,851756,2019-04-23,Senate,"Do pass, but first be re-referred to the Committee on [Appropriations] with the recommendation: To Consent Calendar",6,0,1,0,7
1205329,860183,2019-05-06,Senate,"Placed on suspense file",5,0,1,0,6
1205329,866123,2019-05-16,Senate,"Do pass",6,0,0,0,6
1205329,871018,2019-05-23,Senate,"Special Consent SB289",38,0,0,0,38
1205329,887504,2019-06-25,Assembly,"Do pass and be re-referred to the Committee on [Veterans Affairs] with recommendation: To Consent Calendar",15,0,0,0,15
1205329,892632,2019-07-09,Assembly,"Do pass and be re-referred to the Committee on [Appropriations]",10,0,1,0,11
1205329,892633,2019-08-30,Assembly,"Do pass",18,0,0,0,18
1205329,892634,2019-09-10,Assembly,"SB 289 Archuleta Senate Third Reading By Irwin",79,0,0,0,79
1205329,892635,2019-09-11,Senate,"Unfinished Business SB289 Archuleta et al. Concurrence",40,0,0,0,40
1205342,834373,2019-04-02,Assembly,"Do pass and be re-referred to the Committee on [Appropriations]",12,6,2,0,20
1205342,841386,2019-04-10,Assembly,"Do pass",12,5,1,0,18
1205342,853466,2019-04-25,Assembly,"AB 613 Low Assembly Third Reading",50,21,9,0,80
1205350,830536,2019-03-27,Senate,"Do pass, but first be re-referred to the Committee on [Appropriations]",7,0,0,0,7
1205350,862262,2019-05-09,Senate,"Senate 3rd Reading SB297 Pan",38,0,0,0,38
1205350,888050,2019-06-25,Assembly,"Do pass and be re-referred to the Committee on [Education]",12,0,0,0,12
1205357,851376,2019-04-23,Assembly,"Do pass and be re-referred to the Committee on [Appropriations]",7,0,0,0,7
1205364,853138,2019-04-24,Assembly,"Do pass as amended and be re-referred to the Committee on [Appropriations]",8,0,0,0,8
1205364,862141,2019-05-09,Assembly,"AB 600 Chu Assembly Third Reading",67,1,12,0,80
1205364,885307,2019-06-19,Senate,"Do pass",4,3,0,0,7
1205364,891924,2019-09-11,Senate,"Assembly 3rd Reading AB600 Chu By McGuire",25,12,3,0,40
1205364,893818,2019-09-12,Assembly,"AB 600 Chu Concurrence in Senate Amendments",76,0,3,0,79
1205371,834204,2019-03-27,Senate,"Do pass as amended, but first amend, and re-refer to the Committee on [Appropriations]",7,0,0,0,7
1205371,849498,2019-04-22,Senate,"Placed on suspense file",6,0,0,0,6
1205371,866327,2019-05-16,Senate,"Do pass as amended",4,1,1,0,6
1205371,871461,2019-05-23,Senate,"Senate 3rd Reading SB291 Leyva et al",31,5,2,0,38
1205377,836004,2019-04-02,Assembly,"Do pass as amended, and be re-referred to the Committee on [Privacy and Consumer Protection] with recommendation: To Consent Calendar",12,0,0,0,12
1205377,852526,2019-04-23,Assembly,"Do pass and be re-referred to the Committee on [Appropriations] with recommendation: To Consent Calendar",11,0,0,0,11
1205377,856838,2019-05-01,Assembly,"Do pass. To Consent Calendar",18,0,0,0,18
1205377,862323,2019-05-09,Assembly,"AB 596 Grayson Consent Calendar Second Day Regular Session",76,0,4,0,80
1205377,885208,2019-06-18,Senate,"Do pass, but first be re-referred to the Committee on [Appropriations] with the recommendation: To Consent Calendar",9,0,0,0,9
1205377,891284,2019-09-09,Senate,"Assembly 3rd Reading AB596 Grayson By Jones",40,0,0,0,40
1205377,891285,2019-09-10,Assembly,"AB 596 Grayson Concurrence in Senate Amendments",79,0,0,0,79
1205384,829414,2019-03-25,Assembly,"Do pass as amended and be re-referred to the Committee on [Appropriations]",11,0,0,0,11
1205398,825077,2019-03-19,Assembly,"Do pass. To Consent Calendar",8,0,0,0,8
1205398,828202,2019-03-25,Assembly,"AB 603 Melendez Consent Calendar Second Day Regular Session",74,0,6,0,80
1205398,877732,2019-06-04,Senate,"Do pass",6,0,1,0,7
1205398,888514,2019-06-27,Senate,"Assembly 3rd Reading AB603 Melendez By Roth",30,2,8,0,40
1205406,829174,2019-03-26,Assembly,"Do pass as amended and be re-referred to the Committee on [Appropriations]",19,0,1,0,20
1205406,834750,2019-04-03,Assembly,"Do pass. To Consent Calendar",17,0,1,0,18
1205406,842660,2019-04-11,Assembly,"AB 588 Chen Consent Calendar Second Day Regular Session",72,0,8,0,80
1205406,883429,2019-06-17,Senate,"Do pass as amended, but first amend, and re-refer to the Committee on [Appropriations]",8,0,1,0,9
1205406,892058,2019-09-04,Senate,"Assembly 3rd Reading AB588 Chen et al. By Glazer",40,0,0,0,40
1205406,892059,2019-09-10,Assembly,"AB 588 Chen Concurrence in Senate Amendments",78,0,1,0,79
1205419,836760,2019-04-04,Assembly,"Be re-referred to the Committee on [Judiciary]",9,0,3,0,12
1205419,855820,2019-04-30,Assembly,"Do pass as amended",12,0,0,0,12
1205419,862250,2019-05-09,Assembly,"AB 602 Berman Assembly Third Reading",76,0,4,0,80
1205419,891035,2019-07-09,Senate,"Do pass, but first be re-referred to the Committee on [Appropriations]",8,0,1,0,9
1205419,891036,2019-08-12,Senate,"Placed on suspense file",7,0,0,0,7
1205419,891037,2019-08-30,Senate,"Do pass as amended",7,0,0,0,7
1205419,891038,2019-09-10,Senate,"Assembly 3rd Reading AB602 Berman et al. By Leyva",40,0,0,0,40
1205419,893788,2019-09-12,Assembly,"With recommendation: That Senate amendments be concurred in",10,0,2,0,12
1205419,893987,2019-09-13,Assembly,"AB 602 Berman Concurrence in Senate Amendments",77,0,2,0,79
1205425,840653,2019-04-08,Assembly,"Do pass and be re-referred to the Committee on [Appropriations]",11,0,0,0,11
1205425,866236,2019-05-16,Assembly,"Do pass as amended",18,0,0,0,18
1205425,871605,2019-05-23,Assembly,"AB 614 Eggman Assembly Third Reading",78,0,2,0,80
1205425,881061,2019-06-12,Senate,"Do pass as amended, but first amend, and re-refer to the Committee on [Appropriations]",6,0,1,0,7
1205425,887275,2019-06-24,Senate,"Placed on suspense file",7,0,0,0,7
1205425,893685,2019-08-30,Senate,"Do pass",7,0,0,0,7
1205425,893686,2019-09-09,Senate,"Special Consent AB614",40,0,0,0,40
1205425,893687,2019-09-10,Assembly,"AB 614 Eggman Concurrence in Senate Amendments",79,0,0,0,79
1205425,894821,2019-06-24,Senate,Result,6,0,0,0,6
1205432,816364,2019-03-07,Senate,"Senate 3rd Reading SCR13 Jackson",36,0,2,0,38
1205432,816365,2019-03-07,Senate,"Senate 3rd Reading SCR13 Jackson Reconsider",37,0,1,0,38
1205432,816366,2019-03-07,Senate,"Senate 3rd Reading SCR13 Jackson",37,0,1,0,38
1205432,822243,2019-03-14,Assembly,"Be adopted. To Consent Calendar",11,0,1,0,12
1205432,826730,2019-03-21,Assembly,"SCR 13 Jackson Consent Calendar Second Day Regular Session",72,0,8,0,80
1205440,841625,2019-04-09,Assembly,"Do pass and be re-referred to the Committee on [Higher Education] with recommendation: To Consent Calendar",8,0,0,0,8
1205440,851488,2019-04-23,Assembly,"Do pass and be re-referred to the Committee on [Appropriations]",11,0,1,0,12
1205440,866149,2019-05-16,Assembly,"Do pass",18,0,0,0,18
1205440,873968,2019-05-28,Assembly,"AB 612 Weber Assembly Third Reading",76,0,4,0,80
1205440,881042,2019-06-12,Senate,"Do pass, but first be re-referred to the Committee on [Human Services] with the recommendation: To Consent Calendar",7,0,0,0,7
1205440,887381,2019-06-24,Senate,"Do pass, but first be re-referred to the Committee on [Appropriations] with the recommendation: To Consent Calendar",6,0,0,0,6
1205440,892528,2019-07-08,Senate,"Placed on suspense file",7,0,0,0,7
1205440,892529,2019-08-30,Senate,"Do pass as amended",7,0,0,0,7
1205440,892530,2019-09-10,Senate,"Assembly 3rd Reading AB612 Weber et al. By Hurtado",40,0,0,0,40
1205440,892531,2019-09-11,Assembly,"AB 612 Weber Concurrence in Senate Amendments",79,0,0,0,79
1205445,834443,2019-03-27,Assembly,"Do pass as amended and be re-referred to the Committee on [Appropriations]",5,0,1,0,6
1205445,851640,2019-04-24,Assembly,"Do pass",15,0,3,0,18
1205445,859462,2019-05-06,Assembly,"AB 605 Maienschein Assembly Third Reading",72,0,8,0,80
1205445,878485,2019-06-05,Senate,"Do pass, but first be re-referred to the Committee on [Appropriations] with the recommendation: To Consent Calendar",7,0,0,0,7
1205445,889281,2019-07-01,Senate,"Consent Calendar AB605",39,0,1,0,40
1205445,891475,2019-08-19,Senate,"Assembly 3rd Reading AB605 Maienschein et al. By Rubio",39,0,1,0,40
1205445,891476,2019-08-22,Assembly,"AB 605 Maienschein Concurrence in Senate Amendments",71,0,8,0,79
1205445,894235,2019-07-01,Senate,Date,7,0,0,0,7
1205453,826191,2019-03-20,Assembly,"Do pass and be re-referred to the Committee on [Appropriations] with recommendation: To Consent Calendar",7,0,0,0,7
1205453,856966,2019-05-01,Assembly,"Do pass. To Consent Calendar",18,0,0,0,18
1205453,862369,2019-05-09,Assembly,"AB 593 Carrillo Consent Calendar Second Day Regular Session",76,0,4,0,80
1205453,881316,2019-06-12,Senate,"Do pass, but first be re-referred to the Committee on [Appropriations]",5,0,0,0,5
1205453,890352,2019-09-10,Senate,"Assembly 3rd Reading AB593 Carrillo By Morrell",40,0,0,0,40
1205453,890353,2019-09-11,Assembly,"AB 593 Carrillo Concurrence in Senate Amendments",79,0,0,0,79
1205453,894816,2019-09-10,Senate,As,5,0,0,0,5
1205458,826885,2019-03-20,Assembly,"Do pass and be re-referred to the Committee on [Appropriations]",18,0,3,0,21
1205458,834681,2019-04-03,Assembly,"Do pass. To Consent Calendar",17,0,1,0,18
1205458,842770,2019-04-11,Assembly,"AB 609 Levine Consent Calendar Second Day Regular Session",72,0,8,0,80
1205458,892506,2019-07-09,Senate,"Do pass, but first be re-referred to the Committee on [Appropriations] with the recommendation: To Consent Calendar",15,0,1,0,16
1205473,824951,2019-03-19,Assembly,"Do pass and be re-referred to the Committee on [Appropriations] with recommendation: To Consent Calendar",8,0,0,0,8
1205473,865965,2019-05-16,Assembly,"Do pass",18,0,0,0,18
1205473,869896,2019-05-22,Assembly,"AB 581 Levine Assembly Third Reading",77,0,3,0,80
1205473,883850,2019-06-18,Senate,"Do pass, but first be re-referred to the Committee on [Veterans Affairs] with the recommendation: To Consent Calendar",7,0,0,0,7
1205473,887903,2019-06-25,Senate,"Do pass, but first be re-referred to the Committee on [Appropriations] with the recommendation: To Consent Calendar",6,0,1,0,7
1205473,891379,2019-07-08,Senate,"Placed on suspense file",7,0,0,0,7
1205487,837532,2019-04-02,Assembly,"Do pass and be re-referred to the Committee on [Appropriations]",2,6,0,0,8
1205487,837533,2019-04-02,Assembly,Reconsideration,7,1,0,0,8
1205501,826841,2019-03-20,Senate,"Do pass as amended, but first amend, and re-refer to the Committee on [Appropriations]",8,0,1,0,9
1205501,862213,2019-05-09,Senate,"Senate 3rd Reading SB301 Leyva",38,0,0,0,38
1205501,880401,2019-06-11,Assembly,"Do pass and be re-referred to the Committee on [Appropriations]",14,0,1,0,15
1205501,896206,2019-05-09,Senate,03/20/19,8,0,0,0,8
1205509,856706,2019-05-01,Senate,"Do pass and be ordered to the Consent Calendar",7,0,0,0,7
1205509,862081,2019-05-09,Senate,"Consent Calendar SB295",38,0,0,0,38
1205509,884737,2019-06-19,Assembly,"Do pass. To Consent Calendar",8,0,0,0,8
1205509,893064,2019-08-26,Assembly,"Do pass and be re-referred to the Committee on [Appropriations]",10,0,1,0,11
1205509,896028,2019-05-09,Senate,"NVR Count",38,0,0,0,38
1205514,848383,2019-03-19,Assembly,"Do pass and be re-referred to the Committee on [Appropriations]",2,0,6,0,8
1205514,848384,2019-03-19,Assembly,Reconsideration,8,0,0,0,8
1205514,902830,2020-01-14,Assembly,"Do pass and be re-referred to the Committee on [Appropriations]",7,0,1,0,8
1205514,905408,2020-01-23,Assembly,"Do pass",17,0,1,0,18
1205514,906376,2020-01-27,Assembly,"AB 582 Eduardo Garcia Assembly Third Reading",72,3,5,0,80
1205522,841678,2019-04-10,Assembly,"Do pass and be re-referred to the Committee on [Appropriations]",6,1,0,0,7
1205522,865907,2019-05-16,Assembly,"Do pass",13,5,0,0,18
1205522,874385,2019-05-29,Assembly,"AB 571 Mullin Assembly Third Reading",65,13,2,0,80
1205522,892249,2019-07-02,Senate,"Do pass, but first be re-referred to the Committee on [Appropriations]",4,0,1,0,5
1205522,892250,2019-08-12,Senate,"Placed on suspense file",7,0,0,0,7
1205522,892251,2019-08-30,Senate,"Do pass",5,2,0,0,7
1205522,892252,2019-09-09,Senate,"Assembly 3rd Reading AB571 Mullin et al. By Allen",32,8,0,0,40
1205527,836747,2019-04-03,Senate,"Do pass as amended, but first amend, and re-refer to the Committee on [Appropriations]",7,0,0,0,7
1205527,854362,2019-04-29,Senate,"Placed on suspense file",6,0,0,0,6
1205527,866376,2019-05-16,Senate,"Do pass",5,1,0,0,6
1205527,868912,2019-05-21,Senate,"Senate 3rd Reading SB296 Allen",32,5,1,0,38
1205527,880377,2019-06-11,Assembly,"Do pass and be re-referred to the Committee on [Appropriations]",9,0,3,0,12
1205527,891912,2019-08-30,Assembly,"Do pass",14,3,1,0,18
1205527,891913,2019-09-11,Assembly,"SB 296 Allen Senate Third Reading By Medina",65,9,5,0,79
1205527,893629,2019-09-12,Senate,"Unfinished Business SB296 Allen et al. Concurrence",33,6,1,0,40
1205535,851235,2019-04-23,Assembly,"Do pass and be re-referred to the Committee on [Appropriations]",15,0,0,0,15
1205535,866086,2019-05-16,Assembly,"Do pass as amended",18,0,0,0,18
1205535,873741,2019-05-28,Assembly,"AB 598 Bloom Assembly Third Reading",75,0,5,0,80
1205535,888240,2019-06-26,Senate,"Do pass as amended, but first amend, and re-refer to the Committee on [Appropriations]",8,0,1,0,9
1205535,892386,2019-08-12,Senate,"Placed on suspense file",7,0,0,0,7
1205535,892387,2019-08-30,Senate,"Do pass as amended",7,0,0,0,7
1205535,892388,2019-09-10,Senate,"Assembly 3rd Reading AB598 Bloom et al. By Mitchell",40,0,0,0,40
1205535,892389,2019-09-11,Assembly,"AB 598 Bloom Concurrence in Senate Amendments",79,0,0,0,79
1205535,894705,2019-09-10,Senate,Assem,7,0,0,0,7
1205535,894991,2019-09-10,Senate,"Assembly 3rd Reading AB598 Blclass=""statusCell"">",7,0,0,0,7
1205542,829298,2019-03-26,Senate,"Do pass, but first be re-referred to the Committee on [Rules]",15,0,1,0,16
1205542,848759,2019-04-22,Senate,"Placed on suspense file",6,0,0,0,6
1205542,866069,2019-05-16,Senate,"Do pass",6,0,0,0,6
1205542,871130,2019-05-23,Senate,"Special Consent SB290",38,0,0,0,38
1205542,887995,2019-06-26,Assembly,"Do pass and be re-referred to the Committee on [Governmental Organization]",14,0,0,0,14
1205542,890986,2019-07-10,Assembly,"Do pass and be re-referred to the Committee on [Appropriations] with recommendation: To Consent Calendar",19,0,2,0,21
1205549,825947,2019-03-19,Assembly,"Do pass as amended. To Consent Calendar",8,0,0,0,8
1205549,831435,2019-03-28,Assembly,"AB 597 Levine Consent Calendar Second Day Regular Session",72,0,8,0,80
1205549,877587,2019-06-04,Senate,"Do pass",6,0,1,0,7
1205549,886033,2019-06-20,Senate,"Special Consent AB597",40,0,0,0,40
1205556,858170,2019-04-30,Senate,"Do pass as amended",9,0,0,0,9
1205556,863079,2019-05-13,Senate,"Senate 3rd Reading SB303 Wieckowski",37,0,1,0,38
1205556,883810,2019-06-18,Assembly,"Do pass",12,0,0,0,12
1205556,891410,2019-08-12,Assembly,"SB 303 Wieckowski Senate Third Reading By Obernolte",78,0,1,0,79
1205556,891411,2019-09-03,Senate,"Unfinished Business SB303 Wieckowski Concurrence",40,0,0,0,40
1205563,826818,2019-03-19,Assembly,"Do pass as amended and be re-referred to the Committee on [Appropriations]",15,0,0,0,15
1205563,865871,2019-05-16,Assembly,"Do pass as amended",14,3,1,0,18
1205563,872258,2019-05-24,Assembly,"AB 577 Eggman Assembly Third Reading",76,0,4,0,80
1205563,890808,2019-07-10,Senate,"Do pass as amended, but first amend, and re-refer to the Committee on [Appropriations]",8,0,1,0,9
1205563,890809,2019-09-03,Senate,"Assembly 3rd Reading AB577 Eggman et al. By Portantino",40,0,0,0,40
1205563,890810,2019-09-05,Assembly,"AB 577 Eggman Concurrence in Senate Amendments",77,0,2,0,79
1205570,825971,2019-03-20,Assembly,"Do pass and be re-referred to the Committee on [Judiciary]",7,0,0,0,7
1205570,833991,2019-04-02,Assembly,"Do pass and be re-referred to the Committee on [Appropriations]",10,2,0,0,12
1205570,851651,2019-04-24,Assembly,"Do pass as amended",14,1,3,0,18
1205570,859473,2019-05-06,Assembly,"AB 589 Gonzalez Assembly Third Reading",65,6,9,0,80
1205570,881098,2019-06-12,Senate,"Do pass, but first be re-referred to the Committee on [Judiciary]",4,0,1,0,5
1205570,892122,2019-07-02,Senate,"Do pass, but first be re-referred to the Committee on [Appropriations]",7,2,0,0,9
1205570,892123,2019-09-10,Senate,"Assembly 3rd Reading AB589 Gonzalez By Rubio",30,9,1,0,40
1205570,892124,2019-09-11,Assembly,"AB 589 Gonzalez Concurrence in Senate Amendments",65,9,5,0,79
1208060,831352,2019-03-27,Assembly,"Do pass and be re-referred to the Committee on [Revenue and Taxation]",5,2,1,0,8
1208060,855703,2019-04-29,Assembly,"Do pass",7,3,1,0,11
1208060,859587,2019-05-06,Assembly,"AB 618 Mark Stone Assembly Third Reading",45,22,13,0,80
1208060,881058,2019-06-12,Senate,"Do pass",4,0,3,0,7
1208060,888422,2019-06-27,Senate,"Assembly 3rd Reading AB618 Mark Stone et al. By Monning",23,8,9,0,40
1208060,889297,2019-07-01,Assembly,"AB 618 Mark Stone Concurrence in Senate Amendments",48,21,10,0,79
1208061,842867,2019-04-10,Senate,"Do pass as amended, but first amend, and re-refer to the Committee on [Appropriations]",7,0,0,0,7
1208061,854917,2019-04-29,Senate,"Do pass",6,0,0,0,6
1208061,862244,2019-05-09,Senate,"Senate 3rd Reading SB309 Rubio et al. Urgency Clause",38,0,0,0,38
1208061,887577,2019-06-24,Assembly,"Do pass and be re-referred to the Committee on [Aging and Long-Term Care]",11,0,0,0,11
1208061,892904,2019-07-09,Assembly,Date,11,0,0,0,11
1208061,892905,2019-08-14,Assembly,"Do pass",18,0,0,0,18
1208061,892906,2019-08-19,Assembly,"SB 309 Rubio Third Reading Urgency By Blanca Rubio",77,0,2,0,79
1208061,893813,2019-07-09,Assembly,"Do pass and be re-referred to the Committee on [Appropriations]",7,0,0,0,7
1208066,841663,2019-04-10,Assembly,"Do pass and be re-referred to the Committee on [Appropriations]",7,0,0,0,7
1208066,864920,2019-05-15,Assembly,"Do pass",13,0,5,0,18
1208068,842948,2019-04-10,Senate,"Do pass as amended",9,0,0,0,9
1208068,867778,2019-05-20,Senate,"Senate 3rd Reading SB305 Hueso et al",37,0,1,0,38
1208068,891404,2019-07-09,Assembly,"Do pass as amended",13,0,2,0,15
1208068,891405,2019-09-09,Assembly,"SB 305 Hueso Senate Third Reading By Gloria",76,0,3,0,79
1208068,891406,2019-09-11,Senate,"Unfinished Business SB305 Hueso et al. Concurrence",40,0,0,0,40
1208070,841681,2019-04-09,Assembly,"Do pass as amended and be re-referred to the Committee on [Appropriations]",9,0,0,0,9
1208072,841726,2019-04-10,Assembly,"Do pass and be re-referred to the Committee on [Appropriations]",6,1,0,0,7
1208072,865785,2019-05-16,Assembly,"Do pass as amended",13,4,1,0,18
1208072,874657,2019-05-29,Assembly,"AB 681 Gonzalez Third Reading Urgency",60,16,4,0,80
1208072,891467,2019-07-02,Senate,"Do pass, but first be re-referred to the Committee on [Appropriations]",4,1,0,0,5
1208072,891468,2019-08-12,Senate,"Placed on suspense file",7,0,0,0,7
1208072,891469,2019-08-30,Senate,"Do pass as amended",5,2,0,0,7
1208072,891470,2019-09-10,Senate,"Assembly 3rd Reading AB681 Gonzalez By Umberg Urgency Clause",29,11,0,0,40
1208072,893879,2019-09-13,Assembly,"With recommendation: That Senate amendments be concurred in",7,0,0,0,7
1208072,893946,2019-09-13,Assembly,"AB 681 Gonzalez Concurrence in Senate Amendments",65,13,1,0,79
1208072,894824,2019-08-30,Senate,Result,7,0,0,0,7
1208077,829130,2019-03-25,Assembly,"Do pass and be re-referred to the Committee on [Appropriations]",14,0,1,0,15
1208078,837593,2019-04-02,Assembly,"Do pass as amended and be re-referred to the Committee on [Appropriations]",15,0,0,0,15
1208078,905424,2020-01-23,Assembly,"Do pass",18,0,0,0,18
1208078,911993,2020-01-30,Assembly,"AB 683 Carrillo Assembly Third Reading",75,0,5,0,80
1208081,838880,2019-04-02,Assembly,"Do pass as amended and be re-referred to the Committee on [Appropriations]",15,0,0,0,15
1208081,866271,2019-05-16,Assembly,"Do pass",18,0,0,0,18
1208081,871391,2019-05-23,Assembly,"AB 678 Flora Assembly Third Reading",78,0,2,0,80
1208081,893020,2019-07-03,Senate,"Do pass as amended, but first amend, and re-refer to the Committee on [Appropriations] with the recommendation: To Consent Calendar",8,0,1,0,9
1208081,893021,2019-08-15,Senate,"Consent Calendar AB678",37,0,3,0,40
1208081,893022,2019-08-30,Assembly,"AB 678 Flora Concurrence in Senate Amendments",75,0,4,0,79
1208083,841618,2019-04-09,Assembly,"Do pass and be re-referred to the Committee on [Health]",6,1,1,0,8
1208083,850527,2019-04-23,Assembly,"Do pass and be re-referred to the Committee on [Appropriations]",11,0,4,0,15
1208083,865784,2019-05-16,Assembly,"Do pass as amended",14,4,0,0,18
1208083,875555,2019-05-30,Assembly,"AB 656 Eduardo Garcia Assembly Third Reading",60,13,7,0,80
1208083,893125,2019-07-03,Senate,"Do pass, but first be re-referred to the Committee on [Public Safety]",7,1,1,0,9
1208083,893126,2019-07-09,Senate,"Do pass, but first be re-referred to the Committee on [Appropriations]",5,1,1,0,7
1208083,893127,2019-08-12,Senate,"Placed on suspense file",7,0,0,0,7
1208083,894828,2019-05-30,Assembly,05/16/19,14,13,0,0,27
1208086,851252,2019-04-23,Assembly,"Do pass as amended, and be re-referred to the Committee on [Appropriations] with recommendation: To Consent Calendar",8,0,0,0,8
1208086,866025,2019-05-16,Assembly,"Do pass as amended",18,0,0,0,18
1208086,871446,2019-05-23,Assembly,"AB 627 Frazier Assembly Third Reading",76,0,4,0,80
1208086,887565,2019-06-24,Senate,"Do pass, but first be re-referred to the Committee on [Appropriations]",6,0,0,0,6
1208086,892956,2019-08-12,Senate,"Placed on suspense file",7,0,0,0,7
1208087,830043,2019-03-26,Assembly,"Do pass and be re-referred to the Committee on [Appropriations] with recommendation: To Consent Calendar",8,0,0,0,8
1208087,866774,2019-05-16,Assembly,"Do pass",18,0,0,0,18
1208087,873999,2019-05-28,Assembly,"AB 629 Smith Assembly Third Reading",75,0,5,0,80
1208087,887712,2019-06-25,Senate,"Do pass, but first be re-referred to the Committee on [Appropriations] with the recommendation: To Consent Calendar",7,0,0,0,7
1208087,893401,2019-07-08,Senate,"Placed on suspense file",7,0,0,0,7
1208087,893402,2019-08-30,Senate,"Do pass as amended",7,0,0,0,7
1208087,893403,2019-09-09,Senate,"Assembly 3rd Reading AB629 Smith et al. By Jackson",40,0,0,0,40
1208087,893404,2019-09-10,Assembly,"AB 629 Smith Concurrence in Senate Amendments",78,0,1,0,79
1208087,894766,2019-07-08,Senate,Result,7,0,0,0,7
1208090,831695,2019-03-27,Assembly,"Do pass and be re-referred to the Committee on [Appropriations]",10,0,1,0,11
1208090,866291,2019-05-16,Assembly,"Do pass",18,0,0,0,18
1208090,870047,2019-05-22,Assembly,"AB 635 Bigelow Assembly Third Reading",78,0,2,0,80
1208090,891564,2019-07-02,Senate,"Do pass, but first be re-referred to the Committee on [Appropriations]",5,0,0,0,5
1208090,891565,2019-08-15,Senate,"Assembly 3rd Reading AB635 Bigelow et al. By McGuire Urgency Clause",37,0,3,0,40
1208090,891566,2019-08-28,Assembly,"With recommendation: That Senate amendments be concurred in",9,0,2,0,11
1208090,891567,2019-08-30,Assembly,"AB 635 Bigelow Concurrence - Urgency Added",74,0,5,0,79
1208092,853017,2019-04-24,Assembly,"Do pass as amended and be re-referred to the Committee on [Appropriations]",5,2,0,0,7
1208092,865685,2019-05-16,Assembly,"Do pass as amended",13,5,0,0,18
1208092,873908,2019-05-28,Assembly,"AB 673 Carrillo Assembly Third Reading",51,19,10,0,80
1208092,887968,2019-06-26,Senate,"Do pass, but first be re-referred to the Committee on [Judiciary]",4,1,0,0,5
1208092,892917,2019-07-09,Senate,"Do pass as amended, but first amend, and re-refer to the Committee on [Appropriations]",7,0,2,0,9
1208092,892918,2019-08-12,Senate,"Placed on suspense file",7,0,0,0,7
1208092,892919,2019-08-30,Senate,"Do pass",5,2,0,0,7
1208092,892920,2019-09-05,Senate,"Assembly 3rd Reading AB673 Carrillo et al. By Monning",29,11,0,0,40
1208092,892921,2019-09-09,Assembly,"AB 673 Carrillo Concurrence in Senate Amendments",58,18,3,0,79
1208095,842794,2019-04-10,Assembly,"Do pass and be re-referred to the Committee on [Higher Education]",5,1,0,0,6
1208095,851706,2019-04-23,Assembly,"Do pass and be re-referred to the Committee on [Appropriations]",9,2,1,0,12
1208095,856843,2019-05-01,Assembly,"Do pass",13,4,1,0,18
1208095,862248,2019-05-09,Assembly,"AB 624 Gabriel Assembly Third Reading",58,14,8,0,80
1208095,893114,2019-07-03,Senate,"Do pass",5,1,1,0,7
1208095,893115,2019-09-03,Senate,"Assembly 3rd Reading AB624 Gabriel et al. By Rubio",29,11,0,0,40
1208095,893116,2019-09-05,Assembly,"AB 624 Gabriel Concurrence in Senate Amendments",61,14,4,0,79
1208095,896267,2019-09-03,Senate,"Assembly 3rd Reading AB624 Gabriel et al. By Rubiiv class=""statusCellData"">",5,11,0,0,16
1208096,856959,2019-04-30,Senate,"Do pass, but first be re-referred to the Committee on [Appropriations] with the recommendation: To Consent Calendar",9,0,0,0,9
1208096,863107,2019-05-13,Senate,"Placed on suspense file",6,0,0,0,6
1208096,865930,2019-05-16,Senate,"Do pass as amended",6,0,0,0,6
1208096,868748,2019-05-21,Senate,"Senate 3rd Reading SB318 Hertzberg",38,0,0,0,38
1208096,892120,2019-07-02,Assembly,"Do pass as amended and be re-referred to the Committee on [Insurance]",10,0,2,0,12
1208096,892121,2019-07-10,Assembly,"Do pass as amended",6,4,4,0,14
1208098,851352,2019-04-23,Senate,"Do pass, but first be re-referred to the Committee on [Housing]",7,2,0,0,9
1208098,855893,2019-04-30,Senate,"Do pass as amended",8,2,1,0,11
1208098,862121,2019-05-09,Senate,"Senate 3rd Reading SB326 Hill",28,8,2,0,38
1208098,884784,2019-06-19,Assembly,"Do pass as amended and be re-referred to the Committee on [Judiciary]",7,1,0,0,8
1208098,891995,2019-07-02,Assembly,"Do pass as amended",10,2,0,0,12
1208098,891996,2019-08-12,Assembly,"SB 326 Hill Senate Third Reading By Chiu",64,6,9,0,79
1208098,891997,2019-08-19,Senate,"Unfinished Business SB326 Hill Concurrence",32,5,3,0,40
1208101,830574,2019-03-26,Assembly,"Do pass and be re-referred to the Committee on [Appropriations]",15,0,0,0,15
1208103,851026,2019-04-22,Assembly,"Do pass and be re-referred to the Committee on [Appropriations]",9,1,1,0,11
1208103,856880,2019-05-01,Assembly,"Do pass",13,4,1,0,18
1208103,862271,2019-05-09,Assembly,"AB 660 Levine Assembly Third Reading",61,13,6,0,80
1208103,890957,2019-07-02,Senate,"Do pass as amended, but first amend, and re-refer to the Committee on [Appropriations]",7,3,3,0,13
1208103,975800,2020-08-13,Senate,"Do pass, but first be re-referred to the Committee on [Appropriations]",7,2,0,0,9
1208103,976183,2020-08-19,Senate,"Placed on suspense file",7,0,0,0,7
1208107,851304,2019-04-24,Senate,"Do pass, but first be re-referred to the Committee on [Appropriations]",4,2,1,0,7
1208107,863214,2019-05-13,Senate,"Placed on suspense file",6,0,0,0,6
1208107,866319,2019-05-16,Senate,"Do pass",5,1,0,0,6
1208107,868837,2019-05-21,Senate,"Senate 3rd Reading SB328 Portantino et al",24,9,5,0,38
1208107,892927,2019-07-10,Assembly,"Do pass and be re-referred to the Committee on [Appropriations]",4,1,2,0,7
1208107,892928,2019-08-30,Assembly,"Do pass",14,3,1,0,18
1208107,893938,2019-09-14,Assembly,"SB 328 Portantino Senate Third Reading By Gloria",44,20,15,0,79
1208112,839941,2019-04-09,Senate,"Do pass, but first be re-referred to the Committee on [Judiciary]",7,0,2,0,9
1208112,851273,2019-04-23,Senate,"Do pass as amended, but first amend, and re-refer to the Committee on [Appropriations]",7,0,2,0,9
1208112,867806,2019-05-20,Senate,"Senate 3rd Reading SB313 Hueso",34,0,4,0,38
1208112,883862,2019-06-18,Assembly,"Do pass as amended and be re-referred to the Committee on [Judiciary]",9,2,2,0,13
1208112,887617,2019-06-25,Assembly,"Do pass as amended and be re-referred to the Committee on [Appropriations]",9,1,2,0,12
1208112,891554,2019-08-30,Assembly,"Do pass",13,4,1,0,18
1208112,891555,2019-09-09,Assembly,"SB 313 Hueso Senate Third Reading By Eduardo Garcia",56,13,10,0,79
1208112,891556,2019-09-11,Senate,"Unfinished Business SB313 Hueso Concurrence",35,0,5,0,40
1208113,831735,2019-03-27,Senate,"Do pass, but first be re-referred to the Committee on [Appropriations]",8,0,1,0,9
1208113,852778,2019-04-25,Senate,"Senate 3rd Reading SB322 Bradford",36,0,2,0,38
1208113,880328,2019-06-11,Assembly,"Do pass and be re-referred to the Committee on [Appropriations]",14,0,1,0,15
1208113,884860,2019-06-19,Assembly,"Do pass. To Consent Calendar",17,0,1,0,18
1208113,888414,2019-06-27,Assembly,"SB 322 Bradford Consent Calendar Second Day Regular Session",71,0,8,0,79
1208116,831099,2019-03-26,Assembly,"Do pass as amended and be re-referred to the Committee on [Judiciary]",8,0,0,0,8
1208116,834005,2019-04-02,Assembly,"Do pass and be re-referred to the Committee on [Appropriations] with recommendation: To Consent Calendar",12,0,0,0,12
1208116,852552,2019-04-24,Assembly,"Do pass. To Consent Calendar",18,0,0,0,18
1208116,858171,2019-05-02,Assembly,"AB 686 Waldron Consent Calendar Second Day Regular Session",76,0,4,0,80
1208116,880825,2019-06-10,Senate,"Do pass, but first be re-referred to the Committee on [Judiciary] with the recommendation: To Consent Calendar",5,0,1,0,6
1208116,888285,2019-06-25,Senate,"Do pass, but first be re-referred to the Committee on [Appropriations] with the recommendation: To Consent Calendar",9,0,0,0,9
1208116,892840,2019-09-09,Senate,"Assembly 3rd Reading AB686 Waldron et al. By Rubio",40,0,0,0,40
1208116,892841,2019-09-10,Assembly,"AB 686 Waldron Concurrence in Senate Amendments",79,0,0,0,79
1208118,876985,2019-05-30,Assembly,"Be adopted. To third reading",10,0,2,0,12
1208118,886129,2019-06-20,Senate,"Special Consent ACR30",40,0,0,0,40
1208121,902812,2020-01-14,Assembly,"Do pass and be re-referred to the Committee on [Appropriations]",2,6,0,0,8
1208122,829283,2019-03-26,Assembly,"Do pass and be re-referred to the Committee on [Appropriations]",8,0,0,0,8
1208122,841294,2019-04-10,Assembly,"Do pass",15,0,3,0,18
1208122,853246,2019-04-25,Assembly,"AB 645 Irwin Assembly Third Reading",62,2,16,0,80
1208122,883946,2019-06-18,Senate,"Do pass, but first be re-referred to the Committee on [Appropriations]",5,1,1,0,7
1208122,892243,2019-08-26,Senate,"Assembly 3rd Reading AB645 Irwin By Portantino",29,4,7,0,40
1208122,892244,2019-08-30,Assembly,"AB 645 Irwin Concurrence in Senate Amendments",60,7,12,0,79
1208124,852721,2019-04-24,Assembly,"Do pass and be re-referred to the Committee on [Judiciary]",7,0,1,0,8
1208124,855880,2019-04-30,Assembly,"Do pass",12,0,0,0,12
1208124,859610,2019-05-06,Assembly,"AB 670 Friedman Assembly Third Reading",74,0,6,0,80
1208124,877860,2019-06-04,Senate,"Do pass, but first be re-referred to the Committee on [Judiciary]",8,0,3,0,11
1208124,884698,2019-06-18,Senate,"Do pass",9,0,0,0,9
1208124,892432,2019-08-12,Senate,"Assembly 3rd Reading AB670 Friedman et al. By Wieckowski",39,0,1,0,40
1208124,892433,2019-08-15,Assembly,"AB 670 Friedman Concurrence in Senate Amendments",74,0,5,0,79
1208127,837291,2019-04-03,Assembly,"Do pass",8,0,0,0,8
1208127,849238,2019-04-22,Assembly,"AB 631 McCarty Assembly Third Reading",76,0,4,0,80
1208127,887626,2019-06-25,Senate,"Do pass and be ordered to the Consent Calendar",13,0,0,0,13
1208127,889319,2019-07-01,Senate,"Consent Calendar AB631",39,0,1,0,40
1208129,829284,2019-03-26,Assembly,"Do pass and be re-referred to the Committee on [Appropriations] with recommendation: To Consent Calendar",12,0,0,0,12
1208129,866196,2019-05-16,Assembly,"Do pass",18,0,0,0,18
1208129,871614,2019-05-23,Assembly,"AB 677 Choi Assembly Third Reading",78,0,2,0,80
1208129,885207,2019-06-18,Senate,"Do pass, but first be re-referred to the Committee on [Appropriations] with the recommendation: To Consent Calendar",9,0,0,0,9
1208129,890413,2019-07-01,Senate,"Placed on suspense file",7,0,0,0,7
1208129,890414,2019-08-30,Senate,"Do pass as amended",7,0,0,0,7
1208129,890415,2019-09-04,Senate,"Assembly 3rd Reading AB677 Choi et al. By Borgeas",40,0,0,0,40
1208129,890416,2019-09-09,Assembly,"AB 677 Choi Concurrence in Senate Amendments",79,0,0,0,79
1208131,841969,2019-04-09,Assembly,"Do pass and be re-referred to the Committee on [Appropriations] with recommendation: To Consent Calendar",8,0,0,0,8
1208133,837259,2019-04-03,Assembly,"Do pass and be re-referred to the Committee on [Appropriations]",20,0,1,0,21
1208133,851707,2019-04-24,Assembly,"Do pass. To Consent Calendar",18,0,0,0,18
1208133,858000,2019-05-02,Assembly,"AB 649 Cristina Garcia Consent Calendar Second Day Regular Session",76,0,4,0,80
1208133,890866,2019-07-09,Senate,"Do pass, but first be re-referred to the Committee on [Appropriations]",14,0,2,0,16
1208133,890867,2019-08-12,Senate,"Placed on suspense file",7,0,0,0,7
1208133,890868,2019-08-30,Senate,"Do pass",7,0,0,0,7
1208133,890869,2019-09-10,Senate,"Assembly 3rd Reading AB649 Cristina Garcia By Archuleta",35,0,5,0,40
1208133,890870,2019-09-11,Assembly,"AB 649 Cristina Garcia Concurrence in Senate Amendments",78,0,1,0,79
1208139,829450,2019-03-26,Assembly,"Do pass and be re-referred to the Committee on [Appropriations]",10,0,4,0,14
1208139,865878,2019-05-16,Assembly,"Do pass",14,0,4,0,18
1208139,873800,2019-05-28,Assembly,"AB 658 Arambula Assembly Third Reading",67,0,13,0,80
1208139,892664,2019-07-09,Senate,"Do pass as amended, but first amend, and re-refer to the Committee on [Appropriations]",8,0,1,0,9
1208139,892665,2019-08-12,Senate,"Placed on suspense file",7,0,0,0,7
1208139,892666,2019-08-30,Senate,"Do pass",7,0,0,0,7
1208139,892667,2019-09-11,Senate,"Assembly 3rd Reading AB658 Arambula et al. By Caballero",40,0,0,0,40
1208139,893683,2019-09-12,Assembly,"AB 658 Arambula Concurrence in Senate Amendments",77,0,2,0,79
1208139,895571,2019-09-11,Senate,"Assembly 3rd Reading AB658 Arambula et al. By Call"">",7,0,0,0,7
1208143,851479,2019-04-23,Assembly,"Do pass and be re-referred to the Committee on [Appropriations] with recommendation: To Consent Calendar",8,0,0,0,8
1208148,836999,2019-04-03,Senate,"Do pass, but first be re-referred to the Committee on [Appropriations]",7,0,0,0,7
1208148,855015,2019-04-29,Senate,"Placed on suspense file",6,0,0,0,6
1208148,866456,2019-05-16,Senate,"Do pass as amended",6,0,0,0,6
1208148,871367,2019-05-23,Senate,"Senate 3rd Reading SB317 Caballero et al",38,0,0,0,38
1208148,884625,2019-06-18,Assembly,"Do pass and be re-referred to the Committee on [Appropriations]",8,0,0,0,8
1208148,893551,2019-08-30,Assembly,"Do pass as amended",18,0,0,0,18
1208148,893552,2019-09-09,Assembly,"SB 317 Caballero Senate Third Reading By Grayson",79,0,0,0,79
1208148,893553,2019-09-10,Senate,"Unfinished Business SB317 Caballero et al. Concurrence",40,0,0,0,40
1208149,834137,2019-04-02,Assembly,"Do pass and be re-referred to the Committee on [Appropriations] with recommendation: To Consent Calendar",20,0,0,0,20
1208149,841780,2019-04-10,Assembly,"Do pass. To Consent Calendar",17,0,1,0,18
1208149,853286,2019-04-25,Assembly,"AB 630 Low Consent Calendar Second Day Regular Session",76,0,4,0,80
1208149,879890,2019-06-10,Senate,"Do pass, but first be re-referred to the Committee on [Appropriations]",9,0,0,0,9
1208149,894213,2019-08-19,Senate,"Assembly 3rd Reading AB630 Arambula et al. By Hill",39,0,1,0,40
1208149,894214,2019-08-22,Assembly,"AB 630 Arambula Concurrence in Senate Amendments",75,0,4,0,79
1208152,841544,2019-04-10,Assembly,"Do pass as amended and be re-referred to the Committee on [Banking and Finance]",6,1,1,0,8
1208152,848890,2019-04-22,Assembly,"Do pass",11,0,1,0,12
1208152,854806,2019-04-29,Assembly,"AB 689 McCarty Assembly Third Reading",65,0,15,0,80
1208152,888112,2019-06-26,Senate,"Do pass",5,0,2,0,7
1208152,892565,2019-08-19,Senate,"Assembly 3rd Reading AB689 McCarty et al. By Pan",32,1,7,0,40
1208152,892566,2019-08-22,Assembly,"AB 689 McCarty Concurrence in Senate Amendments",65,0,14,0,79
1208154,853645,2019-04-24,Senate,"Do pass and be ordered to the Consent Calendar",7,0,0,0,7
1208154,858312,2019-05-02,Senate,"Consent Calendar SB324",38,0,0,0,38
1208154,884655,2019-06-19,Assembly,"Do pass. To Consent Calendar",8,0,0,0,8
1208154,888456,2019-06-27,Assembly,"SB 324 Rubio Consent Calendar Second Day Regular Session",71,0,8,0,79
1208157,829263,2019-03-26,Assembly,"Do pass and be re-referred to the Committee on [Appropriations]",14,0,0,0,14
1208157,865931,2019-05-16,Assembly,"Do pass as amended",18,0,0,0,18
1208157,870455,2019-05-22,Assembly,"AB 638 Gray Assembly Third Reading",78,0,2,0,80
1208157,890841,2019-07-09,Senate,"Do pass as amended, but first amend, and re-refer to the Committee on [Appropriations]",8,0,1,0,9
1208157,890842,2019-08-12,Senate,"Placed on suspense file",7,0,0,0,7
1208157,890843,2019-08-30,Senate,"Do pass as amended",7,0,0,0,7
1208157,890844,2019-09-04,Senate,"Assembly 3rd Reading AB638 Gray By Caballero",40,0,0,0,40
1208157,890845,2019-09-09,Assembly,"AB 638 Gray Concurrence in Senate Amendments",79,0,0,0,79
1208157,894104,2019-08-12,Senate,Result,8,0,0,0,8
1208158,829238,2019-03-26,Assembly,"Do pass as amended. To Consent Calendar",12,0,0,0,12
1208158,836487,2019-04-04,Assembly,"AB 622 Chen Consent Calendar Second Day Regular Session",75,0,5,0,80
1208158,877654,2019-06-04,Senate,"Do pass and be ordered to the Consent Calendar",9,0,0,0,9
1208158,882829,2019-06-17,Senate,"Consent Calendar AB622",40,0,0,0,40
1208160,857629,2019-05-01,Assembly,"Do pass. To Consent Calendar",7,0,0,0,7
1208160,862352,2019-05-09,Assembly,"AB 623 Berman Consent Calendar Second Day Regular Session",76,0,4,0,80
1208160,891016,2019-07-02,Senate,"Do pass, but first be re-referred to the Committee on [Appropriations] with the recommendation: To Consent Calendar",5,0,0,0,5
1208160,891017,2019-08-12,Senate,"Placed on suspense file",7,0,0,0,7
1208160,891018,2019-08-30,Senate,"Do pass",7,0,0,0,7
1208160,891019,2019-09-11,Senate,"Assembly 3rd Reading AB623 Berman By Stern",37,1,2,0,40
1208160,893693,2019-09-12,Assembly,"AB 623 Berman Concurrence in Senate Amendments",77,0,2,0,79
1208163,829566,2019-03-26,Senate,"Do pass and be ordered to the Consent Calendar",8,0,0,0,8
1208163,836668,2019-04-04,Senate,"Consent Calendar SB314",37,0,1,0,38
1208163,877674,2019-06-04,Assembly,"Do pass. To Consent Calendar",11,0,1,0,12
1208163,879889,2019-06-10,Assembly,"SB 314 Dodd Consent Calendar Second Day",75,0,5,0,80
1208167,851762,2019-04-23,Senate,"Do pass, but first be re-referred to the Committee on [Appropriations]",7,0,0,0,7
1208167,863275,2019-05-13,Senate,"Placed on suspense file",6,0,0,0,6
1208167,865843,2019-05-16,Senate,"Do pass",6,0,0,0,6
1208167,871267,2019-05-23,Senate,"Special Consent SB312",38,0,0,0,38
1208167,967415,2020-06-18,Assembly,"Be re-referred to the Committee on [Environmental Safety and Toxic Materials]",9,0,3,0,12
1208167,974471,2020-07-30,Assembly,"Do pass and be re-referred to the Committee on [Appropriations]",7,0,2,0,9
1208167,975524,2020-08-11,Assembly,"Do pass",15,0,2,0,17
1208167,976729,2020-08-25,Assembly,"SB 312 Leyva Senate Third Reading By Quirk",72,0,7,0,79
1208167,977337,2020-08-28,Senate,"Unfinished Business SB312 Leyva Concurrence",37,1,2,0,40
1208169,839903,2019-04-08,Assembly,"Do pass as amended and be re-referred to the Committee on [Appropriations]",10,0,1,0,11
1208169,866293,2019-05-16,Assembly,"Do pass",18,0,0,0,18
1208169,873855,2019-05-28,Assembly,"AB 661 McCarty Assembly Third Reading",76,0,4,0,80
1208169,884760,2019-06-19,Senate,"Do pass as amended, but first amend, and re-refer to the Committee on [Appropriations] with the recommendation: To Consent Calendar",7,0,0,0,7
1208169,890501,2019-07-08,Senate,"Placed on suspense file",7,0,0,0,7
1208169,890502,2019-08-30,Senate,"Do pass as amended",7,0,0,0,7
1208169,890503,2019-09-04,Senate,"Assembly 3rd Reading AB661 McCarty By Pan",40,0,0,0,40
1208169,890504,2019-09-09,Assembly,"AB 661 McCarty Concurrence in Senate Amendments",79,0,0,0,79
1208172,829410,2019-03-25,Assembly,"Do pass and be re-referred to the Committee on [Appropriations]",14,0,1,0,15
1208174,836602,2019-04-03,Assembly,"Do pass and be re-referred to the Committee on [Judiciary]",5,0,2,0,7
1208174,839860,2019-04-09,Assembly,"Do pass as amended and be re-referred to the Committee on [Appropriations]",8,3,1,0,12
1208174,866496,2019-05-16,Assembly,"Do pass as amended",12,0,6,0,18
1208174,874569,2019-05-29,Assembly,"AB 628 Bonta Assembly Third Reading",36,15,29,0,80
1208175,834988,2019-04-02,Senate,"Do pass, but first be re-referred to the Committee on [Judiciary]",5,1,1,0,7
1208175,851341,2019-04-23,Senate,"Do pass as amended, but first amend, and re-refer to the Committee on [Appropriations]",5,2,2,0,9
1208175,863101,2019-05-13,Senate,"Placed on suspense file",6,0,0,0,6
1208175,866127,2019-05-16,Senate,"Do pass as amended",4,2,0,0,6
1208175,873848,2019-05-28,Senate,"Senate 3rd Reading SB310 Skinner",27,10,1,0,38
1208175,887505,2019-06-25,Assembly,"Do pass and be re-referred to the Committee on [Appropriations]",7,2,3,0,12
1208175,891803,2019-08-28,Assembly,"Do pass",10,5,3,0,18
1208175,893251,2019-09-09,Assembly,"SB 310 Skinner Senate Third Reading By Kalra",47,26,6,0,79
1208175,893252,2019-09-11,Senate,"Unfinished Business SB310 Skinner Concurrence",29,10,1,0,40
1208178,841694,2019-04-10,Assembly,"Do pass and be re-referred to the Committee on [Local Government]",8,0,0,0,8
1208178,853381,2019-04-24,Assembly,"Do pass and be re-referred to the Committee on [Appropriations]",8,0,0,0,8
1208178,866298,2019-05-16,Assembly,"Do pass",18,0,0,0,18
1208178,869969,2019-05-22,Assembly,"AB 671 Friedman Assembly Third Reading",76,0,4,0,80
1208178,884074,2019-06-18,Senate,"Do pass as amended, but first amend, and re-refer to the Committee on [Appropriations]",10,0,1,0,11
1208178,889251,2019-07-01,Senate,"Placed on suspense file",7,0,0,0,7
1208178,890505,2019-08-30,Senate,"Do pass",7,0,0,0,7
1208178,890506,2019-09-10,Senate,"Assembly 3rd Reading AB671 Friedman By Beall",40,0,0,0,40
1208178,890507,2019-09-11,Assembly,"AB 671 Friedman Concurrence in Senate Amendments",78,1,0,0,79
1208180,841725,2019-04-10,Assembly,"Do pass and be re-referred to the Committee on [Appropriations]",5,1,1,0,7
1208180,905403,2020-01-23,Assembly,"Do pass as amended",12,5,1,0,18
1208180,912010,2020-01-30,Assembly,"AB 646 McCarty Assembly Third Reading",48,20,12,0,80
1208180,974830,2020-08-04,Senate,"Do pass, but first be re-referred to the Committee on [Appropriations]",4,1,0,0,5
1208180,975788,2020-08-13,Senate,"Placed on suspense file",7,0,0,0,7
1208180,976413,2020-08-20,Senate,"Do pass",5,2,0,0,7
1208180,977317,2020-08-28,Senate,"Assembly 3rd Reading AB646 McCarty et al. By Hertzberg",29,10,1,0,40
1208180,977917,2020-08-30,Assembly,"AB 646 McCarty Concurrence in Senate Amendments",51,16,12,0,79
1208183,829278,2019-03-26,Assembly,"Do pass and be re-referred to the Committee on [Appropriations]",6,1,1,0,8
1208183,865882,2019-05-16,Assembly,"Do pass as amended",18,0,0,0,18
1208183,873943,2019-05-28,Assembly,"AB 663 Cunningham Assembly Third Reading",71,4,5,0,80
1208183,887585,2019-06-25,Senate,"Do pass, but first be re-referred to the Committee on [Appropriations]",7,0,0,0,7
1208183,891662,2019-07-08,Senate,"Placed on suspense file",7,0,0,0,7
1208183,894662,2019-05-16,Assembly,Result,18,0,0,0,18
1208184,829136,2019-03-26,Assembly,"Do pass and be re-referred to the Committee on [Appropriations]",5,2,1,0,8
1208186,834492,2019-03-27,Senate,"Do pass as amended, and be ordered to the Consent Calendar",7,0,0,0,7
1208186,870001,2019-05-22,Senate,"Senate 3rd Reading SB316 Rubio et al",35,1,2,0,38
1208186,886063,2019-06-19,Assembly,"Do pass and be re-referred to the Committee on [Appropriations]",7,0,0,0,7
1208186,891207,2019-07-03,Assembly,"Do pass",17,0,1,0,18
1208186,891208,2019-08-19,Assembly,"SB 316 Rubio Senate Third Reading By Quirk-Silva",75,0,4,0,79
1208186,891209,2019-08-22,Senate,"Unfinished Business SB316 Rubio et al. Concurrence",38,0,2,0,40
1208189,862350,2019-05-09,Assembly,"Be adopted. To third reading",11,0,1,0,12
1208189,875619,2019-05-30,Senate,"Special Consent ACR29 Salas et al",38,0,0,0,38
1208191,867684,2019-04-30,Senate,"Do pass as amended",3,3,3,0,9
1208191,867685,2019-04-30,Senate,"[First] hearing set for [05-01-2019]: Failed passage in Committee. Reconsideration granted",9,0,0,0,9
1208193,854840,2019-04-23,Senate,"Do pass as amended, but first amend, and re-refer to the Committee on [Appropriations]",7,0,0,0,7
1208193,863208,2019-05-13,Senate,"Placed on suspense file",6,0,0,0,6
1208193,866141,2019-05-16,Senate,"Do pass",6,0,0,0,6
1208193,871034,2019-05-23,Senate,"Special Consent SB304",38,0,0,0,38
1208193,887540,2019-06-25,Assembly,"Do pass",8,0,0,0,8
1208193,892877,2019-08-15,Assembly,"SB 304 Hill Senate Third Reading By Mullin",76,0,3,0,79
1208195,841698,2019-04-09,Assembly,"Do pass and be re-referred to the Committee on [Public Safety]",15,0,0,0,15
1208195,850505,2019-04-23,Assembly,"Do pass and be re-referred to the Committee on [Appropriations]",8,0,0,0,8
1208198,830496,2019-03-26,Senate,"Do pass and be ordered to the Consent Calendar",8,0,0,0,8
1208198,836648,2019-04-04,Senate,"Consent Calendar SB308",37,0,1,0,38
1208198,884367,2019-06-18,Assembly,"Do pass. To Consent Calendar",12,0,0,0,12
1208198,887015,2019-06-24,Assembly,"SB 308 Jones Consent Calendar Second Day",77,0,2,0,79
1208200,834383,2019-04-01,Assembly,"Do pass and be re-referred to the Committee on [Appropriations]",10,0,5,0,15
1208200,852110,2019-04-24,Assembly,"Do pass",14,0,4,0,18
1208200,862384,2019-05-09,Assembly,"AB 634 Salas Assembly Third Reading",72,0,8,0,80
1208200,880296,2019-06-11,Senate,"Do pass, but first be re-referred to the Committee on [Appropriations] with the recommendation: To Consent Calendar",11,0,1,0,12
1208200,889283,2019-07-01,Senate,"Consent Calendar AB634",39,0,1,0,40
1208201,851675,2019-04-23,Assembly,"Do pass and be re-referred to the Committee on [Appropriations]",15,0,0,0,15
1208201,865696,2019-05-16,Assembly,"Do pass",18,0,0,0,18
1208201,870102,2019-05-22,Assembly,"AB 651 Grayson Assembly Third Reading",78,0,2,0,80
1208201,891359,2019-07-10,Senate,"Do pass, but first be re-referred to the Committee on [Appropriations]",8,0,1,0,9
1208201,891360,2019-08-12,Senate,"Placed on suspense file",7,0,0,0,7
1208201,891361,2019-08-30,Senate,"Do pass as amended",7,0,0,0,7
1208201,893983,2019-09-13,Assembly,"AB 651 Grayson Concurrence in Senate Amendments",79,0,0,0,79
1208201,894210,2019-09-13,Senate,"Assembly 3rd Reading AB651 Grayson et al. By Dodd",40,0,0,0,40
1208204,848850,2019-04-09,Senate,"Do pass as amended, but first amend, and re-refer to the Committee on [Appropriations]",5,1,3,0,9
1208204,859494,2019-05-06,Senate,"Placed on suspense file",5,0,1,0,6
1208204,865982,2019-05-16,Senate,"Do pass",4,2,0,0,6
1208204,868783,2019-05-21,Senate,"Senate 3rd Reading SB307 Roth et al",21,11,6,0,38
1208204,879824,2019-06-10,Assembly,"Do pass and be re-referred to the Committee on [Appropriations]",7,2,2,0,11
1208204,890635,2019-07-10,Assembly,"Do pass",12,4,2,0,18
1208204,890636,2019-07-11,Assembly,"SB 307 Roth Senate Third Reading By FRIEDMAN",50,24,5,0,79
1208209,853093,2019-04-24,Assembly,"Do pass and be re-referred to the Committee on [Appropriations]",8,0,0,0,8
1208209,866547,2019-05-16,Assembly,"Do pass",18,0,0,0,18
1208209,870207,2019-05-22,Assembly,"AB 684 Levine Assembly Third Reading",77,0,3,0,80
1208209,893381,2019-07-02,Senate,"Do pass, but first be re-referred to the Committee on [Appropriations] with the recommendation: To Consent Calendar",11,0,0,0,11
1208209,893382,2019-08-12,Senate,"Placed on suspense file",7,0,0,0,7
1208209,893383,2019-08-30,Senate,"Do pass",7,0,0,0,7
1208209,893384,2019-09-09,Senate,"Special Consent AB684",40,0,0,0,40
1208209,893385,2019-09-10,Assembly,"AB 684 Levine Concurrence in Senate Amendments",78,0,1,0,79
1208210,836005,2019-04-02,Senate,"Do pass, but first be re-referred to the Committee on [Appropriations] with the recommendation: To Consent Calendar",8,0,0,0,8
1208210,853102,2019-04-25,Senate,"Consent Calendar SB306",37,0,1,0,38
1208210,893558,2019-07-02,Assembly,"Do pass and be re-referred to the Committee on [Appropriations] with recommendation: To Consent Calendar",12,0,0,0,12
1208210,893559,2019-08-14,Assembly,"Do pass",18,0,0,0,18
1208210,893560,2019-09-03,Assembly,"SB 306 Morrell Senate Third Reading By Obernolte",77,0,2,0,79
1208210,893561,2019-09-04,Senate,"Unfinished Business SB306 Morrell Concurrence",40,0,0,0,40
1208214,842871,2019-04-10,Assembly,"Do pass. To Consent Calendar",8,0,0,0,8
1208214,853444,2019-04-25,Assembly,"AB 632 Aguiar-Curry Consent Calendar Second Day Regular Session",76,0,4,0,80
1208214,884868,2019-06-19,Senate,"Do pass",6,1,0,0,7
1208214,888593,2019-06-27,Senate,"Assembly 3rd Reading AB632 Aguiar-Curry et al. By McGuire",36,1,3,0,40
1208216,830612,2019-03-26,Assembly,"Do pass and be re-referred to the Committee on [Judiciary] with recommendation: To Consent Calendar",8,0,0,0,8
1208216,833512,2019-04-02,Assembly,"Do pass and be re-referred to the Committee on [Appropriations] with recommendation: To Consent Calendar",12,0,0,0,12
1208216,866229,2019-05-16,Assembly,"Do pass",18,0,0,0,18
1208216,871574,2019-05-23,Assembly,"AB 685 Reyes Assembly Third Reading",78,0,2,0,80
1208216,974902,2020-08-05,Senate,"Do pass, but first be re-referred to the Committee on [Appropriations]",4,1,0,0,5
1208216,975817,2020-08-13,Senate,"Placed on suspense file",7,0,0,0,7
1208216,976338,2020-08-20,Senate,"Do pass as amended",5,2,0,0,7
1208216,977483,2020-08-31,Assembly,"With recommendation: That Senate amendments be concurred in",5,2,0,0,7
1208216,977861,2020-08-30,Senate,"Assembly 3rd Reading AB685 Reyes By Gonzalez",26,9,5,0,40
1208216,977862,2020-08-31,Assembly,"AB 685 REYES Concurrence in Senate Amendments",52,17,10,0,79
1208219,857398,2019-05-01,Assembly,"Do pass. To Consent Calendar",7,0,0,0,7
1208219,862318,2019-05-09,Assembly,"AB 679 Gonzalez Consent Calendar Second Day Regular Session",76,0,4,0,80
1208219,878256,2019-06-04,Senate,"Do pass",4,1,0,0,5
1208219,888553,2019-06-27,Senate,"Assembly 3rd Reading AB679 Gonzalez By Hertzberg",26,6,8,0,40
1208220,832076,2019-03-28,Senate,"Senate 3rd Reading SCR15 Chang et al",37,0,1,0,38
1208220,838371,2019-04-08,Assembly,"Be adopted. To Consent Calendar",11,0,1,0,12
1208220,842970,2019-04-11,Assembly,"SCR 15 Chang Consent Calendar Second Day Regular Session",72,0,8,0,80
1208222,843076,2019-04-10,Senate,"Do pass as amended, but first amend, and re-refer to the Committee on [Appropriations]",9,0,0,0,9
1208222,854207,2019-04-29,Senate,"Placed on suspense file",6,0,0,0,6
1208222,865635,2019-05-16,Senate,"Do pass as amended",6,0,0,0,6
1208222,871173,2019-05-23,Senate,"Senate 3rd Reading SB325 Hill",38,0,0,0,38
1208222,887480,2019-06-25,Assembly,"Do pass and be re-referred to the Committee on [Business and Professions] with recommendation: To Consent Calendar",15,0,0,0,15
1208225,835837,2019-04-02,Assembly,"Do pass and be re-referred to the Committee on [Judiciary]",19,0,1,0,20
1208225,902817,2020-01-14,Assembly,"Do pass and be re-referred to the Committee on [Appropriations]",11,0,0,0,11
1208225,905423,2020-01-23,Assembly,"Do pass",18,0,0,0,18
1208225,912001,2020-01-30,Assembly,"AB 687 Daly Assembly Third Reading",56,0,24,0,80
1208231,851432,2019-04-24,Assembly,"Do pass and be re-referred to the Committee on [Appropriations] with recommendation: To Consent Calendar",7,0,0,0,7
1208231,856920,2019-05-01,Assembly,"Do pass. To Consent Calendar",18,0,0,0,18
1208231,862292,2019-05-09,Assembly,"AB 672 Cervantes Consent Calendar Second Day Regular Session",76,0,4,0,80
1208231,881311,2019-06-12,Senate,"Do pass, but first be re-referred to the Committee on [Appropriations] with the recommendation: To Consent Calendar",5,0,0,0,5
1208231,894365,2019-07-01,Senate,"Consent Calendar AB672",39,0,1,0,40
1208233,840008,2019-04-08,Senate,"Do pass, but first be re-referred to the Committee on [Education]",6,0,0,0,6
1208233,851473,2019-04-24,Senate,"Do pass, but first be re-referred to the Committee on [Appropriations] with the recommendation: To Consent Calendar",7,0,0,0,7
1208233,859536,2019-05-06,Senate,"Placed on suspense file",5,0,1,0,6
1208233,866177,2019-05-16,Senate,"Do pass",6,0,0,0,6
1208233,871054,2019-05-23,Senate,"Special Consent SB321",38,0,0,0,38
1208236,841866,2019-04-10,Assembly,"Do pass and be re-referred to the Committee on [Veterans Affairs]",7,0,0,0,7
1208236,850939,2019-04-23,Assembly,"Do pass and be re-referred to the Committee on [Appropriations]",11,0,0,0,11
1208236,856813,2019-05-01,Assembly,"Do pass. To Consent Calendar",18,0,0,0,18
1208236,862295,2019-05-09,Assembly,"AB 653 Bloom Consent Calendar Second Day Regular Session",76,0,4,0,80
1208236,880580,2019-06-11,Senate,"Do pass, but first be re-referred to the Committee on [Veterans Affairs]",14,0,2,0,16
1208236,887985,2019-06-25,Senate,"Do pass, but first be re-referred to the Committee on [Appropriations]",6,0,1,0,7
1208236,890834,2019-08-19,Senate,"Assembly 3rd Reading AB653 Bloom et al. By Allen",40,0,0,0,40
1208236,890835,2019-08-22,Assembly,"AB 653 Bloom Concurrence in Senate Amendments",76,0,3,0,79
1208237,842963,2019-04-10,Assembly,"Do pass and be re-referred to the Committee on [Appropriations]",6,0,0,0,6
1208240,829264,2019-03-26,Assembly,"Do pass and be re-referred to the Committee on [Appropriations] with recommendation: To Consent Calendar",8,0,0,0,8
1208240,865675,2019-05-16,Assembly,"Do pass",18,0,0,0,18
1208240,873897,2019-05-28,Assembly,"AB 662 Cunningham Assembly Third Reading",76,0,4,0,80
1208240,887592,2019-06-25,Senate,"Do pass, but first be re-referred to the Committee on [Appropriations] with the recommendation: To Consent Calendar",7,0,0,0,7
1208240,892751,2019-07-08,Senate,"Placed on suspense file",7,0,0,0,7
1208240,892752,2019-08-30,Senate,"Do pass",7,0,0,0,7
1208240,892753,2019-09-09,Senate,"Special Consent AB662",40,0,0,0,40
1208242,856916,2019-04-30,Senate,"Do pass, but first be re-referred to the Committee on [Appropriations]",7,2,0,0,9
1208242,863181,2019-05-13,Senate,"Placed on suspense file",6,0,0,0,6
1208242,866325,2019-05-16,Senate,"Do pass as amended",4,2,0,0,6
1208242,871438,2019-05-23,Senate,"Senate 3rd Reading SB329 Mitchell et al",24,11,3,0,38
1208242,884568,2019-06-19,Assembly,"Do pass and be re-referred to the Committee on [Judiciary]",5,1,2,0,8
1208242,887420,2019-06-25,Assembly,"Do pass",7,3,2,0,12
1208242,892437,2019-08-30,Assembly,"Do pass",11,5,2,0,18
1208242,892438,2019-09-10,Assembly,"SB 329 Mitchell Senate Third Reading By Gloria",46,21,12,0,79
1208242,892439,2019-09-11,Senate,"Unfinished Business SB329 Mitchell et al. Concurrence",25,12,3,0,40
1208246,830425,2019-03-26,Assembly,"Do pass as amended, and be re-referred to the Committee on [Appropriations] with recommendation: To Consent Calendar",8,0,0,0,8
1208246,866449,2019-05-16,Assembly,"Do pass",18,0,0,0,18
1208246,874235,2019-05-28,Assembly,"AB 680 Chu Assembly Third Reading",76,0,4,0,80
1208246,891494,2019-07-02,Senate,"Do pass, but first be re-referred to the Committee on [Appropriations]",7,0,0,0,7
1208246,891495,2019-08-19,Senate,"Placed on suspense file",5,0,2,0,7
1208248,836575,2019-04-03,Assembly,"Do pass and be re-referred to the Committee on [Appropriations]",7,0,0,0,7
1208248,866041,2019-05-16,Assembly,"Do pass",14,4,0,0,18
1208248,874556,2019-05-29,Assembly,"AB 625 Kalra Assembly Third Reading",61,16,3,0,80
1208248,887969,2019-06-26,Senate,"Do pass, but first be re-referred to the Committee on [Appropriations]",4,1,0,0,5
1208248,891503,2019-07-08,Senate,"Placed on suspense file",7,0,0,0,7
1208248,891504,2019-08-30,Senate,"Do pass",5,2,0,0,7
1208248,891505,2019-09-03,Senate,"Assembly 3rd Reading AB625 Kalra By Monning",29,11,0,0,40
1208251,851444,2019-04-24,Assembly,"Do pass and be re-referred to the Committee on [Appropriations] with recommendation: To Consent Calendar",7,0,0,0,7
1208251,856859,2019-05-01,Assembly,"Do pass. To Consent Calendar",18,0,0,0,18
1208251,862138,2019-05-09,Assembly,"AB 644 P.E. & R. Consent Calendar Second Day Regular Session",76,0,4,0,80
1208251,881014,2019-06-12,Senate,"Do pass, but first be re-referred to the Committee on [Appropriations] with the recommendation: To Consent Calendar",5,0,0,0,5
1208251,889289,2019-07-01,Senate,"Consent Calendar AB644 P.E. & R",39,0,1,0,40
1208255,855845,2019-04-30,Assembly,"Be adopted. To third reading",13,0,0,0,13
1208255,859584,2019-05-06,Assembly,"AJR 8 Quirk Assembly Third Reading",75,0,5,0,80
1208255,880551,2019-06-11,Senate,"Be adopted, but first be re-referred to the Committee on [Appropriations] with recommendation: To Consent Calendar",8,0,1,0,9
1208255,891362,2019-07-01,Senate,"Consent Calendar AJR8",39,0,1,0,40
1208255,891363,2019-07-08,Assembly,"AJR 8 Quirk Concurrence in Senate Amendments",76,0,3,0,79
1208257,850507,2019-04-22,Senate,"Do pass, but first be re-referred to the Committee on [Appropriations]",9,0,0,0,9
1208257,859598,2019-05-06,Senate,"Placed on suspense file",5,0,1,0,6
1208257,865665,2019-05-16,Senate,"Do pass",6,0,0,0,6
1208257,870967,2019-05-23,Senate,"Special Consent SB315",38,0,0,0,38
1208257,889295,2019-07-01,Assembly,"Be re-referred to the Committee on [Revenue and Taxation]",11,0,1,0,12
1208257,894975,2019-05-23,Senate,05/16/19,5,0,0,0,5
1208257,895248,2019-05-06,Senate,Result,5,0,0,0,5
1208257,969998,2020-06-29,Assembly,"Be re-referred to the Committee on [Public Safety]",7,0,5,0,12
1208257,974959,2020-08-05,Assembly,"Do pass and be re-referred to the Committee on [Appropriations]",5,2,1,0,8
1208260,834488,2019-04-01,Assembly,"Do pass and be re-referred to the Committee on [Privacy and Consumer Protection]",9,3,0,0,12
1208260,851765,2019-04-23,Assembly,"Do pass as amended and be re-referred to the Committee on [Appropriations]",8,2,1,0,11
1208260,866239,2019-05-16,Assembly,"Do pass",13,4,1,0,18
1208260,869840,2019-05-22,Assembly,"AB 642 Limón Assembly Third Reading",54,16,10,0,80
1208260,893930,2019-07-10,Senate,"Do pass as amended, but first amend, and re-refer to the Committee on [Appropriations]",3,2,2,0,7
1208260,893931,2019-07-10,Senate,"[07-10-2019] hearing: Motion to Reconsider. [Reconsideration Granted.]",6,0,1,0,7
1208262,830351,2019-03-26,Assembly,"Do pass as amended and be re-referred to the Committee on [Labor and Employment]",10,3,2,0,15
1208262,836642,2019-04-03,Assembly,"Do pass and be re-referred to the Committee on [Appropriations]",6,1,0,0,7
1208262,905435,2020-01-23,Assembly,"Do pass as amended",12,5,1,0,18
1208262,906411,2020-01-27,Assembly,"AB 648 Nazarian Assembly Third Reading",41,21,18,0,80
1208263,830600,2019-03-26,Assembly,"Do pass and be re-referred to the Committee on [Appropriations] with recommendation: To Consent Calendar",15,0,0,0,15
1208263,834947,2019-04-03,Assembly,"Do pass. To Consent Calendar",17,0,1,0,18
1208263,842861,2019-04-11,Assembly,"AB 619 Chiu Consent Calendar Second Day Regular Session",72,0,8,0,80
1208263,878575,2019-06-05,Senate,"Do pass, but first be re-referred to the Committee on [Appropriations] with the recommendation: To Consent Calendar",9,0,0,0,9
1208263,889267,2019-07-01,Senate,"Consent Calendar AB619",39,0,1,0,40
1208266,835389,2019-04-02,Assembly,"Do pass as amended, and be re-referred to the Committee on [Natural Resources] with recommendation: To Consent Calendar",7,0,0,0,7
1208266,849282,2019-04-22,Assembly,"Do pass and be re-referred to the Committee on [Appropriations]",10,0,1,0,11
1208266,866305,2019-05-16,Assembly,"Do pass",18,0,0,0,18
1208266,870241,2019-05-22,Assembly,"AB 639 Cervantes Assembly Third Reading",78,0,2,0,80
1208266,886016,2019-06-19,Senate,"Do pass, but first be re-referred to the Committee on [Governmental Organization]",6,0,1,0,7
1208266,887653,2019-06-25,Senate,"Do pass, but first be re-referred to the Committee on [Appropriations]",15,0,1,0,16
1208266,892213,2019-07-08,Senate,"Placed on suspense file",7,0,0,0,7
1208266,892214,2019-08-30,Senate,"Do pass as amended",7,0,0,0,7
1208266,977945,2020-08-31,Senate,"Assembly 3rd Reading AB639 Cervantes By Gonzalez",38,0,2,0,40
1208266,977946,2020-08-31,Assembly,"AB 639 CERVANTES Concurrence in Senate Amendments",73,0,6,0,79
1208268,834379,2019-04-02,Assembly,"Do pass and be re-referred to the Committee on [Appropriations]",20,0,0,0,20
1208268,841783,2019-04-10,Assembly,"Do pass. To Consent Calendar",17,0,1,0,18
1208268,852684,2019-04-25,Assembly,"AB 690 Aguiar-Curry Consent Calendar Second Day Regular Session",76,0,4,0,80
1208268,879883,2019-06-10,Senate,"Do pass, but first be re-referred to the Committee on [Appropriations]",9,0,0,0,9
1208268,893327,2019-08-12,Senate,"Assembly 3rd Reading AB690 Aguiar-Curry By Dahle Urgency Clause",39,0,1,0,40
1208268,893328,2019-08-27,Assembly,"With recommendation: That Senate amendments be concurred in",16,0,3,0,19
1208268,893329,2019-08-30,Assembly,"AB 690 Aguiar-Curry Concurrence - Urgency Added",74,0,5,0,79
1208271,830194,2019-03-26,Assembly,"Do pass and be re-referred to the Committee on [Appropriations]",11,0,1,0,12
1208271,834880,2019-04-03,Assembly,"Do pass",16,0,2,0,18
1208271,838609,2019-04-08,Assembly,"AB 669 Holden Assembly Third Reading",68,2,10,0,80
1208271,877727,2019-06-04,Senate,"Do pass, but first be re-referred to the Committee on [Appropriations]",9,0,0,0,9
1208271,889315,2019-07-01,Senate,"Assembly 3rd Reading AB669 Holden By Jackson",39,0,1,0,40
1208272,829165,2019-03-26,Assembly,"Do pass and be re-referred to the Committee on [Appropriations]",8,0,0,0,8
1208272,841328,2019-04-10,Assembly,"Do pass",17,0,1,0,18
1208272,866165,2019-05-16,Assembly,"AB 640 Frazier Assembly Third Reading",75,0,5,0,80
1208272,891955,2019-07-02,Senate,"Do pass, but first be re-referred to the Committee on [Appropriations] with the recommendation: To Consent Calendar",7,0,0,0,7
1208272,891956,2019-08-15,Senate,"Consent Calendar AB640",37,0,3,0,40
1208275,841519,2019-04-09,Assembly,"Do pass and be re-referred to the Committee on [Labor and Employment]",7,0,2,0,9
1208275,852966,2019-04-24,Assembly,"Do pass and be re-referred to the Committee on [Appropriations]",6,0,1,0,7
1208275,864836,2019-05-15,Assembly,"Do pass",12,0,6,0,18
1208275,867787,2019-05-20,Assembly,"AB 647 Kalra Assembly Third Reading",59,1,20,0,80
1208275,885140,2019-06-19,Senate,"Do pass as amended, but first amend, and re-refer to the Committee on [Labor, Public Employment and Retirement ]",6,0,1,0,7
1208275,888105,2019-06-26,Senate,"Do pass as amended, but first amend, and re-refer to the Committee on [Appropriations]",5,0,0,0,5
1208275,892615,2019-09-09,Senate,"Assembly 3rd Reading AB647 Kalra By Hill",40,0,0,0,40
1208275,892616,2019-09-10,Assembly,"AB 647 Kalra Concurrence in Senate Amendments",75,0,4,0,79
1208277,830199,2019-03-26,Assembly,"Do pass and be re-referred to the Committee on [Appropriations]",8,0,0,0,8
1208277,834683,2019-04-03,Assembly,"Do pass",15,0,3,0,18
1208277,853054,2019-04-25,Assembly,"AB 620 Cooley Assembly Third Reading",70,1,9,0,80
1208277,880336,2019-06-11,Senate,"Do pass, but first be re-referred to the Committee on [Judiciary]",6,0,1,0,7
1208277,884643,2019-06-18,Senate,"Do pass as amended, but first amend, and re-refer to the Committee on [Appropriations]",8,0,1,0,9
1208277,884644,2019-06-18,Senate,"[06-19-2019] set for [First] hearing: Reconsideration of favorable vote granted",9,0,0,0,9
1208277,884645,2019-06-18,Senate,"Do pass as amended, but first amend, and re-refer to the Committee on [Appropriations]",9,0,0,0,9
1208277,893132,2019-09-04,Senate,"Assembly 3rd Reading AB620 Cooley By Pan",40,0,0,0,40
1208277,893133,2019-09-10,Assembly,"AB 620 Cooley Concurrence in Senate Amendments",71,1,7,0,79
1208280,852174,2019-04-24,Assembly,"Do pass",7,0,0,0,7
1208280,863091,2019-05-13,Assembly,"AB 664 Cooper Assembly Third Reading",76,0,4,0,80
1208280,975503,2020-08-11,Senate,"Do pass, but first be re-referred to the Committee on [Appropriations]",3,0,2,0,5
1208280,975990,2020-08-17,Senate,"Placed on suspense file",7,0,0,0,7
1208280,976442,2020-08-20,Senate,"Do pass",5,0,2,0,7
1208281,829600,2019-03-26,Assembly,"Do pass and be re-referred to the Committee on [Appropriations]",9,3,0,0,12
1208281,866403,2019-05-16,Assembly,"Do pass",13,4,1,0,18
1208281,873926,2019-05-28,Assembly,"AB 668 Gonzalez Assembly Third Reading",58,15,7,0,80
1208281,890715,2019-07-02,Senate,"Do pass, but first be re-referred to the Committee on [Appropriations]",7,2,0,0,9
1208281,890716,2019-08-12,Senate,"Placed on suspense file",7,0,0,0,7
1208281,890717,2019-08-30,Senate,"Do pass",5,2,0,0,7
1208281,890718,2019-09-10,Senate,"Assembly 3rd Reading AB668 Gonzalez et al. By Durazo",29,11,0,0,40
1208281,890719,2019-09-11,Assembly,"AB 668 Gonzalez Concurrence in Senate Amendments",59,15,5,0,79
1208283,829271,2019-03-26,Assembly,"Do pass and be re-referred to the Committee on [Appropriations] with recommendation: To Consent Calendar",8,0,0,0,8
1208286,839447,2019-04-02,Senate,"Do pass as amended, but first amend, and re-refer to the Committee on [Housing]",7,0,1,0,8
1208286,856111,2019-04-30,Senate,"Do pass as amended",8,1,2,0,11
1208286,874559,2019-05-29,Senate,"Senate 3rd Reading SB323 Wieckowski",28,8,2,0,38
1208286,884660,2019-06-19,Assembly,"Do pass as amended and be re-referred to the Committee on [Judiciary]",5,1,2,0,8
1208286,891798,2019-07-09,Assembly,"Do pass as amended",8,4,0,0,12
1208286,893914,2019-09-13,Assembly,"SB 323 Wieckowski Senate Third Reading By Kalra",41,28,10,0,79
1208286,894190,2019-09-13,Senate,"Unfinished Business SB323 Wieckowski",29,11,0,0,40
1208286,894382,2019-09-14,Senate,"Unfinished Business SB323 Wieckowski",29,11,0,0,40
1208288,832179,2019-03-27,Assembly,"Do pass and be re-referred to the Committee on [Appropriations] with recommendation: To Consent Calendar",10,0,1,0,11
1208288,866304,2019-05-16,Assembly,"Do pass",18,0,0,0,18
1208288,871626,2019-05-23,Assembly,"AB 657 Eggman Assembly Third Reading",78,0,2,0,80
1208288,891311,2019-07-02,Senate,"Do pass, but first be re-referred to the Committee on [Appropriations]",5,0,0,0,5
1208288,891312,2019-08-12,Senate,"Do pass",7,0,0,0,7
1208288,891313,2019-08-26,Senate,"Assembly 3rd Reading AB657 Eggman By Caballero",36,0,4,0,40
1208288,891314,2019-08-30,Assembly,"AB 657 Eggman Concurrence in Senate Amendments",69,0,10,0,79
1210669,836828,2019-04-03,Senate,"Do pass, but first be re-referred to the Committee on [Appropriations]",8,0,1,0,9
1210669,849309,2019-04-22,Senate,"Placed on suspense file",6,0,0,0,6
1210669,866467,2019-05-16,Senate,"Do pass as amended",6,0,0,0,6
1210669,871611,2019-05-23,Senate,"Senate 3rd Reading SB331 Hurtado et al",38,0,0,0,38
1210669,887799,2019-06-25,Assembly,"Do pass and be re-referred to the Committee on [Appropriations] with recommendation: To Consent Calendar",15,0,0,0,15
1210670,853130,2019-04-23,Senate,"Do pass as amended",10,2,0,0,12
1210670,862103,2019-05-09,Senate,"Senate 3rd Reading SB336 Dodd",25,7,6,0,38
1210672,841462,2019-04-09,Assembly,"Do pass and be re-referred to the Committee on [Appropriations]",8,0,0,0,8
1210674,850128,2019-04-22,Assembly,"Do pass and be re-referred to the Committee on [Appropriations]",15,0,0,0,15
1210674,865922,2019-05-16,Assembly,"Do pass as amended",17,0,1,0,18
1210674,871515,2019-05-23,Assembly,"AB 752 Gabriel Assembly Third Reading",73,0,7,0,80
1210674,890784,2019-07-09,Senate,"Do pass as amended, but first amend, and re-refer to the Committee on [Appropriations] with the recommendation: To Consent Calendar",13,0,0,0,13
1210674,890785,2019-08-12,Senate,"Placed on suspense file",7,0,0,0,7
1210674,890786,2019-08-30,Senate,"Do pass",7,0,0,0,7
1210674,890788,2019-09-09,Senate,"Special Consent AB752",40,0,0,0,40
1210674,890789,2019-09-10,Assembly,"AB 752 Gabriel Concurrence in Senate Amendments",77,0,2,0,79
1210674,894865,2019-08-30,Senate,Result,7,0,0,0,7
1210678,841546,2019-04-09,Assembly,"Do pass and be re-referred to the Committee on [Appropriations]",12,0,0,0,12
1210678,851227,2019-04-24,Assembly,"Do pass. To Consent Calendar",18,0,0,0,18
1210678,858215,2019-05-02,Assembly,"AB 710 Cervantes Consent Calendar Second Day Regular Session",76,0,4,0,80
1210678,890710,2019-07-03,Senate,"Do pass, but first be re-referred to the Committee on [Appropriations]",7,0,0,0,7
1210678,890711,2019-08-12,Senate,"Placed on suspense file",7,0,0,0,7
1210678,890712,2019-08-30,Senate,"Do pass as amended",7,0,0,0,7
1210678,890713,2019-09-05,Senate,"Assembly 3rd Reading AB710 Cervantes By Glazer",40,0,0,0,40
1210678,890714,2019-09-09,Assembly,"AB 710 Cervantes Concurrence in Senate Amendments",78,0,1,0,79
1210679,835115,2019-04-03,Senate,"Do pass, but first be re-referred to the Committee on [Judiciary]",5,2,0,0,7
1210679,851699,2019-04-23,Senate,"Do pass as amended, but first amend, and re-refer to the Committee on [Appropriations]",7,2,0,0,9
1210679,863187,2019-05-13,Senate,"Placed on suspense file",6,0,0,0,6
1210682,829486,2019-03-26,Assembly,"Do pass as amended",15,0,0,0,15
1210682,866212,2019-05-16,Assembly,"Do pass",18,0,0,0,18
1210682,873987,2019-05-28,Assembly,"AB 713 Mullin Assembly Third Reading",74,0,6,0,80
1210682,901470,2020-01-08,Senate,"Do pass, but first be re-referred to the Committee on [Rules]",8,0,0,0,8
1210682,975851,2020-08-13,Senate,"Placed on suspense file",7,0,0,0,7
1210682,976322,2020-08-20,Senate,"Do pass as amended",7,0,0,0,7
1210682,977886,2020-08-31,Senate,"Assembly 3rd Reading AB713 Mullin et al. By Pan Urgency Clause",37,0,3,0,40
1210682,977887,2020-09-01,Assembly,"AB 713 MULLIN Concurrence - Urgency Added",74,0,5,0,79
1210685,834851,2019-04-02,Assembly,"Do pass as amended and be re-referred to the Committee on [Appropriations]",9,3,0,0,12
1210686,857569,2019-05-01,Senate,"Do pass as amended",7,0,0,0,7
1210686,859608,2019-05-06,Senate,"Senate 3rd Reading SB355 Portantino",38,0,0,0,38
1210686,892644,2019-07-03,Assembly,"Do pass as amended",8,0,0,0,8
1210686,892645,2019-08-15,Assembly,"SB 355 Portantino Senate Third Reading By Aguiar-Curry",74,0,5,0,79
1210686,892646,2019-08-22,Senate,"Unfinished Business SB355 Portantino Concurrence",39,0,1,0,40
1210687,829474,2019-03-26,Assembly,"Do pass. To Consent Calendar",12,0,0,0,12
1210687,833240,2019-04-01,Assembly,"AB 692 Maienschein Consent Calendar Second Day",74,0,6,0,80
1210687,878241,2019-06-04,Senate,"Do pass and be ordered to the Consent Calendar",9,0,0,0,9
1210687,883301,2019-06-17,Senate,"Consent Calendar AB692",40,0,0,0,40
1210690,843552,2019-04-10,Assembly,"Do pass and be re-referred to the Committee on [Appropriations] with recommendation: To Consent Calendar",6,0,0,0,6
1210690,851388,2019-04-24,Assembly,"Do pass. To Consent Calendar",18,0,0,0,18
1210690,858216,2019-05-02,Assembly,"AB 709 Bonta Consent Calendar Second Day Regular Session",76,0,4,0,80
1210690,881231,2019-06-12,Senate,"Do pass as amended, but first amend, and re-refer to the Committee on [Governance and Finance] with the recommendation: To Consent Calendar",7,0,0,0,7
1210690,891694,2019-07-03,Senate,"Do pass, but first be re-referred to the Committee on [Appropriations] with the recommendation: To Consent Calendar",7,0,0,0,7
1210690,891695,2019-08-15,Senate,"Consent Calendar AB709",37,0,3,0,40
1210690,891696,2019-09-10,Senate,"Assembly 3rd Reading AB709 Bonta By Leyva",40,0,0,0,40
1210690,891697,2019-09-11,Assembly,"AB 709 Bonta Concurrence in Senate Amendments",79,0,0,0,79
1210691,851789,2019-04-23,Assembly,"Do pass as amended and be re-referred to the Committee on [Appropriations]",19,0,1,0,20
1210691,861663,2019-05-08,Assembly,"Do pass. To Consent Calendar",18,0,0,0,18
1210691,866621,2019-05-16,Assembly,"AB 779 Low Consent Calendar Second Day Regular Session",74,0,6,0,80
1210691,879860,2019-06-10,Senate,"Do pass, but first be re-referred to the Committee on [Appropriations]",9,0,0,0,9
1210691,887196,2019-06-24,Senate,"Do pass",7,0,0,0,7
1210691,891682,2019-08-22,Senate,"Assembly 3rd Reading AB779 Low By Chang",39,0,1,0,40
1210691,891683,2019-08-30,Assembly,"AB 779 Low Concurrence in Senate Amendments",75,0,4,0,79
1210692,903148,2020-01-15,Assembly,"Do pass as amended and be re-referred to the Committee on [Appropriations]",5,3,0,0,8
1210692,903149,2020-01-15,Assembly,"Do pass and be re-referred to the Committee on [Local Government]",7,0,1,0,8
1210692,905414,2020-01-23,Assembly,"Do pass",11,6,1,0,18
1210692,912025,2020-01-30,Assembly,"AB 725 Wicks Assembly Third Reading",48,22,10,0,80
1210692,974936,2020-08-06,Senate,"Do pass, but first be re-referred to the Committee on [Appropriations]",8,3,0,0,11
1210692,975764,2020-08-13,Senate,"Placed on suspense file",7,0,0,0,7
1210692,976445,2020-08-20,Senate,"Do pass as amended",5,2,0,0,7
1210692,977427,2020-08-29,Senate,"Assembly 3rd Reading AB725 Wicks et al. By Skinner",23,14,3,0,40
1210692,978174,2020-08-30,Assembly,"AB 725 Wicks Concurrence in Senate Amendments By RIVAS, R",46,22,11,0,79
1210696,851405,2019-04-23,Assembly,"Do pass as amended and be re-referred to the Committee on [Appropriations]",12,1,7,0,20
1210701,850260,2019-04-22,Assembly,"Do pass and be re-referred to the Committee on [Appropriations]",11,1,3,0,15
1210701,866095,2019-05-16,Assembly,"Do pass as amended",14,1,3,0,18
1210701,875568,2019-05-30,Assembly,"AB 753 Eduardo Garcia Assembly Third Reading",56,4,20,0,80
1210701,893288,2019-09-03,Senate,"Assembly 3rd Reading AB753 Eduardo Garcia By Stone Urgency Clause",40,0,0,0,40
1210701,893289,2019-09-09,Assembly,"AB 753 Eduardo Garcia Concurrence - Urgency Added",79,0,0,0,79
1210705,830604,2019-03-26,Assembly,"Do pass and be re-referred to the Committee on [Appropriations]",11,4,0,0,15
1210705,865808,2019-05-16,Assembly,"Do pass as amended",12,5,1,0,18
1210705,871312,2019-05-23,Assembly,"AB 731 Kalra Assembly Third Reading",52,20,8,0,80
1210705,891511,2019-07-03,Senate,"Do pass as amended, but first amend, and re-refer to the Committee on [Appropriations]",7,1,1,0,9
1210705,891512,2019-08-12,Senate,"Placed on suspense file",7,0,0,0,7
1210705,891513,2019-08-30,Senate,"Do pass as amended",5,2,0,0,7
1210705,891514,2019-09-05,Senate,"Assembly 3rd Reading AB731 Kalra et al. By Pan",25,12,3,0,40
1210705,891515,2019-09-09,Assembly,"AB 731 Kalra Concurrence in Senate Amendments",56,20,3,0,79
1210708,835459,2019-04-02,Assembly,"Do pass and be re-referred to the Committee on [Judiciary]",15,0,0,0,15
1210708,840497,2019-04-09,Assembly,"Do pass and be re-referred to the Committee on [Appropriations]",12,0,0,0,12
1210708,851938,2019-04-24,Assembly,"Do pass. To Consent Calendar",18,0,0,0,18
1210708,858220,2019-05-02,Assembly,"AB 785 Bloom Consent Calendar Second Day Regular Session",76,0,4,0,80
1210708,884831,2019-06-19,Senate,"Do pass, but first be re-referred to the Committee on [Judiciary]",9,0,0,0,9
1210708,887988,2019-06-25,Senate,"Do pass, but first be re-referred to the Committee on [Appropriations] with the recommendation: To Consent Calendar",9,0,0,0,9
1210708,891711,2019-08-19,Senate,"Assembly 3rd Reading AB785 Bloom By Beall",40,0,0,0,40
1210708,891712,2019-09-10,Senate,"Assembly 3rd Reading AB785 Bloom By Beall",40,0,0,0,40
1210708,891713,2019-09-11,Assembly,"AB 785 Bloom Concurrence in Senate Amendments",79,0,0,0,79
1210709,854188,2019-04-23,Assembly,"Do pass as amended and be re-referred to the Committee on [Appropriations]",11,2,2,0,15
1210709,865729,2019-05-16,Assembly,"Do pass as amended",14,0,4,0,18
1210709,873810,2019-05-28,Assembly,"AB 767 Wicks Assembly Third Reading",59,10,11,0,80
1210709,974998,2020-08-07,Senate,"Do pass, but first be re-referred to the Committee on [Appropriations]",6,1,0,0,7
1210709,976019,2020-08-17,Senate,"Placed on suspense file",7,0,0,0,7
1210712,856898,2019-05-01,Assembly,"Do pass. To Consent Calendar",7,0,0,0,7
1210712,862145,2019-05-09,Assembly,"AB 730 Berman Consent Calendar Second Day Regular Session",76,0,4,0,80
1210712,890667,2019-07-02,Senate,"Do pass, but first be re-referred to the Committee on [Rules]",3,1,1,0,5
1210712,890668,2019-07-09,Senate,"Do pass as amended",6,2,1,0,9
1210712,893862,2019-09-13,Assembly,"With recommendation: That Senate amendments be concurred in",6,0,1,0,7
1210712,893919,2019-09-13,Assembly,"AB 730 Berman Concurrence in Senate Amendments",67,4,8,0,79
1210712,894192,2019-09-13,Senate,"Assembly 3rd Reading AB730 Berman et al. By Hertzberg",29,7,4,0,40
1210714,888724,2019-04-22,Assembly,"Do pass and be re-referred to the Committee on [Appropriations]",4,2,9,0,15
1210716,854212,2019-04-24,Assembly,"Do pass as amended and be re-referred to the Committee on [Appropriations]",5,0,2,0,7
1210716,861557,2019-05-08,Assembly,"Do pass",14,2,2,0,18
1210716,866209,2019-05-16,Assembly,"AB 711 Chiu Assembly Third Reading",61,0,19,0,80
1210716,884852,2019-06-19,Senate,"Do pass as amended, but first amend, and re-refer to the Committee on [Appropriations]",6,0,1,0,7
1210716,891011,2019-08-12,Senate,"Assembly 3rd Reading AB711 Chiu et al. By Durazo",30,0,10,0,40
1210716,891012,2019-08-15,Assembly,"AB 711 Chiu Concurrence in Senate Amendments",62,0,17,0,79
1210719,834023,2019-03-27,Assembly,"Do pass as amended and be re-referred to the Committee on [Elections and Redistricting]",5,1,0,0,6
1210719,841759,2019-04-10,Assembly,"Do pass as amended and be re-referred to the Committee on [Appropriations]",6,1,0,0,7
1210719,866263,2019-05-16,Assembly,"Do pass as amended",14,2,2,0,18
1210719,873888,2019-05-28,Assembly,"AB 773 Gonzalez Assembly Third Reading",60,12,8,0,80
1210719,884768,2019-06-19,Senate,"Do pass as amended, but first amend, and re-refer to the Committee on [Elections and Constitutional Amendments]",7,0,0,0,7
1210719,891030,2019-07-02,Senate,"Do pass as amended, but first amend, and re-refer to the Committee on [Appropriations]",4,0,1,0,5
1210719,891031,2019-08-12,Senate,"Placed on suspense file",7,0,0,0,7
1210719,891032,2019-08-30,Senate,"Do pass",5,1,1,0,7
1210719,891033,2019-09-04,Senate,"Assembly 3rd Reading AB773 Gonzalez et al. By Dodd",31,7,2,0,40
1210719,891034,2019-09-09,Assembly,"AB 773 Gonzalez Concurrence in Senate Amendments",66,11,2,0,79
1210719,895158,2019-09-04,Senate,"Assembly 3rd Reading AB773 Gonzalez et al. By Dod",5,7,0,0,12
1210720,830329,2019-03-26,Assembly,"Do pass and be re-referred to the Committee on [Appropriations] with recommendation: To Consent Calendar",8,0,1,0,9
1210720,865853,2019-05-16,Assembly,"Do pass as amended",18,0,0,0,18
1210720,871224,2019-05-23,Assembly,"AB 733 Quirk Assembly Third Reading",76,0,4,0,80
1210720,884749,2019-06-19,Senate,"Do pass, but first be re-referred to the Committee on [Appropriations] with the recommendation: To Consent Calendar",7,0,0,0,7
1210720,889232,2019-07-01,Senate,"Placed on suspense file",7,0,0,0,7
1210720,892999,2019-08-30,Senate,"Do pass",7,0,0,0,7
1210720,893000,2019-09-09,Senate,"Special Consent AB733",40,0,0,0,40
1210725,830426,2019-03-26,Assembly,"Do pass and be re-referred to the Committee on [Judiciary]",8,0,0,0,8
1210725,833764,2019-04-02,Assembly,"Do pass and be re-referred to the Committee on [Appropriations] with recommendation: To Consent Calendar",12,0,0,0,12
1210725,865578,2019-05-16,Assembly,"Do pass as amended",18,0,0,0,18
1210725,871571,2019-05-23,Assembly,"AB 748 Gipson Assembly Third Reading",78,0,2,0,80
1210725,887522,2019-06-24,Senate,"Do pass, but first be re-referred to the Committee on [Judiciary] with the recommendation: To Consent Calendar",6,0,0,0,6
1210725,893093,2019-07-09,Senate,"Do pass as amended, but first amend, and re-refer to the Committee on [Appropriations] with the recommendation: To Consent Calendar",8,0,1,0,9
1210725,893094,2019-08-12,Senate,"Placed on suspense file",7,0,0,0,7
1210725,893095,2019-08-30,Senate,"Do pass",7,0,0,0,7
1210725,893096,2019-09-09,Senate,"Special Consent AB748",40,0,0,0,40
1210725,893097,2019-09-10,Assembly,"AB 748 Gipson Concurrence in Senate Amendments",79,0,0,0,79
1210726,829396,2019-03-26,Assembly,"Do pass and be re-referred to the Committee on [Health]",20,0,0,0,20
1210726,839684,2019-04-09,Assembly,"Do pass and be re-referred to the Committee on [Appropriations] with recommendation: To Consent Calendar",15,0,0,0,15
1210726,851337,2019-04-24,Assembly,"Do pass. To Consent Calendar",18,0,0,0,18
1210726,858233,2019-05-02,Assembly,"AB 714 Wood Consent Calendar Second Day Regular Session",76,0,4,0,80
1210726,879861,2019-06-10,Senate,"Do pass as amended, but first amend, and re-refer to the Committee on [Appropriations]",9,0,0,0,9
1210726,892514,2019-08-19,Senate,"Assembly 3rd Reading AB714 Wood By Glazer Urgency Clause",40,0,0,0,40
1210726,892515,2019-08-22,Assembly,"AB 714 Wood Concurrence in Senate Amendments",76,0,3,0,79
1210726,894513,2019-08-19,Senate,"Assembly 3rd Reading AB714 Wood By Glazer Urv class=""statusCell"">",9,0,0,0,9
1210730,829521,2019-03-25,Senate,"Do pass, but first be re-referred to the Committee on [Housing] with the recommendation: To Consent Calendar",6,0,0,0,6
1210730,834188,2019-04-02,Senate,"Do pass, but first be re-referred to the Committee on [Appropriations] with the recommendation: To Consent Calendar",11,0,0,0,11
1210730,848914,2019-04-22,Senate,"Placed on suspense file",6,0,0,0,6
1210730,866060,2019-05-16,Senate,"Do pass as amended",6,0,0,0,6
1210730,873903,2019-05-28,Senate,"Senate 3rd Reading SB333 Wilk et al",38,0,0,0,38
1210730,891008,2019-07-03,Assembly,"Do pass and be re-referred to the Committee on [Appropriations] with recommendation: To Consent Calendar",8,0,0,0,8
1210730,896151,2019-04-22,Senate,Result,6,0,0,0,6
1210731,851777,2019-04-23,Assembly,"Do pass and be re-referred to the Committee on [Appropriations]",11,0,1,0,12
1210731,857072,2019-05-01,Assembly,"Do pass. To Consent Calendar",18,0,0,0,18
1210731,862085,2019-05-09,Assembly,"AB 703 Weber Consent Calendar Second Day Regular Session",76,0,4,0,80
1210731,891630,2019-07-03,Senate,"Do pass as amended, but first amend, and re-refer to the Committee on [Appropriations]",7,0,0,0,7
1210731,891631,2019-09-03,Senate,"Assembly 3rd Reading AB703 Weber By Durazo",40,0,0,0,40
1210731,891632,2019-09-05,Assembly,"AB 703 Weber Concurrence in Senate Amendments",79,0,0,0,79
1210734,836630,2019-04-03,Assembly,"Do pass as amended and be re-referred to the Committee on [Judiciary]",7,0,0,0,7
1210734,849916,2019-04-23,Assembly,"Do pass and be re-referred to the Committee on [Appropriations]",9,2,1,0,12
1210738,829806,2019-03-26,Assembly,"Do pass. To Consent Calendar",20,0,0,0,20
1210738,855680,2019-04-30,Assembly,"Do pass as amended. To Consent Calendar",11,0,0,0,11
1210738,863192,2019-05-13,Assembly,"AB 716 Chen Consent Calendar Second Day Regular Session",74,0,6,0,80
1210738,879873,2019-06-10,Senate,"Do pass and be ordered to the Consent Calendar",9,0,0,0,9
1210738,884012,2019-06-17,Senate,"Consent Calendar AB716",40,0,0,0,40
1210739,851535,2019-04-24,Assembly,"Do pass and be re-referred to the Committee on [Appropriations]",12,0,2,0,14
1210739,866188,2019-05-16,Assembly,"Do pass as amended",14,0,4,0,18
1210739,874457,2019-05-29,Assembly,"AB 740 Burke Third Reading Urgency",73,0,7,0,80
1210739,888025,2019-06-26,Senate,"Do pass, but first be re-referred to the Committee on [Energy, Utilities and Communications]",10,0,3,0,13
1210739,893047,2019-07-10,Senate,"Do pass, but first be re-referred to the Committee on [Appropriations]",11,0,2,0,13
1210740,840414,2019-04-09,Assembly,"Do pass",9,3,0,0,12
1210740,858793,2019-05-02,Assembly,"AB 749 Mark Stone Assembly Third Reading",41,19,20,0,80
1210740,888029,2019-06-25,Senate,"Do pass as amended",7,2,0,0,9
1210740,893056,2019-09-03,Senate,"Assembly 3rd Reading AB749 Mark Stone et al. By Durazo",21,13,6,0,40
1210740,893057,2019-09-05,Assembly,"AB 749 Mark Stone Concurrence in Senate Amendments",46,22,11,0,79
1210740,893842,2019-05-02,Assembly,Date,9,19,0,0,28
1210743,836964,2019-04-03,Assembly,"Do pass and be re-referred to the Committee on [Human Services]",7,0,0,0,7
1210743,850616,2019-04-23,Assembly,"Do pass as amended and be re-referred to the Committee on [Appropriations]",8,0,0,0,8
1210745,840615,2019-04-09,Senate,"Do pass, but first be re-referred to the Committee on [Appropriations] with the recommendation: To Consent Calendar",16,0,0,0,16
1210745,849794,2019-04-22,Senate,"Placed on suspense file",6,0,0,0,6
1210745,866438,2019-05-16,Senate,"Do pass as amended",6,0,0,0,6
1210745,871347,2019-05-23,Senate,"Senate 3rd Reading SB348 Chang et al",38,0,0,0,38
1210745,887697,2019-06-25,Assembly,"Do pass as amended, and be re-referred to the Committee on [Accountability and Administrative Review] with recommendation: To Consent Calendar",11,0,0,0,11
1210745,890330,2019-07-03,Assembly,"Do pass and be re-referred to the Committee on [Appropriations]",5,2,0,0,7
1210747,813079,2019-03-04,Assembly,"Be adopted. To third reading",11,0,1,0,12
1210749,828465,2019-03-25,Senate,"Senate 3rd Reading SR19 Borgeas et al",37,0,1,0,38
1210752,848877,2019-04-09,Assembly,"Do pass as amended and be re-referred to the Committee on [Appropriations]",15,0,0,0,15
1210756,851558,2019-04-23,Senate,"Do pass, but first be re-referred to the Committee on [Appropriations]",12,0,0,0,12
1210756,859544,2019-05-06,Senate,"Placed on suspense file",5,0,1,0,6
1210756,866118,2019-05-16,Senate,"Do pass as amended",6,0,0,0,6
1210756,871058,2019-05-23,Senate,"Senate 3rd Reading SB356 McGuire",38,0,0,0,38
1210756,890695,2019-07-08,Assembly,"Do pass and be re-referred to the Committee on [Appropriations]",14,0,1,0,15
1210756,890696,2019-08-28,Assembly,"Do pass. To Consent Calendar",17,0,1,0,18
1210757,830708,2019-03-26,Assembly,"Do pass and be re-referred to the Committee on [Appropriations]",6,0,3,0,9
1210757,856625,2019-05-01,Assembly,"Do pass",13,0,5,0,18
1210757,862087,2019-05-09,Assembly,"AB 756 Cristina Garcia Assembly Third Reading",64,0,16,0,80
1210757,884716,2019-06-19,Senate,"Do pass as amended, but first amend, and re-refer to the Committee on [Appropriations]",6,0,1,0,7
1210757,892060,2019-07-05,Senate,"Assembly 3rd Reading AB756 Cristina Garcia By Allen",21,3,16,0,40
1210757,892061,2019-07-08,Assembly,"AB 756 Cristina Garcia Concurrence in Senate Amendments",62,1,16,0,79
1210760,841340,2019-04-09,Assembly,"Do pass and be re-referred to the Committee on [Appropriations]",12,0,0,0,12
1210760,865550,2019-05-16,Assembly,"Do pass",18,0,0,0,18
1210760,870159,2019-05-22,Assembly,"AB 720 Muratsuchi Assembly Third Reading",77,0,3,0,80
1210760,884822,2019-06-19,Senate,"Do pass, but first be re-referred to the Committee on [Appropriations]",6,0,1,0,7
1210760,889273,2019-07-01,Senate,"Placed on suspense file",7,0,0,0,7
1210762,842676,2019-04-10,Senate,"Do pass, but first be re-referred to the Committee on [Housing]",6,0,1,0,7
1210762,849876,2019-04-22,Senate,"Do pass as amended, but first amend, and re-refer to the Committee on [Appropriations]",8,2,1,0,11
1210762,863099,2019-05-13,Senate,"Placed on suspense file",6,0,0,0,6
1210762,865677,2019-05-16,Senate,"Do pass as amended",4,2,0,0,6
1210762,874619,2019-05-29,Senate,"Senate 3rd Reading SB330 Skinner",28,7,3,0,38
1210762,885020,2019-06-19,Assembly,"Do pass as amended and be re-referred to the Committee on [Local Government]",7,0,1,0,8
1210762,890488,2019-07-10,Assembly,"Do pass and be re-referred to the Committee on [Appropriations]",7,1,0,0,8
1210762,890489,2019-08-30,Assembly,"Do pass",17,0,1,0,18
1210762,890490,2019-09-05,Assembly,"SB 330 Skinner Senate Third Reading By Daly",67,8,4,0,79
1210762,890491,2019-09-06,Senate,"Unfinished Business SB330 Skinner Concurrence",30,4,6,0,40
1210765,831552,2019-03-27,Assembly,"Do pass as amended and be re-referred to the Committee on [Appropriations]",8,0,0,0,8
1210765,851654,2019-04-24,Assembly,"Do pass. To Consent Calendar",18,0,0,0,18
1210765,858243,2019-05-02,Assembly,"AB 747 Levine Consent Calendar Second Day Regular Session",76,0,4,0,80
1210765,878305,2019-06-05,Senate,"Do pass, but first be re-referred to the Committee on [Appropriations] with the recommendation: To Consent Calendar",7,0,0,0,7
1210765,890541,2019-09-10,Senate,"Assembly 3rd Reading AB747 Levine et al. By Jackson",40,0,0,0,40
1210765,890542,2019-09-11,Assembly,"AB 747 Levine Concurrence in Senate Amendments",79,0,0,0,79
1210768,841116,2019-04-02,Assembly,"Do pass as amended and be re-referred to the Committee on [Appropriations]",11,0,0,0,11
1210768,851645,2019-04-24,Assembly,"Do pass. To Consent Calendar",18,0,0,0,18
1210768,858189,2019-05-02,Assembly,"AB 754 Grayson Consent Calendar Second Day Regular Session",76,0,4,0,80
1210768,880324,2019-06-11,Senate,"Do pass, but first be re-referred to the Committee on [Appropriations]",14,0,2,0,16
1210768,889257,2019-07-01,Senate,"Do pass",7,0,0,0,7
1210768,892044,2019-09-10,Senate,"That the measure be returned to Senate Floor for consideration. Ordered to third reading",6,0,1,0,7
1210768,893994,2019-09-14,Assembly,"AB 754 Grayson Concurrence in Senate Amendments",78,0,1,0,79
1210768,894209,2019-09-13,Senate,"Assembly 3rd Reading AB754 Grayson et al. By Hill",40,0,0,0,40
1210769,830645,2019-03-26,Assembly,"Do pass as amended and be re-referred to the Committee on [Appropriations]",13,0,2,0,15
1210770,902203,2020-01-13,Assembly,"Do pass and be re-referred to the Committee on [Privacy and Consumer Protection]",10,0,2,0,12
1210770,902807,2020-01-14,Assembly,"Do pass and be re-referred to the Committee on [Appropriations]",10,0,1,0,11
1210770,905378,2020-01-23,Assembly,"Do pass",16,0,2,0,18
1210770,906413,2020-01-27,Assembly,"AB 699 Grayson Assembly Third Reading",70,0,10,0,80
1210773,838688,2019-04-08,Senate,"Do pass, but first be re-referred to the Committee on [Appropriations]",9,0,0,0,9
1210773,859453,2019-05-06,Senate,"Senate 3rd Reading SB334 Pan",38,0,0,0,38
1210773,880668,2019-06-11,Assembly,"Do pass and be re-referred to the Committee on [Appropriations]",17,0,2,0,19
1210773,884872,2019-06-19,Assembly,"Do pass. To Consent Calendar",17,0,1,0,18
1210773,888521,2019-06-27,Assembly,"SB 334 Pan Consent Calendar Second Day Regular Session",71,0,8,0,79
1210773,894057,2019-07-11,Senate,"Special Consent SB334",39,0,1,0,40
1210775,831115,2019-03-26,Assembly,"Do pass as amended, and be re-referred to the Committee on [Judiciary] with recommendation: To Consent Calendar",8,0,0,0,8
1210775,833855,2019-04-02,Assembly,"Do pass and be re-referred to the Committee on [Appropriations] with recommendation: To Consent Calendar",12,0,0,0,12
1210775,866241,2019-05-16,Assembly,"Do pass as amended",18,0,0,0,18
1210775,871597,2019-05-23,Assembly,"AB 718 Eggman Assembly Third Reading",78,0,2,0,80
1210775,887683,2019-06-24,Senate,"Do pass, but first be re-referred to the Committee on [Judiciary]",6,0,0,0,6
1210775,893562,2019-07-09,Senate,"Do pass, but first be re-referred to the Committee on [Appropriations] with the recommendation: To Consent Calendar",8,0,1,0,9
1210775,893563,2019-08-12,Senate,"Placed on suspense file",7,0,0,0,7
1210775,893564,2019-08-30,Senate,"Do pass",7,0,0,0,7
1210775,893565,2019-09-09,Senate,"Special Consent AB718",40,0,0,0,40
1210775,893566,2019-09-10,Assembly,"AB 718 Eggman Concurrence in Senate Amendments",79,0,0,0,79
1210778,830603,2019-03-27,Senate,"Do pass, but first be re-referred to the Committee on [Appropriations]",13,0,0,0,13
1210778,852900,2019-04-25,Senate,"Senate 3rd Reading SB350 Hertzberg",37,0,1,0,38
1210778,964361,2020-06-09,Assembly,"Do pass and be re-referred to the Committee on [Appropriations]",12,2,1,0,15
1210778,964990,2020-06-10,Assembly,"Do pass as amended",10,3,5,0,18
1210778,966502,2020-06-15,Assembly,"SB 350 Hill Senate Third Reading By Holden",57,17,5,0,79
1210778,970001,2020-06-29,Senate,"That the Assembly amendments be concurred in",9,3,1,0,13
1210778,970002,2020-06-29,Senate,"Unfinished Business SB350 Hill et al. Concurrence",30,8,2,0,40
1210779,856958,2019-05-01,Assembly,"Do pass. To Consent Calendar",7,0,0,0,7
1210779,862205,2019-05-09,Assembly,"AB 698 Obernolte Consent Calendar Second Day Regular Session",76,0,4,0,80
1210779,877671,2019-06-04,Senate,"Do pass and be ordered to the Consent Calendar",5,0,0,0,5
1210779,882958,2019-06-17,Senate,"Consent Calendar AB698",40,0,0,0,40
1210781,860849,2019-05-06,Assembly,"Do pass and be re-referred to the Committee on [Appropriations]",9,0,2,0,11
1210782,830693,2019-03-25,Assembly,"Do pass as amended and be re-referred to the Committee on [Appropriations]",10,0,1,0,11
1210782,841756,2019-04-10,Assembly,"Do pass. To Consent Calendar",17,0,1,0,18
1210782,853048,2019-04-25,Assembly,"AB 782 Berman Consent Calendar Second Day Regular Session",76,0,4,0,80
1210782,878561,2019-06-05,Senate,"Do pass, but first be re-referred to the Committee on [Appropriations] with the recommendation: To Consent Calendar",7,0,0,0,7
1210782,889243,2019-07-01,Senate,"Consent Calendar AB782",39,0,1,0,40
1210782,891973,2019-08-15,Assembly,"AB 782 Berman Concurrence in Senate Amendments",76,0,3,0,79
1210783,841452,2019-04-08,Assembly,"Do pass and be re-referred to the Committee on [Appropriations]",11,0,0,0,11
1210783,852332,2019-04-24,Assembly,"Do pass. To Consent Calendar",18,0,0,0,18
1210783,858085,2019-05-02,Assembly,"AB 736 Irwin Consent Calendar Second Day Regular Session",76,0,4,0,80
1210783,974887,2020-08-05,Senate,"Do pass, but first be re-referred to the Committee on [Appropriations]",5,0,0,0,5
1210783,976636,2020-08-24,Senate,"Assembly 3rd Reading AB736 Irwin By Hill Urgency Clause",40,0,0,0,40
1210783,976932,2020-08-26,Assembly,"AB 736 Irwin Concurrence - Urgency Added",74,0,5,0,79
1210785,835351,2019-04-03,Assembly,"Do pass and be re-referred to the Committee on [Veterans Affairs]",7,0,1,0,8
1210785,841822,2019-04-09,Assembly,"Do pass and be re-referred to the Committee on [Appropriations]",9,1,1,0,11
1210785,866193,2019-05-16,Assembly,"Do pass as amended",16,0,2,0,18
1210785,872232,2019-05-24,Assembly,"AB 694 Irwin Assembly Third Reading",68,0,12,0,80
1210785,884500,2019-06-18,Senate,"Do pass, but first be re-referred to the Committee on [Veterans Affairs]",8,1,2,0,11
1210785,887910,2019-06-25,Senate,"Do pass, but first be re-referred to the Committee on [Appropriations]",6,0,1,0,7
1210785,891269,2019-07-03,Senate,"Do pass as amended, but first amend, and re-refer to the Committee on [Appropriations]",6,1,0,0,7
1210785,891270,2019-08-26,Senate,"Placed on suspense file",6,0,1,0,7
1210789,841757,2019-04-10,Assembly,"Do pass and be re-referred to the Committee on [Judiciary]",6,1,1,0,8
1210789,849882,2019-04-23,Assembly,"Do pass as amended and be re-referred to the Committee on [Appropriations]",9,1,2,0,12
1210793,851418,2019-04-23,Assembly,"Do pass and be re-referred to the Committee on [Appropriations]",15,0,0,0,15
1210795,831528,2019-03-27,Assembly,"Do pass and be re-referred to the Committee on [Appropriations]",6,0,0,0,6
1210795,865536,2019-05-16,Assembly,"Do pass",18,0,0,0,18
1210795,873902,2019-05-28,Assembly,"AB 751 O'Donnell Assembly Third Reading",75,0,5,0,80
1210795,884696,2019-06-19,Senate,"Do pass, but first be re-referred to the Committee on [Appropriations]",6,1,0,0,7
1210795,891184,2019-08-12,Senate,"Placed on suspense file",7,0,0,0,7
1210795,891185,2019-08-30,Senate,"Do pass",7,0,0,0,7
1210795,894198,2019-09-13,Senate,"Assembly 3rd Reading AB751 O'Donnell et al. By Wiener",38,2,0,0,40
1210797,851456,2019-04-23,Assembly,"Do pass and be re-referred to the Committee on [Appropriations]",8,0,0,0,8
1210798,828274,2019-03-25,Assembly,"Be re-referred to the Committee on [Revenue and Taxation]",12,0,0,0,12
1210798,850028,2019-04-22,Assembly,"Do pass as amended and be re-referred to the Committee on [Appropriations]",11,0,0,0,11
1210801,841406,2019-04-09,Assembly,"Do pass and be re-referred to the Committee on [Privacy and Consumer Protection]",8,0,0,0,8
1210801,851452,2019-04-23,Assembly,"Do pass as amended, and be re-referred to the Committee on [Appropriations] with recommendation: To Consent Calendar",11,0,0,0,11
1210801,861659,2019-05-08,Assembly,"Do pass. To Consent Calendar",18,0,0,0,18
1210801,865862,2019-05-16,Assembly,"AB 728 Santiago Consent Calendar Second Day Regular Session",74,0,6,0,80
1210801,887465,2019-06-24,Senate,"Do pass, but first be re-referred to the Committee on [Judiciary]",6,0,0,0,6
1210801,891898,2019-07-09,Senate,"Do pass as amended, but first amend, and re-refer to the Committee on [Appropriations] with the recommendation: To Consent Calendar",8,0,1,0,9
1210801,891899,2019-08-15,Senate,"Consent Calendar AB728",37,0,3,0,40
1210801,891900,2019-09-05,Assembly,"AB 728 Santiago Concurrence in Senate Amendments",79,0,0,0,79
1210802,835859,2019-04-02,Assembly,"Do pass and be re-referred to the Committee on [Appropriations]",15,0,0,0,15
1210802,866573,2019-05-16,Assembly,"Do pass",18,0,0,0,18
1210802,874563,2019-05-29,Assembly,"AB 715 Arambula Assembly Third Reading",77,0,3,0,80
1210802,893277,2019-07-10,Senate,"Do pass, but first be re-referred to the Committee on [Appropriations] with the recommendation: To Consent Calendar",8,0,1,0,9
1210802,893278,2019-08-12,Senate,"Placed on suspense file",7,0,0,0,7
1210802,893279,2019-08-30,Senate,"Do pass",7,0,0,0,7
1210802,893280,2019-09-09,Senate,"Special Consent AB715",40,0,0,0,40
1210802,893281,2019-09-11,Assembly,"With recommendation: That Senate amendments be concurred in",14,0,1,0,15
1210802,893749,2019-09-12,Assembly,"AB 715 Nazarian Concurrence in Senate Amendments",79,0,0,0,79
1210806,851680,2019-04-23,Assembly,"Do pass and be re-referred to the Committee on [Appropriations]",15,0,0,0,15
1210806,866227,2019-05-16,Assembly,"Do pass as amended",18,0,0,0,18
1210806,871363,2019-05-23,Assembly,"AB 719 Diep Assembly Third Reading",78,0,2,0,80
1210806,891965,2019-07-09,Senate,"Do pass as amended, but first amend, and re-refer to the Committee on [Appropriations]",5,3,1,0,9
1210806,891966,2019-08-19,Senate,"Placed on suspense file",5,0,2,0,7
1210807,833829,2019-04-01,Assembly,"Do pass and be re-referred to the Committee on [Appropriations]",14,0,1,0,15
1210807,866233,2019-05-16,Assembly,"Do pass",18,0,0,0,18
1210807,869899,2019-05-22,Assembly,"AB 708 Frazier Assembly Third Reading",78,0,2,0,80
1210807,890322,2019-07-09,Senate,"Do pass as amended, but first amend, and re-refer to the Committee on [Appropriations]",10,2,1,0,13
1210807,890323,2019-08-12,Senate,"Placed on suspense file",7,0,0,0,7
1210807,890324,2019-08-30,Senate,"Do pass as amended",6,1,0,0,7
1210807,890325,2019-09-06,Senate,"Assembly 3rd Reading AB708 Frazier By Beall",32,7,1,0,40
1210807,890326,2019-09-09,Assembly,"AB 708 Frazier Concurrence in Senate Amendments",75,0,4,0,79
1210807,894088,2019-08-12,Senate,Result,10,2,0,0,12
1210811,830694,2019-03-26,Assembly,"Do pass as amended. To Consent Calendar",15,0,0,0,15
1210811,836455,2019-04-04,Assembly,"AB 781 Maienschein Consent Calendar Second Day Regular Session",75,0,5,0,80
1210811,878905,2019-06-05,Senate,"Do pass as amended, and be ordered to the Consent Calendar",9,0,0,0,9
1210811,882797,2019-06-17,Senate,"Consent Calendar AB781",40,0,0,0,40
1210811,888399,2019-06-27,Assembly,"AB 781 Maienschein Concurrence in Senate Amendments",72,0,7,0,79
1210814,842140,2019-04-09,Assembly,"Do pass as amended and be re-referred to the Committee on [Appropriations]",14,0,0,0,14
1210814,851744,2019-04-24,Assembly,"Do pass. To Consent Calendar",18,0,0,0,18
1210814,858099,2019-05-02,Assembly,"AB 727 Flora Consent Calendar Second Day Regular Session",76,0,4,0,80
1210815,860859,2019-05-06,Assembly,"Do pass and be re-referred to the Committee on [Appropriations]",9,1,1,0,11
1210815,865890,2019-05-16,Assembly,"Do pass",18,0,0,0,18
1210815,871250,2019-05-23,Assembly,"AB 784 Mullin Assembly Third Reading",77,1,2,0,80
1210815,884726,2019-06-19,Senate,"Do pass as amended, but first amend, and re-refer to the Committee on [Appropriations]",6,0,1,0,7
1210815,892024,2019-07-08,Senate,"Placed on suspense file",7,0,0,0,7
1210815,892025,2019-08-30,Senate,"Do pass as amended",7,0,0,0,7
1210815,892026,2019-09-04,Senate,"Assembly 3rd Reading AB784 Mullin et al. By Hill",40,0,0,0,40
1210815,892027,2019-09-10,Assembly,"AB 784 Mullin Concurrence in Senate Amendments",77,1,1,0,79
1210818,835681,2019-04-02,Assembly,"Do pass as amended and be re-referred to the Committee on [Appropriations]",10,1,1,0,12
1210818,851622,2019-04-24,Assembly,"Do pass",16,0,2,0,18
1210818,859475,2019-05-06,Assembly,"AB 695 Medina Assembly Third Reading",72,0,8,0,80
1210818,878259,2019-06-05,Senate,"Do pass, but first be re-referred to the Committee on [Appropriations]",7,0,0,0,7
1210818,887071,2019-06-24,Senate,"Do pass",6,1,0,0,7
1210818,892162,2019-09-04,Senate,"Assembly 3rd Reading AB695 Medina By Wilk",33,6,1,0,40
1210818,892163,2019-09-10,Assembly,"AB 695 Medina Concurrence in Senate Amendments",74,2,3,0,79
1210820,851429,2019-04-23,Assembly,"Do pass and be re-referred to the Committee on [Appropriations]",14,0,1,0,15
1210820,865575,2019-05-16,Assembly,"Do pass as amended",18,0,0,0,18
1210820,871398,2019-05-23,Assembly,"AB 744 Aguiar-Curry Assembly Third Reading",75,0,5,0,80
1210820,893078,2019-07-03,Senate,"Do pass as amended, but first amend, and re-refer to the Committee on [Appropriations]",8,0,1,0,9
1210820,893079,2019-08-12,Senate,"Placed on suspense file",7,0,0,0,7
1210820,893080,2019-08-30,Senate,"Do pass",6,1,0,0,7
1210820,893985,2019-09-13,Assembly,"AB 744 Aguiar-Curry Concurrence in Senate Amendments",79,0,0,0,79
1210820,894212,2019-09-13,Senate,"Assembly 3rd Reading AB744 Aguiar-Curry By Dodd",36,1,3,0,40
1210823,834633,2019-04-03,Senate,"Do pass, but first be re-referred to the Committee on [Appropriations] with the recommendation: To Consent Calendar",7,0,0,0,7
1210823,853146,2019-04-25,Senate,"Consent Calendar SB351",37,0,1,0,38
1210823,879872,2019-06-10,Assembly,"Do pass and be re-referred to the Committee on [Appropriations] with recommendation: To Consent Calendar",11,0,0,0,11
1210823,893194,2019-08-30,Assembly,"Do pass",18,0,0,0,18
1210823,893195,2019-09-05,Assembly,"SB 351 Hurtado Senate Third Reading By Friedman",79,0,0,0,79
1210825,858386,2019-04-30,Senate,"Do pass as amended, but first amend, and re-refer to the Committee on [Appropriations]",9,0,0,0,9
1210825,863238,2019-05-13,Senate,"Placed on suspense file",6,0,0,0,6
1210825,866385,2019-05-16,Senate,"Do pass as amended",6,0,0,0,6
1210825,868782,2019-05-21,Senate,"Senate 3rd Reading SB342 Hertzberg",38,0,0,0,38
1210825,887849,2019-06-25,Assembly,"Do pass and be re-referred to the Committee on [Judiciary]",11,0,0,0,11
1210825,891183,2019-07-09,Assembly,"Do pass as amended",11,0,1,0,12
1210825,976317,2020-08-20,Assembly,"Do pass",17,0,1,0,18
1210825,976730,2020-08-25,Assembly,"SB 342 Hertzberg Senate Third Reading By Mark Stone",71,0,8,0,79
1210825,977171,2020-08-27,Senate,"Unfinished Business SB342 Hertzberg Concurrence",30,0,10,0,40
1210827,856997,2019-05-01,Senate,"Do pass, but first be re-referred to the Committee on [Appropriations]",7,0,0,0,7
1210827,863211,2019-05-13,Senate,"Placed on suspense file",6,0,0,0,6
1210827,866320,2019-05-16,Senate,"Do pass",6,0,0,0,6
1210827,870248,2019-05-22,Senate,"Senate 3rd Reading SB349 Portantino et al",38,0,0,0,38
1210827,893482,2019-07-08,Assembly,"Do pass and be re-referred to the Committee on [Appropriations]",9,1,1,0,11
1210827,893483,2019-08-30,Assembly,"Do pass",18,0,0,0,18
1210827,893484,2019-09-10,Assembly,"SB 349 Portantino Senate Third Reading By Ramos",78,1,0,0,79
1210827,893485,2019-09-11,Senate,"Unfinished Business SB349 Portantino et al. Concurrence",40,0,0,0,40
1210828,835905,2019-04-02,Assembly,"Do pass and be re-referred to the Committee on [Appropriations] with recommendation: To Consent Calendar",20,0,0,0,20
1210828,842364,2019-04-10,Assembly,"Do pass. To Consent Calendar",17,0,1,0,18
1210828,852711,2019-04-25,Assembly,"AB 778 Low Consent Calendar Second Day Regular Session",76,0,4,0,80
1210828,880093,2019-06-10,Senate,"Do pass, but first be re-referred to the Committee on [Appropriations]",9,0,0,0,9
1210831,850524,2019-04-22,Assembly,"Do pass and be re-referred to the Committee on [Appropriations]",7,2,2,0,11
1210831,864871,2019-05-15,Assembly,"Do pass",12,4,2,0,18
1210831,870147,2019-05-22,Assembly,"AB 729 Chu Assembly Third Reading",58,17,5,0,80
1210831,892957,2019-07-03,Senate,"Do pass as amended, but first amend, and re-refer to the Committee on [Judiciary]",6,1,0,0,7
1210831,892958,2019-07-09,Senate,"Do pass, but first be re-referred to the Committee on [Appropriations]",7,1,1,0,9
1210831,892959,2019-08-12,Senate,"Placed on suspense file",7,0,0,0,7
1210831,892960,2019-08-30,Senate,"Do pass",5,2,0,0,7
1210831,892961,2019-09-04,Senate,"Assembly 3rd Reading AB729 Chu By Jackson",27,11,2,0,40
1210831,892962,2019-09-09,Assembly,"AB 729 Chu Concurrence in Senate Amendments",52,23,4,0,79
1210833,853144,2019-04-24,Senate,"Do pass, but first be re-referred to the Committee on [Appropriations] with the recommendation: To Consent Calendar",7,0,0,0,7
1210833,862349,2019-05-09,Senate,"Consent Calendar SB344",38,0,0,0,38
1210833,892215,2019-07-08,Assembly,"Do pass and be re-referred to the Committee on [Appropriations]",8,0,3,0,11
1210833,892216,2019-08-30,Assembly,"Do pass as amended",14,1,3,0,18
1210833,892217,2019-09-10,Assembly,"SB 344 McGuire Senate Third Reading By Burke",66,0,13,0,79
1210833,893895,2019-09-12,Senate,"That the Assembly amendments be concurred in",7,0,0,0,7
1210833,894177,2019-09-13,Senate,"Unfinished Business SB344 McGuire",40,0,0,0,40
1210833,894757,2019-09-13,Senate,09/12/19,7,0,0,0,7
1210836,829274,2019-03-25,Assembly,"Do pass and be re-referred to the Committee on [Environmental Safety and Toxic Materials]",8,3,0,0,11
1210836,840186,2019-04-09,Assembly,"Do pass and be re-referred to the Committee on [Appropriations]",6,3,0,0,9
1210836,865920,2019-05-16,Assembly,"Do pass as amended",11,6,1,0,18
1210837,841601,2019-04-09,Assembly,"Do pass and be re-referred to the Committee on [Appropriations]",14,0,0,0,14
1210837,866690,2019-05-16,Assembly,"Do pass",18,0,0,0,18
1210837,869914,2019-05-22,Assembly,"AB 722 Bigelow Assembly Third Reading",77,1,2,0,80
1210838,835741,2019-04-02,Assembly,"Do pass and be re-referred to the Committee on [Appropriations]",11,0,1,0,12
1210838,851660,2019-04-24,Assembly,"Do pass",18,0,0,0,18
1210838,859437,2019-05-06,Assembly,"AB 706 Low Assembly Third Reading",77,0,3,0,80
1210838,878495,2019-06-05,Senate,"Do pass, but first be re-referred to the Committee on [Appropriations]",6,0,1,0,7
1210838,889271,2019-07-01,Senate,"Assembly 3rd Reading AB706 Low By Grove",38,0,2,0,40
1210840,839996,2019-04-08,Assembly,"Do pass and be re-referred to the Committee on [Housing and Community Development]",10,0,1,0,11
1210840,851485,2019-04-24,Assembly,"Do pass as amended and be re-referred to the Committee on [Appropriations]",8,0,0,0,8
1210840,859526,2019-05-06,Assembly,"AB 723 Wicks Assembly Third Reading",77,0,3,0,80
1210840,893246,2019-07-10,Senate,"Do pass, but first be re-referred to the Committee on [Housing]",4,0,3,0,7
1210840,893247,2019-09-10,Senate,"That the measure be returned to Senate Floor for consideration. Ordered to third reading",4,2,1,0,7
1210840,893248,2019-09-11,Senate,"Assembly 3rd Reading AB723 Quirk By Wieckowski",27,10,3,0,40
1210840,893880,2019-09-13,Assembly,"With recommendation: That Senate amendments be concurred in",5,2,1,0,8
1210840,893955,2019-09-13,Assembly,"AB 723 Quirk Concurrence in Senate Amendments",52,24,3,0,79
1210840,894517,2019-09-11,Senate,"Archuleta, Moorlach, Roth",4,2,0,0,6
1210841,830244,2019-03-26,Assembly,"Do pass and be re-referred to the Committee on [Appropriations]",14,0,0,0,14
1210841,866481,2019-05-16,Assembly,"Do pass",18,0,0,0,18
1210841,870281,2019-05-22,Assembly,"AB 783 Bigelow Assembly Third Reading",77,1,2,0,80
1210845,813431,2019-03-04,Senate,"Senate 3rd Reading SR18 Leyva et al",38,0,0,0,38
1210846,829925,2019-03-26,Assembly,"Do pass",20,0,0,0,20
1210846,831702,2019-03-28,Assembly,"AB 775 Chau Assembly Third Reading",73,0,7,0,80
1210846,889316,2019-07-01,Senate,"Do pass as amended",8,0,1,0,9
1210846,893431,2019-08-22,Senate,"Special Consent AB775",39,0,1,0,40
1210846,893432,2019-08-26,Assembly,"AB 775 Chau Concurrence in Senate Amendments",77,0,2,0,79
1210848,832060,2019-03-26,Assembly,"Do pass as amended",12,1,2,0,15
1210848,849032,2019-04-22,Assembly,"AB 774 Reyes Assembly Third Reading",70,0,10,0,80
1210848,890729,2019-07-03,Senate,"Do pass as amended",7,0,2,0,9
1210848,890730,2019-09-05,Senate,"Assembly 3rd Reading AB774 Reyes By Pan",33,5,2,0,40
1210848,890731,2019-09-09,Assembly,"AB 774 Reyes Concurrence in Senate Amendments",71,1,7,0,79
1210851,841842,2019-04-09,Assembly,"Do pass and be re-referred to the Committee on [Appropriations]",10,0,1,0,11
1210851,852338,2019-04-24,Assembly,"Do pass. To Consent Calendar",18,0,0,0,18
1210851,858116,2019-05-02,Assembly,"AB 761 Nazarian Consent Calendar Second Day Regular Session",76,0,4,0,80
1210851,880421,2019-06-11,Senate,"Do pass, but first be re-referred to the Committee on [Appropriations]",7,0,0,0,7
1210851,891990,2019-09-03,Senate,"Assembly 3rd Reading AB761 Nazarian et al. By Archuleta",40,0,0,0,40
1210851,891991,2019-09-09,Assembly,"AB 761 Nazarian Concurrence in Senate Amendments",79,0,0,0,79
1210852,842215,2019-04-09,Assembly,"Do pass and be re-referred to the Committee on [Appropriations] with recommendation: To Consent Calendar",9,0,0,0,9
1210852,864898,2019-05-15,Assembly,"Do pass. To Consent Calendar",16,0,2,0,18
1210852,870143,2019-05-22,Assembly,"AB 762 Quirk Consent Calendar Second Day Regular Session",77,0,3,0,80
1210852,878404,2019-06-05,Senate,"Do pass, but first be re-referred to the Committee on [Health] with the recommendation: To Consent Calendar",7,0,0,0,7
1210852,891020,2019-07-03,Senate,"Do pass, but first be re-referred to the Committee on [Appropriations] with the recommendation: To Consent Calendar",8,0,1,0,9
1210852,891021,2019-08-12,Senate,"Placed on suspense file",7,0,0,0,7
1210852,891022,2019-08-30,Senate,"Do pass",7,0,0,0,7
1210852,891023,2019-09-10,Senate,"Assembly 3rd Reading AB762 Quirk By Dahle",40,0,0,0,40
1210852,891024,2019-09-11,Assembly,"AB 762 Quirk Concurrence in Senate Amendments",79,0,0,0,79
1210855,851593,2019-04-23,Assembly,"Do pass as amended, and be re-referred to the Committee on [Appropriations] with recommendation: To Consent Calendar",15,0,0,0,15
1210855,859495,2019-05-06,Assembly,"AB 746 Wood Assembly Third Reading",77,0,3,0,80
1210855,894089,2019-07-03,Senate,"Do pass and be ordered to the Consent Calendar",8,0,1,0,9
1210855,894090,2019-08-26,Senate,"Assembly 3rd Reading AB746 Wood By McGuire",39,0,1,0,40
1210856,841623,2019-04-10,Assembly,"Do pass and be re-referred to the Committee on [Revenue and Taxation]",7,0,0,0,7
1210856,850453,2019-04-22,Assembly,"Do pass as amended and be re-referred to the Committee on [Appropriations]",10,0,1,0,11
1210859,841419,2019-04-09,Assembly,"Do pass and be re-referred to the Committee on [Appropriations] with recommendation: To Consent Calendar",15,0,0,0,15
1210859,865850,2019-05-16,Assembly,"Do pass",18,0,0,0,18
1210859,873874,2019-05-28,Assembly,"AB 769 Smith Assembly Third Reading",75,0,5,0,80
1210859,884603,2019-06-19,Senate,"Do pass, but first be re-referred to the Committee on [Appropriations] with the recommendation: To Consent Calendar",9,0,0,0,9
1210859,893150,2019-07-08,Senate,"Placed on suspense file",7,0,0,0,7
1210860,858260,2019-05-01,Assembly,"Do pass",8,0,0,0,8
1210860,875596,2019-05-30,Assembly,"AB 707 Kalra Assembly Third Reading",73,0,7,0,80
1210860,894173,2019-07-03,Senate,"Do pass as amended",7,0,0,0,7
1210860,894174,2019-08-19,Senate,"Assembly 3rd Reading AB707 Kalra et al. By Wieckowski",40,0,0,0,40
1210860,894175,2019-08-26,Assembly,"AB 707 Kalra Concurrence in Senate Amendments",77,0,2,0,79
1210861,841539,2019-04-09,Assembly,"Do pass. To Consent Calendar",8,0,0,0,8
1210861,853338,2019-04-25,Assembly,"AB 737 Eggman Consent Calendar Second Day Regular Session",76,0,4,0,80
1210861,880645,2019-06-10,Senate,"Do pass as amended",5,0,1,0,6
1210861,892473,2019-08-15,Senate,"Assembly 3rd Reading AB737 Eggman By Hurtado",38,0,2,0,40
1210861,892474,2019-08-19,Assembly,"AB 737 Eggman Concurrence in Senate Amendments",78,0,1,0,79
1210863,816451,2019-03-07,Senate,"Senate 3rd Reading SCR16 Pan",37,0,1,0,38
1210863,822205,2019-03-14,Assembly,"Be adopted. To Consent Calendar",11,0,1,0,12
1210863,826782,2019-03-21,Assembly,"SCR 16 Pan Consent Calendar Second Day Regular Session",72,0,8,0,80
1210867,830755,2019-03-27,Senate,"Do pass, but first be re-referred to the Committee on [Appropriations]",1,3,1,0,5
1210867,830756,2019-03-27,Senate,"[First] hearing set for [03-27-2019]: Failed passage in Committee. Reconsideration granted",5,0,0,0,5
1210868,836571,2019-04-04,Assembly,"Be re-referred to the Committee on [Higher Education]",9,0,3,0,12
1210868,851570,2019-04-23,Assembly,"Do pass and be re-referred to the Committee on [Appropriations]",10,0,2,0,12
1210868,861498,2019-05-08,Assembly,"Do pass as amended",13,0,5,0,18
1210868,867840,2019-05-20,Assembly,"AB 697 Ting Assembly Third Reading",57,0,23,0,80
1210868,893166,2019-07-03,Senate,"Do pass as amended, but first amend, and re-refer to the Committee on [Appropriations]",5,1,1,0,7
1210868,893167,2019-08-26,Senate,"Assembly 3rd Reading AB697 Ting et al. By Pan",28,5,7,0,40
1210868,893168,2019-09-03,Assembly,"AB 697 Ting Concurrence in Senate Amendments",66,0,13,0,79
1210869,841416,2019-04-09,Senate,"Do pass, but first be re-referred to the Committee on [Governance and Finance]",3,8,1,0,12
1210869,841417,2019-04-09,Senate,"[First] hearing set for [04-10-2019]: Failed passage in Committee. Reconsideration granted",12,0,0,0,12
1210872,838691,2019-04-02,Senate,"Do pass as amended, but first amend, and re-refer to the Committee on [Human Services] with the recommendation: To Consent Calendar",6,0,1,0,7
1210872,858223,2019-05-02,Senate,"Senate 3rd Reading SB338 Hueso",38,0,0,0,38
1210872,880568,2019-06-11,Assembly,"Do pass and be re-referred to the Committee on [Public Safety]",7,0,0,0,7
1210872,892253,2019-07-09,Assembly,"Do pass",8,0,0,0,8
1210872,892254,2019-09-05,Assembly,"SB 338 Hueso Senate Third Reading By Kalra",79,0,0,0,79
1210872,892255,2019-09-06,Senate,"Unfinished Business SB338 Hueso Concurrence",39,0,1,0,40
1210873,839686,2019-04-03,Senate,"Do pass as amended, but first amend, and re-refer to the Committee on [Appropriations]",7,0,0,0,7
1210873,859535,2019-05-06,Senate,"Placed on suspense file",5,0,1,0,6
1210873,865648,2019-05-16,Senate,"Do pass",4,2,0,0,6
1210873,868866,2019-05-21,Senate,"Senate 3rd Reading SB354 Durazo",30,8,0,0,38
1210873,880387,2019-06-11,Assembly,"Do pass and be re-referred to the Committee on [Appropriations]",9,1,2,0,12
1210873,892224,2019-08-30,Assembly,"Do pass",13,3,2,0,18
1210873,892225,2019-09-10,Assembly,"SB 354 Durazo Senate Third Reading By Medina",64,10,5,0,79
1210873,894774,2019-05-16,Senate,"Bill Votes",5,0,0,0,5
1210875,835216,2019-04-03,Senate,"Do pass, but first be re-referred to the Committee on [Appropriations] with the recommendation: To Consent Calendar",7,0,0,0,7
1210875,849459,2019-04-22,Senate,"Placed on suspense file",6,0,0,0,6
1210875,866882,2019-05-16,Senate,"Do pass",6,0,0,0,6
1210875,871694,2019-05-23,Senate,"Special Consent SB346",38,0,0,0,38
1210875,886069,2019-06-19,Assembly,"Do pass and be re-referred to the Committee on [Appropriations] with recommendation: To Consent Calendar",7,0,0,0,7
1210877,836676,2019-04-03,Senate,"Do pass, but first be re-referred to the Committee on [Appropriations]",7,1,1,0,9
1210877,848963,2019-04-22,Senate,"Do pass",4,2,0,0,6
1210877,859467,2019-05-06,Senate,"Senate 3rd Reading SB343 Pan",26,9,3,0,38
1210877,887449,2019-06-25,Assembly,"Do pass and be re-referred to the Committee on [Appropriations]",11,0,4,0,15
1210877,891859,2019-08-14,Assembly,"Do pass",14,4,0,0,18
1210877,891860,2019-08-22,Assembly,"SB 343 Pan Senate Third Reading By Kalra",58,13,8,0,79
1210877,891861,2019-08-26,Senate,"Unfinished Business SB343 Pan et al. Concurrence",29,10,1,0,40
1210879,830570,2019-03-26,Assembly,"Do pass and be re-referred to the Committee on [Appropriations] with recommendation: To Consent Calendar",8,0,0,0,8
1210879,866220,2019-05-16,Assembly,"Do pass as amended",18,0,0,0,18
1210879,871346,2019-05-23,Assembly,"AB 734 Maienschein Assembly Third Reading",77,0,3,0,80
1210879,890754,2019-07-08,Senate,"Do pass, but first be re-referred to the Committee on [Appropriations]",6,0,0,0,6
1210879,890755,2019-08-12,Senate,"Placed on suspense file",7,0,0,0,7
1210879,890756,2019-08-30,Senate,"Do pass as amended",7,0,0,0,7
1210879,890757,2019-09-04,Senate,"Assembly 3rd Reading AB734 Maienschein et al. By Durazo",40,0,0,0,40
1210879,890758,2019-09-09,Assembly,"AB 734 Maienschein Concurrence in Senate Amendments",79,0,0,0,79
1210881,851056,2019-04-23,Senate,"Do pass, but first be re-referred to the Committee on [Appropriations]",16,0,0,0,16
1210881,860526,2019-05-06,Senate,"Placed on suspense file",5,0,1,0,6
1210881,865972,2019-05-16,Senate,"Do pass as amended",6,0,0,0,6
1210881,871029,2019-05-23,Senate,"Senate 3rd Reading SB352 Dodd",38,0,0,0,38
1210881,887965,2019-06-26,Assembly,"Do pass and be re-referred to the Committee on [Appropriations]",19,0,2,0,21
1210885,836756,2019-04-02,Assembly,"Do pass as amended and be re-referred to the Committee on [Revenue and Taxation]",7,0,0,0,7
1210886,877813,2019-04-10,Assembly,"Do pass and be re-referred to the Committee on [Appropriations]",3,0,3,0,6
1210889,852800,2019-04-22,Senate,"Do pass as amended, but first amend, and re-refer to the Committee on [Appropriations]",9,0,0,0,9
1210889,859564,2019-05-06,Senate,"Senate 3rd Reading SB339 Jones",38,0,0,0,38
1210889,880554,2019-06-11,Assembly,"Do pass as amended",16,0,3,0,19
1210889,894071,2019-07-08,Assembly,"SB 339 Jones Senate Third Reading By Low",77,0,2,0,79
1210889,894072,2019-07-11,Senate,"Unfinished Business SB339 Jones Concurrence",39,0,1,0,40
1210890,851514,2019-04-23,Assembly,"Do pass and be re-referred to the Committee on [Appropriations]",15,0,0,0,15
1210890,866491,2019-05-16,Assembly,"Do pass as amended",18,0,0,0,18
1210890,871321,2019-05-23,Assembly,"AB 763 Gray Assembly Third Reading",78,0,2,0,80
1210890,888167,2019-06-26,Senate,"Do pass as amended, but first amend, and re-refer to the Committee on [Appropriations]",9,0,0,0,9
1210890,891847,2019-08-12,Senate,"Placed on suspense file",7,0,0,0,7
1210891,843303,2019-04-10,Assembly,"Do pass and be re-referred to the Committee on [Appropriations]",6,0,0,0,6
1210891,866321,2019-05-16,Assembly,"Do pass",18,0,0,0,18
1210891,874645,2019-05-29,Assembly,"AB 776 Kalra Assembly Third Reading",77,0,3,0,80
1210891,891506,2019-07-03,Senate,"Do pass as amended, but first amend, and re-refer to the Committee on [Appropriations]",7,0,0,0,7
1210891,891507,2019-08-12,Senate,"Placed on suspense file",7,0,0,0,7
1210891,891508,2019-08-30,Senate,"Do pass as amended",7,0,0,0,7
1210891,891509,2019-09-05,Senate,"Assembly 3rd Reading AB776 Kalra By Beall",40,0,0,0,40
1210891,891510,2019-09-09,Assembly,"AB 776 Kalra Concurrence in Senate Amendments",78,0,1,0,79
1210893,842580,2019-04-09,Assembly,"Do pass as amended and be re-referred to the Committee on [Appropriations]",8,4,3,0,15
1210893,865888,2019-05-16,Assembly,"Do pass as amended",10,4,4,0,18
1210895,840165,2019-04-08,Senate,"Do pass, but first be re-referred to the Committee on [Judiciary]",6,0,0,0,6
1210895,852115,2019-04-23,Senate,"Do pass as amended, but first amend, and re-refer to the Committee on [Appropriations] with the recommendation: To Consent Calendar",9,0,0,0,9
1210895,863244,2019-05-13,Senate,"Placed on suspense file",6,0,0,0,6
1210895,866454,2019-05-16,Senate,"Do pass as amended",6,0,0,0,6
1210895,868924,2019-05-21,Senate,"Senate 3rd Reading SB337 Skinner",38,0,0,0,38
1210895,884135,2019-06-18,Assembly,"Do pass and be re-referred to the Committee on [Judiciary] with recommendation: To Consent Calendar",8,0,0,0,8
1210895,887562,2019-06-25,Assembly,"Do pass as amended, and be re-referred to the Committee on [Appropriations] with recommendation: To Consent Calendar",12,0,0,0,12
1210895,891831,2019-08-30,Assembly,"Do pass as amended",18,0,0,0,18
1210895,891832,2019-09-10,Assembly,"SB 337 Skinner Senate Third Reading By Blanca Rubio",78,0,1,0,79
1210895,891833,2019-09-11,Senate,"Unfinished Business SB337 Skinner et al. Concurrence",40,0,0,0,40
1210895,894581,2019-06-25,Assembly,06/18/19,8,0,0,0,8
1210898,829388,2019-03-26,Assembly,"Do pass and be re-referred to the Committee on [Appropriations]",8,0,0,0,8
1210898,905415,2020-01-23,Assembly,"Do pass as amended",13,0,5,0,18
1210898,906401,2020-01-27,Assembly,"AB 732 Bonta Assembly Third Reading",63,0,17,0,80
1210898,974623,2020-07-31,Senate,"Do pass, but first be re-referred to the Committee on [Appropriations]",5,1,1,0,7
1210898,975790,2020-08-13,Senate,"Placed on suspense file",7,0,0,0,7
1210898,976507,2020-08-20,Senate,"Do pass as amended",6,1,0,0,7
1210898,977438,2020-08-29,Senate,"Assembly 3rd Reading AB732 Bonta et al. By Mitchell",33,1,6,0,40
1210898,978133,2020-08-30,Assembly,"AB 732 Bonta Concurrence in Senate Amendments",63,0,16,0,79
1210900,856974,2019-05-01,Assembly,"Do pass",5,0,2,0,7
1210900,862181,2019-05-09,Assembly,"AB 693 Berman Assembly Third Reading",59,16,5,0,80
1210900,883970,2019-06-18,Senate,"Do pass",4,1,0,0,5
1210900,889299,2019-07-01,Senate,"Assembly 3rd Reading AB693 Berman By Umberg",29,10,1,0,40
1210902,843304,2019-04-10,Assembly,"Do pass as amended",6,0,0,0,6
1210902,858162,2019-05-02,Assembly,"AB 743 Eduardo Garcia Assembly Third Reading",76,0,4,0,80
1210902,878480,2019-06-05,Senate,"Do pass, but first be re-referred to the Committee on [Judiciary] with the recommendation: To Consent Calendar",7,0,0,0,7
1210902,885042,2019-06-18,Senate,"Do pass and be ordered to the Consent Calendar",9,0,0,0,9
1210902,893719,2019-07-01,Senate,"Consent Calendar AB743 Eduardo Garcia et al",39,0,1,0,40
1210902,894899,2019-07-01,Senate,"Bill Votes",9,0,0,0,9
1210903,853047,2019-04-24,Assembly,"Do pass. To Consent Calendar",19,0,2,0,21
1210903,858325,2019-05-02,Assembly,"AB 759 Bigelow Consent Calendar Second Day Regular Session",76,0,4,0,80
1210903,880932,2019-06-11,Senate,"Do pass and be ordered to the Consent Calendar",14,0,2,0,16
1210903,890463,2019-07-09,Senate,"Do pass as amended, but first amend, and re-refer to the Committee on [Appropriations]",13,0,0,0,13
1210903,890464,2019-08-12,Senate,"Placed on suspense file",7,0,0,0,7
1210903,890465,2019-08-30,Senate,"Do pass",7,0,0,0,7
1210903,890466,2019-09-09,Senate,"Assembly 3rd Reading AB759 Bigelow et al. By Umberg",40,0,0,0,40
1210903,890467,2019-09-11,Assembly,"With recommendation: That Senate amendments be concurred in",14,0,1,0,15
1210903,893761,2019-09-12,Assembly,"AB 759 Bigelow Concurrence in Senate Amendments",79,0,0,0,79
1210904,831348,2019-03-27,Senate,"Do pass, but first be re-referred to the Committee on [Appropriations]",5,1,3,0,9
1210904,838604,2019-04-08,Senate,"Placed on suspense file",6,0,0,0,6
1210904,865730,2019-05-16,Senate,"Do pass as amended",4,2,0,0,6
1210904,871562,2019-05-23,Senate,"Senate 3rd Reading SB347 Monning et al",21,11,6,0,38
1210906,841966,2019-04-09,Assembly,"Do pass and be re-referred to the Committee on [Appropriations] with recommendation: To Consent Calendar",8,0,0,0,8
1210906,865826,2019-05-16,Assembly,"Do pass",18,0,0,0,18
1210906,871255,2019-05-23,Assembly,"AB 701 Weber Assembly Third Reading",78,0,2,0,80
1210906,890403,2019-07-02,Senate,"Do pass, but first be re-referred to the Committee on [Appropriations]",7,0,0,0,7
1210906,890404,2019-08-12,Senate,"Placed on suspense file",7,0,0,0,7
1210906,890405,2019-08-30,Senate,"Do pass as amended",7,0,0,0,7
1210906,890406,2019-09-05,Senate,"Assembly 3rd Reading AB701 Weber",40,0,0,0,40
1210906,890407,2019-09-09,Assembly,"AB 701 Weber Concurrence in Senate Amendments",79,0,0,0,79
1210906,895646,2019-09-05,Senate,"Assembly 3rd Reading AB701 We",7,0,0,0,7
1212409,831364,2019-03-27,Assembly,"Do pass and be re-referred to the Committee on [Appropriations]",8,0,0,0,8
1212410,830495,2019-03-27,Senate,"Do pass and be ordered to the Consent Calendar",7,0,0,0,7
1212410,836801,2019-04-04,Senate,"Consent Calendar SB380 GOV. & F. (McGuire) Urgency Clause",37,0,1,0,38
1212410,884739,2019-06-19,Assembly,"Do pass. To Consent Calendar",8,0,0,0,8
1212410,888490,2019-06-27,Assembly,"SB 380 GOV.& F. Consent Calendar Second Day Regular Session",71,0,8,0,79
1212412,852489,2019-04-23,Assembly,"Do pass and be re-referred to the Committee on [Appropriations] with recommendation: To Consent Calendar",15,0,0,0,15
1212412,866338,2019-05-16,Assembly,"Do pass",18,0,0,0,18
1212412,870760,2019-05-22,Assembly,"AB 919 Petrie-Norris Assembly Third Reading",78,0,2,0,80
1212412,893089,2019-07-03,Senate,"Do pass as amended, but first amend, and re-refer to the Committee on [Appropriations]",8,0,1,0,9
1212412,893090,2019-08-12,Senate,"Placed on suspense file",7,0,0,0,7
1212412,893091,2019-08-30,Senate,"Do pass",7,0,0,0,7
1212412,893092,2019-09-11,Senate,"Assembly 3rd Reading AB919 Petrie-Norris et al. By Hill",40,0,0,0,40
1212412,893729,2019-09-12,Assembly,"AB 919 Petrie-Norris Concurrence in Senate Amendments",77,0,2,0,79
1212414,841826,2019-04-10,Assembly,"Be re-referred to the Committee on [Transportation]",8,0,4,0,12
1212415,834571,2019-04-02,Assembly,"Do pass and be re-referred to the Committee on [Appropriations]",12,0,0,0,12
1212415,856810,2019-05-01,Assembly,"Do pass. To Consent Calendar",18,0,0,0,18
1212415,862306,2019-05-09,Assembly,"AB 809 Santiago Consent Calendar Second Day Regular Session",76,0,4,0,80
1212415,880969,2019-06-12,Senate,"Do pass, but first be re-referred to the Committee on [Appropriations]",7,0,0,0,7
1212415,891434,2019-08-19,Senate,"Assembly 3rd Reading AB809 Santiago et al. By Leyva",39,0,1,0,40
1212415,891435,2019-08-22,Assembly,"AB 809 Santiago Concurrence in Senate Amendments",76,0,3,0,79
1212415,894802,2019-05-01,Assembly,04/02/19,12,0,0,0,12
1212420,834908,2019-04-02,Assembly,"Do pass",12,0,0,0,12
1212420,838564,2019-04-08,Assembly,"AB 853 Smith Assembly Third Reading",74,0,6,0,80
1212420,878535,2019-06-05,Senate,"Do pass and be ordered to the Consent Calendar",7,0,0,0,7
1212420,882956,2019-06-17,Senate,"Consent Calendar AB853",40,0,0,0,40
1212421,851648,2019-04-23,Assembly,"Do pass and be re-referred to the Committee on [Appropriations]",10,0,1,0,11
1212421,856942,2019-05-01,Assembly,"Do pass. To Consent Calendar",18,0,0,0,18
1212421,862291,2019-05-09,Assembly,"AB 874 Irwin Consent Calendar Second Day Regular Session",76,0,4,0,80
1212421,890733,2019-07-09,Senate,"Do pass, but first be re-referred to the Committee on [Appropriations] with the recommendation: To Consent Calendar",8,0,1,0,9
1212421,890734,2019-09-11,Senate,"Assembly 3rd Reading AB874 Irwin By Hertzberg",40,0,0,0,40
1212421,893766,2019-09-12,Assembly,"AB 874 Irwin Concurrence in Senate Amendments",79,0,0,0,79
1212424,831355,2019-03-27,Assembly,"Do pass as amended, and be re-referred to the Committee on [Appropriations] with recommendation: To Consent Calendar",7,0,0,0,7
1212424,841791,2019-04-10,Assembly,"Do pass. To Consent Calendar",17,0,1,0,18
1212424,852717,2019-04-25,Assembly,"AB 902 Levine Consent Calendar Second Day Regular Session",76,0,4,0,80
1212424,877573,2019-06-04,Senate,"Do pass, but first be re-referred to the Committee on [Appropriations] with the recommendation: To Consent Calendar",5,0,0,0,5
1212424,891948,2019-08-26,Senate,"Consent Calendar AB902",39,0,1,0,40
1212424,891949,2019-08-30,Assembly,"AB 902 Levine Concurrence in Senate Amendments",75,0,4,0,79
1212425,829546,2019-03-26,Assembly,"Do pass as amended, and be re-referred to the Committee on [Appropriations] with recommendation: To Consent Calendar",12,0,0,0,12
1212425,865816,2019-05-16,Assembly,"Do pass",18,0,0,0,18
1212425,871266,2019-05-23,Assembly,"AB 800 Chu Assembly Third Reading",77,0,3,0,80
1212425,892011,2019-07-09,Senate,"Do pass, but first be re-referred to the Committee on [Appropriations]",8,0,1,0,9
1212425,892012,2019-08-26,Senate,"Assembly 3rd Reading AB800 Chu et al. By Jackson",37,0,3,0,40
1212425,892013,2019-08-30,Assembly,"AB 800 Chu Concurrence in Senate Amendments",73,0,6,0,79
1212429,835772,2019-04-02,Assembly,"Do pass as amended and be re-referred to the Committee on [Appropriations]",11,0,1,0,12
1212429,856853,2019-05-01,Assembly,"Do pass. To Consent Calendar",18,0,0,0,18
1212429,863163,2019-05-13,Assembly,"AB 943 Chiu Assembly Third Reading",75,0,5,0,80
1212429,880951,2019-06-12,Senate,"Do pass, but first be re-referred to the Committee on [Appropriations]",7,0,0,0,7
1212429,887093,2019-06-24,Senate,"Placed on suspense file",7,0,0,0,7
1212429,892693,2019-08-30,Senate,"Do pass",6,0,1,0,7
1212429,892694,2019-09-04,Senate,"Assembly 3rd Reading AB943 Chiu et al. By Wilk",40,0,0,0,40
1212429,894580,2019-05-13,Assembly,Result,75,0,0,0,75
1212432,833939,2019-03-26,Assembly,"Do pass as amended and be re-referred to the Committee on [Appropriations]",8,0,0,0,8
1212432,866364,2019-05-16,Assembly,"Do pass as amended",16,1,1,0,18
1212432,873997,2019-05-28,Assembly,"AB 807 Bauer-Kahan Third Reading Urgency",69,2,9,0,80
1212432,887666,2019-06-24,Senate,"Do pass as amended, but first amend, and re-refer to the Committee on [Appropriations]",6,0,0,0,6
1212432,892272,2019-08-12,Senate,"Placed on suspense file",7,0,0,0,7
1212432,892273,2019-08-30,Senate,"Do pass as amended",6,0,1,0,7
1212432,892274,2019-09-04,Senate,"Assembly 3rd Reading AB807 Bauer-Kahan et al. By Wiener Urgency Clause",38,1,1,0,40
1212432,892275,2019-09-11,Assembly,"AB 807 Bauer-Kahan Concurrence in Senate Amendments",76,0,3,0,79
1212434,833572,2019-03-27,Assembly,"Do pass as amended, and be re-referred to the Committee on [Appropriations] with recommendation: To Consent Calendar",7,0,0,0,7
1212434,841787,2019-04-10,Assembly,"Do pass. To Consent Calendar",17,0,1,0,18
1212434,853241,2019-04-25,Assembly,"AB 909 Gallagher Consent Calendar Second Day Regular Session",76,0,4,0,80
1212434,877749,2019-06-04,Senate,"Do pass, but first be re-referred to the Committee on [Appropriations] with the recommendation: To Consent Calendar",5,0,0,0,5
1212434,893460,2019-07-11,Senate,"Consent Calendar AB909",39,0,1,0,40
1212434,893461,2019-09-05,Assembly,"AB 909 Gallagher Concurrence in Senate Amendments",79,0,0,0,79
1212436,841490,2019-04-10,Assembly,"Do pass and be re-referred to the Committee on [Appropriations]",5,0,2,0,7
1212436,865904,2019-05-16,Assembly,"Do pass",13,5,0,0,18
1212436,874361,2019-05-29,Assembly,"AB 787 Gipson Assembly Third Reading",52,23,5,0,80
1212436,890993,2019-07-02,Senate,"Do pass, but first be re-referred to the Committee on [Public Safety]",4,1,0,0,5
1212436,890994,2019-07-09,Senate,"Do pass, but first be re-referred to the Committee on [Appropriations]",5,1,1,0,7
1212436,890995,2019-08-12,Senate,"Placed on suspense file",7,0,0,0,7
1212436,894823,2019-05-16,Assembly,"Asm Appropri",13,5,0,0,18
1212438,835622,2019-04-02,Assembly,"Do pass and be re-referred to the Committee on [Appropriations]",11,0,1,0,12
1212438,905388,2020-01-23,Assembly,"Do pass as amended",18,0,0,0,18
1212438,906371,2020-01-27,Assembly,"AB 897 Medina Assembly Third Reading",76,0,4,0,80
1212441,830521,2019-03-27,Senate,"Do pass, but first be re-referred to the Committee on [Appropriations]",4,1,0,0,5
1212441,838467,2019-04-08,Senate,"Placed on suspense file",6,0,0,0,6
1212441,866307,2019-05-16,Senate,"Do pass",4,2,0,0,6
1212441,868911,2019-05-21,Senate,"Senate 3rd Reading SB416 Hueso",26,10,2,0,38
1212441,891516,2019-07-10,Assembly,"Do pass as amended and be re-referred to the Committee on [Appropriations]",11,0,3,0,14
1212441,891517,2019-08-30,Assembly,"Do pass",15,0,3,0,18
1212441,891518,2019-09-10,Assembly,"SB 416 Hueso Senate Third Reading By Gipson",74,0,5,0,79
1212445,834130,2019-04-02,Assembly,"Do pass and be re-referred to the Committee on [Appropriations] with recommendation: To Consent Calendar",20,0,0,0,20
1212445,841447,2019-04-10,Assembly,"Do pass. To Consent Calendar",17,0,1,0,18
1212445,853407,2019-04-25,Assembly,"AB 896 Low Consent Calendar Second Day Regular Session",76,0,4,0,80
1212445,879877,2019-06-10,Senate,"Do pass, but first be re-referred to the Committee on [Appropriations] with the recommendation: To Consent Calendar",9,0,0,0,9
1212445,975378,2020-08-08,Senate,"Pursuant to Senate Rule 29.10, that the measure be re-referred to the Committee on Appropriations pursuant to Joint Rule 10.5",9,0,0,0,9
1212445,975839,2020-08-13,Senate,"That the measure be returned to Senate Floor for consideration. Ordered to third reading",7,0,0,0,7
1212445,977891,2020-08-30,Senate,"Assembly 3rd Reading AB896 Low et al. By Pan Urgency Clause",39,0,1,0,40
1212445,977892,2020-08-31,Assembly,"AB 896 Low Concurrence - Urgency Added",76,0,3,0,79
1212446,833983,2019-04-01,Assembly,"Do pass and be re-referred to the Committee on [Appropriations] with recommendation: To Consent Calendar",12,0,0,0,12
1212446,841699,2019-04-10,Assembly,"Do pass. To Consent Calendar",17,0,1,0,18
1212446,853450,2019-04-25,Assembly,"AB 913 Limón Consent Calendar Second Day Regular Session",76,0,4,0,80
1212446,878874,2019-06-05,Senate,"Do pass, but first be re-referred to the Committee on [Appropriations] with the recommendation: To Consent Calendar",7,0,0,0,7
1212446,977390,2020-08-28,Senate,"Do pass, but first be re-referred to the Committee on [Appropriations]",13,0,0,0,13
1212446,977481,2020-08-31,Assembly,"With recommendation: That Senate amendments be concurred in",13,0,2,0,15
1212446,977878,2020-08-30,Senate,"Assembly 3rd Reading AB913 Calderon",39,0,1,0,40
1212446,977879,2020-08-31,Assembly,"AB 913 Calderon Concurrence in Senate Amendments",75,0,4,0,79
1212447,839870,2019-04-08,Assembly,"Do pass and be re-referred to the Committee on [Appropriations] with recommendation: To Consent Calendar",11,0,0,0,11
1212447,866180,2019-05-16,Assembly,"Do pass as amended",13,0,5,0,18
1212447,871595,2019-05-23,Assembly,"AB 933 Petrie-Norris Assembly Third Reading",75,0,5,0,80
1212447,891395,2019-07-09,Senate,"Do pass as amended, but first amend, and re-refer to the Committee on [Appropriations]",7,1,1,0,9
1212447,891396,2019-08-12,Senate,"Placed on suspense file",7,0,0,0,7
1212448,902813,2020-01-14,Senate,"Do pass, but first be re-referred to the Committee on [Appropriations]",7,0,0,0,7
1212448,904097,2020-01-21,Senate,"Placed on suspense file",7,0,0,0,7
1212448,905346,2020-01-23,Senate,"Do pass",7,0,0,0,7
1212448,906432,2020-01-27,Senate,"Senate 3rd Reading SB388 Galgiani",39,0,0,0,39
1212448,974939,2020-08-05,Assembly,"Do pass and be re-referred to the Committee on [Appropriations] with recommendation: To Consent Calendar",8,0,0,0,8
1212448,976383,2020-08-20,Assembly,"Do pass",18,0,0,0,18
1212448,978033,2020-08-30,Assembly,"SB 388 Galgiani Senate Third Reading By Daly",75,0,4,0,79
1212452,839429,2019-04-02,Assembly,"Do pass as amended and be re-referred to the Committee on [Appropriations]",15,0,0,0,15
1212452,865856,2019-05-16,Assembly,"Do pass",18,0,0,0,18
1212452,870186,2019-05-22,Assembly,"AB 798 Cervantes Assembly Third Reading",78,0,2,0,80
1212452,880950,2019-06-12,Senate,"Do pass as amended, but first amend, and re-refer to the Committee on [Appropriations]",9,0,0,0,9
1212452,976158,2020-08-19,Senate,"Placed on suspense file",7,0,0,0,7
1212453,833036,2019-03-26,Assembly,"Do pass as amended and be re-referred to the Committee on [Appropriations]",6,0,2,0,8
1212453,866042,2019-05-16,Assembly,"Do pass",18,0,0,0,18
1212453,874581,2019-05-29,Assembly,"AB 907 Grayson Assembly Third Reading",74,0,6,0,80
1212453,892725,2019-07-02,Senate,"Do pass as amended, but first amend, and re-refer to the Committee on [Appropriations]",7,0,0,0,7
1212453,892726,2019-08-12,Senate,"Placed on suspense file",7,0,0,0,7
1212456,850149,2019-04-23,Senate,"Do pass, but first be re-referred to the Committee on [Appropriations]",0,4,1,0,5
1212460,831071,2019-03-26,Assembly,"Do pass and be re-referred to the Committee on [Appropriations]",8,0,0,0,8
1212460,866201,2019-05-16,Assembly,"Do pass",14,1,3,0,18
1212460,870048,2019-05-22,Assembly,"AB 944 Quirk Assembly Third Reading",66,0,14,0,80
1212460,880931,2019-06-10,Senate,"Do pass, but first be re-referred to the Committee on [Appropriations]",5,0,1,0,6
1212460,889301,2019-07-01,Senate,"Placed on suspense file",7,0,0,0,7
1212460,891303,2019-08-30,Senate,"Do pass as amended",7,0,0,0,7
1212460,891304,2019-09-06,Senate,"Assembly 3rd Reading AB944 Quirk et al. By Wieckowski",39,0,1,0,40
1212460,891305,2019-09-10,Assembly,"AB 944 Quirk Concurrence in Senate Amendments",68,0,11,0,79
1212460,893848,2019-08-30,Senate,Date,7,0,0,0,7
1212461,837224,2019-04-03,Senate,"Do pass as amended, but first amend, and re-refer to the Committee on [Appropriations]",8,0,1,0,9
1212461,855233,2019-04-29,Senate,"Placed on suspense file",6,0,0,0,6
1212461,865554,2019-05-16,Senate,"Do pass as amended",6,0,0,0,6
1212461,870985,2019-05-23,Senate,"Senate 3rd Reading SB361 Mitchell",38,0,0,0,38
1212461,887643,2019-06-25,Assembly,"Do pass as amended and be re-referred to the Committee on [Appropriations]",15,0,0,0,15
1212461,894666,2019-04-29,Senate,Result,6,0,0,0,6
1212461,894884,2019-05-23,Senate,Date,6,0,0,0,6
1212465,902853,2020-01-14,Assembly,"Do pass and be re-referred to the Committee on [Appropriations]",6,2,0,0,8
1212466,860597,2019-05-06,Assembly,"Do pass and be re-referred to the Committee on [Appropriations]",9,0,2,0,11
1212467,861023,2019-05-06,Assembly,"Do pass and be re-referred to the Committee on [Appropriations]",11,0,0,0,11
1212467,864917,2019-05-15,Assembly,"Do pass. To Consent Calendar",16,0,2,0,18
1212467,870250,2019-05-22,Assembly,"AB 872 Aguiar-Curry Consent Calendar Second Day Regular Session",77,0,3,0,80
1212467,890479,2019-07-03,Senate,"Do pass as amended, but first amend, and re-refer to the Committee on [Appropriations]",7,0,0,0,7
1212467,890480,2019-08-19,Senate,"Assembly 3rd Reading AB872 Aguiar-Curry By Galgiani",40,0,0,0,40
1212467,890481,2019-08-22,Assembly,"AB 872 Aguiar-Curry Concurrence in Senate Amendments",76,0,3,0,79
1212470,855892,2019-04-24,Senate,"Do pass as amended, but first amend, and re-refer to the Committee on [Appropriations]",7,0,0,0,7
1212470,863145,2019-05-13,Senate,"Placed on suspense file",6,0,0,0,6
1212470,865638,2019-05-16,Senate,"Do pass as amended",5,0,1,0,6
1212470,871045,2019-05-23,Senate,"Senate 3rd Reading SB390 Umberg",38,0,0,0,38
1212470,886003,2019-06-19,Assembly,"Do pass and be re-referred to the Committee on [Higher Education]",7,0,0,0,7
1212470,888109,2019-06-25,Assembly,"Do pass and be re-referred to the Committee on [Appropriations]",12,0,0,0,12
1212470,890822,2019-08-30,Assembly,"Do pass",18,0,0,0,18
1212470,890823,2019-09-09,Assembly,"SB 390 Umberg Senate Third Reading By Rodriguez",79,0,0,0,79
1212470,890824,2019-09-10,Senate,"Unfinished Business SB390 Umberg Concurrence",40,0,0,0,40
1212472,839821,2019-04-08,Assembly,"Do pass as amended and be re-referred to the Committee on [Appropriations]",11,0,0,0,11
1212472,856846,2019-05-01,Assembly,"Do pass. To Consent Calendar",18,0,0,0,18
1212472,862127,2019-05-09,Assembly,"AB 815 Aguiar-Curry Consent Calendar Second Day Regular Session",76,0,4,0,80
1212472,884797,2019-06-19,Senate,"Do pass, but first be re-referred to the Committee on [Appropriations]",5,1,1,0,7
1212472,891576,2019-07-08,Senate,"Do pass",5,2,0,0,7
1212472,891577,2019-08-12,Senate,"Assembly 3rd Reading AB815 Aguiar-Curry By Skinner",30,9,1,0,40
1212472,891578,2019-08-15,Assembly,"AB 815 Aguiar-Curry Concurrence in Senate Amendments",75,0,4,0,79
1212474,853325,2019-04-24,Assembly,"Do pass and be re-referred to the Committee on [Appropriations] with recommendation: To Consent Calendar",8,0,0,0,8
1212474,866301,2019-05-16,Assembly,"Do pass as amended",13,0,5,0,18
1212474,873995,2019-05-28,Assembly,"AB 831 Grayson Assembly Third Reading",73,0,7,0,80
1212474,974930,2020-08-06,Senate,"Do pass, but first be re-referred to the Committee on [Appropriations]",10,0,1,0,11
1212474,977474,2020-08-31,Assembly,"With recommendation: That Senate amendments be concurred in",7,0,1,0,8
1212474,977770,2020-08-30,Senate,"Assembly 3rd Reading AB831 Grayson By Caballero Urgency Clause",29,0,11,0,40
1212474,977771,2020-08-31,Assembly,"AB 831 Grayson Concurrence in Senate Amendments",73,0,6,0,79
1212475,841356,2019-04-08,Assembly,"Do pass as amended and be re-referred to the Committee on [Appropriations]",8,3,0,0,11
1212475,866161,2019-05-16,Assembly,"Do pass as amended",13,5,0,0,18
1212475,872201,2019-05-24,Assembly,"AB 936 Robert Rivas Assembly Third Reading",45,19,16,0,80
1212475,887477,2019-06-25,Senate,"Do pass as amended, but first amend, and re-refer to the Committee on [Environmental Quality]",7,1,1,0,9
1212475,892675,2019-07-03,Senate,"Do pass, but first be re-referred to the Committee on [Appropriations]",5,1,1,0,7
1212475,892676,2019-08-12,Senate,"Placed on suspense file",7,0,0,0,7
1212475,892677,2019-08-30,Senate,"Do pass",5,2,0,0,7
1212475,892678,2019-09-10,Senate,"That the measure be returned to Senate Floor for consideration. Ordered to third reading",12,1,0,0,13
1212475,892679,2019-09-11,Senate,"Assembly 3rd Reading AB936 Robert Rivas et al. By Wiener",31,7,2,0,40
1212475,893698,2019-09-12,Assembly,"AB 936 Robert Rivas Concurrence in Senate Amendments",60,10,9,0,79
1212475,894689,2019-09-10,Senate,08/30/19,5,1,0,0,6
1212478,839704,2019-04-09,Senate,"Do pass",5,0,2,0,7
1212478,858152,2019-05-02,Senate,"Senate 3rd Reading SB394 Skinner",30,2,6,0,38
1212478,887573,2019-06-25,Assembly,"Do pass",6,0,2,0,8
1212478,891231,2019-09-11,Assembly,"SB 394 Skinner Senate Third Reading By Wicks",46,14,19,0,79
1212478,893764,2019-09-12,Senate,"Unfinished Business SB394 Skinner et al. Concurrence",29,8,3,0,40
1212481,851880,2019-04-23,Assembly,"Do pass",13,0,2,0,15
1212481,859907,2019-05-06,Assembly,"AB 920 Petrie-Norris Assembly Third Reading",67,1,12,0,80
1212481,891133,2019-07-03,Senate,"Do pass, but first be re-referred to the Committee on [Appropriations]",8,0,1,0,9
1212481,891134,2019-08-12,Senate,"Placed on suspense file",7,0,0,0,7
1212481,891135,2019-08-30,Senate,"Do pass",7,0,0,0,7
1212481,891136,2019-09-11,Senate,"Do pass, but first be re-referred to the Committee on [Appropriations]",8,0,1,0,9
1212481,893793,2019-09-12,Senate,"Do pass",7,0,0,0,7
1212481,893859,2019-09-13,Assembly,"With recommendation: That Senate amendments be concurred in",15,0,3,0,18
1212481,893981,2019-09-13,Assembly,"AB 920 Petrie-Norris Concurrence in Senate Amendments",78,0,1,0,79
1212481,894194,2019-09-13,Senate,"Assembly 3rd Reading AB920 Petrie-Norris et al. By Hill",40,0,0,0,40
1212484,843119,2019-04-10,Senate,"Do pass, but first be re-referred to the Committee on [Appropriations] with the recommendation: To Consent Calendar",8,0,1,0,9
1212484,855207,2019-04-29,Senate,"Placed on suspense file",6,0,0,0,6
1212484,865609,2019-05-16,Senate,"Do pass",6,0,0,0,6
1212484,871245,2019-05-23,Senate,"Special Consent SB389",38,0,0,0,38
1212484,887639,2019-06-25,Assembly,"Do pass and be re-referred to the Committee on [Appropriations] with recommendation: To Consent Calendar",15,0,0,0,15
1212484,890538,2019-07-10,Assembly,"Do pass. To Consent Calendar",16,0,2,0,18
1212484,890539,2019-08-15,Assembly,"SB 389 Hertzberg Consent Calendar Second Day Regular Session",76,0,3,0,79
1212484,894868,2019-08-15,Assembly,Date,16,0,0,0,16
1212487,829432,2019-03-25,Assembly,"Do pass and be re-referred to the Committee on [Appropriations] with recommendation: To Consent Calendar",11,0,0,0,11
1212488,830798,2019-03-27,Senate,"Do pass, but first be re-referred to the Committee on [Veterans Affairs]",7,0,0,0,7
1212488,851462,2019-04-23,Senate,"Do pass, but first be re-referred to the Committee on [Appropriations]",7,0,0,0,7
1212488,860357,2019-05-06,Senate,"Placed on suspense file",5,0,1,0,6
1212488,866485,2019-05-16,Senate,"Do pass as amended",6,0,0,0,6
1212488,871604,2019-05-23,Senate,"Senate 3rd Reading SB364 Stone",38,0,0,0,38
1212488,974194,2020-07-27,Assembly,"Do pass",6,1,3,0,10
1212488,974759,2020-08-03,Assembly,"SB 364 Mitchell Senate Third Reading By Ting",56,12,11,0,79
1212488,976621,2020-08-24,Senate,"Unfinished Business SB364 Mitchell Concurrence",30,10,0,0,40
1212492,901474,2020-01-08,Assembly,"Do pass and be re-referred to the Committee on [Appropriations]",5,2,0,0,7
1212494,836189,2019-04-02,Assembly,"Do pass and be re-referred to the Committee on [Appropriations]",11,1,3,0,15
1212496,842917,2019-04-10,Assembly,"Do pass and be re-referred to the Committee on [Appropriations]",14,0,1,0,15
1212496,851646,2019-04-24,Assembly,"Do pass",18,0,0,0,18
1212496,859528,2019-05-06,Assembly,"AB 923 Wicks Assembly Third Reading",77,0,3,0,80
1212496,883814,2019-06-18,Senate,"Do pass as amended, but first amend, and re-refer to the Committee on [Appropriations]",13,0,0,0,13
1212496,893717,2019-08-26,Senate,"Assembly 3rd Reading AB923 Wicks By Wiener",39,0,1,0,40
1212496,893718,2019-09-03,Assembly,"AB 923 Wicks Concurrence in Senate Amendments",77,0,2,0,79
1212499,830639,2019-03-27,Assembly,"Do pass. To Consent Calendar",7,0,0,0,7
1212499,836938,2019-04-04,Assembly,"AB 946 E. & R. Consent Calendar Second Day Regular Session",75,0,5,0,80
1212499,860990,2019-05-07,Senate,"Do pass and be ordered to the Consent Calendar",5,0,0,0,5
1212499,890743,2019-09-03,Senate,"Assembly 3rd Reading AB946 E. & R. (Berman) By Umberg",40,0,0,0,40
1212499,890744,2019-09-05,Assembly,"AB 946 E. & R. Concurrence in Senate Amendments By BERMAN",79,0,0,0,79
1212500,841848,2019-04-09,Assembly,"Do pass and be re-referred to the Committee on [Appropriations]",14,0,0,0,14
1212502,852817,2019-04-24,Assembly,"Do pass and be re-referred to the Committee on [Appropriations]",5,2,0,0,7
1212502,905377,2020-01-23,Assembly,"Do pass as amended",11,6,1,0,18
1212502,906415,2020-01-27,Assembly,"AB 790 Levine Assembly Third Reading",37,24,19,0,80
1212504,833192,2019-03-26,Senate,"Do pass as amended, but first amend, and re-refer to the Committee on [Appropriations]",7,0,2,0,9
1212504,859513,2019-05-06,Senate,"Senate 3rd Reading SB367 Hueso",33,0,5,0,38
1212504,879874,2019-06-10,Assembly,"Do pass as amended and be re-referred to the Committee on [Appropriations]",10,0,1,0,11
1212504,891414,2019-08-30,Assembly,"Do pass",16,0,2,0,18
1212504,891415,2019-09-10,Assembly,"SB 367 Hueso Senate Third Reading By Gloria",73,1,5,0,79
1212504,891416,2019-09-11,Senate,"Unfinished Business SB367 Hueso Concurrence",36,0,4,0,40
1212508,830522,2019-03-27,Senate,"Do pass and be ordered to the Consent Calendar",7,0,0,0,7
1212508,836667,2019-04-04,Senate,"Consent Calendar SB381 GOV. & F",37,0,1,0,38
1212508,884635,2019-06-19,Assembly,"Do pass. To Consent Calendar",8,0,0,0,8
1212508,888502,2019-06-27,Assembly,"SB 381 GOV.& F. Consent Calendar Second Day Regular Session",71,0,8,0,79
1212509,830468,2019-03-26,Assembly,"Do pass and be re-referred to the Committee on [Public Safety]",11,0,0,0,11
1212509,849993,2019-04-23,Assembly,"Do pass. To Consent Calendar",8,0,0,0,8
1212509,858262,2019-05-02,Assembly,"AB 814 Chau Consent Calendar Second Day Regular Session",76,0,4,0,80
1212509,877724,2019-06-04,Senate,"Do pass and be ordered to the Consent Calendar",7,0,0,0,7
1212509,882818,2019-06-17,Senate,"Consent Calendar AB814",40,0,0,0,40
1212512,851314,2019-04-24,Senate,"Do pass, but first be re-referred to the Committee on [Appropriations] with the recommendation: To Consent Calendar",7,0,0,0,7
1212512,862089,2019-05-09,Senate,"Consent Calendar SB383 ED",38,0,0,0,38
1212512,880399,2019-06-11,Assembly,"Do pass and be re-referred to the Committee on [Appropriations]",11,0,1,0,12
1212512,884750,2019-06-19,Assembly,"Do pass. To Consent Calendar",17,0,1,0,18
1212512,888397,2019-06-27,Assembly,"SB 383 ED. Consent Calendar Second Day Regular Session",71,0,8,0,79
1212512,894432,2019-06-19,Assembly,"Do pass. To Consrcia",11,0,0,0,11
1212513,835580,2019-04-03,Senate,"Do pass, but first be re-referred to the Committee on [Appropriations] with the recommendation: To Consent Calendar",7,0,0,0,7
1212513,853150,2019-04-25,Senate,"Consent Calendar SB366",37,0,1,0,38
1212513,880391,2019-06-11,Assembly,"Do pass and be re-referred to the Committee on [Appropriations]",11,0,1,0,12
1212513,884774,2019-06-19,Assembly,"Do pass. To Consent Calendar",17,0,1,0,18
1212513,888540,2019-06-27,Assembly,"SB 366 Chang Consent Calendar Second Day Regular Session",71,0,8,0,79
1212513,891753,2019-07-11,Senate,"Special Consent SB366",39,0,1,0,40
1212514,841803,2019-04-09,Senate,"Do pass, but first be re-referred to the Committee on [Natural Resources and Water]",10,2,0,0,12
1212514,850962,2019-04-23,Senate,"Do pass, but first be re-referred to the Committee on [Appropriations]",6,2,1,0,9
1212514,860086,2019-05-06,Senate,"Do pass",4,0,2,0,6
1212514,867853,2019-05-20,Senate,"Senate 3rd Reading SB402 Borgeas",33,0,5,0,38
1212514,894000,2019-07-01,Assembly,"Do pass and be re-referred to the Committee on [Water, Parks, and Wildlife]",14,0,1,0,15
1212514,894001,2019-07-02,Assembly,"Do pass and be re-referred to the Committee on [Appropriations]",10,0,4,0,14
1212514,894002,2019-08-14,Assembly,"Do pass",17,1,0,0,18
1212514,894003,2019-08-19,Assembly,"SB 402 Borgeas Senate Third Reading",58,11,10,0,79
1212517,834345,2019-04-02,Senate,"Do pass, but first be re-referred to the Committee on [Appropriations]",5,0,2,0,7
1212517,848780,2019-04-22,Senate,"Placed on suspense file",6,0,0,0,6
1212517,865835,2019-05-16,Senate,"Do pass as amended",4,2,0,0,6
1212517,871219,2019-05-23,Senate,"Senate 3rd Reading SB360 Hill",30,4,4,0,38
1212521,835512,2019-04-02,Assembly,"Do pass and be re-referred to the Committee on [Appropriations]",12,0,0,0,12
1212521,866288,2019-05-16,Assembly,"Do pass as amended",18,0,0,0,18
1212521,871369,2019-05-23,Assembly,"AB 843 Rodriguez Assembly Third Reading",78,0,2,0,80
1212522,850529,2019-04-22,Senate,"Do pass, but first be re-referred to the Committee on [Appropriations]",6,0,0,0,6
1212522,859496,2019-05-06,Senate,"Placed on suspense file",5,0,1,0,6
1212525,855673,2019-04-29,Assembly,"Do pass. To Consent Calendar",11,0,0,0,11
1212525,859580,2019-05-06,Assembly,"AB 793 Ting Consent Calendar Second Day Regular Session",77,0,3,0,80
1212525,975950,2020-08-14,Senate,"Do pass as amended, but first amend, and re-refer to the Committee on [Appropriations]",7,0,0,0,7
1212525,976174,2020-08-19,Senate,"Placed on suspense file",7,0,0,0,7
1212525,976431,2020-08-20,Senate,"Do pass as amended",7,0,0,0,7
1212525,978047,2020-08-30,Senate,"Assembly 3rd Reading AB793 Ting et al. By Skinner",39,0,1,0,40
1212525,978048,2020-08-30,Assembly,"AB 793 Ting Concurrence in Senate Amendments",65,0,14,0,79
1212527,830341,2019-03-26,Assembly,"Do pass and be re-referred to the Committee on [Appropriations]",15,0,0,0,15
1212527,851628,2019-04-24,Assembly,"Do pass",18,0,0,0,18
1212527,859597,2019-05-06,Assembly,"AB 929 Luz Rivas Assembly Third Reading",77,0,3,0,80
1212527,888173,2019-06-26,Senate,"Do pass as amended, but first amend, and re-refer to the Committee on [Appropriations]",7,0,2,0,9
1212527,893157,2019-09-04,Senate,"Assembly 3rd Reading AB929 Luz Rivas By Pan",40,0,0,0,40
1212527,893158,2019-09-09,Assembly,"AB 929 Luz Rivas Concurrence in Senate Amendments",78,0,1,0,79
1212529,841765,2019-04-10,Assembly,"Do pass as amended and be re-referred to the Committee on [Governmental Organization]",13,0,0,0,13
1212529,852898,2019-04-24,Assembly,"Do pass as amended and be re-referred to the Committee on [Appropriations]",18,0,3,0,21
1212529,865770,2019-05-16,Assembly,"Do pass as amended",18,0,0,0,18
1212529,872278,2019-05-24,Assembly,"AB 911 Rodriguez Assembly Third Reading",76,0,4,0,80
1212529,887501,2019-06-25,Senate,"Do pass, but first be re-referred to the Committee on [Energy, Utilities and Communications]",14,1,1,0,16
1212529,892495,2019-07-02,Senate,"Do pass, but first be re-referred to the Committee on [Judiciary]",11,0,2,0,13
1212529,892496,2019-07-09,Senate,"Do pass as amended, but first amend, and re-refer to the Committee on [Appropriations]",8,0,1,0,9
1212529,892497,2019-08-12,Senate,"Placed on suspense file",7,0,0,0,7
1212529,892498,2019-08-30,Senate,"Do pass as amended",7,0,0,0,7
1212529,892499,2019-09-04,Senate,"Assembly 3rd Reading AB911 Rodriguez By Monning",39,0,1,0,40
1212529,892500,2019-09-09,Assembly,"AB 911 Rodriguez Concurrence in Senate Amendments",79,0,0,0,79
1212531,841541,2019-04-10,Assembly,"Do pass and be re-referred to the Committee on [Appropriations]",11,0,0,0,11
1212531,905386,2020-01-23,Assembly,"Do pass as amended",17,0,1,0,18
1212531,906364,2020-01-27,Assembly,"AB 838 Eggman Assembly Third Reading",74,0,6,0,80
1212531,974886,2020-08-05,Senate,"Do pass as amended, and be ordered to the Consent Calendar",9,0,0,0,9
1212531,977168,2020-08-27,Senate,"Assembly 3rd Reading AB838 Eggman et al. By Galgiani",30,0,10,0,40
1212531,977811,2020-08-31,Assembly,"AB 838 Eggman Concurrence in Senate Amendments By CALDERON",76,0,3,0,79
1212535,902839,2020-01-14,Assembly,"Do pass and be re-referred to the Committee on [Appropriations]",14,0,1,0,15
1212535,905393,2020-01-23,Assembly,"Do pass. To Consent Calendar",18,0,0,0,18
1212535,912030,2020-01-30,Assembly,"AB 910 Wood Consent Calendar Second Day Regular Session",76,0,4,0,80
1212538,854294,2019-04-23,Assembly,"Do pass as amended and be re-referred to the Committee on [Appropriations]",9,0,2,0,11
1212538,861603,2019-05-08,Assembly,"Do pass",18,0,0,0,18
1212538,873858,2019-05-28,Assembly,"AB 846 Burke Assembly Third Reading",69,4,7,0,80
1212538,891901,2019-07-09,Senate,"Do pass as amended, but first amend, and re-refer to the Committee on [Appropriations]",8,0,1,0,9
1212538,974618,2020-07-31,Senate,"Do pass, but first be re-referred to the Committee on [Appropriations] with the recommendation: To Consent Calendar",7,0,0,0,7
1212538,975768,2020-08-13,Senate,"Placed on suspense file",7,0,0,0,7
1212538,976386,2020-08-20,Senate,"Do pass",7,0,0,0,7
1212538,977181,2020-08-27,Senate,"Assembly 3rd Reading AB846 Burke et al. By Bradford",30,0,10,0,40
1212538,977800,2020-08-31,Assembly,"AB 846 BURKE Concurrence in Senate Amendments",67,0,12,0,79
1212539,850513,2019-04-22,Assembly,"Do pass and be re-referred to the Committee on [Local Government]",7,3,2,0,12
1212539,853022,2019-04-24,Assembly,"Do pass as amended and be re-referred to the Committee on [Appropriations]",5,2,1,0,8
1212539,866020,2019-05-16,Assembly,"Do pass as amended",11,5,2,0,18
1212539,875571,2019-05-30,Assembly,"AB 857 Chiu Assembly Third Reading",41,29,10,0,80
1212539,884569,2019-06-19,Senate,"Do pass as amended, but first amend, and re-refer to the Committee on [Governance and Finance]",4,2,1,0,7
1212539,891985,2019-07-03,Senate,"Do pass as amended, but first amend, and re-refer to the Committee on [Appropriations]",4,3,0,0,7
1212539,891986,2019-08-12,Senate,"Placed on suspense file",7,0,0,0,7
1212539,891987,2019-08-30,Senate,"Do pass as amended",5,2,0,0,7
1212539,891988,2019-09-11,Senate,"Assembly 3rd Reading AB857 Chiu et al. By Hueso",25,11,4,0,40
1212539,893937,2019-09-13,Assembly,"AB 857 Chiu Concurrence in Senate Amendments",42,29,8,0,79
1212540,841646,2019-04-09,Assembly,"Do pass as amended and be re-referred to the Committee on [Appropriations]",8,0,0,0,8
1212540,866207,2019-05-16,Assembly,"Do pass as amended",18,0,0,0,18
1212540,871038,2019-05-23,Assembly,"AB 865 Reyes Assembly Third Reading",77,0,3,0,80
1212540,887834,2019-06-24,Senate,"Do pass, but first be re-referred to the Committee on [Appropriations]",6,0,0,0,6
1212540,892524,2019-08-12,Senate,"Placed on suspense file",7,0,0,0,7
1212540,892525,2019-08-30,Senate,"Do pass as amended",7,0,0,0,7
1212540,892526,2019-09-10,Senate,"Assembly 3rd Reading AB865 Reyes By Mitchell",40,0,0,0,40
1212540,892527,2019-09-11,Assembly,"AB 865 Reyes Concurrence in Senate Amendments",79,0,0,0,79
1212544,855770,2019-04-24,Senate,"Do pass as amended",9,1,3,0,13
1212544,903146,2020-01-15,Senate,"That the measure be held in committee pursuant to Senate Rule 29.10",12,0,0,0,12
1212546,842420,2019-04-10,Senate,"Do pass, but first be re-referred to the Committee on [Appropriations]",3,1,1,0,5
1212546,849454,2019-04-22,Senate,"Placed on suspense file",6,0,0,0,6
1212546,866150,2019-05-16,Senate,"Do pass",4,2,0,0,6
1212546,873859,2019-05-28,Senate,"Senate 3rd Reading SB362 Roth",38,0,0,0,38
1212547,842099,2019-04-09,Assembly,"Do pass and be re-referred to the Committee on [Business and Professions]",10,0,5,0,15
1212547,850726,2019-04-23,Assembly,"Do pass as amended and be re-referred to the Committee on [Appropriations]",18,0,2,0,20
1212550,839966,2019-04-09,Senate,"Do pass, but first be re-referred to the Committee on [Appropriations] with the recommendation: To Consent Calendar",7,0,0,0,7
1212550,852971,2019-04-25,Senate,"Consent Calendar SB399",37,0,1,0,38
1212550,880390,2019-06-11,Assembly,"Do pass and be re-referred to the Committee on [Appropriations] with recommendation: To Consent Calendar",8,0,0,0,8
1212550,884776,2019-06-19,Assembly,"Do pass. To Consent Calendar",17,0,1,0,18
1212550,888408,2019-06-27,Assembly,"SB 399 Atkins Consent Calendar Second Day Regular Session",71,0,8,0,79
1212550,891663,2019-09-10,Assembly,"SB 399 Atkins Senate Third Reading By Kamlager-Dove",77,0,2,0,79
1212550,891664,2019-09-11,Senate,"Unfinished Business SB399 Atkins Concurrence",40,0,0,0,40
1212553,842042,2019-04-09,Assembly,"Do pass as amended",14,0,1,0,15
1212553,868313,2019-05-20,Assembly,"AB 922 Burke Assembly Third Reading",68,0,12,0,80
1212553,881071,2019-06-12,Senate,"Do pass",6,1,2,0,9
1212553,891166,2019-09-11,Senate,"Assembly 3rd Reading AB922 Burke By Portantino",28,4,8,0,40
1212553,893701,2019-09-12,Assembly,"AB 922 Burke Concurrence in Senate Amendments",74,0,5,0,79
1212553,894351,2019-05-20,Assembly,"Bill Votes",14,0,0,0,14
1212554,853133,2019-04-24,Assembly,"Do pass and be re-referred to the Committee on [Appropriations]",7,0,0,0,7
1212554,866092,2019-05-16,Assembly,"Do pass",18,0,0,0,18
1212554,869949,2019-05-22,Assembly,"AB 875 Wicks Assembly Third Reading",78,0,2,0,80
1212555,851672,2019-04-23,Assembly,"Do pass and be re-referred to the Committee on [Appropriations] with recommendation: To Consent Calendar",8,0,0,0,8
1212555,856960,2019-05-01,Assembly,"Do pass. To Consent Calendar",18,0,0,0,18
1212555,862343,2019-05-09,Assembly,"AB 819 Mark Stone Consent Calendar Second Day Regular Session",76,0,4,0,80
1212555,891227,2019-07-08,Senate,"Do pass, but first be re-referred to the Committee on [Public Safety]",6,0,0,0,6
1212555,891228,2019-07-09,Senate,"Do pass, but first be re-referred to the Committee on [Appropriations] with the recommendation: To Consent Calendar",7,0,0,0,7
1212555,891229,2019-09-09,Senate,"Assembly 3rd Reading AB819 Mark Stone By Hurtado",40,0,0,0,40
1212555,891230,2019-09-10,Assembly,"AB 819 Mark Stone Concurrence in Senate Amendments",79,0,0,0,79
1212558,831123,2019-03-27,Assembly,"Do pass and be re-referred to the Committee on [Appropriations] with recommendation: To Consent Calendar",7,0,0,0,7
1212558,841789,2019-04-10,Assembly,"Do pass. To Consent Calendar",17,0,1,0,18
1212558,852698,2019-04-25,Assembly,"AB 805 Obernolte Consent Calendar Second Day Regular Session",76,0,4,0,80
1212562,830508,2019-03-26,Assembly,"Do pass and be re-referred to the Committee on [Judiciary]",12,0,3,0,15
1212562,839888,2019-04-09,Assembly,"Do pass as amended and be re-referred to the Committee on [Appropriations]",10,0,2,0,12
1212562,865726,2019-05-16,Assembly,"Do pass as amended",13,1,4,0,18
1212562,872077,2019-05-24,Assembly,"AB 824 Wood Assembly Third Reading",56,0,24,0,80
1212562,891760,2019-07-03,Senate,"Do pass, but first be re-referred to the Committee on [Judiciary]",7,2,0,0,9
1212562,891761,2019-07-09,Senate,"Do pass as amended, but first amend, and re-refer to the Committee on [Appropriations]",7,1,1,0,9
1212562,891762,2019-08-12,Senate,"Placed on suspense file",7,0,0,0,7
1212562,891763,2019-08-30,Senate,"Do pass as amended",5,1,1,0,7
1212562,891764,2019-09-11,Senate,"Assembly 3rd Reading AB824 Wood et al. By Hertzberg",31,8,1,0,40
1212562,893602,2019-09-12,Assembly,"AB 824 Wood Concurrence in Senate Amendments",64,1,14,0,79
1212564,851779,2019-04-23,Senate,"Do pass as amended, but first amend, and re-refer to the Committee on [Appropriations]",12,0,0,0,12
1212564,867879,2019-05-20,Senate,"Senate 3rd Reading SB369 Hertzberg",38,0,0,0,38
1212564,970008,2020-06-29,Assembly,"Be re-referred to the Committee on [Public Safety]",7,0,5,0,12
1212564,975811,2020-08-13,Assembly,"Do pass and be re-referred to the Committee on [Appropriations]",7,0,1,0,8
1212564,976478,2020-08-20,Assembly,"Do pass as amended",17,0,1,0,18
1212564,977933,2020-08-31,Senate,"Unfinished Business SB369 Hertzberg et al. Concurrence",32,2,6,0,40
1212564,977934,2020-08-31,Assembly,"SB 369 Hertzberg Senate Third Reading By Weber",72,0,7,0,79
1212566,853686,2019-04-24,Assembly,"Do pass as amended and be re-referred to the Committee on [Appropriations]",7,0,0,0,7
1212566,905399,2020-01-23,Assembly,"Do pass",18,0,0,0,18
1212566,906369,2020-01-27,Assembly,"AB 908 O'Donnell Assembly Third Reading",78,0,2,0,80
1212566,974276,2020-07-29,Senate,"Do pass as amended, and be ordered to the Consent Calendar",7,0,0,0,7
1212566,977287,2020-08-28,Senate,"Consent Calendar AB908 O'Donnell Urgency Clause",39,0,1,0,40
1212566,978156,2020-08-30,Assembly,"AB 908 O'Donnell Concurrence - Urgency Added",75,0,4,0,79
1212567,832492,2019-03-27,Assembly,"Do pass as amended and be re-referred to the Committee on [Appropriations]",6,0,0,0,6
1212567,866070,2019-05-16,Assembly,"Do pass",18,0,0,0,18
1212567,874425,2019-05-29,Assembly,"AB 852 Burke Assembly Third Reading",78,0,2,0,80
1212567,884741,2019-06-19,Senate,"Do pass as amended, but first amend, and re-refer to the Committee on [Appropriations] with the recommendation: To Consent Calendar",6,0,1,0,7
1212567,891264,2019-07-08,Senate,"Placed on suspense file",7,0,0,0,7
1212567,891265,2019-08-30,Senate,"Do pass",7,0,0,0,7
1212567,891266,2019-09-09,Senate,"Special Consent AB852",40,0,0,0,40
1212567,891267,2019-09-10,Assembly,"AB 852 Burke Concurrence in Senate Amendments",79,0,0,0,79
1212569,841556,2019-04-10,Assembly,"Do pass. To Consent Calendar",7,0,0,0,7
1212569,853580,2019-04-25,Assembly,"AB 869 Cunningham Consent Calendar Second Day Regular Session",76,0,4,0,80
1212569,887874,2019-06-25,Senate,"Do pass and be ordered to the Consent Calendar",16,0,0,0,16
1212569,891426,2019-09-09,Senate,"Assembly 3rd Reading AB869 Cunningham By Jones",40,0,0,0,40
1212569,891427,2019-09-10,Assembly,"AB 869 Cunningham Concurrence in Senate Amendments",79,0,0,0,79
1212570,841930,2019-04-09,Assembly,"Do pass and be re-referred to the Committee on [Health] with recommendation: To Consent Calendar",8,0,0,0,8
1212570,850502,2019-04-23,Assembly,"Do pass as amended and be re-referred to the Committee on [Appropriations]",15,0,0,0,15
1212570,866244,2019-05-16,Assembly,"Do pass",18,0,0,0,18
1212570,870214,2019-05-22,Assembly,"AB 826 Reyes Assembly Third Reading",78,0,2,0,80
1212570,881070,2019-06-12,Senate,"Do pass, but first be re-referred to the Committee on [Human Services]",7,1,1,0,9
1212570,975354,2020-08-10,Senate,"Do pass, but first be re-referred to the Committee on [Appropriations]",5,2,0,0,7
1212570,976045,2020-08-17,Senate,"Placed on suspense file",7,0,0,0,7
1212570,976313,2020-08-20,Senate,"Do pass as amended",5,2,0,0,7
1212570,977487,2020-08-31,Assembly,"With recommendation: That Senate amendments be concurred in",13,0,4,0,17
1212570,977729,2020-08-30,Senate,"Assembly 3rd Reading AB826 Santiago et al. By Durazo Urgency Clause",29,9,2,0,40
1212570,977730,2020-08-31,Assembly,"AB 826 Santiago Concurrence - Urgency Added",64,0,15,0,79
1212575,834203,2019-04-02,Senate,"Do pass, but first be re-referred to the Committee on [Appropriations]",5,1,1,0,7
1212575,848841,2019-04-22,Senate,"Placed on suspense file",6,0,0,0,6
1212575,866443,2019-05-16,Senate,"Do pass as amended",4,2,0,0,6
1212575,871274,2019-05-23,Senate,"Senate 3rd Reading SB376 Portantino",26,9,3,0,38
1212575,891610,2019-07-09,Assembly,"Do pass and be re-referred to the Committee on [Appropriations]",7,1,0,0,8
1212575,891611,2019-08-30,Assembly,"Do pass",14,4,0,0,18
1212575,891612,2019-09-10,Assembly,"SB 376 Portantino Senate Third Reading By Bauer-Kahan",57,19,3,0,79
1212575,891613,2019-09-11,Senate,"Unfinished Business SB376 Portantino Concurrence",27,12,1,0,40
1212576,853699,2019-04-09,Senate,"Do pass as amended, but first amend, and re-refer to the Committee on [Appropriations]",9,0,0,0,9
1212576,863246,2019-05-13,Senate,"Placed on suspense file",6,0,0,0,6
1212576,866335,2019-05-16,Senate,"Do pass",6,0,0,0,6
1212576,871269,2019-05-23,Senate,"Special Consent SB395",38,0,0,0,38
1212576,890895,2019-07-02,Assembly,"Do pass as amended and be re-referred to the Committee on [Appropriations]",8,0,6,0,14
1212576,890896,2019-08-30,Assembly,"Do pass",17,1,0,0,18
1212576,890897,2019-09-11,Assembly,"SB 395 Archuleta Senate Third Reading By Aguiar-Curry",63,5,11,0,79
1212576,893713,2019-09-12,Senate,"Unfinished Business SB395 Archuleta et al. Concurrence",40,0,0,0,40
1212579,853428,2019-04-24,Assembly,"Do pass as amended and be re-referred to the Committee on [Appropriations]",8,0,0,0,8
1212579,864914,2019-05-15,Assembly,"Do pass. To Consent Calendar",16,0,2,0,18
1212579,869796,2019-05-22,Assembly,"AB 948 Kalra Consent Calendar Second Day Regular Session",77,0,3,0,80
1212579,887918,2019-06-26,Senate,"Do pass, but first be re-referred to the Committee on [Appropriations]",7,0,0,0,7
1212579,890965,2019-08-26,Senate,"Assembly 3rd Reading AB948 Kalra et al. By Monning",35,3,2,0,40
1212579,890966,2019-09-03,Assembly,"AB 948 Kalra Concurrence in Senate Amendments",77,0,2,0,79
1212582,836198,2019-04-03,Assembly,"Do pass and be re-referred to the Committee on [Appropriations]",5,2,0,0,7
1212582,866292,2019-05-16,Assembly,"Do pass",13,5,0,0,18
1212582,870771,2019-05-22,Assembly,"AB 894 Santiago Assembly Third Reading",59,18,3,0,80
1212582,884863,2019-06-19,Senate,"Do pass, but first be re-referred to the Committee on [Appropriations]",4,1,0,0,5
1212582,891642,2019-07-01,Senate,"Placed on suspense file",7,0,0,0,7
1212582,891643,2019-08-30,Senate,"Do pass as amended",5,2,0,0,7
1212582,891644,2019-09-04,Senate,"Assembly 3rd Reading AB894 Santiago et al. By Hill",29,11,0,0,40
1212582,891645,2019-09-09,Assembly,"AB 894 Santiago Concurrence in Senate Amendments",61,18,0,0,79
1212583,830609,2019-03-27,Senate,"Do pass, but first be re-referred to the Committee on [Environmental Quality]",7,0,0,0,7
1212583,834576,2019-04-03,Senate,"Do pass as amended, but first amend, and re-refer to the Committee on [Appropriations]",7,0,0,0,7
1212583,848893,2019-04-22,Senate,"Placed on suspense file",6,0,0,0,6
1212583,866176,2019-05-16,Senate,"Do pass as amended",6,0,0,0,6
1212583,870927,2019-05-23,Senate,"Senate 3rd Reading SB414 Caballero",37,0,1,0,38
1212583,892507,2019-07-02,Assembly,"Do pass and be re-referred to the Committee on [Local Government]",5,2,2,0,9
1212583,892508,2019-07-10,Assembly,"Do pass and be re-referred to the Committee on [Appropriations]",7,1,0,0,8
1212588,842400,2019-04-09,Assembly,"Do pass and be re-referred to the Committee on [Judiciary]",8,0,0,0,8
1212588,850161,2019-04-23,Assembly,"Do pass as amended and be re-referred to the Committee on [Appropriations]",12,0,0,0,12
1212589,829404,2019-03-26,Assembly,"Do pass and be re-referred to the Committee on [Appropriations]",8,0,0,0,8
1212589,865525,2019-05-16,Assembly,"Do pass",18,0,0,0,18
1212589,869719,2019-05-22,Assembly,"AB 917 Reyes Assembly Third Reading",71,0,9,0,80
1212589,887519,2019-06-25,Senate,"Do pass, but first be re-referred to the Committee on [Appropriations]",5,0,2,0,7
1212589,892147,2019-07-08,Senate,"Placed on suspense file",7,0,0,0,7
1212589,892148,2019-08-30,Senate,"Do pass as amended",5,1,1,0,7
1212589,892149,2019-09-05,Senate,"Assembly 3rd Reading AB917 Reyes",32,4,4,0,40
1212589,892150,2019-09-09,Assembly,"AB 917 Reyes Concurrence in Senate Amendments",73,3,3,0,79
1212589,894810,2019-08-30,Senate,Date,7,0,0,0,7
1212591,830592,2019-03-26,Assembly,"Do pass as amended, and be re-referred to the Committee on [Appropriations] with recommendation: To Consent Calendar",12,0,0,0,12
1212591,841426,2019-04-10,Assembly,"Do pass. To Consent Calendar",17,0,1,0,18
1212591,853425,2019-04-25,Assembly,"AB 925 Gloria Consent Calendar Second Day Regular Session",76,0,4,0,80
1212591,884864,2019-06-18,Senate,"Do pass, but first be re-referred to the Committee on [Appropriations] with the recommendation: To Consent Calendar",9,0,0,0,9
1212591,891896,2019-08-26,Senate,"Assembly 3rd Reading AB925 Gloria By Rubio",39,0,1,0,40
1212591,891897,2019-08-30,Assembly,"AB 925 Gloria Concurrence in Senate Amendments",75,0,4,0,79
1212594,854828,2019-04-23,Assembly,"Do pass as amended and be re-referred to the Committee on [Appropriations]",10,0,1,0,11
1212594,864842,2019-05-15,Assembly,"Do pass",16,0,2,0,18
1212594,870367,2019-05-22,Assembly,"AB 873 Irwin Assembly Third Reading",73,0,7,0,80
1212594,892045,2019-07-09,Senate,"Do pass, but first be re-referred to the Committee on [Appropriations]",3,3,3,0,9
1212594,892046,2019-07-09,Senate,"[First] hearing set for [07-10-2019]: Failed passage in Committee. Reconsideration granted",9,0,0,0,9
1212596,833767,2019-03-26,Senate,"Do pass as amended, but first amend, and re-refer to the Committee on [Appropriations]",9,0,0,0,9
1212596,859708,2019-05-06,Senate,"Placed on suspense file",5,0,1,0,6
1212599,850755,2019-04-22,Senate,"Do pass, but first be re-referred to the Committee on [Appropriations]",6,0,0,0,6
1212599,859659,2019-05-06,Senate,"Placed on suspense file",5,0,1,0,6
1212599,865955,2019-05-16,Senate,"Do pass",6,0,0,0,6
1212599,871636,2019-05-23,Senate,"Special Consent SB412",38,0,0,0,38
1212599,884008,2019-06-18,Assembly,"Do pass and be re-referred to the Committee on [Appropriations] with recommendation: To Consent Calendar",8,0,0,0,8
1212601,830438,2019-03-27,Senate,"Do pass and be ordered to the Consent Calendar",7,0,0,0,7
1212601,836658,2019-04-04,Senate,"Consent Calendar SB379 GOV. & F. (McGuire) Urgency Clause",37,0,1,0,38
1212601,884620,2019-06-19,Assembly,"Do pass. To Consent Calendar",8,0,0,0,8
1212601,888427,2019-06-27,Assembly,"SB 379 GOV.& F. Consent Calendar Second Day Regular Session",71,0,8,0,79
1212602,837077,2019-04-03,Senate,"Do pass as amended, but first amend, and re-refer to the Committee on [Labor, Public Employment and Retirement ]",8,0,1,0,9
1212602,851818,2019-04-24,Senate,"Do pass, but first be re-referred to the Committee on [Appropriations]",5,0,0,0,5
1212602,863256,2019-05-13,Senate,"Placed on suspense file",6,0,0,0,6
1212602,865899,2019-05-16,Senate,"Do pass",6,0,0,0,6
1212602,871323,2019-05-23,Senate,"Special Consent SB363",38,0,0,0,38
1212602,888661,2019-06-26,Assembly,"Do pass and be re-referred to the Committee on [Health] with recommendation: To Consent Calendar",7,0,0,0,7
1212602,891046,2019-07-09,Assembly,"Do pass and be re-referred to the Committee on [Appropriations] with recommendation: To Consent Calendar",15,0,0,0,15
1212602,891047,2019-08-30,Assembly,"Do pass",18,0,0,0,18
1212602,891048,2019-09-10,Assembly,"SB 363 Pan Senate Third Reading By Aguiar-Curry",79,0,0,0,79
1212602,891049,2019-09-11,Senate,"Unfinished Business SB363 Pan Concurrence",40,0,0,0,40
1212605,837206,2019-04-03,Assembly,"Do pass and be re-referred to the Committee on [Accountability and Administrative Review]",7,0,1,0,8
1212605,866578,2019-05-16,Assembly,"Do pass as amended",13,3,2,0,18
1212605,872328,2019-05-24,Assembly,"AB 931 Boerner Horvath Assembly Third Reading",58,11,11,0,80
1212605,884547,2019-06-19,Senate,"Do pass as amended, but first amend, and re-refer to the Committee on [Judiciary]",5,1,1,0,7
1212605,892935,2019-07-09,Senate,"Do pass as amended, but first amend, and re-refer to the Committee on [Appropriations]",6,1,2,0,9
1212605,892936,2019-08-19,Senate,"Placed on suspense file",5,0,2,0,7
1212605,892937,2019-08-30,Senate,"Do pass as amended",5,2,0,0,7
1212605,892938,2019-09-05,Senate,"Assembly 3rd Reading AB931 Boerner Horvath By Skinner",27,9,4,0,40
1212605,892939,2019-09-09,Assembly,"AB 931 Boerner Horvath Concurrence in Senate Amendments",60,13,6,0,79
1212606,839814,2019-04-08,Senate,"Do pass as amended, but first amend, and re-refer to the Committee on [Appropriations] with the recommendation: To Consent Calendar",6,0,0,0,6
1212606,855203,2019-04-29,Senate,"Placed on suspense file",6,0,0,0,6
1212606,866488,2019-05-16,Senate,"Do pass",6,0,0,0,6
1212606,871050,2019-05-23,Senate,"Special Consent SB365",38,0,0,0,38
1212606,883851,2019-06-18,Assembly,"Do pass and be re-referred to the Committee on [Appropriations]",8,0,0,0,8
1212606,890684,2019-08-30,Assembly,"Do pass as amended",18,0,0,0,18
1212606,890685,2019-09-09,Assembly,"SB 365 Durazo Senate Third Reading By Mathis",79,0,0,0,79
1212606,890686,2019-09-10,Senate,"Unfinished Business SB365 Durazo et al. Concurrence",40,0,0,0,40
1212607,853238,2019-04-24,Senate,"Do pass, but first be re-referred to the Committee on [Appropriations]",7,2,0,0,9
1212607,863245,2019-05-13,Senate,"Placed on suspense file",6,0,0,0,6
1212607,866099,2019-05-16,Senate,"Do pass",4,2,0,0,6
1212607,868631,2019-05-21,Senate,"Senate 3rd Reading SB407 Monning",29,9,0,0,38
1212607,893571,2019-07-09,Assembly,"Do pass as amended and be re-referred to the Committee on [Appropriations]",12,0,3,0,15
1212607,893572,2019-08-30,Assembly,"Do pass",14,3,1,0,18
1212607,893573,2019-09-09,Assembly,"SB 407 Monning Senate Third Reading By Wood",66,8,5,0,79
1212607,893574,2019-09-11,Senate,"Unfinished Business SB407 Monning Concurrence",30,10,0,0,40
1212610,839076,2019-04-02,Senate,"Do pass as amended, but first amend, and re-refer to the Committee on [Appropriations]",7,0,0,0,7
1212610,858236,2019-05-02,Senate,"Senate 3rd Reading SB409 Wilk et al",38,0,0,0,38
1212610,974941,2020-08-05,Assembly,"Do pass as amended and be re-referred to the Committee on [Appropriations]",8,0,0,0,8
1212614,851576,2019-04-23,Assembly,"Do pass as amended and be re-referred to the Committee on [Appropriations]",8,0,0,0,8
1212616,829481,2019-03-26,Assembly,"Do pass and be re-referred to the Committee on [Judiciary] with recommendation: To Consent Calendar",8,0,0,0,8
1212616,833826,2019-04-02,Assembly,"Do pass and be re-referred to the Committee on [Appropriations] with recommendation: To Consent Calendar",12,0,0,0,12
1212616,893809,2019-04-02,Assembly,03/26/19,8,0,0,0,8
1212619,856600,2019-04-24,Senate,"Do pass as amended, but first amend, and re-refer to the Committee on [Appropriations]",7,0,0,0,7
1212619,868881,2019-05-21,Senate,"Senate 3rd Reading SB387 Wilk",38,0,0,0,38
1212619,893140,2019-07-03,Assembly,"Do pass and be re-referred to the Committee on [Appropriations] with recommendation: To Consent Calendar",8,0,0,0,8
1212619,893141,2019-08-14,Assembly,"Do pass",18,0,0,0,18
1212619,893142,2019-09-03,Assembly,"SB 387 Wilk Senate Third Reading By Lackey",76,0,3,0,79
1212620,841802,2019-04-09,Senate,"Do pass, but first be re-referred to the Committee on [Education]",8,3,1,0,12
1212620,852009,2019-04-24,Senate,"Do pass, but first be re-referred to the Committee on [Judiciary]",6,0,1,0,7
1212620,856628,2019-04-30,Senate,"Do pass as amended",9,0,0,0,9
1212621,836767,2019-04-03,Assembly,"Do pass and be re-referred to the Committee on [Appropriations]",20,0,1,0,21
1212621,851619,2019-04-24,Assembly,"Do pass. To Consent Calendar",18,0,0,0,18
1212621,858135,2019-05-02,Assembly,"AB 860 Berman Consent Calendar Second Day Regular Session",76,0,4,0,80
1212621,962410,2020-06-02,Senate,"Do pass, but first be re-referred to the Committee on [Appropriations]",4,1,0,0,5
1212621,964375,2020-06-09,Senate,"Placed on suspense file",2,5,0,0,7
1212621,964376,2020-06-09,Senate,"Do pass",5,2,0,0,7
1212621,965565,2020-06-11,Senate,"Assembly 3rd Reading AB860 Berman et al. By Umberg Urgency Clause",31,7,2,0,40
1212621,966778,2020-06-16,Assembly,"With recommendation: That Senate amendments be concurred in",6,0,1,0,7
1212621,967512,2020-06-18,Assembly,"AB 860 Berman Concurrence - Urgency Added",68,5,6,0,79
1212626,838479,2019-04-08,Senate,"Do pass as amended, but first amend, and re-refer to the Committee on [Public Safety]",9,0,0,0,9
1212626,852296,2019-04-23,Senate,"Do pass, but first be re-referred to the Committee on [Appropriations] with the recommendation: To Consent Calendar",7,0,0,0,7
1212626,862163,2019-05-09,Senate,"Senate 3rd Reading SB385 Jones",38,0,0,0,38
1212626,887663,2019-06-25,Assembly,"Do pass as amended and be re-referred to the Committee on [Appropriations]",19,0,0,0,19
1212626,893581,2019-08-14,Assembly,"Do pass",18,0,0,0,18
1212626,893582,2019-09-03,Assembly,"SB 385 Jones Senate Third Reading By Obernolte",77,0,2,0,79
1212626,893583,2019-09-04,Senate,"Unfinished Business SB385 Jones Concurrence",40,0,0,0,40
1212628,851881,2019-04-23,Senate,"Do pass, but first be re-referred to the Committee on [Appropriations]",12,0,0,0,12
1212628,863274,2019-05-13,Senate,"Senate 3rd Reading SB397 Glazer",37,0,1,0,38
1212628,889227,2019-07-01,Assembly,"Do pass and be re-referred to the Committee on [Appropriations] with recommendation: To Consent Calendar",15,0,0,0,15
1212628,893147,2019-08-14,Assembly,"Do pass",18,0,0,0,18
1212628,893148,2019-09-09,Assembly,"SB 397 Glazer Senate Third Reading By Smith",79,0,0,0,79
1212628,893149,2019-09-10,Senate,"Unfinished Business SB397 Glazer Concurrence",40,0,0,0,40
1212628,893988,2019-09-09,Assembly,08/14/19,18,0,0,0,18
1212629,852612,2019-04-23,Assembly,"Do pass and be re-referred to the Committee on [Appropriations]",14,1,0,0,15
1212632,841439,2019-04-08,Assembly,"Do pass as amended and be re-referred to the Committee on [Appropriations]",8,1,2,0,11
1212632,866162,2019-05-16,Assembly,"Do pass as amended",13,4,1,0,18
1212632,871336,2019-05-23,Assembly,"AB 792 Ting Assembly Third Reading",50,15,15,0,80
1212632,891750,2019-07-03,Senate,"Do pass as amended, but first amend, and re-refer to the Committee on [Appropriations]",5,1,1,0,7
1212632,891751,2019-08-12,Senate,"Placed on suspense file",7,0,0,0,7
1212632,891752,2019-08-30,Senate,"Do pass as amended",5,1,1,0,7
1212632,893951,2019-09-14,Assembly,"AB 792 Ting Concurrence in Senate Amendments",60,12,7,0,79
1212632,894146,2019-09-13,Senate,"Assembly 3rd Reading AB792 Ting et al. By Skinner",31,7,2,0,40
1212633,811665,2019-02-28,Assembly,"Be adopted. To third reading",11,0,1,0,12
1212634,830416,2019-03-26,Assembly,"Do pass and be re-referred to the Committee on [Appropriations]",15,0,0,0,15
1212634,865934,2019-05-16,Assembly,"Do pass",18,0,0,0,18
1212634,870204,2019-05-22,Assembly,"AB 848 Gray Assembly Third Reading",78,0,2,0,80
1212634,880949,2019-06-12,Senate,"Do pass, but first be re-referred to the Committee on [Appropriations]",9,0,0,0,9
1212634,887086,2019-06-24,Senate,"Placed on suspense file",7,0,0,0,7
1212634,892134,2019-08-30,Senate,"Do pass as amended",7,0,0,0,7
1212634,892135,2019-09-04,Senate,"Assembly 3rd Reading AB848 Gray et al. By Galgiani",40,0,0,0,40
1212634,892136,2019-09-09,Assembly,"AB 848 Gray Concurrence in Senate Amendments",79,0,0,0,79
1212641,851449,2019-04-23,Assembly,"Do pass and be re-referred to the Committee on [Appropriations] with recommendation: To Consent Calendar",15,0,0,0,15
1212641,865844,2019-05-16,Assembly,"Do pass",18,0,0,0,18
1212641,869936,2019-05-22,Assembly,"AB 898 Wicks Assembly Third Reading",78,0,2,0,80
1212641,881089,2019-06-12,Senate,"Do pass as amended, but first amend, and re-refer to the Committee on [Appropriations] with the recommendation: To Consent Calendar",9,0,0,0,9
1212641,887003,2019-06-24,Senate,"Placed on suspense file",7,0,0,0,7
1212643,830613,2019-03-27,Senate,"Do pass, but first be re-referred to the Committee on [Environmental Quality]",7,0,0,0,7
1212643,834883,2019-04-03,Senate,"Do pass as amended, but first amend, and re-refer to the Committee on [Appropriations] with the recommendation: To Consent Calendar",7,0,0,0,7
1212643,858280,2019-05-02,Senate,"Senate 3rd Reading SB413 Rubio et al",38,0,0,0,38
1212643,877814,2019-06-04,Assembly,"Do pass as amended and be re-referred to the Committee on [Local Government]",8,0,1,0,9
1212643,885022,2019-06-19,Assembly,"Do pass and be re-referred to the Committee on [Appropriations]",8,0,0,0,8
1212643,892266,2019-08-14,Assembly,"Do pass",18,0,0,0,18
1212643,892267,2019-08-22,Assembly,"SB 413 Rubio Senate Third Reading By Chau",75,0,4,0,79
1212643,892268,2019-08-30,Senate,"Special Consent SB413",37,0,3,0,40
1212645,841461,2019-04-09,Assembly,"Do pass and be re-referred to the Committee on [Appropriations] with recommendation: To Consent Calendar",8,0,0,0,8
1212645,866276,2019-05-16,Assembly,"Do pass as amended",17,0,1,0,18
1212645,873731,2019-05-28,Assembly,"AB 942 Weber Assembly Third Reading",72,0,8,0,80
1212645,887760,2019-06-24,Senate,"Do pass, but first be re-referred to the Committee on [Appropriations]",6,0,0,0,6
1212645,893511,2019-08-12,Senate,"Placed on suspense file",7,0,0,0,7
1212645,893512,2019-08-30,Senate,"Do pass",7,0,0,0,7
1212645,893513,2019-09-10,Senate,"Assembly 3rd Reading AB942 Weber et al. By Skinner",40,0,0,0,40
1212645,893514,2019-09-11,Assembly,"AB 942 Weber Concurrence in Senate Amendments",78,0,1,0,79
1212647,835819,2019-04-02,Assembly,"Do pass as amended",12,0,0,0,12
1212647,849353,2019-04-22,Assembly,"AB 795 Irwin Assembly Third Reading",78,0,2,0,80
1212647,887094,2019-06-24,Senate,"Do pass as amended",9,0,0,0,9
1212647,893428,2019-07-11,Senate,"Special Consent AB795",39,0,1,0,40
1212647,893429,2019-08-12,Assembly,"AB 795 Irwin Concurrence in Senate Amendments",77,0,2,0,79
1212648,854933,2019-04-24,Assembly,"Do pass as amended, and be re-referred to the Committee on [Appropriations] with recommendation: To Consent Calendar",15,0,0,0,15
1212650,836233,2019-04-03,Senate,"Do pass, but first be re-referred to the Committee on [Transportation]",5,0,2,0,7
1212650,850706,2019-04-23,Senate,"Do pass, but first be re-referred to the Committee on [Appropriations]",12,0,0,0,12
1212650,867657,2019-05-20,Senate,"Senate 3rd Reading SB400 Umberg",38,0,0,0,38
1212650,889280,2019-07-01,Assembly,"Do pass and be re-referred to the Committee on [Appropriations]",14,0,1,0,15
1212650,891970,2019-08-14,Assembly,"Do pass",18,0,0,0,18
1212650,891971,2019-08-22,Assembly,"SB 400 Umberg Senate Third Reading By Ting",74,0,5,0,79
1212650,894862,2019-05-20,Senate,Date,12,0,0,0,12
1212653,836841,2019-04-03,Assembly,"Do pass and be re-referred to the Committee on [Accountability and Administrative Review]",7,1,0,0,8
1212653,865841,2019-05-16,Assembly,"Do pass as amended",12,4,2,0,18
1212653,872228,2019-05-24,Assembly,"AB 891 Burke Assembly Third Reading",55,17,8,0,80
1212653,884889,2019-06-19,Senate,"Do pass as amended, but first amend, and re-refer to the Committee on [Appropriations]",5,2,0,0,7
1212653,890568,2019-07-08,Senate,"Placed on suspense file",7,0,0,0,7
1212653,890569,2019-08-30,Senate,"Do pass as amended",5,2,0,0,7
1212653,890570,2019-09-10,Senate,"Assembly 3rd Reading AB891 Burke et al. By Wiener",29,10,1,0,40
1212653,890571,2019-09-11,Assembly,"AB 891 Burke Concurrence in Senate Amendments",57,18,4,0,79
1212654,830419,2019-03-26,Assembly,"Do pass and be re-referred to the Committee on [Appropriations]",11,0,0,0,11
1212654,862054,2019-05-08,Assembly,"Do pass. To Consent Calendar",18,0,0,0,18
1212654,866495,2019-05-16,Assembly,"AB 949 Medina Consent Calendar Second Day Regular Session",74,0,6,0,80
1212654,887069,2019-06-24,Senate,"Do pass, but first be re-referred to the Committee on [Appropriations]",9,0,0,0,9
1212654,894189,2019-08-26,Senate,"Assembly 3rd Reading AB949 Medina By Galgiani",39,0,1,0,40
1212656,829421,2019-03-26,Senate,"Do pass, but first be re-referred to the Committee on [Appropriations]",4,0,3,0,7
1212656,838502,2019-04-08,Senate,"Placed on suspense file",6,0,0,0,6
1212658,834648,2019-04-03,Assembly,"Do pass as amended and be re-referred to the Committee on [Appropriations]",15,0,0,0,15
1212665,857054,2019-04-02,Assembly,"Do pass and be re-referred to the Committee on [Appropriations]",3,4,1,0,8
1212665,857055,2019-04-02,Assembly,Reconsideration,8,0,0,0,8
1212668,841192,2019-04-09,Assembly,"Do pass and be re-referred to the Committee on [Appropriations]",9,0,0,0,9
1212668,851641,2019-04-24,Assembly,"Do pass as amended",17,0,1,0,18
1212668,855773,2019-04-24,Assembly,"Do pass",17,0,1,0,18
1212668,867700,2019-05-20,Assembly,"AB 912 Muratsuchi Assembly Third Reading",75,0,5,0,80
1212668,887614,2019-06-25,Senate,"Do pass, but first be re-referred to the Committee on [Environmental Quality]",9,0,0,0,9
1212668,893714,2019-07-03,Senate,"Do pass, but first be re-referred to the Committee on [Appropriations] with the recommendation: To Consent Calendar",7,0,0,0,7
1212668,893715,2019-08-26,Senate,"Assembly 3rd Reading AB912 Muratsuchi et al. By Hill",39,0,1,0,40
1212668,893716,2019-08-30,Assembly,"AB 912 Muratsuchi Concurrence in Senate Amendments",75,0,4,0,79
1212670,816712,2019-03-07,Senate,"Senate 3rd Reading SCR19 Galgiani et al",37,0,1,0,38
1212670,822106,2019-03-14,Assembly,"Be adopted. To Consent Calendar",11,0,1,0,12
1212670,826733,2019-03-21,Assembly,"SCR 19 Galgiani Consent Calendar Second Day Regular Session",72,0,8,0,80
1212672,833076,2019-03-27,Assembly,"Do pass as amended and be re-referred to the Committee on [Appropriations]",6,0,0,0,6
1212672,866011,2019-05-16,Assembly,"Do pass",17,0,1,0,18
1212672,871043,2019-05-23,Assembly,"AB 842 Limón Assembly Third Reading",77,0,3,0,80
1212672,891740,2019-07-03,Senate,"Do pass as amended, but first amend, and re-refer to the Committee on [Appropriations] with the recommendation: To Consent Calendar",7,0,0,0,7
1212672,891741,2019-08-12,Senate,"Placed on suspense file",7,0,0,0,7
1212672,891742,2019-08-30,Senate,"Do pass",7,0,0,0,7
1212672,891743,2019-09-10,Senate,"Assembly 3rd Reading AB842 Limón et al. By Mitchell",40,0,0,0,40
1212672,891744,2019-09-11,Assembly,"AB 842 Limón Concurrence in Senate Amendments",79,0,0,0,79
1212676,835401,2019-04-03,Assembly,"Do pass and be re-referred to the Committee on [Appropriations]",14,0,0,0,14
1212676,852597,2019-04-24,Assembly,"Do pass",18,0,0,0,18
1212676,860044,2019-05-06,Assembly,"AB 932 Low Assembly Third Reading",75,0,5,0,80
1212680,851006,2019-04-22,Senate,"Do pass, but first be re-referred to the Committee on [Judiciary]",8,0,1,0,9
1212680,852383,2019-04-23,Senate,"Do pass, but first be re-referred to the Committee on [Appropriations] with the recommendation: To Consent Calendar",9,0,0,0,9
1212680,871706,2019-05-23,Senate,"Senate 3rd Reading SB377 McGuire",28,2,8,0,38
1212680,890830,2019-07-02,Assembly,"Do pass and be re-referred to the Committee on [Business and Professions]",12,0,0,0,12
1212680,890831,2019-07-09,Assembly,"Do pass and be re-referred to the Committee on [Appropriations]",19,0,0,0,19
1212680,890832,2019-08-14,Assembly,"Do pass",18,0,0,0,18
1212680,890833,2019-09-11,Assembly,"SB 377 McGuire Senate Third Reading By Mark Stone",78,0,1,0,79
1212680,893590,2019-09-12,Senate,"Unfinished Business SB377 McGuire Concurrence",39,0,1,0,40
1212681,829191,2019-03-25,Assembly,"Do pass and be re-referred to the Committee on [Appropriations] with recommendation: To Consent Calendar",11,0,0,0,11
1212681,865881,2019-05-16,Assembly,"Do pass",18,0,0,0,18
1212681,874674,2019-05-29,Assembly,"AB 926 O'Donnell Assembly Third Reading",78,0,2,0,80
1212681,890364,2019-07-09,Senate,"Do pass, but first be re-referred to the Committee on [Appropriations]",8,0,1,0,9
1212681,890365,2019-08-12,Senate,"Placed on suspense file",7,0,0,0,7
1212681,893900,2019-05-16,Assembly,Result,18,0,0,0,18
1212685,829856,2019-03-26,Assembly,"Do pass and be re-referred to the Committee on [Appropriations]",13,0,1,0,14
1212685,866331,2019-05-16,Assembly,"Do pass as amended",13,0,5,0,18
1212685,872348,2019-05-24,Assembly,"AB 834 Quirk Assembly Third Reading",71,0,9,0,80
1212685,891306,2019-07-03,Senate,"Do pass, but first be re-referred to the Committee on [Appropriations] with the recommendation: To Consent Calendar",7,0,0,0,7
1212685,891307,2019-08-12,Senate,"Placed on suspense file",7,0,0,0,7
1212685,891308,2019-08-30,Senate,"Do pass as amended",7,0,0,0,7
1212685,891309,2019-09-04,Senate,"Assembly 3rd Reading AB834 Quirk By Wieckowski",40,0,0,0,40
1212685,891310,2019-09-09,Assembly,"AB 834 Quirk Concurrence in Senate Amendments",78,0,1,0,79
1212686,831430,2019-03-26,Assembly,"Do pass as amended and be re-referred to the Committee on [Appropriations]",20,0,0,0,20
1212686,841771,2019-04-10,Assembly,"Do pass. To Consent Calendar",17,0,1,0,18
1212686,852899,2019-04-25,Assembly,"AB 845 Maienschein Consent Calendar Second Day Regular Session",76,0,4,0,80
1212686,877043,2019-06-03,Senate,"Do pass, but first be re-referred to the Committee on [Appropriations]",9,0,0,0,9
1212686,892578,2019-08-12,Senate,"Assembly 3rd Reading AB845 Maienschein By Durazo",39,0,1,0,40
1212691,825913,2019-03-19,Assembly,"Be adopted. To Consent Calendar",12,0,0,0,12
1212691,862168,2019-05-09,Senate,"Special Consent ACR31",38,0,0,0,38
1212693,830158,2019-03-26,Assembly,"Do pass as amended. To Consent Calendar",12,0,0,0,12
1212693,836502,2019-04-04,Assembly,"AB 828 Ting Consent Calendar Second Day Regular Session",75,0,5,0,80
1212695,851567,2019-04-23,Assembly,"Do pass and be re-referred to the Committee on [Appropriations]",9,1,2,0,12
1212695,866047,2019-05-16,Assembly,"Do pass as amended",17,0,1,0,18
1212695,871362,2019-05-23,Assembly,"AB 930 Gloria Assembly Third Reading",76,0,4,0,80
1212695,891546,2019-07-10,Senate,"Do pass, but first be re-referred to the Committee on [Appropriations]",6,0,1,0,7
1212695,891547,2019-08-12,Senate,"Placed on suspense file",7,0,0,0,7
1212698,831082,2019-03-26,Assembly,"Do pass. To Consent Calendar",15,0,0,0,15
1212698,836541,2019-04-04,Assembly,"AB 899 Wood Consent Calendar Second Day Regular Session",75,0,5,0,80
1212698,893202,2019-07-10,Senate,"Do pass as amended, but first amend, and re-refer to the Committee on [Appropriations] with the recommendation: To Consent Calendar",8,0,1,0,9
1212698,893203,2019-09-03,Senate,"Assembly 3rd Reading AB899 Wood By McGuire",40,0,0,0,40
1212698,893204,2019-09-05,Assembly,"AB 899 Wood Concurrence in Senate Amendments",79,0,0,0,79
1212699,840336,2019-04-09,Senate,"Do pass, but first be re-referred to the Committee on [Appropriations] with the recommendation: To Consent Calendar",7,0,0,0,7
1212699,848817,2019-04-22,Senate,"Placed on suspense file",6,0,0,0,6
1212699,866388,2019-05-16,Senate,"Do pass",6,0,0,0,6
1212699,871566,2019-05-23,Senate,"Special Consent SB375",38,0,0,0,38
1212699,887495,2019-06-25,Assembly,"Do pass as amended and be re-referred to the Committee on [Appropriations]",8,0,0,0,8
1212699,892910,2019-08-30,Assembly,"Do pass",17,0,1,0,18
1212699,892911,2019-09-10,Assembly,"SB 375 Durazo Senate Third Reading By Smith",78,0,1,0,79
1212699,892912,2019-09-11,Senate,"Unfinished Business SB375 Durazo et al. Concurrence",40,0,0,0,40
1212702,830342,2019-03-26,Assembly,"Do pass and be re-referred to the Committee on [Appropriations] with recommendation: To Consent Calendar",15,0,0,0,15
1212702,841359,2019-04-10,Assembly,"Do pass. To Consent Calendar",17,0,1,0,18
1212702,853122,2019-04-25,Assembly,"AB 916 Muratsuchi Consent Calendar Second Day Regular Session",76,0,4,0,80
1212704,843270,2019-04-10,Assembly,"Do pass and be re-referred to the Committee on [Banking and Finance]",8,0,0,0,8
1212704,848784,2019-04-22,Assembly,"Do pass",12,0,0,0,12
1212704,855249,2019-04-29,Assembly,"AB 945 McCarty Assembly Third Reading",75,0,5,0,80
1212704,884830,2019-06-19,Senate,"Do pass, but first be re-referred to the Committee on [Banking and Financial Institutions]",5,0,2,0,7
1212704,888157,2019-06-26,Senate,"Do pass as amended",7,0,0,0,7
1212704,891323,2019-09-09,Senate,"Assembly 3rd Reading AB945 McCarty et al. By Pan",39,1,0,0,40
1212704,891324,2019-09-10,Assembly,"AB 945 McCarty Concurrence in Senate Amendments",79,0,0,0,79
1212704,894812,2019-09-09,Senate,"Assembly 3rd Reading AB945 usCell"">",7,1,0,0,8
1212708,902814,2020-01-14,Assembly,"Do pass and be re-referred to the Committee on [Appropriations]",14,0,1,0,15
1212711,856804,2019-05-01,Senate,"Do pass as amended",9,0,0,0,9
1212711,859441,2019-05-06,Senate,"Senate 3rd Reading SB373 Hertzberg",38,0,0,0,38
1212722,829809,2019-03-26,Assembly,"Do pass and be re-referred to the Committee on [Appropriations]",14,0,0,0,14
1212727,841679,2019-04-09,Assembly,"Do pass and be re-referred to the Committee on [Revenue and Taxation] with recommendation: To Consent Calendar",8,0,0,0,8
1212727,902208,2020-01-13,Assembly,"Do pass and be re-referred to the Committee on [Appropriations]",9,0,2,0,11
1212729,840064,2019-04-09,Assembly,"Do pass",20,0,0,0,20
1212729,848936,2019-04-22,Assembly,"AB 833 Lackey Assembly Third Reading",78,0,2,0,80
1212729,890651,2019-07-09,Senate,"Do pass, but first be re-referred to the Committee on [Appropriations]",13,0,0,0,13
1212729,890652,2019-08-26,Senate,"Assembly 3rd Reading AB833 Lackey By Galgiani Urgency Clause",39,0,1,0,40
1212729,890653,2019-09-11,Assembly,"With recommendation: That Senate amendments be concurred in",14,0,1,0,15
1212729,893768,2019-09-12,Assembly,"AB 833 Lackey Concurrence - Urgency Added",79,0,0,0,79
1212731,840069,2019-04-08,Assembly,"Do pass and be re-referred to the Committee on [Appropriations]",9,1,1,0,11
1212731,865822,2019-05-16,Assembly,"Do pass",14,3,1,0,18
1212731,871086,2019-05-23,Assembly,"AB 839 Mullin Assembly Third Reading",65,8,7,0,80
1212731,887613,2019-06-25,Senate,"Do pass as amended, but first amend, and re-refer to the Committee on [Insurance]",7,1,1,0,9
1212731,891892,2019-08-12,Senate,"Placed on suspense file",7,0,0,0,7
1212734,853247,2019-04-24,Assembly,"Do pass and be re-referred to the Committee on [Appropriations] with recommendation: To Consent Calendar",8,0,0,0,8
1212734,864888,2019-05-15,Assembly,"Do pass. To Consent Calendar",16,0,2,0,18
1212734,870199,2019-05-22,Assembly,"AB 825 Mullin Consent Calendar Second Day Regular Session",77,0,3,0,80
1212734,884719,2019-06-19,Senate,"Do pass, but first be re-referred to the Committee on [Natural Resources and Water]",6,0,1,0,7
1212734,891156,2019-07-09,Senate,"Do pass, but first be re-referred to the Committee on [Appropriations]",7,1,1,0,9
1212734,891157,2019-08-26,Senate,"Assembly 3rd Reading AB825 Mullin et al. By Hill",32,5,3,0,40
1212734,891158,2019-08-30,Assembly,"AB 825 Mullin Concurrence in Senate Amendments",74,0,5,0,79
1212735,835752,2019-03-27,Assembly,"Do pass as amended and be re-referred to the Committee on [Appropriations]",6,0,0,0,6
1212737,841723,2019-04-08,Assembly,"Do pass as amended and be re-referred to the Committee on [Appropriations]",11,0,0,0,11
1212737,865738,2019-05-16,Assembly,"Do pass as amended",18,0,0,0,18
1212737,874599,2019-05-29,Assembly,"AB 836 Wicks Assembly Third Reading",78,0,2,0,80
1212737,890836,2019-07-03,Senate,"Do pass, but first be re-referred to the Committee on [Appropriations] with the recommendation: To Consent Calendar",7,0,0,0,7
1212737,890837,2019-08-12,Senate,"Placed on suspense file",7,0,0,0,7
1212737,890838,2019-08-30,Senate,"Do pass as amended",7,0,0,0,7
1212737,890839,2019-09-04,Senate,"Assembly 3rd Reading AB836 Wicks et al. By Hill",40,0,0,0,40
1212737,890840,2019-09-09,Assembly,"AB 836 Wicks Concurrence in Senate Amendments",79,0,0,0,79
1212742,840126,2019-04-08,Assembly,"Do pass and be re-referred to the Committee on [Housing and Community Development]",8,0,3,0,11
1212742,856755,2019-05-01,Assembly,"Do pass and be re-referred to the Committee on [Appropriations]",7,0,1,0,8
1212743,857946,2019-04-30,Senate,"Do pass and be ordered to the Consent Calendar",9,0,0,0,9
1212743,862227,2019-05-09,Senate,"Consent Calendar SB370 Umberg",38,0,0,0,38
1212743,892469,2019-07-09,Assembly,"Do pass. To Consent Calendar",12,0,0,0,12
1212743,892470,2019-08-12,Assembly,"SB 370 Umberg Consent Calendar Second Day Regular Session",77,0,2,0,79
1212746,853398,2019-04-23,Assembly,"Do pass as amended, and be re-referred to the Committee on [Appropriations] with recommendation: To Consent Calendar",7,0,0,0,7
1212747,832498,2019-03-27,Assembly,"Do pass as amended and be re-referred to the Committee on [Appropriations]",6,0,0,0,6
1212747,841754,2019-04-10,Assembly,"Do pass. To Consent Calendar",17,0,1,0,18
1212747,853050,2019-04-25,Assembly,"AB 947 Quirk-Silva Consent Calendar Second Day Regular Session",76,0,4,0,80
1212747,878505,2019-06-05,Senate,"Do pass, but first be re-referred to the Committee on [Appropriations] with the recommendation: To Consent Calendar",7,0,0,0,7
1212747,887085,2019-06-24,Senate,"Placed on suspense file",7,0,0,0,7
1212747,892626,2019-08-30,Senate,"Do pass",7,0,0,0,7
1212747,892627,2019-09-09,Senate,"Special Consent AB947",40,0,0,0,40
1212752,829427,2019-03-26,Assembly,"Do pass and be re-referred to the Committee on [Appropriations] with recommendation: To Consent Calendar",12,0,0,0,12
1212752,865933,2019-05-16,Assembly,"Do pass as amended",18,0,0,0,18
1212752,871056,2019-05-23,Assembly,"AB 859 Maienschein Assembly Third Reading",77,0,3,0,80
1212752,893172,2019-07-02,Senate,"Do pass, but first be re-referred to the Committee on [Human Services]",9,0,0,0,9
1212752,893173,2019-07-08,Senate,"Do pass as amended, but first amend, and re-refer to the Committee on [Appropriations]",6,0,0,0,6
1212752,893174,2019-08-12,Senate,"Placed on suspense file",7,0,0,0,7
1212752,893175,2019-08-30,Senate,"Do pass as amended",7,0,0,0,7
1212752,893176,2019-09-10,Senate,"Assembly 3rd Reading AB859 Maienschein By Mitchell",40,0,0,0,40
1212752,893177,2019-09-11,Assembly,"AB 859 Maienschein Concurrence in Senate Amendments",79,0,0,0,79
1212756,841687,2019-04-10,Senate,"Do pass, but first be re-referred to the Committee on [Rules]",2,5,0,0,7
1212756,841688,2019-04-10,Senate,"[First] hearing set for [04-10-2019]: Failed passage in Committee. Reconsideration granted",7,0,0,0,7
1212757,830947,2019-03-27,Assembly,"Do pass as amended, and be re-referred to the Committee on [Appropriations] with recommendation: To Consent Calendar",7,0,0,0,7
1212757,834734,2019-04-03,Assembly,"Do pass. To Consent Calendar",17,0,1,0,18
1212757,842744,2019-04-11,Assembly,"AB 903 Levine Consent Calendar Second Day Regular Session",72,0,8,0,80
1212757,861348,2019-05-07,Senate,"Do pass, but first be re-referred to the Committee on [Appropriations] with the recommendation: To Consent Calendar",5,0,0,0,5
1212757,889278,2019-07-01,Senate,"Consent Calendar AB903",39,0,1,0,40
1212761,901160,2019-04-22,Assembly,"Do pass and be re-referred to the Committee on [Appropriations]",3,4,8,0,15
1212762,829494,2019-03-26,Assembly,"Do pass and be re-referred to the Committee on [Appropriations] with recommendation: To Consent Calendar",8,0,0,0,8
1212762,866256,2019-05-16,Assembly,"Do pass",18,0,0,0,18
1212762,874501,2019-05-29,Assembly,"AB 803 Gipson Assembly Third Reading",78,0,2,0,80
1212762,891053,2019-07-02,Senate,"Do pass as amended, but first amend, and re-refer to the Committee on [Appropriations]",5,0,2,0,7
1212762,891054,2019-08-12,Senate,"Placed on suspense file",7,0,0,0,7
1212762,891055,2019-08-30,Senate,"Do pass",7,0,0,0,7
1212762,891056,2019-09-09,Senate,"Assembly 3rd Reading AB803 Gipson et al. By Leyva",39,0,1,0,40
1212762,891057,2019-09-10,Assembly,"AB 803 Gipson Concurrence in Senate Amendments",79,0,0,0,79
1212765,829501,2019-03-26,Assembly,"Do pass and be re-referred to the Committee on [Appropriations]",6,1,1,0,8
1212765,865897,2019-05-16,Assembly,"Do pass as amended",11,4,3,0,18
1212765,874456,2019-05-29,Assembly,"AB 901 Gipson Assembly Third Reading",42,27,11,0,80
1212765,892985,2019-07-02,Senate,"Do pass, but first be re-referred to the Committee on [Education]",5,1,1,0,7
1212765,892986,2019-07-10,Senate,"Do pass as amended, but first amend, and re-refer to the Committee on [Appropriations]",6,0,1,0,7
1212765,892987,2019-08-19,Senate,"Placed on suspense file",5,0,2,0,7
1212765,892988,2019-08-30,Senate,"Do pass",5,2,0,0,7
1212765,892989,2019-09-11,Senate,"That the measure be held in committee pursuant to Senate Rule 29.10",5,0,2,0,7
1212765,974283,2020-07-29,Senate,"That the measure be returned to Senate Floor for consideration. Ordered to third reading",4,0,3,0,7
1212765,976614,2020-08-24,Senate,"Assembly 3rd Reading AB901 Gipson et al. By Beall",27,7,6,0,40
1212765,976920,2020-08-26,Assembly,"AB 901 Gipson Concurrence in Senate Amendments",52,12,15,0,79
1212768,850837,2019-04-23,Senate,"Do pass, but first be re-referred to the Committee on [Appropriations]",5,0,0,0,5
1212768,868520,2019-05-20,Senate,"Senate 3rd Reading SB359 Moorlach",38,0,0,0,38
1212768,893577,2019-07-03,Assembly,"Do pass and be re-referred to the Committee on [Appropriations]",6,0,1,0,7
1212768,893578,2019-08-14,Assembly,"Do pass",18,0,0,0,18
1212768,893579,2019-09-05,Assembly,"SB 359 Moorlach Senate Third Reading By Petrie-Norris",78,0,1,0,79
1212768,893580,2019-09-06,Senate,"Unfinished Business SB359 Moorlach et al. Concurrence",39,0,1,0,40
1212769,811721,2019-02-28,Senate,"Senate 3rd Reading SR20 Dodd et al",38,0,0,0,38
1212770,852897,2019-04-24,Senate,"Do pass as amended, but first amend, and re-refer to the Committee on [Appropriations]",9,0,0,0,9
1212770,863228,2019-05-13,Senate,"Do pass",6,0,0,0,6
1212770,867843,2019-05-20,Senate,"Senate 3rd Reading SB382 Nielsen et al",38,0,0,0,38
1212770,891315,2019-07-09,Assembly,"Do pass as amended, and be re-referred to the Committee on [Appropriations] with recommendation: To Consent Calendar",15,0,0,0,15
1212770,891316,2019-08-30,Assembly,"Do pass as amended",18,0,0,0,18
1212770,891317,2019-09-09,Assembly,"SB 382 Nielsen Senate Third Reading By Aguiar-Curry",78,0,1,0,79
1212770,891318,2019-09-10,Senate,"Unfinished Business SB382 Nielsen et al. Concurrence",40,0,0,0,40
1212773,811547,2019-02-28,Senate,"Senate 3rd Reading SCR17 Leyva et al",38,0,0,0,38
1212773,813425,2019-03-04,Assembly,"Be adopted. To Consent Calendar",11,0,1,0,12
1212773,816694,2019-03-07,Assembly,"SCR 17 Leyva Consent Calendar Second Day Regular Session",74,0,6,0,80
1212774,829413,2019-03-26,Assembly,"Do pass and be re-referred to the Committee on [Appropriations]",5,2,1,0,8
1212774,835451,2019-04-03,Assembly,"Do pass",12,5,1,0,18
1212774,853103,2019-04-25,Assembly,"AB 893 Gloria Assembly Third Reading",52,22,6,0,80
1212774,880320,2019-06-11,Senate,"Do pass, but first be re-referred to the Committee on [Appropriations]",5,2,0,0,7
1212774,887065,2019-06-24,Senate,"Placed on suspense file",7,0,0,0,7
1212774,892966,2019-08-30,Senate,"Do pass as amended",5,2,0,0,7
1212774,892967,2019-09-10,Senate,"Assembly 3rd Reading AB893 Gloria et al. By Atkins",27,11,2,0,40
1212774,892968,2019-09-11,Assembly,"AB 893 Gloria Concurrence in Senate Amendments",55,21,3,0,79
1212775,853110,2019-04-23,Assembly,"Do pass as amended, and be re-referred to the Committee on [Appropriations] with recommendation: To Consent Calendar",12,0,0,0,12
1212775,861578,2019-05-08,Assembly,"Do pass. To Consent Calendar",18,0,0,0,18
1212775,865996,2019-05-16,Assembly,"AB 892 Holden Consent Calendar Second Day Regular Session",74,0,6,0,80
1212775,888660,2019-06-25,Senate,"Do pass as amended, but first amend, and re-refer to the Committee on [Appropriations] with the recommendation: To Consent Calendar",9,0,0,0,9
1212775,890468,2019-08-26,Senate,"Consent Calendar AB892",39,0,1,0,40
1212775,890469,2019-09-05,Assembly,"AB 892 Holden Concurrence in Senate Amendments",79,0,0,0,79
1212779,834297,2019-04-02,Assembly,"Do pass and be re-referred to the Committee on [Appropriations]",6,2,0,0,8
1212779,866029,2019-05-16,Assembly,"Do pass as amended",13,5,0,0,18
1212779,873910,2019-05-28,Assembly,"AB 879 Gipson Assembly Third Reading",45,21,14,0,80
1212779,887604,2019-06-25,Senate,"Do pass, but first be re-referred to the Committee on [Appropriations]",5,1,1,0,7
1212779,892695,2019-07-08,Senate,"Placed on suspense file",7,0,0,0,7
1212779,892696,2019-08-30,Senate,"Do pass",5,1,1,0,7
1212779,892697,2019-09-04,Senate,"Assembly 3rd Reading AB879 Gipson By Portantino",27,11,2,0,40
1212779,892698,2019-09-09,Assembly,"AB 879 Gipson Concurrence in Senate Amendments",52,21,6,0,79
1212779,894943,2019-07-08,Senate,Result,5,1,0,0,6
1212781,829517,2019-03-26,Assembly,"Do pass and be re-referred to the Committee on [Appropriations]",7,0,1,0,8
1212786,833210,2019-04-01,Assembly,"Be re-referred to the Committee on [Housing and Community Development]",10,0,2,0,12
1212788,833558,2019-04-01,Senate,"Do pass, but first be re-referred to the Committee on [Public Safety]",9,0,0,0,9
1212788,851963,2019-04-23,Senate,"Do pass, but first be re-referred to the Committee on [Appropriations] with the recommendation: To Consent Calendar",7,0,0,0,7
1212788,862191,2019-05-09,Senate,"Senate 3rd Reading SB391 Monning",38,0,0,0,38
1212788,894021,2019-07-02,Assembly,"Do pass and be re-referred to the Committee on [Appropriations] with recommendation: To Consent Calendar",19,0,0,0,19
1212788,894022,2019-07-10,Assembly,"Do pass. To Consent Calendar",16,0,2,0,18
1212788,894023,2019-08-15,Assembly,"SB 391 Monning Consent Calendar Second Day Regular Session",76,0,3,0,79
1212789,852851,2019-04-24,Assembly,"Do pass and be re-referred to the Committee on [Appropriations]",7,0,1,0,8
1212790,834850,2019-04-03,Assembly,"Do pass and be re-referred to the Committee on [Local Government]",7,0,1,0,8
1212790,841645,2019-04-10,Assembly,"Do pass and be re-referred to the Committee on [Appropriations]",7,0,1,0,8
1212790,851702,2019-04-24,Assembly,"Do pass",18,0,0,0,18
1212790,863112,2019-05-13,Assembly,"AB 881 Bloom Assembly Third Reading",71,2,7,0,80
1212790,883953,2019-06-18,Senate,"Do pass, but first be re-referred to the Committee on [Governance and Finance]",9,1,1,0,11
1212790,892878,2019-07-03,Senate,"Do pass as amended, but first amend, and re-refer to the Committee on [Appropriations]",7,0,0,0,7
1212790,892879,2019-08-19,Senate,"Placed on suspense file",5,0,2,0,7
1212790,892880,2019-08-30,Senate,"Do pass",5,2,0,0,7
1212790,893944,2019-09-13,Assembly,"AB 881 Bloom Concurrence in Senate Amendments",73,0,6,0,79
1212790,894188,2019-09-13,Senate,"Assembly 3rd Reading AB881 Bloom By Wieckowski",30,6,4,0,40
1212794,860645,2019-05-06,Assembly,"Do pass and be re-referred to the Committee on [Appropriations]",11,0,0,0,11
1212795,841382,2019-04-09,Assembly,"Do pass and be re-referred to the Committee on [Appropriations]",12,0,0,0,12
1212795,865753,2019-05-16,Assembly,"Do pass",18,0,0,0,18
1212795,874660,2019-05-29,Assembly,"AB 829 Bloom Assembly Third Reading",77,0,3,0,80
1212795,884713,2019-06-19,Senate,"Do pass, but first be re-referred to the Committee on [Appropriations]",6,0,1,0,7
1212795,889245,2019-07-01,Senate,"Do pass",7,0,0,0,7
1212795,892395,2019-08-15,Senate,"Assembly 3rd Reading AB829 Bloom et al. By Bradford",38,0,2,0,40
1212797,834226,2019-04-02,Assembly,"Do pass and be re-referred to the Committee on [Health]",17,0,3,0,20
1212797,840145,2019-04-09,Assembly,"Do pass as amended and be re-referred to the Committee on [Appropriations]",15,0,0,0,15
1212797,856681,2019-05-01,Assembly,"Do pass",15,0,3,0,18
1212797,862101,2019-05-09,Assembly,"AB 888 Low Assembly Third Reading",68,0,12,0,80
1212799,841488,2019-04-10,Assembly,"Do pass as amended and be re-referred to the Committee on [Appropriations]",7,0,0,0,7
1212799,851278,2019-04-24,Assembly,"Do pass. To Consent Calendar",18,0,0,0,18
1212799,858136,2019-05-02,Assembly,"AB 864 Mullin Consent Calendar Second Day Regular Session",76,0,4,0,80
1212799,892785,2019-07-02,Senate,"Do pass, but first be re-referred to the Committee on [Appropriations]",4,0,1,0,5
1212799,892786,2019-09-11,Senate,"Assembly 3rd Reading AB864 Mullin By Hill",37,2,1,0,40
1212799,893703,2019-09-12,Assembly,"AB 864 Mullin Concurrence in Senate Amendments",77,0,2,0,79
1212799,894980,2019-09-11,Senate,Noes,4,2,0,0,6
1212801,829851,2019-03-26,Senate,"Do pass, but first be re-referred to the Committee on [Appropriations] with the recommendation: To Consent Calendar",7,0,0,0,7
1212801,848935,2019-04-22,Senate,"Consent Calendar SB393",38,0,0,0,38
1212801,887463,2019-06-25,Assembly,"Do pass and be re-referred to the Committee on [Appropriations]",7,1,0,0,8
1212801,891390,2019-07-03,Assembly,"Do pass. To Consent Calendar",17,0,1,0,18
1212801,891391,2019-08-30,Assembly,"SB 393 Stone Senate Third Reading By Eduardo Garcia",71,0,8,0,79
1212801,891392,2019-09-03,Senate,"Unfinished Business SB393 Stone Concurrence",40,0,0,0,40
1212802,853285,2019-04-24,Assembly,"Do pass and be re-referred to the Committee on [Appropriations]",6,2,0,0,8
1212806,811628,2019-02-28,Assembly,"Be adopted. To third reading",11,0,1,0,12
1212806,831307,2019-03-28,Senate,"Special Consent ACR33 Gloria et al",35,0,3,0,38
1212808,840078,2019-04-09,Assembly,"Do pass as amended and be re-referred to the Committee on [Appropriations]",16,0,4,0,20
1212808,905428,2020-01-23,Assembly,"Do pass as amended",13,0,5,0,18
1212808,906396,2020-01-27,Assembly,"AB 890 Wood Assembly Third Reading",61,1,18,0,80
1212808,975326,2020-08-08,Senate,"Do pass as amended, but first amend, and re-refer to the Committee on [Appropriations]",7,1,1,0,9
1212808,976167,2020-08-19,Senate,"Placed on suspense file",7,0,0,0,7
1212808,976321,2020-08-20,Senate,"Do pass as amended",4,2,1,0,7
1212808,977845,2020-08-31,Senate,"Assembly 3rd Reading AB890 Wood et al. By Glazer",27,3,10,0,40
1212808,977846,2020-08-31,Assembly,"AB 890 WOOD Concurrence in Senate Amendments",53,1,25,0,79
1212813,834358,2019-04-02,Assembly,"Do pass and be re-referred to the Committee on [Appropriations]",8,0,0,0,8
1212813,866550,2019-05-16,Assembly,"Do pass",16,0,2,0,18
1212813,871074,2019-05-23,Assembly,"AB 927 Jones-Sawyer Assembly Third Reading",62,2,16,0,80
1212813,884465,2019-06-18,Senate,"Do pass, but first be re-referred to the Committee on [Appropriations]",6,1,0,0,7
1212813,891291,2019-07-01,Senate,"Placed on suspense file",7,0,0,0,7
1212813,891292,2019-08-30,Senate,"Do pass as amended",6,1,0,0,7
1212813,891293,2019-09-05,Senate,"Assembly 3rd Reading AB927 Jones-Sawyer By Wiener",32,5,3,0,40
1212813,891294,2019-09-10,Assembly,"AB 927 Jones-Sawyer Concurrence in Senate Amendments",63,5,11,0,79
1212815,841336,2019-04-10,Assembly,"Do pass and be re-referred to the Committee on [Local Government]",5,2,0,0,7
1212815,853101,2019-04-24,Assembly,"Do pass and be re-referred to the Committee on [Appropriations]",6,2,0,0,8
1212815,866367,2019-05-16,Assembly,"Do pass as amended",13,5,0,0,18
1212815,871525,2019-05-23,Assembly,"AB 849 Bonta Assembly Third Reading",55,20,5,0,80
1212815,883809,2019-06-18,Senate,"Do pass, but first be re-referred to the Committee on [Governance and Finance]",4,1,0,0,5
1212815,890911,2019-07-10,Senate,"Do pass, but first be re-referred to the Committee on [Appropriations]",5,1,1,0,7
1212815,890912,2019-08-12,Senate,"Placed on suspense file",7,0,0,0,7
1212815,890913,2019-08-30,Senate,"Do pass as amended",5,2,0,0,7
1212815,890914,2019-09-09,Senate,"Assembly 3rd Reading AB849 Bonta et al. By Hertzberg",29,10,1,0,40
1212815,890915,2019-09-10,Assembly,"AB 849 Bonta Concurrence in Senate Amendments",59,18,2,0,79
1212816,842073,2019-04-10,Assembly,"Do pass as amended and be re-referred to the Committee on [Public Safety]",12,0,1,0,13
1212816,853167,2019-04-25,Assembly,"AB 880 Obernolte Assembly Third Reading",73,0,7,0,80
1212816,883936,2019-06-18,Senate,"Do pass, but first be re-referred to the Committee on [Rules]",13,0,0,0,13
1212816,892669,2019-07-09,Senate,"Do pass, but first be re-referred to the Committee on [Appropriations] with the recommendation: To Consent Calendar",7,0,0,0,7
1212816,892670,2019-08-15,Senate,"Consent Calendar AB880",37,0,3,0,40
1212816,892671,2019-09-10,Assembly,"With recommendation: That Senate amendments be concurred in",11,0,2,0,13
1212816,892672,2019-09-11,Assembly,"AB 880 Obernolte Concurrence in Senate Amendments",77,0,2,0,79
1212820,902846,2020-01-14,Assembly,"Do pass and be re-referred to the Committee on [Privacy and Consumer Protection]",8,0,0,0,8
1212820,902847,2020-01-14,Assembly,"Do pass as amended",11,0,0,0,11
1212820,906399,2020-01-27,Assembly,"AB 904 Chau Assembly Third Reading",78,0,2,0,80
1212820,974609,2020-07-31,Senate,"Do pass and be ordered to the Consent Calendar",7,0,0,0,7
1212820,977328,2020-08-28,Senate,"Consent Calendar AB904",39,0,1,0,40
1212820,977989,2020-08-30,Assembly,"AB 904 Chau Concurrence in Senate Amendments",75,0,4,0,79
1212821,853185,2019-04-09,Assembly,"Do pass and be re-referred to the Committee on [Appropriations]",3,4,1,0,8
1212821,853186,2019-04-09,Assembly,Reconsideration,6,0,2,0,8
1212821,902859,2020-01-14,Assembly,"Do pass and be re-referred to the Committee on [Appropriations]",3,4,1,0,8
1212822,901469,2020-01-08,Senate,"Do pass, but first be re-referred to the Committee on [Appropriations]",8,0,0,0,8
1212822,906381,2020-01-27,Senate,"Senate 3rd Reading SB406 Pan",39,0,0,0,39
1212822,975013,2020-08-04,Assembly,"Do pass as amended and be re-referred to the Committee on [Appropriations]",15,0,0,0,15
1212822,976357,2020-08-20,Assembly,"Do pass as amended",17,0,1,0,18
1212822,977852,2020-08-30,Assembly,"SB 406 Pan Third Reading Urgency By Wood",72,0,7,0,79
1212822,977853,2020-08-31,Senate,"Unfinished Business SB406 Pan et al. Urgency Clause Concurrence",39,0,1,0,40
1212826,855951,2019-04-24,Assembly,"Do pass as amended and be re-referred to the Committee on [Appropriations]",19,0,2,0,21
1212826,861651,2019-05-08,Assembly,"Do pass. To Consent Calendar",18,0,0,0,18
1212826,866191,2019-05-16,Assembly,"AB 840 Dahle Consent Calendar Second Day Regular Session",74,0,6,0,80
1212826,891690,2019-07-09,Senate,"Do pass, but first be re-referred to the Committee on [Appropriations]",15,0,1,0,16
1212826,891691,2019-08-26,Senate,"Assembly 3rd Reading AB840 Dahle By Dahle",39,0,1,0,40
1212826,891692,2019-09-09,Assembly,"AB 840 Dahle Concurrence in Senate Amendments By GRAY",79,0,0,0,79
1212826,894952,2019-05-08,Assembly,"Bill Votes",18,0,0,0,18
1212828,829214,2019-03-26,Assembly,"Do pass and be re-referred to the Committee on [Human Services] with recommendation: To Consent Calendar",12,0,0,0,12
1212828,851071,2019-04-23,Assembly,"Do pass and be re-referred to the Committee on [Appropriations] with recommendation: To Consent Calendar",8,0,0,0,8
1212828,866173,2019-05-16,Assembly,"Do pass as amended",18,0,0,0,18
1212828,874587,2019-05-29,Assembly,"AB 861 Chen Assembly Third Reading",77,1,2,0,80
1212828,887838,2019-06-24,Senate,"Do pass as amended, but first amend, and re-refer to the Committee on [Judiciary]",4,0,2,0,6
1212828,893755,2019-07-02,Senate,"Do pass, but first be re-referred to the Committee on [Appropriations]",9,0,0,0,9
1212828,893756,2019-08-12,Senate,"Placed on suspense file",7,0,0,0,7
1212830,830584,2019-03-26,Assembly,"Do pass and be re-referred to the Committee on [Appropriations]",8,0,1,0,9
1212830,866057,2019-05-16,Assembly,"Do pass",18,0,0,0,18
1212830,869734,2019-05-22,Assembly,"AB 841 Ting Assembly Third Reading",76,0,4,0,80
1212830,974755,2020-08-03,Senate,"Do pass as amended, but first amend, and re-refer to the Committee on [Appropriations]",9,4,0,0,13
1212830,975980,2020-08-17,Senate,"Placed on suspense file",7,0,0,0,7
1212830,976337,2020-08-20,Senate,"Do pass as amended",5,2,0,0,7
1212830,977816,2020-08-31,Senate,"Assembly 3rd Reading AB841 Ting By Hueso",25,10,5,0,40
1212830,977817,2020-08-31,Assembly,"AB 841 TING Concurrence in Senate Amendments",55,7,17,0,79
1212834,840954,2019-04-08,Assembly,"Do pass and be re-referred to the Committee on [Appropriations]",11,0,0,0,11
1212834,867013,2019-05-16,Assembly,"Do pass",18,0,0,0,18
1212834,870166,2019-05-22,Assembly,"AB 885 Irwin Assembly Third Reading",77,0,3,0,80
1212834,881387,2019-06-12,Senate,"Do pass, but first be re-referred to the Committee on [Appropriations]",6,0,1,0,7
1212834,887204,2019-06-24,Senate,"Placed on suspense file",7,0,0,0,7
1212834,890929,2019-08-30,Senate,"Do pass as amended",7,0,0,0,7
1212834,890930,2019-09-04,Senate,"Assembly 3rd Reading AB885 Irwin et al. By Dodd",40,0,0,0,40
1212834,890931,2019-09-09,Assembly,"AB 885 Irwin Concurrence in Senate Amendments",79,0,0,0,79
1212835,835815,2019-04-02,Assembly,"Do pass and be re-referred to the Committee on [Appropriations]",11,0,1,0,12
1212835,856852,2019-05-01,Assembly,"Do pass. To Consent Calendar",18,0,0,0,18
1212835,862237,2019-05-09,Assembly,"AB 806 Bloom Consent Calendar Second Day Regular Session",76,0,4,0,80
1212835,881069,2019-06-12,Senate,"Do pass, but first be re-referred to the Committee on [Appropriations] with the recommendation: To Consent Calendar",7,0,0,0,7
1212835,887067,2019-06-24,Senate,"Do pass",7,0,0,0,7
1212835,891192,2019-07-11,Senate,"Special Consent AB806",39,0,1,0,40
1212836,835942,2019-04-02,Assembly,"Do pass. To Consent Calendar",15,0,0,0,15
1212836,842946,2019-04-11,Assembly,"AB 851 Cooper Consent Calendar Second Day",72,0,8,0,80
1212836,878452,2019-06-05,Senate,"Do pass, but first be re-referred to the Committee on [Rules] with the recommendation: To Consent Calendar",9,0,0,0,9
1212836,886128,2019-06-20,Senate,"Special Consent AB851",40,0,0,0,40
1212839,841338,2019-04-10,Assembly,"Do pass and be re-referred to the Committee on [Business and Professions]",11,0,0,0,11
1212839,850423,2019-04-23,Assembly,"Do pass and be re-referred to the Committee on [Appropriations]",20,0,0,0,20
1212839,856973,2019-05-01,Assembly,"Do pass. To Consent Calendar",18,0,0,0,18
1212839,862304,2019-05-09,Assembly,"AB 858 Levine Consent Calendar Second Day Regular Session",76,0,4,0,80
1212839,866326,2019-05-01,Assembly,"Do pass. To Cons",20,0,0,0,20
1212839,883875,2019-06-18,Senate,"Do pass, but first be re-referred to the Committee on [Business, Professions and Economic Development]",4,0,1,0,5
1212839,892080,2019-07-08,Senate,"Do pass, but first be re-referred to the Committee on [Appropriations]",9,0,0,0,9
1212839,892081,2019-09-05,Senate,"Assembly 3rd Reading AB858 Levine By McGuire",32,7,1,0,40
1212839,892082,2019-09-09,Assembly,"AB 858 Levine Concurrence in Senate Amendments",74,0,5,0,79
1212840,902844,2020-01-14,Assembly,"Do pass and be re-referred to the Committee on [Appropriations] with recommendation: To Consent Calendar",8,0,0,0,8
1212840,905397,2020-01-23,Assembly,"Do pass. To Consent Calendar",18,0,0,0,18
1212840,912029,2020-01-30,Assembly,"AB 823 Arambula Consent Calendar Second Day Regular Session",76,0,4,0,80
1212843,811682,2019-02-28,Assembly,"Be adopted. To Consent Calendar",11,0,1,0,12
1212843,816760,2019-03-07,Assembly,"ACR 32 Flora Consent Calendar Second Day Regular Session",74,0,6,0,80
1212843,827930,2019-03-25,Senate,"Assembly 3rd Reading ACR32 Flora et al. By Jones",36,0,2,0,38
1212846,852438,2019-04-24,Assembly,"Do pass and be re-referred to the Committee on [Appropriations] with recommendation: To Consent Calendar",7,0,0,0,7
1212846,856752,2019-05-01,Assembly,"Do pass. To Consent Calendar",18,0,0,0,18
1212846,862243,2019-05-09,Assembly,"AB 802 Mark Stone Consent Calendar Second Day Regular Session",76,0,4,0,80
1212846,893479,2019-07-09,Senate,"Do pass, but first be re-referred to the Committee on [Appropriations] with the recommendation: To Consent Calendar",15,0,1,0,16
1212846,893480,2019-08-12,Senate,"Placed on suspense file",7,0,0,0,7
1212848,903155,2020-01-15,Senate,"Do pass, but first be re-referred to the Committee on [Appropriations]",4,1,2,0,7
1212848,904105,2020-01-21,Senate,"Placed on suspense file",7,0,0,0,7
1212848,905363,2020-01-23,Senate,"Do pass as amended",5,1,1,0,7
1212848,910504,2020-01-29,Senate,"Senate 3rd Reading SB372 Wieckowski",17,10,12,0,39
1212848,910505,2020-01-29,Senate,"Senate 3rd Reading SB372 Wieckowski Reconsider",38,0,1,0,39
1212850,839976,2019-04-08,Senate,"Do pass, but first be re-referred to the Committee on [Judiciary]",6,0,0,0,6
1212850,856707,2019-04-30,Senate,"Do pass",9,0,0,0,9
1212850,873881,2019-05-28,Senate,"Senate 3rd Reading SB398 Durazo et al",38,0,0,0,38
1212850,883803,2019-06-18,Assembly,"Do pass and be re-referred to the Committee on [Judiciary]",8,0,0,0,8
1212850,887659,2019-06-25,Assembly,"Do pass as amended. To Consent Calendar",12,0,0,0,12
1212850,890920,2019-09-09,Assembly,"SB 398 Durazo Senate Third Reading By Reyes",79,0,0,0,79
1212850,890921,2019-09-10,Senate,"Unfinished Business SB398 Durazo et al. Concurrence",40,0,0,0,40
1212853,829433,2019-03-26,Senate,"Do pass as amended, but first amend, and re-refer to the Committee on [Environmental Quality]",12,0,0,0,12
1212853,851332,2019-04-24,Senate,"Do pass as amended, but first amend, and re-refer to the Committee on [Appropriations]",7,0,0,0,7
1212853,863031,2019-05-13,Senate,"Placed on suspense file",6,0,0,0,6
1212853,866084,2019-05-16,Senate,"Do pass as amended",6,0,0,0,6
1212853,873834,2019-05-28,Senate,"Senate 3rd Reading SB405 Archuleta et al",38,0,0,0,38
1212853,890956,2019-07-08,Assembly,"Do pass",15,0,0,0,15
1212853,894119,2019-05-28,Senate,Date,6,0,0,0,6
1212853,894220,2019-05-13,Senate,Result,6,0,0,0,6
1212854,901162,2019-04-23,Assembly,"Do pass and be re-referred to the Committee on [Appropriations]",1,3,4,0,8
1212854,901163,2019-04-23,Assembly,Reconsideration,8,0,0,0,8
1212855,835611,2019-04-03,Senate,"Do pass, but first be re-referred to the Committee on [Judiciary]",5,1,1,0,7
1212855,841659,2019-04-09,Senate,"Do pass, but first be re-referred to the Committee on [Appropriations]",7,1,0,0,8
1212855,855251,2019-04-29,Senate,"Placed on suspense file",6,0,0,0,6
1212855,866183,2019-05-16,Senate,"Do pass as amended",4,2,0,0,6
1212855,871468,2019-05-23,Senate,"Senate 3rd Reading SB392 Allen",23,9,6,0,38
1212855,884689,2019-06-18,Assembly,"Do pass and be re-referred to the Committee on [Judiciary]",6,1,1,0,8
1212855,893074,2019-07-09,Assembly,"Do pass and be re-referred to the Committee on [Appropriations]",11,0,1,0,12
1212855,893075,2019-08-30,Assembly,"Do pass as amended",18,0,0,0,18
1212859,833190,2019-03-25,Assembly,"Do pass as amended",8,0,3,0,11
1212859,862090,2019-05-09,Assembly,"AB 827 McCarty Assembly Third Reading",55,9,16,0,80
1212859,876436,2019-03-25,Assembly,"Do pass as amen",0,0,3,0,3
1212859,878263,2019-06-05,Senate,"Do pass as amended",5,2,0,0,7
1212859,893320,2019-09-03,Senate,"Assembly 3rd Reading AB827 McCarty By Allen",30,9,1,0,40
1212859,893321,2019-09-05,Assembly,"AB 827 McCarty Concurrence in Senate Amendments",58,11,10,0,79
1212861,841716,2019-04-09,Assembly,"Do pass and be re-referred to the Committee on [Appropriations]",15,0,0,0,15
1212861,866039,2019-05-16,Assembly,"Do pass as amended",18,0,0,0,18
1212861,871244,2019-05-23,Assembly,"AB 914 Holden Assembly Third Reading",75,0,5,0,80
1212861,884554,2019-06-19,Senate,"Do pass, but first be re-referred to the Committee on [Appropriations]",9,0,0,0,9
1212861,892220,2019-07-08,Senate,"Placed on suspense file",7,0,0,0,7
1212861,892221,2019-08-30,Senate,"Do pass as amended",7,0,0,0,7
1212861,892222,2019-09-05,Senate,"Assembly 3rd Reading AB914 Holden By Skinner",40,0,0,0,40
1212861,892223,2019-09-09,Assembly,"AB 914 Holden Concurrence in Senate Amendments",78,0,1,0,79
1212864,903158,2020-01-15,Senate,"Do pass, but first be re-referred to the Committee on [Appropriations]",10,1,1,0,12
1212864,904116,2020-01-21,Senate,"Placed on suspense file",7,0,0,0,7
1212864,905401,2020-01-23,Senate,"Do pass",4,2,1,0,7
1212864,906393,2020-01-27,Senate,"Senate 3rd Reading SB378 Wiener et al",25,2,12,0,39
1212881,851822,2019-04-23,Senate,"Do pass, but first be re-referred to the Committee on [Appropriations] with the recommendation: To Consent Calendar",12,0,0,0,12
1212881,862169,2019-05-09,Senate,"Consent Calendar SB358 TRANS",38,0,0,0,38
1212881,890767,2019-07-08,Assembly,"Do pass and be re-referred to the Committee on [Appropriations] with recommendation: To Consent Calendar",15,0,0,0,15
1212881,890768,2019-08-14,Assembly,"Do pass",18,0,0,0,18
1212881,890769,2019-09-09,Assembly,"SB 358 TRANS. Senate Third Reading By FRAZIER",79,0,0,0,79
1212881,890770,2019-09-10,Senate,"Unfinished Business SB358 TRANS. (Beall) Concurrence",40,0,0,0,40
1213796,841841,2019-04-10,Assembly,"Do pass and be re-referred to the Committee on [Education]",11,0,0,0,11
1213796,853475,2019-04-24,Assembly,"Do pass as amended and be re-referred to the Committee on [Appropriations]",7,0,0,0,7
1213823,835358,2019-04-02,Assembly,"Do pass and be re-referred to the Committee on [Appropriations]",14,0,1,0,15
1213823,866405,2019-05-16,Assembly,"Do pass as amended",18,0,0,0,18
1213823,873805,2019-05-28,Assembly,"AB 954 Wood Assembly Third Reading",74,0,6,0,80
1213823,887973,2019-06-26,Senate,"Do pass as amended, but first amend, and re-refer to the Committee on [Appropriations]",9,0,0,0,9
1213823,891331,2019-08-12,Senate,"Placed on suspense file",7,0,0,0,7
1213823,891332,2019-08-30,Senate,"Do pass",7,0,0,0,7
1213823,891333,2019-09-09,Senate,"Special Consent AB954",40,0,0,0,40
1213823,891334,2019-09-10,Assembly,"AB 954 Wood Concurrence in Senate Amendments",79,0,0,0,79
1213852,852827,2019-04-24,Assembly,"Do pass and be re-referred to the Committee on [Appropriations] with recommendation: To Consent Calendar",8,0,0,0,8
1213852,861769,2019-05-08,Assembly,"Do pass. To Consent Calendar",18,0,0,0,18
1213852,866190,2019-05-16,Assembly,"AB 957 H. & C.D. Consent Calendar Second Day Regular Session",74,0,6,0,80
1213852,892463,2019-07-02,Senate,"Do pass as amended, but first amend, and re-refer to the Committee on [Appropriations] with the recommendation: To Consent Calendar",11,0,0,0,11
1213852,892464,2019-08-26,Senate,"Assembly 3rd Reading AB957 H. & C.D. (Chiu) By Wiener Urgency Clause",39,0,1,0,40
1213852,892465,2019-09-09,Assembly,"AB 957 H. & C.D. Concurrence - Urgency Added By CHIU",79,0,0,0,79
1213885,852996,2019-04-24,Assembly,"Do pass as amended, and be re-referred to the Committee on [Privacy and Consumer Protection] with recommendation: To Consent Calendar",8,0,5,0,13
1213885,855943,2019-04-30,Assembly,"Do pass as amended. To Consent Calendar",11,0,0,0,11
1213885,863137,2019-05-13,Assembly,"AB 956 Diep Consent Calendar Second Day Regular Session",74,0,6,0,80
1213885,875923,2019-04-24,Assembly,"Do pass as amended, and be re-referred to the C",0,0,5,0,5
1213885,877582,2019-06-04,Senate,"Do pass",11,0,2,0,13
1213885,881217,2019-04-24,Assembly,"Do pass as amended, and be re-referred to the Committee on [Privacy and Consumer Protection] with recommendation: To Consen",0,0,5,0,5
1213885,890605,2019-08-19,Senate,"Assembly 3rd Reading AB956 Diep et al. By Umberg",40,0,0,0,40
1213885,890606,2019-08-22,Assembly,"AB 956 Diep Concurrence in Senate Amendments",75,0,4,0,79
1213944,901324,2020-01-06,Assembly,"Be re-referred to the Committees on [Housing and Community Development] and [Local Government]",12,0,0,0,12
1213944,903150,2020-01-15,Assembly,"Do pass and be re-referred to the Committee on [Appropriations] with recommendation: To Consent Calendar",8,0,0,0,8
1213944,903151,2020-01-15,Assembly,"Do pass and be re-referred to the Committee on [Local Government] with recommendation: To Consent Calendar",8,0,0,0,8
1213944,905351,2020-01-23,Assembly,"Do pass. To Consent Calendar",18,0,0,0,18
1213944,912006,2020-01-30,Assembly,"AB 953 Ting Consent Calendar Second Day Regular Session",76,0,4,0,80
1213970,842353,2019-04-09,Assembly,"Do pass and be re-referred to the Committee on [Appropriations]",14,0,0,0,14
1213970,866382,2019-05-16,Assembly,"Do pass as amended",18,0,0,0,18
1213970,872323,2019-05-24,Assembly,"AB 955 Gipson Assembly Third Reading",77,0,3,0,80
1213970,884601,2019-06-19,Senate,"Do pass, but first be re-referred to the Committee on [Natural Resources and Water]",6,0,1,0,7
1213970,890991,2019-07-09,Senate,"Do pass as amended, but first amend, and re-refer to the Committee on [Appropriations] with the recommendation: To Consent Calendar",8,0,1,0,9
1213970,890992,2019-08-12,Senate,"Placed on suspense file",7,0,0,0,7
1213978,840923,2019-04-09,Senate,"Do pass, but first be re-referred to the Committee on [Appropriations] with the recommendation: To Consent Calendar",16,0,0,0,16
1213978,848742,2019-04-22,Senate,"Placed on suspense file",6,0,0,0,6
1213978,865936,2019-05-16,Senate,"Do pass",6,0,0,0,6
1213978,871564,2019-05-23,Senate,"Special Consent SB420",38,0,0,0,38
1213979,851724,2019-04-23,Assembly,"Do pass and be re-referred to the Committee on [Appropriations]",14,5,1,0,20
1213979,905418,2020-01-23,Assembly,"Do pass as amended",13,5,0,0,18
1213979,906414,2020-01-27,Assembly,"AB 1140 Mark Stone Assembly Third Reading",55,17,8,0,80
1213979,974883,2020-08-05,Senate,"Do pass, but first be re-referred to the Committee on [Appropriations]",5,0,0,0,5
1213979,976640,2020-08-24,Senate,"Assembly 3rd Reading AB1140 Mark Stone et al. By Monning",39,0,1,0,40
1213979,977442,2020-08-30,Assembly,"With recommendation: That Senate amendments be concurred in",6,0,1,0,7
1213979,978115,2020-08-30,Assembly,"AB 1140 Mark Stone Concurrence in Senate Amendments",75,0,4,0,79
1213980,834759,2019-04-02,Senate,"Do pass, but first be re-referred to the Committee on [Appropriations]",4,0,0,0,4
1213980,849014,2019-04-22,Senate,"Do pass",6,0,0,0,6
1213980,858145,2019-05-02,Senate,"Senate 3rd Reading SB449 McGuire",38,0,0,0,38
1213980,878520,2019-06-05,Assembly,"Do pass and be re-referred to the Committee on [Appropriations]",9,0,2,0,11
1213980,891977,2019-08-30,Assembly,"Do pass",18,0,0,0,18
1213980,891978,2019-09-05,Assembly,"SB 449 McGuire Senate Third Reading By Aguiar-Curry",79,0,0,0,79
1213980,891979,2019-09-06,Senate,"Unfinished Business SB449 McGuire et al. Concurrence",39,0,1,0,40
1213981,834795,2019-04-02,Assembly,"Do pass and be re-referred to the Committee on [Appropriations]",15,0,0,0,15
1213981,866052,2019-05-16,Assembly,"Do pass as amended",18,0,0,0,18
1213981,873895,2019-05-28,Assembly,"AB 1031 Nazarian Assembly Third Reading",74,0,6,0,80
1213981,884993,2019-06-19,Senate,"Do pass as amended, but first amend, and re-refer to the Committee on [Appropriations]",9,0,0,0,9
1213981,892823,2019-07-08,Senate,"Placed on suspense file",7,0,0,0,7
1213982,829268,2019-03-25,Assembly,"Do pass and be re-referred to the Committee on [Appropriations]",10,0,1,0,11
1213982,834751,2019-04-03,Assembly,"Do pass. To Consent Calendar",17,0,1,0,18
1213982,842827,2019-04-11,Assembly,"AB 1011 Petrie-Norris Consent Calendar Second Day Regular Session",72,0,8,0,80
1213982,880664,2019-06-11,Senate,"Do pass, but first be re-referred to the Committee on [Appropriations]",8,0,1,0,9
1213982,894024,2019-08-12,Senate,"Assembly 3rd Reading AB1011 Petrie-Norris By Monning",39,0,1,0,40
1213984,851678,2019-04-24,Assembly,"Do pass and be re-referred to the Committee on [Appropriations]",7,0,0,0,7
1213984,866318,2019-05-16,Assembly,"Do pass as amended",18,0,0,0,18
1213984,873937,2019-05-28,Assembly,"AB 971 Salas Assembly Third Reading",75,0,5,0,80
1213984,891804,2019-07-09,Senate,"Do pass, but first be re-referred to the Committee on [Appropriations]",15,0,1,0,16
1213984,891805,2019-09-04,Senate,"Assembly 3rd Reading AB971 Salas By Glazer",40,0,0,0,40
1213984,891806,2019-09-09,Assembly,"AB 971 Salas Concurrence in Senate Amendments",79,0,0,0,79
1213985,851769,2019-04-24,Assembly,"Do pass",10,0,4,0,14
1213985,858009,2019-05-02,Assembly,"AB 1107 Chu Assembly Third Reading",62,0,18,0,80
1213985,975951,2020-08-14,Senate,"Do pass, but first be re-referred to the Committee on [Appropriations] with the recommendation: To Consent Calendar",16,0,0,0,16
1213985,976166,2020-08-19,Senate,"Placed on suspense file",7,0,0,0,7
1213986,832457,2019-03-26,Assembly,"Do pass and be re-referred to the Committee on [Appropriations]",2,2,4,0,8
1213987,854879,2019-04-24,Assembly,"Do pass as amended and be re-referred to the Committee on [Appropriations]",15,0,0,0,15
1213987,861495,2019-05-08,Assembly,"Do pass. To Consent Calendar",18,0,0,0,18
1213987,866171,2019-05-16,Assembly,"AB 1026 Wood Consent Calendar Second Day Regular Session",74,0,6,0,80
1213987,891767,2019-07-10,Senate,"Do pass as amended, but first amend, and re-refer to the Committee on [Appropriations]",12,0,1,0,13
1213987,891768,2019-09-04,Senate,"Assembly 3rd Reading AB1026 Wood By Wiener",40,0,0,0,40
1213987,891769,2019-09-09,Assembly,"AB 1026 Wood Concurrence in Senate Amendments",78,0,1,0,79
1213987,894515,2019-05-16,Assembly,"Bill Votes",18,0,0,0,18
1213988,840015,2019-04-09,Senate,"Do pass, but first be re-referred to the Committee on [Appropriations]",2,4,1,0,7
1213991,838381,2019-04-08,Senate,"Do pass",9,0,0,0,9
1213991,858041,2019-05-02,Senate,"Senate 3rd Reading SB483 Pan",38,0,0,0,38
1213992,831396,2019-03-27,Senate,"Do pass, but first be re-referred to the Committee on [Human Services] with the recommendation: To Consent Calendar",8,0,1,0,9
1213992,839849,2019-04-08,Senate,"Do pass, but first be re-referred to the Committee on [Appropriations] with the recommendation: To Consent Calendar",6,0,0,0,6
1213992,849005,2019-04-22,Senate,"Placed on suspense file",6,0,0,0,6
1213993,852017,2019-04-23,Senate,"Do pass as amended, but first amend, and re-refer to the Committee on [Appropriations]",6,0,1,0,7
1213993,863098,2019-05-13,Senate,"Placed on suspense file",6,0,0,0,6
1213993,866285,2019-05-16,Senate,"Do pass",6,0,0,0,6
1213993,871123,2019-05-23,Senate,"Special Consent SB459",38,0,0,0,38
1213993,893521,2019-07-09,Assembly,"Do pass and be re-referred to the Committee on [Appropriations]",8,0,0,0,8
1213993,893522,2019-08-30,Assembly,"Do pass",18,0,0,0,18
1213993,893523,2019-09-10,Assembly,"SB 459 Galgiani Senate Third Reading By Bauer-Kahan",78,0,1,0,79
1213994,886994,2019-05-01,Assembly,"Do pass",4,3,1,0,8
1213994,886995,2019-05-01,Assembly,Reconsideration,8,0,0,0,8
1213994,903161,2020-01-15,Assembly,"Do pass",5,3,0,0,8
1213994,912003,2020-01-30,Assembly,"AB 992 Mullin Assembly Third Reading",57,13,10,0,80
1213994,974302,2020-07-29,Senate,"Do pass as amended",6,0,1,0,7
1213994,976645,2020-08-24,Senate,"Assembly 3rd Reading AB992 Mullin By Hill",33,6,1,0,40
1213994,976911,2020-08-26,Assembly,"AB 992 Mullin Concurrence in Senate Amendments",69,0,10,0,79
1213996,835112,2019-04-03,Senate,"Do pass, but first be re-referred to the Committee on [Appropriations] with the recommendation: To Consent Calendar",7,0,0,0,7
1213996,859522,2019-05-06,Senate,"Placed on suspense file",5,0,1,0,6
1213996,865583,2019-05-16,Senate,"Do pass",6,0,0,0,6
1213996,871561,2019-05-23,Senate,"Special Consent SB519",38,0,0,0,38
1213996,890980,2019-07-02,Assembly,"Do pass and be re-referred to the Committee on [Appropriations]",7,0,2,0,9
1213996,890981,2019-08-30,Assembly,"Do pass",18,0,0,0,18
1213996,890982,2019-09-09,Assembly,"SB 519 Bradford Senate Third Reading By Quirk",79,0,0,0,79
1213996,890983,2019-09-10,Senate,"Unfinished Business SB519 Bradford Concurrence",40,0,0,0,40
1213997,833003,2019-03-26,Assembly,"Do pass as amended and be re-referred to the Committee on [Appropriations]",8,0,0,0,8
1213997,866205,2019-05-16,Assembly,"Do pass as amended",18,0,0,0,18
1213997,873950,2019-05-28,Assembly,"AB 987 Robert Rivas Assembly Third Reading",75,0,5,0,80
1213997,893831,2019-07-08,Senate,"Do pass as amended, but first amend, and re-refer to the Committee on [Appropriations] with the recommendation: To Consent Calendar",6,0,0,0,6
1213998,835834,2019-04-02,Senate,"Do pass",7,0,1,0,8
1213998,838556,2019-04-08,Senate,"Senate 3rd Reading SB495 Durazo et al",30,0,8,0,38
1213998,877744,2019-06-04,Assembly,"Do pass",9,0,3,0,12
1213998,890778,2019-08-26,Assembly,"SB 495 Durazo Senate Third Reading By Mark Stone",62,0,17,0,79
1213998,890779,2019-09-03,Senate,"Unfinished Business SB495 Durazo et al. Concurrence",32,0,8,0,40
1213999,850436,2019-04-22,Assembly,"Do pass and be re-referred to the Committee on [Appropriations] with recommendation: To Consent Calendar",15,0,0,0,15
1214000,840911,2019-04-09,Assembly,"Do pass and be re-referred to the Committee on [Appropriations]",9,3,0,0,12
1214002,835608,2019-04-02,Assembly,"Do pass and be re-referred to the Committee on [Appropriations]",5,2,1,0,8
1214002,905343,2020-01-23,Assembly,"Do pass",10,6,2,0,18
1214002,906416,2020-01-27,Assembly,"AB 1145 Cristina Garcia Assembly Third Reading",47,19,14,0,80
1214002,974613,2020-07-31,Senate,"Do pass, but first be re-referred to the Committee on [Appropriations]",5,1,1,0,7
1214002,977338,2020-08-28,Senate,"Assembly 3rd Reading AB1145 Cristina Garcia By Wiener",28,10,2,0,40
1214003,841423,2019-04-09,Senate,"Do pass, but first be re-referred to the Committee on [Appropriations] with the recommendation: To Consent Calendar",12,0,0,0,12
1214003,849429,2019-04-22,Senate,"Placed on suspense file",6,0,0,0,6
1214003,866469,2019-05-16,Senate,"Do pass",6,0,0,0,6
1214003,871383,2019-05-23,Senate,"Special Consent SB504",38,0,0,0,38
1214003,890622,2019-07-01,Assembly,"Do pass and be re-referred to the Committee on [Appropriations] with recommendation: To Consent Calendar",15,0,0,0,15
1214003,890623,2019-08-30,Assembly,"Do pass",18,0,0,0,18
1214003,890624,2019-09-05,Assembly,"SB 504 Monning Senate Third Reading By Cunningham",79,0,0,0,79
1214003,890625,2019-09-06,Senate,"Unfinished Business SB504 Monning et al. Concurrence",39,0,1,0,40
1214004,843045,2019-04-10,Assembly,"Do pass and be re-referred to the Committee on [Appropriations]",5,0,1,0,6
1214005,854352,2019-04-23,Assembly,"Do pass as amended and be re-referred to the Committee on [Appropriations]",10,0,1,0,11
1214005,862284,2019-05-09,Assembly,"AB 1138 Gallagher Assembly Third Reading",24,11,45,0,80
1214005,871511,2019-05-23,Assembly,"AB 1138 Gallagher Assembly Third Reading",56,6,18,0,80
1214005,892057,2019-07-09,Senate,"Do pass as amended",8,0,1,0,9
1214005,893654,2019-09-12,Senate,"Assembly 3rd Reading AB1138 Gallagher et al. By Stern",31,4,5,0,40
1214005,893918,2019-09-14,Assembly,"AB 1138 Gallagher Concurrence in Senate Amendments",37,12,30,0,79
1214005,978160,2020-08-30,Assembly,"AB 1138 Gallagher Concurrence in Senate Amendments",54,4,21,0,79
1214008,850469,2019-04-22,Assembly,"Do pass and be re-referred to the Committee on [Privacy and Consumer Protection]",12,1,2,0,15
1214008,855876,2019-04-30,Assembly,"Do pass as amended",11,0,0,0,11
1214008,870202,2019-05-22,Assembly,"AB 1112 Friedman Assembly Third Reading",74,1,5,0,80
1214009,841673,2019-04-09,Assembly,"Do pass as amended and be re-referred to the Committee on [Judiciary]",8,0,0,0,8
1214009,849922,2019-04-23,Assembly,"Do pass as amended, and be re-referred to the Committee on [Appropriations] with recommendation: To Consent Calendar",12,0,0,0,12
1214009,865697,2019-05-16,Assembly,"Do pass as amended",18,0,0,0,18
1214009,873768,2019-05-28,Assembly,"AB 1068 Cooley Assembly Third Reading By FRIEDMAN",74,0,6,0,80
1214009,887662,2019-06-24,Senate,"Do pass, but first be re-referred to the Committee on [Judiciary]",6,0,0,0,6
1214009,892406,2019-07-09,Senate,"Do pass as amended, but first amend, and re-refer to the Committee on [Appropriations] with the recommendation: To Consent Calendar",8,0,1,0,9
1214009,892407,2019-08-12,Senate,"Placed on suspense file",7,0,0,0,7
1214009,892408,2019-08-30,Senate,"Do pass as amended",7,0,0,0,7
1214009,892409,2019-09-05,Senate,"Assembly 3rd Reading AB1068 Cooley By Gonzalez",40,0,0,0,40
1214009,892410,2019-09-09,Assembly,"AB 1068 Cooley Concurrence in Senate Amendments",78,0,1,0,79
1214009,894726,2019-09-05,Senate,"Asseml"">",7,0,0,0,7
1214011,842472,2019-04-09,Assembly,"Do pass and be re-referred to the Committee on [Judiciary]",15,0,0,0,15
1214011,850659,2019-04-23,Assembly,"Do pass as amended, and be re-referred to the Committee on [Appropriations] with recommendation: To Consent Calendar",12,0,0,0,12
1214011,866219,2019-05-16,Assembly,"Do pass",18,0,0,0,18
1214011,874711,2019-05-29,Assembly,"AB 1116 Grayson Assembly Third Reading",78,0,2,0,80
1214011,890638,2019-07-03,Senate,"Do pass, but first be re-referred to the Committee on [Judiciary]",7,0,2,0,9
1214011,890639,2019-07-09,Senate,"Do pass as amended, but first amend, and re-refer to the Committee on [Appropriations] with the recommendation: To Consent Calendar",8,0,1,0,9
1214011,890640,2019-08-12,Senate,"Placed on suspense file",7,0,0,0,7
1214011,890641,2019-08-30,Senate,"Do pass as amended",7,0,0,0,7
1214011,893924,2019-09-13,Assembly,"AB 1116 Grayson Concurrence in Senate Amendments",77,0,2,0,79
1214011,894133,2019-09-13,Senate,"Assembly 3rd Reading AB1116 Grayson et al. By Gonzalez",40,0,0,0,40
1214011,894804,2019-08-12,Senate,Result,8,0,0,0,8
1214011,894842,2019-05-29,Assembly,"AB 1116 Grayson Assembly Third Rea",18,0,0,0,18
1214012,851087,2019-04-23,Senate,"Do pass, but first be re-referred to the Committee on [Appropriations]",5,0,0,0,5
1214012,868320,2019-05-20,Senate,"Senate 3rd Reading SB423 Umberg",38,0,0,0,38
1214012,969393,2020-06-26,Assembly,"Amend, and re-refer to the Committee on [Elections and Redistricting]",7,0,0,0,7
1214012,973990,2020-07-27,Assembly,"Do pass",5,1,1,0,7
1214012,974745,2020-08-03,Assembly,"SB 423 Umberg Third Reading Urgency By Berman",57,12,10,0,79
1214012,974814,2020-08-04,Senate,"That the Assembly amendments be concurred in",4,1,0,0,5
1214012,974947,2020-08-06,Senate,"Unfinished Business SB423 Umberg et al. Urgency Clause Concurrence",29,4,7,0,40
1214014,852128,2019-04-23,Assembly,"Do pass and be re-referred to the Committee on [Appropriations]",15,0,0,0,15
1214019,839985,2019-04-09,Senate,"Do pass, but first be re-referred to the Committee on [Environmental Quality]",7,0,2,0,9
1214019,851579,2019-04-24,Senate,"Do pass, but first be re-referred to the Committee on [Appropriations]",6,0,1,0,7
1214019,863076,2019-05-13,Senate,"Placed on suspense file",6,0,0,0,6
1214019,865977,2019-05-16,Senate,"Do pass",6,0,0,0,6
1214019,871316,2019-05-23,Senate,"Special Consent SB463",38,0,0,0,38
1214019,893143,2019-07-08,Assembly,"Do pass as amended and be re-referred to the Committee on [Appropriations]",8,2,1,0,11
1214019,893144,2019-08-30,Assembly,"Do pass as amended",14,4,0,0,18
1214019,893145,2019-09-09,Assembly,"SB 463 Stern Senate Third Reading By Smith",63,13,3,0,79
1214019,893146,2019-09-11,Senate,"Unfinished Business SB463 Stern Concurrence",33,4,3,0,40
1214020,828151,2019-03-25,Assembly,"Be re-referred to the Committees on [Health] and [Judiciary]",12,0,0,0,12
1214020,840002,2019-04-09,Assembly,"Do pass and be re-referred to the Committee on [Judiciary]",15,0,0,0,15
1214020,850501,2019-04-23,Assembly,"Do pass as amended, and be re-referred to the Committee on [Appropriations] with recommendation: To Consent Calendar",12,0,0,0,12
1214020,866082,2019-05-16,Assembly,"Do pass",18,0,0,0,18
1214020,874362,2019-05-29,Assembly,"AB 1117 Grayson Assembly Third Reading",78,0,2,0,80
1214020,887475,2019-06-25,Senate,"Do pass, but first be re-referred to the Committee on [Judiciary]",7,0,0,0,7
1214020,892767,2019-07-09,Senate,"Do pass as amended, but first amend, and re-refer to the Committee on [Appropriations] with the recommendation: To Consent Calendar",8,0,1,0,9
1214020,892768,2019-08-12,Senate,"Placed on suspense file",7,0,0,0,7
1214020,892769,2019-08-30,Senate,"Do pass",7,0,0,0,7
1214020,892770,2019-09-10,Senate,"Assembly 3rd Reading AB1117 Grayson et al. By Leyva",40,0,0,0,40
1214020,892771,2019-09-11,Assembly,"AB 1117 Grayson Concurrence in Senate Amendments",79,0,0,0,79
1214021,829631,2019-03-26,Senate,"Do pass, but first be re-referred to the Committee on [Appropriations]",9,0,0,0,9
1214021,849074,2019-04-22,Senate,"Placed on suspense file",6,0,0,0,6
1214021,866448,2019-05-16,Senate,"Do pass as amended",6,0,0,0,6
1214021,871435,2019-05-23,Senate,"Senate 3rd Reading SB487 Caballero",38,0,0,0,38
1214021,893567,2019-07-02,Assembly,"Do pass and be re-referred to the Committee on [Appropriations]",14,0,0,0,14
1214021,893568,2019-08-30,Assembly,"Do pass",18,0,0,0,18
1214021,893569,2019-09-05,Assembly,"SB 487 Caballero Senate Third Reading By Quirk",79,0,0,0,79
1214021,893570,2019-09-06,Senate,"Unfinished Business SB487 Caballero Concurrence",39,0,1,0,40
1214021,895245,2019-05-23,Senate,Date,6,0,0,0,6
1214022,835685,2019-04-03,Assembly,"Do pass and be re-referred to the Committee on [Labor and Employment]",15,0,0,0,15
1214022,853119,2019-04-24,Assembly,"Do pass and be re-referred to the Committee on [Appropriations] with recommendation: To Consent Calendar",7,0,0,0,7
1214022,866005,2019-05-16,Assembly,"Do pass",17,0,1,0,18
1214022,870206,2019-05-22,Assembly,"AB 1028 Gonzalez Assembly Third Reading",76,0,4,0,80
1214022,884828,2019-06-19,Senate,"Do pass as amended, but first amend, and re-refer to the Committee on [Energy, Utilities and Communications]",4,1,0,0,5
1214022,890449,2019-07-02,Senate,"Do pass, but first be re-referred to the Committee on [Appropriations]",11,1,1,0,13
1214022,890450,2019-08-12,Senate,"Placed on suspense file",7,0,0,0,7
1214025,844646,2019-04-02,Assembly,"Do pass",2,6,0,0,8
1214027,843035,2019-04-10,Assembly,"Do pass as amended",6,0,0,0,6
1214027,856734,2019-05-01,Assembly,"Do pass. To Consent Calendar",18,0,0,0,18
1214027,862345,2019-05-09,Assembly,"AB 1127 Luz Rivas Consent Calendar Second Day Regular Session",76,0,4,0,80
1214027,879248,2019-06-05,Senate,"Do pass, but first be re-referred to the Committee on [Appropriations] with the recommendation: To Consent Calendar",7,0,0,0,7
1214027,887050,2019-06-24,Senate,"Placed on suspense file",7,0,0,0,7
1214027,893584,2019-08-30,Senate,"Do pass",7,0,0,0,7
1214027,893585,2019-09-09,Senate,"Special Consent AB1127",40,0,0,0,40
1214028,839788,2019-04-09,Senate,"Do pass, but first be re-referred to the Committee on [Appropriations] with the recommendation: To Consent Calendar",16,0,0,0,16
1214028,849494,2019-04-22,Senate,"Placed on suspense file",6,0,0,0,6
1214028,866407,2019-05-16,Senate,"Do pass as amended",6,0,0,0,6
1214028,871662,2019-05-23,Senate,"Senate 3rd Reading SB513 Hurtado",38,0,0,0,38
1214028,890902,2019-07-02,Assembly,"Do pass and be re-referred to the Committee on [Appropriations]",9,0,0,0,9
1214028,890903,2019-08-30,Assembly,"Do pass",18,0,0,0,18
1214028,890904,2019-09-05,Assembly,"SB 513 Hurtado Senate Third Reading By Arambula",78,0,1,0,79
1214028,890905,2019-09-06,Senate,"Unfinished Business SB513 Hurtado et al. Concurrence",39,0,1,0,40
1214029,842087,2019-04-09,Senate,"Do pass, but first be re-referred to the Committee on [Rules]",6,0,1,0,7
1214029,850657,2019-04-23,Senate,"Do pass as amended, but first amend, and re-refer to the Committee on [Appropriations]",16,0,0,0,16
1214029,863221,2019-05-13,Senate,"Placed on suspense file",6,0,0,0,6
1214029,866250,2019-05-16,Senate,"Do pass",6,0,0,0,6
1214029,871308,2019-05-23,Senate,"Special Consent SB501",38,0,0,0,38
1214030,832086,2019-03-27,Assembly,"Do pass and be re-referred to the Committee on [Appropriations] with recommendation: To Consent Calendar",6,0,0,0,6
1214032,835266,2019-04-03,Assembly,"Do pass and be re-referred to the Committee on [Local Government]",8,0,0,0,8
1214032,841655,2019-04-10,Assembly,"Do pass and be re-referred to the Committee on [Appropriations] with recommendation: To Consent Calendar",8,0,0,0,8
1214032,852277,2019-04-24,Assembly,"Do pass. To Consent Calendar",18,0,0,0,18
1214032,858150,2019-05-02,Assembly,"AB 1084 Mayes Consent Calendar Second Day Regular Session",76,0,4,0,80
1214032,877716,2019-06-04,Senate,"Do pass as amended, but first amend, and re-refer to the Committee on [Appropriations] with the recommendation: To Consent Calendar",10,0,1,0,11
1214032,887155,2019-06-24,Senate,"Do pass",7,0,0,0,7
1214032,893720,2019-07-11,Senate,"Special Consent AB1084",39,0,1,0,40
1214032,893721,2019-08-12,Assembly,"AB 1084 Mayes Concurrence in Senate Amendments",78,0,1,0,79
1214033,852821,2019-04-24,Senate,"Do pass as amended",5,2,0,0,7
1214033,865704,2019-05-16,Senate,"Senate 3rd Reading SB531 Glazer et al",27,8,3,0,38
1214033,884804,2019-06-19,Assembly,"Do pass and be re-referred to the Committee on [Revenue and Taxation]",6,2,0,0,8
1214033,890619,2019-07-08,Assembly,"Do pass",9,1,1,0,11
1214033,890620,2019-08-30,Assembly,"SB 531 Glazer Senate Third Reading By Quirk",36,21,22,0,79
1214033,890621,2019-09-05,Assembly,"SB 531 Glazer Senate Third Reading By Quirk",48,21,10,0,79
1214035,853040,2019-04-24,Assembly,"Do pass and be re-referred to the Committee on [Appropriations] with recommendation: To Consent Calendar",7,0,0,0,7
1214035,866242,2019-05-16,Assembly,"Do pass",18,0,0,0,18
1214035,870223,2019-05-22,Assembly,"AB 1019 Frazier Assembly Third Reading",78,0,2,0,80
1214035,884862,2019-06-19,Senate,"Do pass, but first be re-referred to the Committee on [Appropriations] with the recommendation: To Consent Calendar",5,0,0,0,5
1214035,894107,2019-07-11,Senate,"Consent Calendar AB1019",39,0,1,0,40
1214036,835782,2019-04-02,Assembly,"Do pass and be re-referred to the Committee on [Appropriations]",11,0,4,0,15
1214036,841748,2019-04-10,Assembly,"Do pass",14,0,4,0,18
1214036,863043,2019-05-13,Assembly,"AB 1014 O'Donnell Assembly Third Reading",58,1,21,0,80
1214036,881076,2019-06-12,Senate,"Do pass as amended, but first amend, and re-refer to the Committee on [Appropriations]",7,1,1,0,9
1214036,891967,2019-09-03,Senate,"Assembly 3rd Reading AB1014 O'Donnell et al. By Pan",29,10,1,0,40
1214036,891968,2019-09-05,Assembly,"AB 1014 O'Donnell Concurrence in Senate Amendments",64,8,7,0,79
1214039,829417,2019-03-26,Assembly,"Do pass. To Consent Calendar",12,0,0,0,12
1214039,833068,2019-04-01,Assembly,"AB 991 Gallagher Consent Calendar Second Day Regular Session",74,0,6,0,80
1214039,892561,2019-07-02,Senate,"Do pass and be ordered to the Consent Calendar",9,0,0,0,9
1214039,892562,2019-09-04,Senate,"Assembly 3rd Reading AB991 Gallagher By Borgeas",40,0,0,0,40
1214039,892563,2019-09-09,Assembly,"AB 991 Gallagher Concurrence in Senate Amendments",79,0,0,0,79
1214039,895547,2019-09-04,Senate,A,9,0,0,0,9
1214040,852878,2019-04-24,Assembly,"Do pass and be re-referred to the Committee on [Appropriations] with recommendation: To Consent Calendar",8,0,0,0,8
1214041,851647,2019-04-23,Assembly,"Do pass and be re-referred to the Committee on [Appropriations]",19,0,1,0,20
1214041,861956,2019-05-08,Assembly,"Do pass",17,0,1,0,18
1214041,866036,2019-05-16,Assembly,"AB 1018 Frazier Assembly Third Reading",73,0,7,0,80
1214041,887068,2019-06-24,Senate,"Do pass, but first be re-referred to the Committee on [Appropriations] with the recommendation: To Consent Calendar",9,0,0,0,9
1214041,891540,2019-08-15,Senate,"Consent Calendar AB1018",37,0,3,0,40
1214041,891541,2019-08-26,Assembly,"AB 1018 Frazier Concurrence in Senate Amendments",77,0,2,0,79
1214042,836046,2019-03-27,Assembly,"Do pass as amended, and be re-referred to the Committee on [Appropriations] with recommendation: To Consent Calendar",6,0,0,0,6
1214042,852309,2019-04-24,Assembly,"Do pass. To Consent Calendar",18,0,0,0,18
1214042,858093,2019-05-02,Assembly,"AB 988 Berman Consent Calendar Second Day Regular Session",76,0,4,0,80
1214042,878679,2019-06-05,Senate,"Do pass, but first be re-referred to the Committee on [Appropriations] with the recommendation: To Consent Calendar",7,0,0,0,7
1214042,894360,2019-07-01,Senate,"Consent Calendar AB988",39,0,1,0,40
1214043,856539,2019-04-23,Senate,"Do pass as amended, but first amend, and re-refer to the Committee on [Appropriations]",7,0,0,0,7
1214043,868929,2019-05-21,Senate,"Senate 3rd Reading SB481 Umberg",37,0,1,0,38
1214043,884143,2019-06-18,Assembly,"Do pass and be re-referred to the Committee on [Appropriations]",10,0,1,0,11
1214043,892471,2019-08-14,Assembly,"Do pass",18,0,0,0,18
1214043,892472,2019-09-09,Assembly,"SB 481 Umberg Senate Third Reading By Eggman",79,0,0,0,79
1214047,839940,2019-04-09,Assembly,"Do pass as amended and be re-referred to the Committee on [Appropriations]",9,4,1,0,14
1214047,865804,2019-05-16,Assembly,"Do pass",14,4,0,0,18
1214047,872311,2019-05-24,Assembly,"AB 1086 Bauer-Kahan Assembly Third Reading",53,18,9,0,80
1214047,891387,2019-09-11,Senate,"Do pass, but first be re-referred to the Committee on [Governmental Organization]",5,1,3,0,9
1214047,891388,2019-09-11,Senate,"Do pass, but first be re-referred to the Committee on [Appropriations]",11,2,3,0,16
1214047,893773,2019-09-12,Senate,"Do pass",5,2,0,0,7
1214047,893927,2019-09-13,Assembly,"AB 1086 Bauer-Kahan Concurrence in Senate Amendments",56,21,2,0,79
1214047,894154,2019-09-13,Senate,"Assembly 3rd Reading AB1086 Bauer-Kahan et al. By Glazer",30,10,0,0,40
1214049,841410,2019-04-10,Senate,"Do pass, but first be re-referred to the Committee on [Appropriations]",3,0,2,0,5
1214049,849017,2019-04-22,Senate,"Placed on suspense file",6,0,0,0,6
1214049,865678,2019-05-16,Senate,"Do pass as amended",6,0,0,0,6
1214049,868723,2019-05-21,Senate,"Senate 3rd Reading SB430 Wieckowski",38,0,0,0,38
1214050,835677,2019-04-03,Senate,"Do pass, but first be re-referred to the Committee on [Appropriations]",7,0,0,0,7
1214050,852876,2019-04-25,Senate,"Senate 3rd Reading SB467 Monning et al",37,0,1,0,38
1214050,880385,2019-06-11,Assembly,"Do pass and be re-referred to the Committee on [Appropriations]",11,0,1,0,12
1214050,888035,2019-06-26,Assembly,"Do pass",15,0,3,0,18
1214050,890800,2019-09-03,Assembly,"SB 467 Monning Senate Third Reading By Cunningham",75,0,4,0,79
1214053,839745,2019-04-08,Senate,"Do pass, but first be re-referred to the Committee on [Governmental Organization]",6,0,0,0,6
1214053,850560,2019-04-23,Senate,"Do pass as amended, but first amend, and re-refer to the Committee on [Appropriations]",14,1,1,0,16
1214053,863196,2019-05-13,Senate,"Placed on suspense file",6,0,0,0,6
1214053,866299,2019-05-16,Senate,"Do pass",5,1,0,0,6
1214053,868791,2019-05-21,Senate,"Senate 3rd Reading SB512 Pan et al",35,1,2,0,38
1214053,880577,2019-06-11,Assembly,"Do pass and be re-referred to the Committee on [Human Services]",7,0,0,0,7
1214053,891389,2019-07-02,Assembly,"Do pass as amended and be re-referred to the Committee on [Appropriations]",8,0,0,0,8
1214054,829791,2019-03-26,Senate,"Do pass, but first be re-referred to the Committee on [Appropriations]",6,0,1,0,7
1214054,839140,2019-04-08,Senate,"Placed on suspense file",6,0,0,0,6
1214055,841653,2019-04-10,Senate,"Do pass, but first be re-referred to the Committee on [Appropriations]",4,0,1,0,5
1214055,849706,2019-04-22,Senate,"Placed on suspense file",6,0,0,0,6
1214055,866444,2019-05-16,Senate,"Do pass",6,0,0,0,6
1214055,871381,2019-05-23,Senate,"Special Consent SB530",38,0,0,0,38
1214055,888389,2019-06-26,Assembly,"Do pass and be re-referred to the Committee on [Appropriations]",7,0,0,0,7
1214055,891748,2019-08-30,Assembly,"Do pass as amended",18,0,0,0,18
1214055,891749,2019-09-10,Assembly,"SB 530 Galgiani Senate Third Reading By Carrillo",72,5,2,0,79
1214055,893601,2019-09-12,Senate,"Unfinished Business SB530 Galgiani et al. Concurrence",33,7,0,0,40
1214056,841740,2019-04-10,Assembly,"Do pass and be re-referred to the Committee on [Privacy and Consumer Protection]",7,0,0,0,7
1214056,852586,2019-04-23,Assembly,"Do pass and be re-referred to the Committee on [Appropriations]",11,0,0,0,11
1214056,857068,2019-05-01,Assembly,"Do pass. To Consent Calendar",18,0,0,0,18
1214056,862144,2019-05-09,Assembly,"AB 1032 Quirk Consent Calendar Second Day Regular Session",76,0,4,0,80
1214056,877230,2019-06-03,Senate,"Do pass, but first be re-referred to the Committee on [Appropriations]",9,0,0,0,9
1214056,893888,2019-07-01,Senate,"Assembly 3rd Reading AB1032 Quirk By Pan",39,0,1,0,40
1214059,854198,2019-04-22,Assembly,"Do pass as amended and be re-referred to the Committee on [Appropriations]",11,0,0,0,11
1214060,860560,2019-05-01,Senate,"Do pass as amended, but first amend, and re-refer to the Committee on [Appropriations]",6,0,1,0,7
1214060,863123,2019-05-13,Senate,"Placed on suspense file",6,0,0,0,6
1214060,865624,2019-05-16,Senate,"Do pass as amended",6,0,0,0,6
1214060,871000,2019-05-23,Senate,"Senate 3rd Reading SB477 Wieckowski",36,1,1,0,38
1214062,849741,2019-04-10,Assembly,"Do pass as amended and be re-referred to the Committee on [Appropriations]",14,0,1,0,15
1214062,857083,2019-05-01,Assembly,"Do pass. To Consent Calendar",18,0,0,0,18
1214062,862150,2019-05-09,Assembly,"AB 1017 Boerner Horvath Consent Calendar Second Day Regular Session",76,0,4,0,80
1214062,883779,2019-06-18,Senate,"Do pass, but first be re-referred to the Committee on [Appropriations]",13,0,0,0,13
1214062,887564,2019-04-10,Assembly,"Do pass as amended and be re-referred to tn, Quirk, Reyes, Santiago, Ting",0,0,1,0,1
1214062,894511,2019-08-19,Senate,"Assembly 3rd Reading AB1017 Boerner Horvath et a By Gonzalez",40,0,0,0,40
1214062,894512,2019-08-22,Assembly,"AB 1017 Boerner Horvath Concurrence in Senate Amendments",76,0,3,0,79
1214063,860863,2019-05-06,Assembly,"Do pass and be re-referred to the Committee on [Appropriations]",10,0,1,0,11
1214064,838593,2019-04-08,Senate,"Do pass, but first be re-referred to the Committee on [Judiciary]",9,0,0,0,9
1214064,851503,2019-04-23,Senate,"Do pass as amended, but first amend, and re-refer to the Committee on [Appropriations]",7,2,0,0,9
1214064,863095,2019-05-13,Senate,"Placed on suspense file",6,0,0,0,6
1214064,866106,2019-05-16,Senate,"Do pass as amended",4,2,0,0,6
1214064,873851,2019-05-28,Senate,"Senate 3rd Reading SB425 Hill",33,5,0,0,38
1214064,887492,2019-06-25,Assembly,"Do pass as amended and be re-referred to the Committee on [Judiciary]",19,0,0,0,19
1214064,892538,2019-07-09,Assembly,"Do pass and be re-referred to the Committee on [Appropriations]",12,0,0,0,12
1214064,892539,2019-08-30,Assembly,"Do pass",18,0,0,0,18
1214064,892540,2019-09-10,Assembly,"SB 425 Hill Senate Third Reading By Gallagher",79,0,0,0,79
1214064,892541,2019-09-11,Senate,"Unfinished Business SB425 Hill Concurrence",40,0,0,0,40
1214065,853270,2019-04-24,Senate,"Do pass, but first be re-referred to the Committee on [Appropriations]",9,0,0,0,9
1214065,863162,2019-05-13,Senate,"Placed on suspense file",6,0,0,0,6
1214066,851873,2019-04-24,Assembly,"Do pass and be re-referred to the Committee on [Appropriations]",5,1,1,0,7
1214066,866258,2019-05-16,Assembly,"Do pass as amended",13,5,0,0,18
1214066,873919,2019-05-28,Assembly,"AB 1007 Jones-Sawyer Assembly Third Reading",54,18,8,0,80
1214066,885348,2019-06-19,Senate,"Do pass as amended, but first amend, and re-refer to the Committee on [Appropriations]",4,1,0,0,5
1214066,886809,2019-04-24,Assembly,"Do pass and be re-referred to the Committee on [Appropriattle=""No Votes Recorded"">No Votes Recorded:",0,0,1,0,1
1214066,891154,2019-07-08,Senate,"Placed on suspense file",7,0,0,0,7
1214066,891155,2019-08-30,Senate,"Do pass",5,2,0,0,7
1214068,850984,2019-04-23,Senate,"Do pass, but first be re-referred to the Committee on [Appropriations] with the recommendation: To Consent Calendar",9,0,0,0,9
1214068,859778,2019-05-06,Senate,"Placed on suspense file",5,0,1,0,6
1214068,866474,2019-05-16,Senate,"Do pass",6,0,0,0,6
1214068,871674,2019-05-23,Senate,"Special Consent SB507",38,0,0,0,38
1214068,891364,2019-07-08,Assembly,"Do pass and be re-referred to the Committee on [Appropriations] with recommendation: To Consent Calendar",11,0,0,0,11
1214068,891365,2019-08-21,Assembly,"Do pass. To Consent Calendar",17,0,1,0,18
1214068,891366,2019-08-30,Assembly,"SB 507 Atkins Consent Calendar Second Day Regular Session",67,0,12,0,79
1214068,891367,2019-09-04,Senate,"Unfinished Business SB507 Atkins et al. Concurrence",40,0,0,0,40
1214069,834236,2019-04-02,Assembly,"Do pass and be re-referred to the Committee on [Appropriations]",6,1,1,0,8
1214069,866432,2019-05-16,Assembly,"Do pass as amended",12,5,1,0,18
1214069,872320,2019-05-24,Assembly,"AB 965 Mark Stone Assembly Third Reading",44,23,13,0,80
1214069,887595,2019-06-25,Senate,"Do pass, but first be re-referred to the Committee on [Appropriations]",5,1,1,0,7
1214069,892089,2019-08-12,Senate,"Placed on suspense file",7,0,0,0,7
1214069,892090,2019-08-30,Senate,"Do pass as amended",5,2,0,0,7
1214069,892091,2019-09-09,Senate,"Assembly 3rd Reading AB965 Mark Stone By Wiener",26,12,2,0,40
1214069,892092,2019-09-10,Assembly,"AB 965 Mark Stone Concurrence in Senate Amendments",47,27,5,0,79
1214072,834275,2019-04-02,Senate,"Do pass, but first be re-referred to the Committee on [Appropriations]",12,0,1,0,13
1214072,848793,2019-04-22,Senate,"Placed on suspense file",6,0,0,0,6
1214072,866315,2019-05-16,Senate,"Do pass",6,0,0,0,6
1214072,871003,2019-05-23,Senate,"Special Consent SB457",38,0,0,0,38
1214072,880958,2019-06-12,Assembly,"Do pass as amended and be re-referred to the Committee on [Appropriations]",12,0,3,0,15
1214072,888052,2019-06-26,Assembly,"Do pass",15,0,3,0,18
1214072,892197,2019-09-10,Assembly,"SB 457 Hueso Senate Third Reading By Eduardo Garcia",60,9,10,0,79
1214072,892198,2019-09-11,Senate,"Unfinished Business SB457 Hueso Concurrence",34,0,6,0,40
1214075,841872,2019-04-09,Assembly,"Do pass as amended and be re-referred to the Committee on [Appropriations]",15,0,0,0,15
1214076,837592,2019-04-02,Assembly,"Do pass as amended and be re-referred to the Committee on [Appropriations]",15,0,0,0,15
1214076,865921,2019-05-16,Assembly,"Do pass",18,0,0,0,18
1214076,874653,2019-05-29,Assembly,"AB 1088 Wood Assembly Third Reading",78,0,2,0,80
1214076,892479,2019-07-10,Senate,"Do pass, but first be re-referred to the Committee on [Appropriations] with the recommendation: To Consent Calendar",8,0,1,0,9
1214076,892480,2019-08-30,Senate,"Do pass as amended",7,0,0,0,7
1214076,892481,2019-09-04,Senate,"Assembly 3rd Reading AB1088 Wood By Pan",40,0,0,0,40
1214076,892482,2019-09-09,Assembly,"AB 1088 Wood Concurrence in Senate Amendments",79,0,0,0,79
1214076,893684,2019-08-12,Senate,"Placed on suspense file",7,0,0,0,7
1214079,836314,2019-04-02,Assembly,"Do pass as amended and be re-referred to the Committee on [Appropriations]",12,0,0,0,12
1214079,851537,2019-04-24,Assembly,"Do pass. To Consent Calendar",18,0,0,0,18
1214079,858258,2019-05-02,Assembly,"AB 1000 Cervantes Consent Calendar Second Day Regular Session",76,0,4,0,80
1214079,878576,2019-06-05,Senate,"Do pass as amended, but first amend, and re-refer to the Committee on [Appropriations] with the recommendation: To Consent Calendar",7,0,0,0,7
1214079,889211,2019-07-01,Senate,"Consent Calendar AB1000",39,0,1,0,40
1214079,892199,2019-07-08,Assembly,"AB 1000 Cervantes Concurrence in Senate Amendments",77,0,2,0,79
1214079,894708,2019-07-01,Senate,"CotatusCell"">",7,0,0,0,7
1214083,839786,2019-04-08,Assembly,"Do pass. To Consent Calendar",15,0,0,0,15
1214083,849703,2019-04-22,Assembly,"AB 1142 Friedman Consent Calendar Second Day Regular Session",78,0,2,0,80
1214083,880280,2019-06-11,Senate,"Do pass, but first be re-referred to the Committee on [Rules]",8,3,1,0,12
1214083,893669,2019-07-02,Senate,"Do pass, but first be re-referred to the Committee on [Judiciary]",9,2,2,0,13
1214083,893670,2019-07-09,Senate,"Do pass as amended, but first amend, and re-refer to the Committee on [Appropriations]",6,1,2,0,9
1214083,893671,2019-08-19,Senate,"Placed on suspense file",5,0,2,0,7
1214085,856803,2019-05-01,Senate,"Do pass, but first be re-referred to the Committee on [Appropriations]",9,0,0,0,9
1214085,863190,2019-05-13,Senate,"Placed on suspense file",6,0,0,0,6
1214085,866004,2019-05-16,Senate,"Do pass",6,0,0,0,6
1214085,871031,2019-05-23,Senate,"Special Consent SB538 Rubio Urgency Clause",38,0,0,0,38
1214085,890874,2019-07-10,Assembly,"Do pass as amended and be re-referred to the Committee on [Health]",20,0,1,0,21
1214085,890875,2019-08-20,Assembly,"Do pass and be re-referred to the Committee on [Appropriations]",15,0,0,0,15
1214085,890876,2019-08-30,Assembly,"Do pass",18,0,0,0,18
1214085,890877,2019-09-10,Assembly,"SB 538 Rubio Third Reading Urgency By Eduardo Garcia",77,0,2,0,79
1214085,893778,2019-09-12,Senate,"Unfinished Business SB538 Rubio et al. Urgency Clause Concurrence",40,0,0,0,40
1214086,849009,2019-04-22,Assembly,"Do pass and be re-referred to the Committee on [Human Services]",7,0,0,0,7
1214086,849989,2019-04-23,Assembly,"Do pass and be re-referred to the Committee on [Appropriations]",6,2,0,0,8
1214088,851127,2019-04-22,Senate,"Do pass, but first be re-referred to the Committee on [Appropriations] with the recommendation: To Consent Calendar",6,0,0,0,6
1214088,859810,2019-05-06,Senate,"Placed on suspense file",5,0,1,0,6
1214088,865819,2019-05-16,Senate,"Do pass as amended",6,0,0,0,6
1214088,871270,2019-05-23,Senate,"Senate 3rd Reading SB470 Skinner",38,0,0,0,38
1214088,884203,2019-06-18,Assembly,"Do pass as amended and be re-referred to the Committee on [Appropriations]",8,0,0,0,8
1214089,902848,2020-01-14,Senate,"Do pass, but first be re-referred to the Committee on [Banking and Financial Institutions]",8,0,1,0,9
1214089,903162,2020-01-15,Senate,"Do pass, but first be re-referred to the Committee on [Appropriations]",5,0,2,0,7
1214089,905389,2020-01-23,Senate,"Senate 3rd Reading SB522 Hertzberg",37,0,2,0,39
1214089,975647,2020-08-12,Assembly,"Do pass and be re-referred to the Committee on [Appropriations] with recommendation: To Consent Calendar",12,0,0,0,12
1214089,976085,2020-08-18,Assembly,"Do pass. To Consent Calendar",18,0,0,0,18
1214089,978117,2020-08-30,Senate,"Unfinished Business SB522 Hertzberg Concurrence",39,0,1,0,40
1214089,978118,2020-08-30,Assembly,"SB 522 Hertzberg Consent Calendar Second Day Regular Session",75,0,4,0,79
1214090,842958,2019-04-10,Senate,"Do pass as amended, but first amend, and re-refer to the Committee on [Appropriations]",8,0,1,0,9
1214090,854269,2019-04-29,Senate,"Placed on suspense file",6,0,0,0,6
1214090,866074,2019-05-16,Senate,"Do pass",6,0,0,0,6
1214090,869907,2019-05-22,Senate,"Senate 3rd Reading SB464 Mitchell et al",38,0,0,0,38
1214090,887390,2019-06-25,Assembly,"Do pass as amended and be re-referred to the Committee on [Appropriations]",15,0,0,0,15
1214090,891248,2019-08-30,Assembly,"Do pass as amended",18,0,0,0,18
1214090,891249,2019-09-09,Assembly,"SB 464 Mitchell Senate Third Reading By Eggman",79,0,0,0,79
1214090,891250,2019-09-10,Senate,"Unfinished Business SB464 Mitchell et al. Concurrence",40,0,0,0,40
1214091,851459,2019-04-23,Assembly,"Do pass and be re-referred to the Committee on [Appropriations]",11,0,1,0,12
1214091,865746,2019-05-16,Assembly,"Do pass",18,0,0,0,18
1214091,871239,2019-05-23,Assembly,"AB 1153 Wicks Assembly Third Reading",78,0,2,0,80
1214091,881090,2019-06-12,Senate,"Do pass as amended, but first amend, and re-refer to the Committee on [Appropriations] with the recommendation: To Consent Calendar",7,0,0,0,7
1214091,889234,2019-07-01,Senate,"Placed on suspense file",7,0,0,0,7
1214091,891657,2019-08-30,Senate,"Do pass as amended",7,0,0,0,7
1214091,891658,2019-09-10,Senate,"Assembly 3rd Reading AB1153 Wicks By Leyva",40,0,0,0,40
1214091,891659,2019-09-11,Assembly,"AB 1153 Wicks Concurrence in Senate Amendments",79,0,0,0,79
1214095,856051,2019-04-29,Assembly,"Do pass and be re-referred to the Committee on [Appropriations]",9,0,2,0,11
1214096,833075,2019-03-26,Assembly,"Do pass as amended, and be re-referred to the Committee on [Appropriations] with recommendation: To Consent Calendar",8,0,0,0,8
1214097,841749,2019-04-09,Assembly,"Do pass and be re-referred to the Committee on [Appropriations] with recommendation: To Consent Calendar",9,0,0,0,9
1214097,865769,2019-05-16,Assembly,"Do pass as amended",13,0,5,0,18
1214097,872185,2019-05-24,Assembly,"AB 1093 Blanca Rubio Assembly Third Reading",77,0,3,0,80
1214097,884901,2019-06-19,Senate,"Do pass, but first be re-referred to the Committee on [Appropriations]",6,1,0,0,7
1214097,889264,2019-07-01,Senate,"Placed on suspense file",7,0,0,0,7
1214097,891380,2019-08-30,Senate,"Do pass",7,0,0,0,7
1214097,891381,2019-09-05,Senate,"Assembly 3rd Reading AB1093 Blanca Rubio By Hertzberg",40,0,0,0,40
1214098,841551,2019-04-10,Senate,"Do pass, but first be re-referred to the Committee on [Natural Resources and Water]",7,0,0,0,7
1214098,850408,2019-04-23,Senate,"Do pass as amended, but first amend, and re-refer to the Committee on [Appropriations]",9,0,0,0,9
1214098,863257,2019-05-13,Senate,"Placed on suspense file",6,0,0,0,6
1214098,865643,2019-05-16,Senate,"Do pass",6,0,0,0,6
1214098,870932,2019-05-23,Senate,"Special Consent SB462",38,0,0,0,38
1214098,888227,2019-06-25,Assembly,"Do pass and be re-referred to the Committee on [Natural Resources]",12,0,0,0,12
1214098,892883,2019-07-08,Assembly,"Do pass and be re-referred to the Committee on [Appropriations] with recommendation: To Consent Calendar",11,0,0,0,11
1214098,893847,2019-05-16,Senate,Result,6,0,0,0,6
1214099,850380,2019-04-22,Senate,"Do pass, but first be re-referred to the Committee on [Judiciary]",9,0,2,0,11
1214099,856738,2019-04-30,Senate,"Do pass as amended",9,0,0,0,9
1214101,830605,2019-03-26,Assembly,"Do pass and be re-referred to the Committee on [Judiciary]",6,2,1,0,9
1214101,834135,2019-04-02,Assembly,"Do pass and be re-referred to the Committee on [Appropriations]",9,3,0,0,12
1214101,851700,2019-04-24,Assembly,"Do pass",13,5,0,0,18
1214101,858010,2019-05-02,Assembly,"AB 1123 Reyes Assembly Third Reading",58,19,3,0,80
1214101,880910,2019-06-11,Senate,"Do pass, but first be re-referred to the Committee on [Environmental Quality]",7,2,0,0,9
1214101,884977,2019-06-19,Senate,"Do pass, but first be re-referred to the Committee on [Appropriations]",5,2,0,0,7
1214101,894054,2019-08-19,Senate,"Assembly 3rd Reading AB1123 Reyes By Wieckowski",29,11,0,0,40
1214102,841795,2019-04-10,Senate,"Do pass as amended, but first amend, and re-refer to the Committee on [Banking and Financial Institutions]",12,0,1,0,13
1214102,851361,2019-04-24,Senate,"Do pass as amended",6,0,1,0,7
1214102,859592,2019-05-06,Senate,"Senate 3rd Reading SB540 Jones",31,4,3,0,38
1214102,893412,2019-07-08,Assembly,"Do pass and be re-referred to the Committee on [Insurance] with recommendation: To Consent Calendar",10,0,2,0,12
1214102,893413,2019-07-10,Assembly,"Do pass. To Consent Calendar",14,0,0,0,14
1214102,893414,2019-08-22,Assembly,"SB 540 Jones Senate Third Reading By Cooley",68,3,8,0,79
1214103,854826,2019-04-24,Assembly,"Do pass as amended and be re-referred to the Committee on [Appropriations]",8,2,4,0,14
1214103,866056,2019-05-16,Assembly,"Do pass",12,3,3,0,18
1214103,870126,2019-05-22,Assembly,"AB 1066 Gonzalez Assembly Third Reading",51,19,10,0,80
1214103,892558,2019-07-10,Senate,"Do pass, but first be re-referred to the Committee on [Appropriations]",4,1,0,0,5
1214103,892559,2019-08-12,Senate,"Placed on suspense file",7,0,0,0,7
1214103,892560,2019-08-30,Senate,"Do pass as amended",5,2,0,0,7
1214103,894155,2019-09-13,Senate,"Assembly 3rd Reading AB1066 Gonzalez et al. By Leyva",19,14,0,0,33
1214103,894156,2019-09-13,Senate,"Assembly 3rd Reading AB1066 Gonzalez et al. By Leyva Reconsider",31,0,0,0,31
1214103,894362,2019-09-14,Senate,"Assembly 3rd Reading AB1066 Gonzalez et al. By Leyva",19,14,7,0,40
1214103,894458,2019-09-14,Senate,"Assembly 3rd Reading AB1066 Gonzalez et al. By Leyva Reconsider",31,0,9,0,40
1214103,974895,2020-08-05,Senate,"Do pass as amended, but first amend, and re-refer to the Committee on [Appropriations]",4,1,0,0,5
1214103,976012,2020-08-17,Senate,"Placed on suspense file",7,0,0,0,7
1214103,976415,2020-08-20,Senate,"Do pass as amended",5,2,0,0,7
1214103,977479,2020-08-31,Assembly,"With recommendation: That Senate amendments be concurred in",8,0,6,0,14
1214103,977918,2020-08-31,Senate,"Assembly 3rd Reading AB1066 Gonzalez By Skinner",25,10,5,0,40
1214103,977919,2020-08-31,Assembly,"AB 1066 GONZALEZ Concurrence in Senate Amendments",54,17,8,0,79
1214106,835414,2019-04-03,Senate,"Do pass as amended, but first amend, and re-refer to the Committee on [Appropriations]",5,0,2,0,7
1214106,854258,2019-04-29,Senate,"Placed on suspense file",6,0,0,0,6
1214106,865834,2019-05-16,Senate,"Do pass as amended",5,1,0,0,6
1214106,868874,2019-05-21,Senate,"Senate 3rd Reading SB426 Bradford",34,0,4,0,38
1214106,888104,2019-06-25,Assembly,"Do pass and be re-referred to the Committee on [Appropriations]",11,0,1,0,12
1214107,834250,2019-04-02,Assembly,"Do pass",8,0,0,0,8
1214107,875337,2019-05-30,Assembly,"AB 1125 Cooley Assembly Third Reading By WOOD",70,1,9,0,80
1214107,891638,2019-07-02,Senate,"Do pass, but first be re-referred to the Committee on [Business, Professions and Economic Development]",5,0,2,0,7
1214107,891639,2019-07-08,Senate,"Do pass",8,1,0,0,9
1214107,891640,2019-09-10,Senate,"Assembly 3rd Reading AB1125 Cooley By Archuleta",31,6,3,0,40
1214107,891641,2019-09-11,Assembly,"AB 1125 Cooley Concurrence in Senate Amendments",75,1,3,0,79
1214108,835875,2019-04-02,Assembly,"Do pass and be re-referred to the Committee on [Appropriations]",15,0,0,0,15
1214108,865716,2019-05-16,Assembly,"Do pass",18,0,0,0,18
1214108,874662,2019-05-29,Assembly,"AB 1042 Wood Assembly Third Reading",78,0,2,0,80
1214108,893708,2019-07-10,Senate,"Do pass, but first be re-referred to the Committee on [Appropriations] with the recommendation: To Consent Calendar",8,0,1,0,9
1214108,893709,2019-08-12,Senate,"Placed on suspense file",7,0,0,0,7
1214109,904115,2020-01-21,Senate,"Do pass",5,2,0,0,7
1214109,906426,2020-01-27,Senate,"Senate 3rd Reading SB417 Portantino Urgency Clause",29,5,5,0,39
1214109,962430,2020-06-02,Assembly,"Do pass",17,0,1,0,18
1214109,966481,2020-06-15,Assembly,"SB 417 Portantino Third Reading Urgency By Gonzalez",75,0,4,0,79
1214109,970004,2020-06-29,Senate,"Unfinished Business SB417 Portantino Urgency Clause Concurrence",31,2,7,0,40
1214110,850182,2019-04-23,Senate,"Do pass",4,1,0,0,5
1214110,858024,2019-05-02,Senate,"Senate 3rd Reading SB431 McGuire",33,3,2,0,38
1214110,882923,2019-06-17,Assembly,"Be re-referred to the Committee on [Communications and Conveyance]",11,0,1,0,12
1214110,974754,2020-08-03,Assembly,"Do pass and be re-referred to the Committee on [Appropriations]",9,2,2,0,13
1214112,834738,2019-04-02,Assembly,"Do pass and be re-referred to the Committee on [Health]",7,0,0,0,7
1214112,850451,2019-04-23,Assembly,"Do pass and be re-referred to the Committee on [Appropriations] with recommendation: To Consent Calendar",15,0,0,0,15
1214112,865803,2019-05-16,Assembly,"Do pass as amended",13,0,5,0,18
1214112,873913,2019-05-28,Assembly,"AB 1128 Petrie-Norris Assembly Third Reading",74,0,6,0,80
1214112,890660,2019-07-03,Senate,"Do pass as amended, but first amend, and re-refer to the Committee on [Appropriations]",8,0,1,0,9
1214112,890661,2019-08-12,Senate,"Placed on suspense file",7,0,0,0,7
1214112,890662,2019-08-30,Senate,"Do pass",7,0,0,0,7
1214112,890663,2019-09-10,Senate,"Assembly 3rd Reading AB1128 Petrie-Norris et al. By Rubio",40,0,0,0,40
1214112,890664,2019-09-11,Assembly,"AB 1128 Petrie-Norris Concurrence in Senate Amendments",79,0,0,0,79
1214113,902849,2020-01-14,Assembly,"Do pass as amended and be re-referred to the Committee on [Appropriations]",16,1,2,0,19
1214115,842836,2019-04-10,Senate,"Do pass, but first be re-referred to the Committee on [Banking and Financial Institutions]",4,2,1,0,7
1214115,851394,2019-04-24,Senate,"Do pass as amended, but first amend, and re-refer to the Committee on [Appropriations]",4,0,3,0,7
1214115,863216,2019-05-13,Senate,"Placed on suspense file",6,0,0,0,6
1214116,833143,2019-03-27,Assembly,"Do pass as amended and be re-referred to the Committee on [Appropriations]",5,1,0,0,6
1214116,866019,2019-05-16,Assembly,"Do pass",13,5,0,0,18
1214116,874595,2019-05-29,Assembly,"AB 967 Smith Assembly Third Reading",56,18,6,0,80
1214116,884890,2019-06-19,Senate,"Do pass, but first be re-referred to the Committee on [Appropriations]",4,3,0,0,7
1214116,889244,2019-07-01,Senate,"Placed on suspense file",7,0,0,0,7
1214116,893017,2019-08-30,Senate,"Do pass",5,2,0,0,7
1214116,893018,2019-09-09,Senate,"Assembly 3rd Reading AB967 Smith By Durazo",27,12,1,0,40
1214116,893019,2019-09-10,Assembly,"AB 967 Smith Concurrence in Senate Amendments",61,16,2,0,79
1214119,859464,2019-05-01,Senate,"Do pass as amended, but first amend, and re-refer to the Committee on [Appropriations]",6,0,1,0,7
1214119,863269,2019-05-13,Senate,"Placed on suspense file",6,0,0,0,6
1214119,866372,2019-05-16,Senate,"Do pass as amended",6,0,0,0,6
1214119,871372,2019-05-23,Senate,"Senate 3rd Reading SB422 Hueso",35,0,3,0,38
1214119,892492,2019-07-08,Assembly,"Do pass and be re-referred to the Committee on [Appropriations]",9,1,1,0,11
1214120,836916,2019-04-03,Senate,"Do pass as amended, but first amend, and re-refer to the Committee on [Appropriations]",5,0,2,0,7
1214120,859525,2019-05-06,Senate,"Placed on suspense file",5,0,1,0,6
1214120,866079,2019-05-16,Senate,"Do pass as amended",6,0,0,0,6
1214120,873900,2019-05-28,Senate,"Senate 3rd Reading SB451 Atkins",36,0,2,0,38
1214120,892104,2019-07-08,Assembly,"Do pass and be re-referred to the Committee on [Appropriations]",10,0,1,0,11
1214120,892105,2019-08-30,Assembly,"Do pass as amended",18,0,0,0,18
1214120,892106,2019-09-10,Assembly,"SB 451 Atkins Senate Third Reading By Burke",77,0,2,0,79
1214120,892107,2019-09-11,Senate,"Unfinished Business SB451 Atkins Concurrence",40,0,0,0,40
1214121,829232,2019-03-26,Assembly,"Do pass and be re-referred to the Committee on [Appropriations]",6,0,2,0,8
1214123,853145,2019-04-23,Senate,"Do pass as amended, but first amend, and re-refer to the Committee on [Appropriations] with the recommendation: To Consent Calendar",12,0,0,0,12
1214123,863202,2019-05-13,Senate,"Placed on suspense file",6,0,0,0,6
1214125,845665,2019-04-10,Senate,"Do pass as amended, but first amend, and re-refer to the Committee on [Judiciary]",7,0,0,0,7
1214125,856636,2019-04-30,Senate,"Do pass as amended",8,0,1,0,9
1214125,863313,2019-05-13,Senate,"Senate 3rd Reading SB472 Caballero",35,0,3,0,38
1214125,891839,2019-07-08,Assembly,"Do pass and be re-referred to the Committee on [Judiciary]",10,0,2,0,12
1214125,891840,2019-07-09,Assembly,"Do pass as amended",12,0,0,0,12
1214125,891841,2019-08-30,Assembly,"Do pass as amended",18,0,0,0,18
1214126,853483,2019-04-24,Assembly,"Do pass as amended and be re-referred to the Committee on [Appropriations]",8,0,0,0,8
1214126,866312,2019-05-16,Assembly,"Do pass as amended",18,0,0,0,18
1214126,875666,2019-05-30,Assembly,"AB 1010 Eduardo Garcia Assembly Third Reading",75,0,5,0,80
1214126,892100,2019-07-02,Senate,"Do pass, but first be re-referred to the Committee on [Appropriations] with the recommendation: To Consent Calendar",11,0,0,0,11
1214126,892101,2019-08-12,Senate,"Placed on suspense file",7,0,0,0,7
1214126,892102,2019-08-30,Senate,"Do pass",7,0,0,0,7
1214126,892103,2019-09-11,Senate,"Assembly 3rd Reading AB1010 Eduardo Garcia By McGuire",40,0,0,0,40
1214126,893653,2019-09-12,Assembly,"AB 1010 Eduardo Garcia Concurrence in Senate Amendments",79,0,0,0,79
1214126,894108,2019-08-12,Senate,Result,11,0,0,0,11
1214127,853018,2019-04-24,Senate,"Do pass, but first be re-referred to the Committee on [Appropriations]",9,0,0,0,9
1214127,863261,2019-05-13,Senate,"Placed on suspense file",6,0,0,0,6
1214129,860339,2019-05-01,Senate,"Do pass as amended, but first amend, and re-refer to the Committee on [Appropriations]",6,0,1,0,7
1214129,863132,2019-05-13,Senate,"Placed on suspense file",6,0,0,0,6
1214129,866231,2019-05-16,Senate,"Do pass as amended",6,0,0,0,6
1214129,873938,2019-05-28,Senate,"Senate 3rd Reading SB521 Portantino et al",37,0,1,0,38
1214129,893200,2019-07-08,Assembly,"Do pass and be re-referred to the Committee on [Appropriations]",9,0,2,0,11
1214129,894121,2019-05-13,Senate,Result,6,0,0,0,6
1214132,834550,2019-04-03,Senate,"Do pass, but first be re-referred to the Committee on [Appropriations]",7,0,0,0,7
1214132,848911,2019-04-22,Senate,"Placed on suspense file",6,0,0,0,6
1214132,865997,2019-05-16,Senate,"Do pass as amended",4,2,0,0,6
1214132,871489,2019-05-23,Senate,"Senate 3rd Reading SB484 Portantino",33,0,5,0,38
1214132,887911,2019-06-25,Assembly,"Do pass and be re-referred to the Committee on [Appropriations]",12,0,0,0,12
1214132,890953,2019-08-30,Assembly,"Do pass as amended",17,1,0,0,18
1214132,890954,2019-09-09,Assembly,"SB 484 Portantino Senate Third Reading By Luz Rivas",76,0,3,0,79
1214132,890955,2019-09-11,Senate,"Unfinished Business SB484 Portantino Concurrence",39,0,1,0,40
1214133,830347,2019-03-26,Assembly,"Do pass",12,2,1,0,15
1214133,852833,2019-04-25,Assembly,"AB 1063 Petrie-Norris Assembly Third Reading",62,13,5,0,80
1214133,878591,2019-06-05,Senate,"Do pass as amended",7,1,1,0,9
1214136,853405,2019-04-24,Assembly,"Do pass and be re-referred to the Committee on [Appropriations] with recommendation: To Consent Calendar",8,0,0,0,8
1214136,864911,2019-05-15,Assembly,"Do pass. To Consent Calendar",16,0,2,0,18
1214136,870056,2019-05-22,Assembly,"AB 1089 Mark Stone Consent Calendar Second Day Regular Session",77,0,3,0,80
1214136,880861,2019-06-11,Senate,"Do pass, but first be re-referred to the Committee on [Appropriations] with the recommendation: To Consent Calendar",11,0,1,0,12
1214136,893896,2019-07-01,Senate,"Consent Calendar AB1089",39,0,1,0,40
1214138,835892,2019-04-03,Senate,"Do pass, but first be re-referred to the Committee on [Judiciary]",6,0,1,0,7
1214138,851292,2019-04-23,Senate,"Do pass as amended, but first amend, and re-refer to the Committee on [Appropriations]",7,0,2,0,9
1214138,863273,2019-05-13,Senate,"Placed on suspense file",6,0,0,0,6
1214138,866237,2019-05-16,Senate,"Do pass as amended",4,2,0,0,6
1214138,873947,2019-05-28,Senate,"Senate 3rd Reading SB493 Jackson et al",30,8,0,0,38
1214138,888131,2019-06-25,Assembly,"Do pass and be re-referred to the Committee on [Judiciary]",9,3,0,0,12
1214138,890356,2019-07-09,Assembly,"Do pass as amended and be re-referred to the Committee on [Appropriations]",9,2,1,0,12
1214138,976456,2020-08-20,Assembly,"Do pass as amended",14,4,0,0,18
1214138,977850,2020-08-30,Assembly,"SB 493 Jackson Senate Third Reading By Gonzalez",60,12,7,0,79
1214138,977851,2020-08-31,Senate,"Unfinished Business SB493 Jackson et al. Concurrence",31,8,1,0,40
1214139,834158,2019-04-02,Senate,"Do pass, but first be re-referred to the Committee on [Transportation]",4,0,1,0,5
1214139,850051,2019-04-23,Senate,"Do pass, but first be re-referred to the Committee on [Appropriations]",4,5,3,0,12
1214139,850052,2019-04-23,Senate,"[First] hearing set for [04-23-2019]: Failed passage in Committee. Reconsideration granted",12,0,0,0,12
1214140,902231,2020-01-13,Assembly,"Do pass as amended and be re-referred to the Committee on [Appropriations]",8,2,1,0,11
1214141,838608,2019-04-08,Assembly,"Be re-referred to the Committee on [Health]",11,0,1,0,12
1214143,842905,2019-04-10,Senate,"Do pass as amended, but first amend, and re-refer to the Committee on [Appropriations]",9,0,0,0,9
1214143,854852,2019-04-29,Senate,"Placed on suspense file",6,0,0,0,6
1214143,866154,2019-05-16,Senate,"Do pass",6,0,0,0,6
1214143,870994,2019-05-23,Senate,"Special Consent SB445",38,0,0,0,38
1214143,883771,2019-06-18,Assembly,"Do pass and be re-referred to the Committee on [Appropriations]",14,0,1,0,15
1214143,892852,2019-08-30,Assembly,"Do pass",18,0,0,0,18
1214143,892853,2019-09-10,Assembly,"SB 445 Portantino Senate Third Reading By Gonzalez",78,0,1,0,79
1214143,892854,2019-09-11,Senate,"Unfinished Business SB445 Portantino Concurrence",40,0,0,0,40
1214144,835533,2019-04-03,Assembly,"Do pass and be re-referred to the Committee on [Appropriations] with recommendation: To Consent Calendar",14,0,0,0,14
1214144,841769,2019-04-10,Assembly,"Do pass. To Consent Calendar",17,0,1,0,18
1214144,853091,2019-04-25,Assembly,"AB 1099 Calderon Consent Calendar Second Day Regular Session",76,0,4,0,80
1214144,891452,2019-07-10,Senate,"Do pass, but first be re-referred to the Committee on [Judiciary]",11,0,2,0,13
1214144,891453,2019-08-19,Senate,"Assembly 3rd Reading AB1099 Calderon By Rubio",40,0,0,0,40
1214144,891454,2019-08-22,Assembly,"AB 1099 Calderon Concurrence in Senate Amendments",75,0,4,0,79
1214145,835663,2019-04-02,Assembly,"Do pass and be re-referred to the Committee on [Appropriations]",12,0,0,0,12
1214145,866430,2019-05-16,Assembly,"Do pass",18,0,0,0,18
1214145,874651,2019-05-29,Assembly,"AB 1051 Smith Assembly Third Reading",78,0,2,0,80
1214145,888070,2019-06-26,Senate,"Do pass, but first be re-referred to the Committee on [Appropriations]",7,0,0,0,7
1214145,891837,2019-07-08,Senate,"Do pass",7,0,0,0,7
1214145,891838,2019-08-22,Senate,"Special Consent AB1051",39,0,1,0,40
1214145,896255,2019-05-29,Assembly,Result,79,0,0,0,79
1214146,853195,2019-04-24,Senate,"Do pass, but first be re-referred to the Committee on [Appropriations]",9,0,0,0,9
1214146,863220,2019-05-13,Senate,"Placed on suspense file",6,0,0,0,6
1214146,866290,2019-05-16,Senate,"Do pass",6,0,0,0,6
1214146,870233,2019-05-22,Senate,"Senate 3rd Reading SB503 Pan",38,0,0,0,38
1214146,887466,2019-06-25,Assembly,"Do pass and be re-referred to the Committee on [Appropriations]",14,0,1,0,15
1214146,890470,2019-08-30,Assembly,"Do pass as amended",18,0,0,0,18
1214146,890471,2019-09-09,Assembly,"SB 503 Pan Senate Third Reading By Wood",79,0,0,0,79
1214146,890472,2019-09-10,Senate,"Unfinished Business SB503 Pan Concurrence",40,0,0,0,40
1214150,834258,2019-04-02,Senate,"Do pass, but first be re-referred to the Committee on [Judiciary]",12,0,1,0,13
1214150,851696,2019-04-23,Senate,"Do pass, but first be re-referred to the Committee on [Appropriations] with the recommendation: To Consent Calendar",9,0,0,0,9
1214150,859547,2019-05-06,Senate,"Do pass",5,0,1,0,6
1214150,871420,2019-05-23,Senate,"Senate 3rd Reading SB506 Hueso",38,0,0,0,38
1214150,881023,2019-06-12,Assembly,"Do pass and be re-referred to the Committee on [Judiciary] with recommendation: To Consent Calendar",14,0,1,0,15
1214150,887456,2019-06-25,Assembly,"Do pass and be re-referred to the Committee on [Appropriations] with recommendation: To Consent Calendar",12,0,0,0,12
1214150,892132,2019-07-03,Assembly,"Do pass. To Consent Calendar",17,0,1,0,18
1214150,892133,2019-07-11,Assembly,"SB 506 Hueso Consent Calendar Second Day Regular Session",76,0,3,0,79
1214151,840033,2019-04-09,Senate,"Do pass, but first be re-referred to the Committee on [Appropriations] with the recommendation: To Consent Calendar",7,0,0,0,7
1214151,855254,2019-04-29,Senate,"Placed on suspense file",6,0,0,0,6
1214151,866440,2019-05-16,Senate,"Do pass",6,0,0,0,6
1214151,871002,2019-05-23,Senate,"Special Consent SB471",38,0,0,0,38
1214151,887471,2019-06-25,Assembly,"Do pass as amended, and be re-referred to the Committee on [Appropriations] with recommendation: To Consent Calendar",8,0,0,0,8
1214151,891670,2019-08-30,Assembly,"Do pass as amended",18,0,0,0,18
1214151,891671,2019-09-10,Assembly,"SB 471 Stern Senate Third Reading By Irwin",78,0,1,0,79
1214151,891672,2019-09-11,Senate,"Unfinished Business SB471 Stern Concurrence",40,0,0,0,40
1214152,840028,2019-04-03,Senate,"Do pass as amended, but first amend, and re-refer to the Committee on [Appropriations]",7,0,0,0,7
1214152,854845,2019-04-29,Senate,"Placed on suspense file",6,0,0,0,6
1214152,865623,2019-05-16,Senate,"Do pass as amended",6,0,0,0,6
1214152,871540,2019-05-23,Senate,"Senate 3rd Reading SB499 McGuire et al",38,0,0,0,38
1214156,841914,2019-04-09,Assembly,"Do pass and be re-referred to the Committee on [Appropriations] with recommendation: To Consent Calendar",8,0,0,0,8
1214156,865981,2019-05-16,Assembly,"Do pass as amended",18,0,0,0,18
1214156,874945,2019-05-29,Assembly,"AB 995 Ting Assembly Third Reading",77,0,3,0,80
1214156,894769,2019-05-29,Assembly,Date,18,0,0,0,18
1214156,975526,2020-08-11,Senate,"Do pass, but first be re-referred to the Committee on [Appropriations]",4,0,3,0,7
1214156,976035,2020-08-17,Senate,"Placed on suspense file",7,0,0,0,7
1214156,976318,2020-08-20,Senate,"Do pass",5,1,1,0,7
1214156,977760,2020-08-31,Senate,"Assembly 3rd Reading AB995 Cristina Garcia et a By Leyva",28,9,3,0,40
1214156,977761,2020-08-31,Assembly,"AB 995 GARCIA, C. Concurrence in Senate Amendments",61,9,9,0,79
1214163,841606,2019-04-10,Senate,"Do pass, but first be re-referred to the Committee on [Appropriations]",7,0,0,0,7
1214163,859575,2019-05-06,Senate,"Senate 3rd Reading SB478 Rubio",38,0,0,0,38
1214163,886071,2019-06-19,Assembly,"Do pass and be re-referred to the Committee on [Appropriations] with recommendation: To Consent Calendar",7,0,0,0,7
1214163,891101,2019-07-03,Assembly,"Do pass. To Consent Calendar",17,0,1,0,18
1214163,891102,2019-07-11,Assembly,"SB 478 Rubio Consent Calendar Second Day Regular Session",76,0,3,0,79
1214165,829880,2019-03-26,Assembly,"Do pass and be re-referred to the Committee on [Natural Resources]",14,0,0,0,14
1214165,850157,2019-04-22,Assembly,"Do pass as amended and be re-referred to the Committee on [Appropriations]",11,0,0,0,11
1214166,901472,2020-01-08,Senate,"Do pass, but first be re-referred to the Committee on [Judiciary]",4,0,3,0,7
1214166,902852,2020-01-14,Senate,"Do pass as amended, but first amend, and re-refer to the Committee on [Appropriations]",8,0,1,0,9
1214166,904112,2020-01-21,Senate,"Placed on suspense file",7,0,0,0,7
1214166,905405,2020-01-23,Senate,"Do pass",7,0,0,0,7
1214166,910506,2020-01-29,Senate,"Senate 3rd Reading SB444 Umberg",38,0,1,0,39
1214168,836947,2019-04-02,Assembly,"Do pass as amended, and be re-referred to the Committee on [Appropriations] with recommendation: To Consent Calendar",8,0,0,0,8
1214168,851271,2019-04-24,Assembly,"Do pass. To Consent Calendar",18,0,0,0,18
1214168,858133,2019-05-02,Assembly,"AB 1129 Chau Consent Calendar Second Day Regular Session",76,0,4,0,80
1214168,877720,2019-06-04,Senate,"Do pass and be ordered to the Consent Calendar",7,0,0,0,7
1214168,891957,2019-09-09,Senate,"Assembly 3rd Reading AB1129 Chau et al. By Nielsen",40,0,0,0,40
1214168,891958,2019-09-10,Assembly,"AB 1129 Chau Concurrence in Senate Amendments",79,0,0,0,79
1214169,902230,2020-01-13,Senate,"Do pass as amended, but first amend, and re-refer to the Committee on [Appropriations]",9,0,0,0,9
1214169,904111,2020-01-21,Senate,"Do pass",7,0,0,0,7
1214169,905374,2020-01-23,Senate,"Senate 3rd Reading SB480 Archuleta",37,0,2,0,39
1214169,974929,2020-08-05,Assembly,"Do pass as amended and be re-referred to the Committee on [Appropriations]",7,1,0,0,8
1214169,976088,2020-08-18,Assembly,"Do pass",12,6,0,0,18
1214169,977854,2020-08-30,Assembly,"SB 480 Archuleta Senate Third Reading By Jones-Sawyer",57,13,9,0,79
1214169,977855,2020-08-31,Senate,"Unfinished Business SB480 Archuleta Concurrence",34,1,5,0,40
1214170,835520,2019-04-02,Assembly,"Do pass and be re-referred to the Committee on [Appropriations]",7,1,0,0,8
1214171,852507,2019-04-23,Assembly,"Do pass and be re-referred to the Committee on [Appropriations]",15,0,0,0,15
1214171,856835,2019-05-01,Assembly,"Do pass. To Consent Calendar",18,0,0,0,18
1214171,862140,2019-05-09,Assembly,"AB 1152 Holden Consent Calendar Second Day Regular Session",76,0,4,0,80
1214171,884697,2019-06-19,Senate,"Do pass, but first be re-referred to the Committee on [Appropriations] with the recommendation: To Consent Calendar",9,0,0,0,9
1214171,891754,2019-07-11,Senate,"Consent Calendar AB1152",39,0,1,0,40
1214171,891755,2019-08-15,Assembly,"AB 1152 Holden Concurrence in Senate Amendments",76,0,3,0,79
1214174,850479,2019-04-23,Senate,"Do pass, but first be re-referred to the Committee on [Appropriations]",15,0,1,0,16
1214174,860579,2019-05-06,Senate,"Placed on suspense file",5,0,1,0,6
1214174,866470,2019-05-16,Senate,"Do pass",6,0,0,0,6
1214174,871697,2019-05-23,Senate,"Special Consent SB465",38,0,0,0,38
1214174,893546,2019-07-10,Assembly,"Do pass and be re-referred to the Committee on [Appropriations]",21,0,0,0,21
1214176,841633,2019-04-09,Assembly,"Do pass and be re-referred to the Committee on [Appropriations] with recommendation: To Consent Calendar",8,0,0,0,8
1214178,855837,2019-04-24,Assembly,"Do pass as amended, and be re-referred to the Committee on [Appropriations] with recommendation: To Consent Calendar",15,0,0,0,15
1214178,861505,2019-05-08,Assembly,"Do pass. To Consent Calendar",18,0,0,0,18
1214178,873918,2019-05-28,Assembly,"AB 1072 Patterson Assembly Third Reading",74,0,6,0,80
1214178,890566,2019-07-02,Senate,"Do pass, but first be re-referred to the Committee on [Appropriations]",12,0,1,0,13
1214178,890567,2019-09-03,Senate,"Assembly 3rd Reading AB1072 Patterson By Hill",39,0,1,0,40
1214178,894176,2019-05-28,Assembly,Result,74,0,0,0,74
1214180,850617,2019-04-22,Assembly,"Do pass and be re-referred to the Committee on [Appropriations]",12,0,0,0,12
1214181,851956,2019-04-23,Senate,"Do pass, but first be re-referred to the Committee on [Appropriations]",6,2,1,0,9
1214181,859929,2019-05-06,Senate,"Placed on suspense file",5,0,1,0,6
1214181,866455,2019-05-16,Senate,"Do pass",4,2,0,0,6
1214181,871663,2019-05-23,Senate,"Senate 3rd Reading SB518 Wieckowski",29,9,0,0,38
1214181,883744,2019-06-18,Assembly,"Do pass as amended",10,1,1,0,12
1214181,890596,2019-08-30,Assembly,"Do pass",14,4,0,0,18
1214181,890597,2019-09-09,Assembly,"SB 518 Wieckowski Senate Third Reading By Chiu",62,13,4,0,79
1214181,890598,2019-09-11,Senate,"Unfinished Business SB518 Wieckowski Concurrence",28,11,1,0,40
1214185,837138,2019-04-03,Assembly,"Do pass and be re-referred to the Committee on [Appropriations]",7,0,0,0,7
1214185,866369,2019-05-16,Assembly,"Do pass",18,0,0,0,18
1214185,871672,2019-05-23,Assembly,"AB 1158 Carrillo Assembly Third Reading",77,0,3,0,80
1214185,888301,2019-06-26,Senate,"Do pass, but first be re-referred to the Committee on [Appropriations]",4,0,1,0,5
1214185,891794,2019-07-08,Senate,"Placed on suspense file",7,0,0,0,7
1214188,835037,2019-03-27,Assembly,"Do pass as amended and be re-referred to the Committee on [Appropriations]",6,0,0,0,6
1214188,866192,2019-05-16,Assembly,"Do pass as amended",18,0,0,0,18
1214188,874004,2019-05-28,Assembly,"AB 1097 Holden Assembly Third Reading",75,0,5,0,80
1214188,888129,2019-06-26,Senate,"Do pass, but first be re-referred to the Committee on [Appropriations] with the recommendation: To Consent Calendar",7,0,0,0,7
1214188,893497,2019-07-08,Senate,"Placed on suspense file",7,0,0,0,7
1214188,893498,2019-08-30,Senate,"Do pass",7,0,0,0,7
1214188,893499,2019-09-09,Senate,"Special Consent AB1097",40,0,0,0,40
1214188,893500,2019-09-10,Assembly,"AB 1097 Holden Concurrence in Senate Amendments",79,0,0,0,79
1214189,850240,2019-04-23,Senate,"Do pass, but first be re-referred to the Committee on [Appropriations]",9,0,0,0,9
1214189,859844,2019-05-06,Senate,"Placed on suspense file",5,0,1,0,6
1214189,866462,2019-05-16,Senate,"Do pass as amended",6,0,0,0,6
1214189,873996,2019-05-28,Senate,"Senate 3rd Reading SB474 Stern",34,2,2,0,38
1214189,970010,2020-06-29,Assembly,"Be re-referred to the Committee on [Local Government]",7,0,5,0,12
1214190,843097,2019-04-08,Senate,"Do pass as amended",6,0,0,0,6
1214190,858374,2019-05-02,Senate,"Senate 3rd Reading SB418 Portantino Urgency Clause",38,0,0,0,38
1214190,884871,2019-06-19,Assembly,"Do pass",17,0,1,0,18
1214190,894080,2019-07-01,Assembly,"SB 418 Portantino Third Reading Urgency By Gonzalez",77,0,2,0,79
1214190,894081,2019-07-11,Senate,"Special Consent SB418 Portantino Urgency Clause",39,0,1,0,40
1214191,835628,2019-04-02,Assembly,"Do pass and be re-referred to the Committee on [Appropriations]",11,0,1,0,12
1214191,851610,2019-04-24,Assembly,"Do pass",18,0,0,0,18
1214191,859562,2019-05-06,Assembly,"AB 1090 Medina Assembly Third Reading",76,0,4,0,80
1214191,878276,2019-06-05,Senate,"Do pass, but first be re-referred to the Committee on [Appropriations]",7,0,0,0,7
1214191,887070,2019-06-24,Senate,"Placed on suspense file",7,0,0,0,7
1214191,892829,2019-08-30,Senate,"Do pass",7,0,0,0,7
1214191,892830,2019-09-09,Senate,"Special Consent AB1090",40,0,0,0,40
1214195,852810,2019-04-22,Senate,"Do pass as amended, but first amend, and re-refer to the Committee on [Appropriations]",9,0,0,0,9
1214195,863225,2019-05-13,Senate,"Placed on suspense file",6,0,0,0,6
1214196,845653,2019-04-10,Senate,"Do pass, but first be re-referred to the Committee on [Judiciary]",7,0,0,0,7
1214196,845654,2019-04-10,Senate,"Do pass, but first be re-referred to the Committee on [Judiciary]",7,0,0,0,7
1214196,853208,2019-04-23,Senate,"Do pass as amended, but first amend, and re-refer to the Committee on [Appropriations] with the recommendation: To Consent Calendar",9,0,0,0,9
1214196,868909,2019-05-21,Senate,"Senate 3rd Reading SB496 Moorlach",38,0,0,0,38
1214196,880601,2019-06-11,Assembly,"Do pass and be re-referred to the Committee on [Judiciary]",7,0,0,0,7
1214196,884005,2019-06-18,Assembly,"Do pass as amended, and be re-referred to the Committee on [Appropriations] with recommendation: To Consent Calendar",12,0,0,0,12
1214196,890811,2019-07-10,Assembly,"Do pass. To Consent Calendar",16,0,2,0,18
1214196,890812,2019-08-15,Assembly,"SB 496 Moorlach Consent Calendar Second Day Regular Session",76,0,3,0,79
1214196,890813,2019-08-22,Senate,"Special Consent SB496",39,0,1,0,40
1214197,841893,2019-04-10,Senate,"Do pass, but first be re-referred to the Committee on [Judiciary]",7,0,0,0,7
1214197,854830,2019-04-29,Senate,"Placed on suspense file",6,0,0,0,6
1214197,865757,2019-05-16,Senate,"Do pass as amended",6,0,0,0,6
1214197,869084,2019-05-21,Senate,"Senate 3rd Reading SB428 Pan et al",38,0,0,0,38
1214197,886024,2019-06-19,Assembly,"Do pass as amended and be re-referred to the Committee on [Health]",7,0,0,0,7
1214197,892873,2019-07-02,Assembly,"Do pass as amended, and be re-referred to the Committee on [Appropriations] with recommendation: To Consent Calendar",15,0,0,0,15
1214197,892874,2019-08-30,Assembly,"Do pass",18,0,0,0,18
1214197,892875,2019-09-05,Assembly,"SB 428 Pan Senate Third Reading By Eggman",79,0,0,0,79
1214197,892876,2019-09-06,Senate,"Unfinished Business SB428 Pan et al. Concurrence",39,0,1,0,40
1214198,851383,2019-04-24,Senate,"Do pass, but first be re-referred to the Committee on [Appropriations]",12,0,1,0,13
1214198,863237,2019-05-13,Senate,"Placed on suspense file",6,0,0,0,6
1214198,865961,2019-05-16,Senate,"Do pass",5,0,1,0,6
1214198,868757,2019-05-21,Senate,"Senate 3rd Reading SB520 Hertzberg",36,0,2,0,38
1214198,893704,2019-07-10,Assembly,"Do pass as amended and be re-referred to the Committee on [Appropriations]",15,0,0,0,15
1214198,893705,2019-08-30,Assembly,"Do pass as amended",18,0,0,0,18
1214198,893706,2019-09-10,Assembly,"SB 520 Hertzberg Senate Third Reading By Quirk",69,3,7,0,79
1214198,893707,2019-09-11,Senate,"Unfinished Business SB520 Hertzberg Concurrence",33,2,5,0,40
1214200,834719,2019-04-03,Assembly,"Do pass as amended and be re-referred to the Committee on [Privacy and Consumer Protection]",14,0,0,0,14
1214200,851409,2019-04-23,Assembly,"Do pass as amended and be re-referred to the Committee on [Appropriations]",9,0,2,0,11
1214200,864889,2019-05-15,Assembly,"Do pass. To Consent Calendar",16,0,2,0,18
1214200,869707,2019-05-22,Assembly,"AB 981 Daly Consent Calendar Second Day Regular Session",77,0,3,0,80
1214201,843458,2019-04-10,Assembly,"Do pass and be re-referred to the Committee on [Natural Resources]",12,0,3,0,15
1214201,849831,2019-04-22,Assembly,"Do pass",11,0,0,0,11
1214201,852696,2019-04-25,Assembly,"AB 1144 Friedman Assembly Third Reading",74,0,6,0,80
1214201,884153,2019-06-18,Senate,"Do pass as amended, but first amend, and re-refer to the Committee on [Appropriations]",13,0,0,0,13
1214201,893471,2019-08-19,Senate,"Placed on suspense file",5,0,2,0,7
1214201,893472,2019-08-30,Senate,"Do pass",5,2,0,0,7
1214201,893473,2019-08-30,Senate,"[08-30-2019] set for [Second] hearing: Reconsideration of favorable vote granted",7,0,0,0,7
1214201,893474,2019-08-30,Senate,"Do pass",7,0,0,0,7
1214201,893475,2019-09-10,Senate,"Assembly 3rd Reading AB1144 Friedman et al. By Dahle",40,0,0,0,40
1214201,893476,2019-09-11,Assembly,"AB 1144 Friedman Concurrence in Senate Amendments",79,0,0,0,79
1214202,829597,2019-03-26,Assembly,"Do pass as amended, and be re-referred to the Committee on [Appropriations] with recommendation: To Consent Calendar",8,0,0,0,8
1214202,866232,2019-05-16,Assembly,"Do pass",18,0,0,0,18
1214202,870155,2019-05-22,Assembly,"AB 1061 Gipson Assembly Third Reading",78,0,2,0,80
1214202,880905,2019-06-10,Senate,"Do pass, but first be re-referred to the Committee on [Public Safety]",5,0,1,0,6
1214202,893205,2019-07-02,Senate,"Do pass, but first be re-referred to the Committee on [Appropriations] with the recommendation: To Consent Calendar",7,0,0,0,7
1214202,893206,2019-08-15,Senate,"Consent Calendar AB1061",37,0,3,0,40
1214202,893207,2019-09-09,Senate,"Assembly 3rd Reading AB1061 Gipson By Wiener",40,0,0,0,40
1214202,893208,2019-09-10,Assembly,"AB 1061 Gipson Concurrence in Senate Amendments",79,0,0,0,79
1214203,854290,2019-04-23,Assembly,"Do pass as amended and be re-referred to the Committee on [Appropriations]",10,0,1,0,11
1214203,861454,2019-05-08,Assembly,"Do pass",18,0,0,0,18
1214203,871451,2019-05-23,Assembly,"AB 1146 Berman Assembly Third Reading",77,0,3,0,80
1214203,892792,2019-07-09,Senate,"Do pass, but first be re-referred to the Committee on [Appropriations]",8,0,1,0,9
1214203,892793,2019-09-11,Senate,"Assembly 3rd Reading AB1146 Berman By Wieckowski",40,0,0,0,40
1214203,893700,2019-09-12,Assembly,"AB 1146 Berman Concurrence in Senate Amendments",79,0,0,0,79
1214203,896249,2019-09-11,Senate,"Assembly 3rd Reading AB1146lass=""statusCell"">",8,0,0,0,8
1214208,836680,2019-04-03,Assembly,"Do pass and be re-referred to the Committee on [Appropriations]",20,0,1,0,21
1214208,866390,2019-05-16,Assembly,"Do pass as amended",18,0,0,0,18
1214208,873831,2019-05-28,Assembly,"AB 1133 Low Assembly Third Reading",72,2,6,0,80
1214208,887670,2019-06-25,Senate,"Do pass, but first be re-referred to the Committee on [Appropriations]",16,0,0,0,16
1214208,891934,2019-07-08,Senate,"Placed on suspense file",7,0,0,0,7
1214208,891935,2019-08-30,Senate,"Do pass",7,0,0,0,7
1214208,891936,2019-09-10,Senate,"Assembly 3rd Reading AB1133 Low By Portantino",39,0,1,0,40
1214208,891937,2019-09-11,Assembly,"AB 1133 Low Concurrence in Senate Amendments",77,1,1,0,79
1214209,841609,2019-04-09,Assembly,"Do pass and be re-referred to the Committee on [Appropriations]",15,0,0,0,15
1214209,851682,2019-04-24,Assembly,"Do pass",17,0,1,0,18
1214209,854821,2019-04-29,Assembly,"AB 1030 Calderon Assembly Third Reading",73,0,7,0,80
1214209,887092,2019-06-24,Senate,"Do pass as amended, but first amend, and re-refer to the Committee on [Appropriations]",5,0,4,0,9
1214213,829378,2019-03-25,Assembly,"Do pass and be re-referred to the Committee on [Appropriations]",8,3,0,0,11
1214213,866306,2019-05-16,Assembly,"Do pass",12,4,2,0,18
1214213,875554,2019-05-30,Assembly,"AB 1080 Gonzalez Assembly Third Reading",44,19,17,0,80
1214213,891704,2019-07-03,Senate,"Do pass as amended, but first amend, and re-refer to the Committee on [Appropriations]",5,0,2,0,7
1214213,891705,2019-08-26,Senate,"Placed on suspense file",6,0,1,0,7
1214213,891706,2019-08-30,Senate,"Do pass",5,1,1,0,7
1214213,891707,2019-09-10,Senate,"That the measure be returned to Senate Floor for consideration. Ordered to third reading",5,0,2,0,7
1214213,895310,2019-05-16,Assembly,Result,12,4,0,0,16
1214213,978175,2020-08-30,Senate,"Assembly 3rd Reading AB1080 Gonzalez et al. By Allen",23,12,5,0,40
1214214,856789,2019-05-01,Assembly,"Do pass. To Consent Calendar",10,0,3,0,13
1214214,862219,2019-05-09,Assembly,"AB 1079 Santiago Consent Calendar Second Day Regular Session",76,0,4,0,80
1214214,877747,2019-06-04,Senate,"Do pass as amended",11,0,2,0,13
1214214,888503,2019-06-27,Senate,"Assembly 3rd Reading AB1079 Santiago By Dodd",37,0,3,0,40
1214214,892657,2019-07-08,Assembly,"AB 1079 Santiago Concurrence in Senate Amendments",77,0,2,0,79
1214214,892658,2019-09-09,Assembly,"AB 1079 Santiago Concurrence in Senate Amendments",79,0,0,0,79
1214214,896263,2019-06-27,Senate,"Bill Votes",11,0,0,0,11
1214215,858874,2019-05-01,Assembly,"Do pass. To Consent Calendar",8,0,0,0,8
1214215,862373,2019-05-09,Assembly,"AB 1095 Eduardo Garcia Consent Calendar Second Day Regular Session",76,0,4,0,80
1214215,884590,2019-06-19,Senate,"Do pass",5,0,2,0,7
1214215,893993,2019-07-08,Senate,"Assembly 3rd Reading AB1095 Eduardo Garcia By Hueso",35,1,4,0,40
1214216,841292,2019-04-09,Assembly,"Do pass and be re-referred to the Committee on [Appropriations]",7,0,1,0,8
1214217,835690,2019-04-03,Assembly,"Do pass",14,0,0,0,14
1214217,838640,2019-04-08,Assembly,"AB 1065 Berman Assembly Third Reading",72,0,8,0,80
1214217,887976,2019-06-26,Senate,"Do pass as amended, but first amend, and re-refer to the Committee on [Judiciary]",13,0,0,0,13
1214217,892996,2019-07-09,Senate,"Do pass as amended, but first amend, and re-refer to the Committee on [Appropriations] with the recommendation: To Consent Calendar",8,0,1,0,9
1214217,892997,2019-08-19,Senate,"Assembly 3rd Reading AB1065 Berman By Jones",40,0,0,0,40
1214217,892998,2019-08-22,Assembly,"AB 1065 Berman Concurrence in Senate Amendments",76,0,3,0,79
1214219,851602,2019-04-23,Assembly,"Do pass and be re-referred to the Committee on [Appropriations]",15,0,0,0,15
1214219,866329,2019-05-16,Assembly,"Do pass",18,0,0,0,18
1214219,869869,2019-05-22,Assembly,"AB 1058 Salas Assembly Third Reading",78,0,2,0,80
1214219,884578,2019-06-19,Senate,"Do pass as amended, but first amend, and re-refer to the Committee on [Appropriations]",9,0,0,0,9
1214219,892516,2019-07-08,Senate,"Placed on suspense file",7,0,0,0,7
1214220,852616,2019-04-24,Assembly,"Do pass and be re-referred to the Committee on [Appropriations]",5,0,2,0,7
1214220,866279,2019-05-16,Assembly,"Do pass",14,0,4,0,18
1214220,874622,2019-05-29,Assembly,"AB 1002 Rodriguez Assembly Third Reading",68,0,12,0,80
1214222,841762,2019-04-09,Assembly,"Do pass as amended, and be re-referred to the Committee on [Appropriations] with recommendation: To Consent Calendar",15,0,0,0,15
1214222,851612,2019-04-24,Assembly,"Do pass. To Consent Calendar",18,0,0,0,18
1214222,857962,2019-05-02,Assembly,"AB 993 Nazarian Consent Calendar Second Day Regular Session",76,0,4,0,80
1214222,878471,2019-06-05,Senate,"Do pass, but first be re-referred to the Committee on [Appropriations]",9,0,0,0,9
1214222,890482,2019-09-09,Senate,"Assembly 3rd Reading AB993 Nazarian By Galgiani",40,0,0,0,40
1214222,890483,2019-09-10,Assembly,"AB 993 Nazarian Concurrence in Senate Amendments",79,0,0,0,79
1214222,893858,2019-04-24,Assembly,Result,18,0,0,0,18
1214222,894521,2019-05-02,Assembly,"Bill Votes",18,0,0,0,18
1214225,849129,2019-04-10,Assembly,"Do pass as amended and be re-referred to the Committee on [Appropriations]",10,2,3,0,15
1214227,854981,2019-04-23,Senate,"Do pass as amended, but first amend, and re-refer to the Committee on [Appropriations]",6,2,1,0,9
1214227,863193,2019-05-13,Senate,"Placed on suspense file",6,0,0,0,6
1214227,866152,2019-05-16,Senate,"Do pass as amended",4,2,0,0,6
1214227,873905,2019-05-28,Senate,"Senate 3rd Reading SB529 Durazo",19,15,4,0,38
1214227,873906,2019-05-28,Senate,"Senate 3rd Reading SB529 Durazo Reconsider",37,0,1,0,38
1214227,874561,2019-05-29,Senate,"Senate 3rd Reading SB529 Durazo",20,15,3,0,38
1214228,839385,2019-04-03,Assembly,"Do pass as amended and be re-referred to the Committee on [Judiciary]",8,0,0,0,8
1214228,856164,2019-04-30,Assembly,"Do pass",10,1,1,0,12
1214228,862322,2019-05-09,Assembly,"AB 1106 Smith Assembly Third Reading",69,2,9,0,80
1214228,878865,2019-06-05,Senate,"Do pass, but first be re-referred to the Committee on [Judiciary]",5,0,2,0,7
1214228,887941,2019-06-25,Senate,"Do pass",9,0,0,0,9
1214228,894105,2019-07-11,Senate,"Special Consent AB1106",39,0,1,0,40
1214230,841506,2019-04-09,Assembly,"Do pass and be re-referred to the Committee on [Appropriations]",15,0,0,0,15
1214230,852329,2019-04-24,Assembly,"Do pass. To Consent Calendar",18,0,0,0,18
1214230,858084,2019-05-02,Assembly,"AB 1037 Gipson Consent Calendar Second Day Regular Session",76,0,4,0,80
1214230,888292,2019-06-26,Senate,"Do pass, but first be re-referred to the Committee on [Appropriations] with the recommendation: To Consent Calendar",8,0,1,0,9
1214230,893253,2019-09-10,Senate,"Assembly 3rd Reading AB1037 Gipson By Bradford",40,0,0,0,40
1214230,893254,2019-09-11,Assembly,"AB 1037 Gipson Concurrence in Senate Amendments",79,0,0,0,79
1214233,835261,2019-04-03,Senate,"Do pass, but first be re-referred to the Committee on [Appropriations]",6,0,1,0,7
1214233,848987,2019-04-22,Senate,"Placed on suspense file",6,0,0,0,6
1214235,843542,2019-04-10,Senate,"Do pass as amended, but first amend, and re-refer to the Committee on [Environmental Quality]",6,1,2,0,9
1214235,851681,2019-04-24,Senate,"Do pass as amended, but first amend, and re-refer to the Committee on [Appropriations]",5,2,0,0,7
1214235,863219,2019-05-13,Senate,"Placed on suspense file",6,0,0,0,6
1214238,830061,2019-03-26,Assembly,"Do pass and be re-referred to the Committee on [Appropriations]",5,1,2,0,8
1214240,841738,2019-04-09,Assembly,"Do pass and be re-referred to the Committee on [Education] with recommendation: To Consent Calendar",8,0,0,0,8
1214240,852842,2019-04-24,Assembly,"Do pass as amended and be re-referred to the Committee on [Appropriations]",7,0,0,0,7
1214240,865828,2019-05-16,Assembly,"Do pass as amended",13,0,5,0,18
1214240,874543,2019-05-29,Assembly,"AB 1001 Ting Assembly Third Reading",78,0,2,0,80
1214240,888151,2019-06-26,Senate,"Do pass as amended, but first amend, and re-refer to the Committee on [Human Services]",7,0,0,0,7
1214240,892913,2019-07-08,Senate,"Do pass, but first be re-referred to the Committee on [Appropriations] with the recommendation: To Consent Calendar",6,0,0,0,6
1214240,892914,2019-08-12,Senate,"Placed on suspense file",7,0,0,0,7
1214241,835926,2019-04-03,Assembly,"Do pass and be re-referred to the Committee on [Appropriations]",7,0,0,0,7
1214241,866309,2019-05-16,Assembly,"Do pass as amended",18,0,0,0,18
1214241,873954,2019-05-28,Assembly,"AB 1033 Cooper Assembly Third Reading",74,0,6,0,80
1214241,888138,2019-06-26,Senate,"Do pass, but first be re-referred to the Committee on [Appropriations] with the recommendation: To Consent Calendar",5,0,0,0,5
1214241,892286,2019-07-08,Senate,"Placed on suspense file",7,0,0,0,7
1214241,892287,2019-08-30,Senate,"Do pass",7,0,0,0,7
1214241,892288,2019-09-09,Senate,"Special Consent AB1033",40,0,0,0,40
1214243,834639,2019-04-01,Senate,"Do pass as amended, but first amend, and re-refer to the Committee on [Governance and Finance]",8,0,1,0,9
1214243,852916,2019-04-24,Senate,"Do pass as amended, but first amend, and re-refer to the Committee on [Appropriations]",5,1,1,0,7
1214243,867839,2019-05-20,Senate,"Senate 3rd Reading SB475 Skinner et al",31,5,2,0,38
1214243,891887,2019-07-02,Assembly,"Do pass and be re-referred to the Committee on [Appropriations]",18,0,1,0,19
1214246,850371,2019-04-22,Assembly,"Do pass and be re-referred to the Committee on [Appropriations]",15,0,0,0,15
1214246,866040,2019-05-16,Assembly,"Do pass",18,0,0,0,18
1214246,871397,2019-05-23,Assembly,"AB 1025 Grayson Assembly Third Reading",78,0,2,0,80
1214246,892887,2019-07-09,Senate,"Do pass, but first be re-referred to the Committee on [Appropriations]",10,3,0,0,13
1214246,892888,2019-08-12,Senate,"Placed on suspense file",7,0,0,0,7
1214246,892889,2019-08-30,Senate,"Do pass",5,2,0,0,7
1214246,892890,2019-09-04,Senate,"Assembly 3rd Reading AB1025 Grayson By Glazer",33,7,0,0,40
1214249,842962,2019-04-10,Assembly,"Do pass and be re-referred to the Committee on [Appropriations] with recommendation: To Consent Calendar",6,0,0,0,6
1214250,835897,2019-04-02,Assembly,"Do pass and be re-referred to the Committee on [Transportation]",7,0,0,0,7
1214250,848764,2019-04-22,Assembly,"Do pass and be re-referred to the Committee on [Appropriations]",14,1,0,0,15
1214250,865703,2019-05-16,Assembly,"Do pass",18,0,0,0,18
1214250,869980,2019-05-22,Assembly,"AB 970 Salas Assembly Third Reading",76,0,4,0,80
1214250,880378,2019-06-10,Senate,"Do pass, but first be re-referred to the Committee on [Environmental Quality]",4,0,2,0,6
1214250,893614,2019-07-03,Senate,"Do pass as amended, but first amend, and re-refer to the Committee on [Appropriations]",6,0,1,0,7
1214250,893615,2019-09-03,Senate,"Assembly 3rd Reading AB970 Salas By Jackson",39,0,1,0,40
1214250,893616,2019-09-05,Assembly,"AB 970 Salas Concurrence in Senate Amendments",78,0,1,0,79
1214251,851544,2019-04-23,Assembly,"Do pass and be re-referred to the Committee on [Appropriations] with recommendation: To Consent Calendar",15,0,0,0,15
1214251,865912,2019-05-16,Assembly,"Do pass as amended",18,0,0,0,18
1214251,873887,2019-05-28,Assembly,"AB 1131 Gloria Assembly Third Reading",75,0,5,0,80
1214251,885047,2019-06-19,Senate,"Do pass as amended, but first amend, and re-refer to the Committee on [Appropriations]",9,0,0,0,9
1214251,893843,2019-07-08,Senate,"Placed on suspense file",7,0,0,0,7
1214253,842427,2019-04-10,Senate,"Do pass as amended, but first amend, and re-refer to the Committee on [Appropriations]",4,0,1,0,5
1214253,854211,2019-04-29,Senate,"Placed on suspense file",6,0,0,0,6
1214253,866164,2019-05-16,Senate,"Do pass",5,0,1,0,6
1214253,868865,2019-05-21,Senate,"Senate 3rd Reading SB537 Hill",38,0,0,0,38
1214253,893221,2019-07-10,Assembly,"Do pass as amended and be re-referred to the Committee on [Appropriations]",14,0,0,0,14
1214253,893222,2019-08-30,Assembly,"Do pass as amended",18,0,0,0,18
1214253,893223,2019-09-10,Assembly,"SB 537 Hill Senate Third Reading By Chiu",78,0,1,0,79
1214253,893744,2019-09-12,Senate,"Unfinished Business SB537 Hill Concurrence",40,0,0,0,40
1214254,847135,2019-04-09,Assembly,"Do pass as amended, and be re-referred to the Committee on [Appropriations] with recommendation: To Consent Calendar",15,0,0,0,15
1214254,866049,2019-05-16,Assembly,"Do pass",18,0,0,0,18
1214254,870922,2019-05-23,Assembly,"AB 1004 McCarty Assembly Third Reading",78,0,2,0,80
1214254,891872,2019-07-03,Senate,"Do pass as amended, but first amend, and re-refer to the Committee on [Appropriations] with the recommendation: To Consent Calendar",8,0,1,0,9
1214254,891873,2019-08-12,Senate,"Placed on suspense file",7,0,0,0,7
1214254,891874,2019-08-30,Senate,"Do pass as amended",7,0,0,0,7
1214254,891875,2019-09-05,Senate,"Assembly 3rd Reading AB1004 McCarty et al. By Gonzalez",40,0,0,0,40
1214254,891876,2019-09-09,Assembly,"AB 1004 McCarty Concurrence in Senate Amendments",79,0,0,0,79
1214254,895160,2019-05-23,Assembly,"Bill Votes",18,0,0,0,18
1214256,841682,2019-04-09,Assembly,"Do pass and be re-referred to the Committee on [Education]",15,0,0,0,15
1214256,852958,2019-04-24,Assembly,"Do pass as amended and be re-referred to the Committee on [Appropriations]",7,0,0,0,7
1214256,865951,2019-05-16,Assembly,"Do pass",18,0,0,0,18
1214256,874357,2019-05-29,Assembly,"AB 1098 O'Donnell Third Reading Urgency",77,0,3,0,80
1214256,887920,2019-06-26,Senate,"Do pass as amended, but first amend, and re-refer to the Committee on [Appropriations] with the recommendation: To Consent Calendar",8,0,1,0,9
1214256,888534,2019-06-26,Senate,"Do pass as amended, but first amend, and re-refer to the Committee on [Education] with the recommendation: To Consent Calendar",8,0,1,0,9
1214256,893435,2019-07-10,Senate,"Do pass, but first be re-referred to the Committee on [Appropriations] with the recommendation: To Consent Calendar",7,0,0,0,7
1214256,893436,2019-08-12,Senate,"Placed on suspense file",7,0,0,0,7
1214257,843815,2019-04-10,Senate,"Do pass, but first be re-referred to the Committee on [Appropriations]",7,0,0,0,7
1214257,854220,2019-04-29,Senate,"Placed on suspense file",6,0,0,0,6
1214257,865681,2019-05-16,Senate,"Do pass as amended",6,0,0,0,6
1214257,871218,2019-05-23,Senate,"Senate 3rd Reading SB455 Bradford et al",38,0,0,0,38
1214257,892390,2019-07-08,Assembly,"Do pass and be re-referred to the Committee on [Appropriations] with recommendation: To Consent Calendar",10,0,2,0,12
1214257,892391,2019-08-30,Assembly,"Do pass",18,0,0,0,18
1214257,892392,2019-09-10,Assembly,"SB 455 Bradford Senate Third Reading By Limón",79,0,0,0,79
1214257,892393,2019-09-11,Senate,"Unfinished Business SB455 Bradford et al. Concurrence",40,0,0,0,40
1214258,859183,2019-04-30,Assembly,"Do pass as amended",10,0,1,0,11
1214258,862288,2019-05-09,Assembly,"AB 1035 Mayes Assembly Third Reading",77,0,3,0,80
1214259,830602,2019-03-26,Assembly,"Do pass and be re-referred to the Committee on [Appropriations]",7,1,3,0,11
1214259,865541,2019-05-16,Assembly,"Do pass as amended",12,5,1,0,18
1214259,874516,2019-05-29,Assembly,"AB 1130 Levine Assembly Third Reading",46,19,15,0,80
1214259,891342,2019-07-02,Senate,"Do pass, but first be re-referred to the Committee on [Appropriations]",7,2,0,0,9
1214259,891343,2019-08-12,Senate,"Placed on suspense file",7,0,0,0,7
1214259,891344,2019-08-30,Senate,"Do pass",5,2,0,0,7
1214259,891345,2019-09-05,Senate,"Assembly 3rd Reading AB1130 Levine By Wieckowski",26,12,2,0,40
1214259,894903,2019-05-16,Assembly,"Asm Ap",12,5,0,0,17
1214260,850926,2019-04-22,Senate,"Do pass, but first be re-referred to the Committee on [Appropriations] with the recommendation: To Consent Calendar",6,0,0,0,6
1214260,862290,2019-05-09,Senate,"Consent Calendar SB436",38,0,0,0,38
1214260,893121,2019-07-02,Assembly,"Do pass and be re-referred to the Committee on [Appropriations]",8,0,0,0,8
1214260,893122,2019-07-10,Assembly,"Do pass. To Consent Calendar",16,0,2,0,18
1214260,893123,2019-08-22,Assembly,"SB 436 Hurtado Senate Third Reading By Reyes",75,0,4,0,79
1214260,893124,2019-08-30,Senate,"Special Consent SB436",37,0,3,0,40
1214262,853134,2019-04-25,Assembly,"Do pass and be re-referred to the Committee on [Appropriations]",8,0,3,0,11
1214264,851839,2019-04-24,Assembly,"Do pass and be re-referred to the Committee on [Appropriations]",7,0,0,0,7
1214265,855878,2019-04-30,Assembly,"Do pass as amended",9,3,0,0,12
1214265,870218,2019-05-22,Assembly,"AB 1110 Friedman Assembly Third Reading",58,19,3,0,80
1214265,884744,2019-06-18,Senate,"Do pass",7,2,0,0,9
1214265,893371,2019-09-09,Senate,"Assembly 3rd Reading AB1110 Friedman By Portantino",29,10,1,0,40
1214265,893372,2019-09-10,Assembly,"AB 1110 Friedman Concurrence in Senate Amendments",62,16,1,0,79
1214265,894814,2019-09-09,Senate,Ass,7,10,0,0,17
1214265,894989,2019-05-22,Assembly,"Bill Votes",9,19,0,0,28
1214267,901481,2020-01-08,Assembly,"Do pass and be re-referred to the Committee on [Appropriations]",4,1,2,0,7
1214267,905410,2020-01-23,Assembly,"Do pass",17,0,1,0,18
1214267,906375,2020-01-27,Assembly,"AB 979 Reyes Assembly Third Reading",73,0,7,0,80
1214267,975756,2020-08-13,Senate,"Do pass, but first be re-referred to the Committee on [Appropriations]",6,0,1,0,7
1214267,976018,2020-08-17,Senate,"Placed on suspense file",7,0,0,0,7
1214267,976468,2020-08-20,Senate,"Do pass as amended",4,2,1,0,7
1214267,977424,2020-08-29,Senate,"Assembly 3rd Reading AB979 Holden et al. By Hueso",26,8,6,0,40
1214267,978032,2020-08-30,Assembly,"AB 979 Holden Concurrence in Senate Amendments",56,8,15,0,79
1214268,834264,2019-04-02,Senate,"Do pass and be ordered to the Consent Calendar",6,0,1,0,7
1214268,838547,2019-04-08,Senate,"Consent Calendar SB439 Umberg",38,0,0,0,38
1214268,891442,2019-07-09,Assembly,"Do pass as amended",8,0,0,0,8
1214268,891443,2019-08-21,Assembly,"Do pass. To Consent Calendar",17,0,1,0,18
1214268,891444,2019-09-05,Assembly,"SB 439 Umberg Senate Third Reading By Smith",78,1,0,0,79
1214268,891445,2019-09-06,Senate,"Unfinished Business SB439 Umberg Concurrence",39,0,1,0,40
1214270,859595,2019-05-01,Senate,"Do pass as amended, but first amend, and re-refer to the Committee on [Appropriations]",6,0,1,0,7
1214270,863258,2019-05-13,Senate,"Placed on suspense file",6,0,0,0,6
1214270,866033,2019-05-16,Senate,"Do pass",4,2,0,0,6
1214270,873977,2019-05-28,Senate,"Senate 3rd Reading SB468 Jackson",27,9,2,0,38
1214270,891736,2019-07-08,Assembly,"Do pass as amended and be re-referred to the Committee on [Appropriations]",7,0,4,0,11
1214270,891737,2019-08-30,Assembly,"Do pass as amended",13,5,0,0,18
1214270,891738,2019-09-10,Assembly,"SB 468 Jackson Senate Third Reading By Mullin",53,21,5,0,79
1214270,891739,2019-09-11,Senate,"Unfinished Business SB468 Jackson et al. Concurrence",28,10,2,0,40
1214271,834292,2019-04-02,Senate,"Do pass, but first be re-referred to the Committee on [Appropriations]",4,0,1,0,5
1214271,848765,2019-04-22,Senate,"Placed on suspense file",6,0,0,0,6
1214271,865658,2019-05-16,Senate,"Do pass",4,2,0,0,6
1214271,870122,2019-05-22,Senate,"Senate 3rd Reading SB523 McGuire",29,9,0,0,38
1214271,890319,2019-07-03,Assembly,"Do pass and be re-referred to the Committee on [Appropriations]",5,1,1,0,7
1214271,890320,2019-08-21,Assembly,"Do pass",12,5,1,0,18
1214271,890321,2019-09-11,Assembly,"SB 523 McGuire Senate Third Reading By Gonzalez",61,18,0,0,79
1214271,893752,2019-09-12,Senate,"Unfinished Business SB523 McGuire et al. Concurrence",29,11,0,0,40
1214274,836764,2019-04-03,Assembly,"Do pass and be re-referred to the Committee on [Appropriations]",8,0,0,0,8
1214274,841743,2019-04-10,Assembly,"Do pass",12,5,1,0,18
1214274,873842,2019-05-28,Assembly,"AB 1118 Blanca Rubio Assembly Third Reading",60,14,6,0,80
1214274,884567,2019-06-19,Senate,"Do pass, but first be re-referred to the Committee on [Appropriations]",5,0,2,0,7
1214274,889268,2019-07-01,Senate,"Placed on suspense file",7,0,0,0,7
1214274,891863,2019-08-30,Senate,"Do pass",5,1,1,0,7
1214274,891864,2019-09-09,Senate,"That the measure be returned to Senate Floor for consideration. Ordered to third reading",5,1,0,0,6
1214274,891865,2019-09-11,Senate,"Assembly 3rd Reading AB1118 Blanca Rubio By Hueso",32,6,2,0,40
1214274,893622,2019-09-12,Assembly,"AB 1118 Blanca Rubio Concurrence in Senate Amendments",76,0,3,0,79
1214275,841664,2019-04-10,Assembly,"Do pass and be re-referred to the Committee on [Judiciary]",13,0,0,0,13
1214275,850022,2019-04-23,Assembly,"Do pass as amended, and be re-referred to the Committee on [Appropriations] with recommendation: To Consent Calendar",12,0,0,0,12
1214275,861580,2019-05-08,Assembly,"Do pass. To Consent Calendar",18,0,0,0,18
1214275,867698,2019-05-20,Assembly,"AB 1132 Gabriel Assembly Third Reading",76,0,4,0,80
1214275,883846,2019-06-18,Senate,"Do pass, but first be re-referred to the Committee on [Judiciary]",13,0,0,0,13
1214275,890585,2019-07-02,Senate,"Do pass, but first be re-referred to the Committee on [Appropriations] with the recommendation: To Consent Calendar",9,0,0,0,9
1214275,890586,2019-08-12,Senate,"Placed on suspense file",7,0,0,0,7
1214275,890587,2019-08-30,Senate,"Do pass",7,0,0,0,7
1214275,890588,2019-09-09,Senate,"Special Consent AB1132",40,0,0,0,40
1214275,890589,2019-09-10,Assembly,"AB 1132 Gabriel Concurrence in Senate Amendments",79,0,0,0,79
1214276,903138,2020-01-15,Senate,"Do pass, but first be re-referred to the Committee on [Appropriations]",1,4,3,0,8
1214277,850072,2019-04-22,Senate,"Do pass as amended, but first amend, and re-refer to the Committee on [Appropriations] with the recommendation: To Consent Calendar",6,0,0,0,6
1214277,863165,2019-05-13,Senate,"Placed on suspense file",6,0,0,0,6
1214277,866245,2019-05-16,Senate,"Do pass",6,0,0,0,6
1214277,871474,2019-05-23,Senate,"Special Consent SB453",38,0,0,0,38
1214277,892869,2019-07-09,Assembly,"Do pass and be re-referred to the Committee on [Appropriations]",7,0,0,0,7
1214277,892870,2019-08-30,Assembly,"Do pass as amended",18,0,0,0,18
1214277,892871,2019-09-09,Assembly,"SB 453 Hurtado Senate Third Reading By Nazarian",79,0,0,0,79
1214277,892872,2019-09-10,Senate,"Unfinished Business SB453 Hurtado et al. Concurrence",40,0,0,0,40
1214278,842937,2019-04-10,Assembly,"Do pass and be re-referred to the Committee on [Health]",6,0,0,0,6
1214278,850395,2019-04-23,Assembly,"Do pass and be re-referred to the Committee on [Appropriations]",15,0,0,0,15
1214280,835635,2019-04-03,Senate,"Do pass, but first be re-referred to the Committee on [Appropriations]",7,0,0,0,7
1214280,848848,2019-04-22,Senate,"Placed on suspense file",6,0,0,0,6
1214280,865533,2019-05-16,Senate,"Do pass as amended",6,0,0,0,6
1214280,871513,2019-05-23,Senate,"Senate 3rd Reading SB461 Roth et al",38,0,0,0,38
1214281,841798,2019-04-10,Senate,"Do pass, but first be re-referred to the Committee on [Judiciary]",9,0,4,0,13
1214281,851363,2019-04-23,Senate,"Do pass as amended, but first amend, and re-refer to the Committee on [Appropriations]",7,0,2,0,9
1214281,863113,2019-05-13,Senate,"Do pass",4,0,2,0,6
1214281,874458,2019-05-29,Senate,"Senate 3rd Reading SB534 Bradford",32,1,5,0,38
1214281,887429,2019-06-25,Assembly,"Do pass and be re-referred to the Committee on [Insurance]",9,2,1,0,12
1214281,890601,2019-07-10,Assembly,"Do pass and be re-referred to the Committee on [Appropriations]",12,0,2,0,14
1214281,890602,2019-08-14,Assembly,"Do pass",13,3,2,0,18
1214281,890603,2019-08-22,Assembly,"SB 534 Bradford Senate Third Reading By Daly",61,4,14,0,79
1214281,890604,2019-08-26,Senate,"Unfinished Business SB534 Bradford Concurrence",32,0,8,0,40
1214282,830300,2019-03-27,Assembly,"Do pass and be re-referred to the Committee on [Privacy and Consumer Protection] with recommendation: To Consent Calendar",7,0,0,0,7
1214282,856053,2019-04-30,Assembly,"Do pass. To Consent Calendar",11,0,0,0,11
1214282,862228,2019-05-09,Assembly,"AB 1043 Irwin Consent Calendar Second Day Regular Session",76,0,4,0,80
1214282,884258,2019-06-18,Senate,"Do pass and be ordered to the Consent Calendar",5,0,0,0,5
1214282,887090,2019-06-24,Senate,"Consent Calendar AB1043 Irwin",40,0,0,0,40
1214283,831199,2019-03-27,Assembly,"Do pass",7,0,0,0,7
1214283,849695,2019-04-22,Assembly,"AB 1013 Obernolte Assembly Third Reading",78,0,2,0,80
1214283,880927,2019-06-11,Senate,"Do pass as amended",13,0,3,0,16
1214283,892739,2019-09-03,Senate,"Assembly 3rd Reading AB1013 Obernolte By Leyva",40,0,0,0,40
1214283,892740,2019-09-05,Assembly,"AB 1013 Obernolte Concurrence in Senate Amendments",79,0,0,0,79
1214284,829129,2019-03-25,Assembly,"Do pass and be re-referred to the Committee on [Appropriations]",14,0,1,0,15
1214286,836757,2019-04-02,Senate,"Do pass as amended, but first amend, and re-refer to the Committee on [Appropriations]",11,2,0,0,13
1214286,863102,2019-05-13,Senate,"Senate 3rd Reading SB524 Stern",30,7,1,0,38
1214286,890989,2019-07-10,Assembly,"Do pass as amended and be re-referred to the Committee on [Appropriations]",13,0,2,0,15
1214286,890990,2019-08-30,Assembly,"Do pass",14,4,0,0,18
1214289,834304,2019-04-02,Senate,"Do pass, but first be re-referred to the Committee on [Appropriations]",5,1,1,0,7
1214289,848863,2019-04-22,Senate,"Placed on suspense file",6,0,0,0,6
1214289,866414,2019-05-16,Senate,"Do pass as amended",4,2,0,0,6
1214289,871522,2019-05-23,Senate,"Senate 3rd Reading SB485 Beall et al",28,10,0,0,38
1214289,891648,2019-07-09,Assembly,"Do pass and be re-referred to the Committee on [Appropriations]",6,2,0,0,8
1214289,891649,2019-08-14,Assembly,"Do pass",12,5,1,0,18
1214289,891650,2019-09-11,Assembly,"SB 485 Beall Senate Third Reading By Jones-Sawyer",52,24,3,0,79
1214289,893586,2019-09-12,Senate,"Unfinished Business SB485 Beall et al. Concurrence",29,10,1,0,40
1214290,853659,2019-04-23,Assembly,"Do pass as amended, and be re-referred to the Committee on [Appropriations] with recommendation: To Consent Calendar",15,0,0,0,15
1214290,865956,2019-05-16,Assembly,"Do pass as amended",18,0,0,0,18
1214290,873978,2019-05-28,Assembly,"AB 1122 Irwin Assembly Third Reading",74,0,6,0,80
1214290,893837,2019-07-10,Senate,"Do pass as amended, but first amend, and re-refer to the Committee on [Appropriations]",8,0,1,0,9
1214290,893838,2019-08-12,Senate,"Placed on suspense file",7,0,0,0,7
1214291,842942,2019-04-10,Senate,"Do pass as amended, but first amend, and re-refer to the Committee on [Environmental Quality]",7,1,1,0,9
1214291,851688,2019-04-24,Senate,"Do pass, but first be re-referred to the Committee on [Judiciary]",5,1,1,0,7
1214291,863078,2019-05-13,Senate,"Placed on suspense file",6,0,0,0,6
1214291,866119,2019-05-16,Senate,"Do pass as amended",4,2,0,0,6
1214291,871379,2019-05-23,Senate,"Senate 3rd Reading SB424 Jackson",25,10,3,0,38
1214292,834381,2019-04-01,Assembly,"Do pass and be re-referred to the Committee on [Appropriations]",14,0,1,0,15
1214292,841786,2019-04-10,Assembly,"Do pass",17,0,1,0,18
1214292,849146,2019-04-22,Assembly,"AB 998 Aguiar-Curry Assembly Third Reading",75,0,5,0,80
1214292,880263,2019-06-11,Senate,"Do pass, but first be re-referred to the Committee on [Appropriations] with the recommendation: To Consent Calendar",11,0,1,0,12
1214292,893894,2019-07-01,Senate,"Consent Calendar AB998",39,0,1,0,40
1214294,842931,2019-04-10,Assembly,"Do pass and be re-referred to the Committee on [Appropriations] with recommendation: To Consent Calendar",6,0,0,0,6
1214295,845714,2019-04-10,Senate,"Do pass, but first be re-referred to the Committee on [Judiciary]",4,1,2,0,7
1214296,841611,2019-04-09,Senate,"Do pass, but first be re-referred to the Committee on [Appropriations]",7,0,0,0,7
1214296,855136,2019-04-29,Senate,"Placed on suspense file",6,0,0,0,6
1214296,866451,2019-05-16,Senate,"Do pass as amended",6,0,0,0,6
1214296,870917,2019-05-23,Senate,"Senate 3rd Reading SB500 Morrell et al",37,0,1,0,38
1214296,884336,2019-06-18,Assembly,"Do pass as amended and be re-referred to the Committee on [Appropriations]",10,0,1,0,11
1214297,835051,2019-04-03,Assembly,"Do pass and be re-referred to the Committee on [Appropriations]",14,0,0,0,14
1214297,866249,2019-05-16,Assembly,"Do pass",18,0,0,0,18
1214297,870229,2019-05-22,Assembly,"AB 1104 Calderon Assembly Third Reading",77,0,3,0,80
1214297,881160,2019-06-12,Senate,"Do pass, but first be re-referred to the Committee on [Appropriations]",13,0,0,0,13
1214297,892564,2019-08-22,Senate,"Assembly 3rd Reading AB1104 Calderon By Roth",39,0,1,0,40
1214298,834819,2019-04-03,Senate,"Do pass, but first be re-referred to the Committee on [Transportation]",5,2,0,0,7
1214298,841727,2019-04-09,Senate,"Do pass as amended, but first amend, and re-refer to the Committee on [Housing]",9,3,0,0,12
1214298,850456,2019-04-22,Senate,"Do pass as amended, but first amend, and re-refer to the Committee on [Appropriations]",7,3,1,0,11
1214298,850457,2019-04-22,Senate,"[04-23-2019] set for [First] hearing: Reconsideration of favorable vote granted",11,0,0,0,11
1214298,850458,2019-04-22,Senate,"Do pass as amended, but first amend, and re-refer to the Committee on [Appropriations]",8,3,0,0,11
1214298,866135,2019-05-16,Senate,"Placed on suspense file",6,0,0,0,6
1214300,835567,2019-04-02,Assembly,"Do pass and be re-referred to the Committee on [Elections and Redistricting]",10,0,2,0,12
1214300,841635,2019-04-10,Assembly,"Do pass and be re-referred to the Committee on [Appropriations]",6,1,0,0,7
1214300,856820,2019-05-01,Assembly,"Do pass",13,4,1,0,18
1214300,862305,2019-05-09,Assembly,"AB 1150 Gloria Assembly Third Reading",61,13,6,0,80
1214300,878569,2019-06-05,Senate,"Do pass, but first be re-referred to the Committee on [Elections and Constitutional Amendments]",6,0,1,0,7
1214300,892975,2019-07-02,Senate,"Do pass as amended, but first amend, and re-refer to the Committee on [Appropriations]",4,1,0,0,5
1214300,892976,2019-08-26,Senate,"Assembly 3rd Reading AB1150 Gloria By Hueso",31,6,3,0,40
1214300,892977,2019-09-05,Assembly,"AB 1150 Gloria Concurrence in Senate Amendments",63,11,5,0,79
1214302,834303,2019-04-02,Assembly,"Do pass and be re-referred to the Committee on [Appropriations]",6,2,0,0,8
1214302,866216,2019-05-16,Assembly,"Do pass as amended",12,5,1,0,18
1214302,874613,2019-05-29,Assembly,"AB 1076 Ting Assembly Third Reading",52,21,7,0,80
1214302,893525,2019-07-09,Senate,"Do pass as amended, but first amend, and re-refer to the Committee on [Appropriations]",4,1,2,0,7
1214302,893526,2019-08-19,Senate,"Placed on suspense file",5,0,2,0,7
1214302,893527,2019-08-30,Senate,"Do pass as amended",5,2,0,0,7
1214302,893528,2019-09-05,Senate,"Assembly 3rd Reading AB1076 Ting et al. By Wiener",27,12,1,0,40
1214302,893529,2019-09-10,Assembly,"AB 1076 Ting Concurrence in Senate Amendments",52,23,4,0,79
1214303,854811,2019-04-23,Senate,"Do pass as amended, but first amend, and re-refer to the Committee on [Appropriations]",6,2,1,0,9
1214303,863194,2019-05-13,Senate,"Placed on suspense file",6,0,0,0,6
1214304,851597,2019-04-23,Senate,"Do pass, but first be re-referred to the Committee on [Appropriations]",5,2,0,0,7
1214304,859490,2019-05-06,Senate,"Placed on suspense file",5,0,1,0,6
1214306,851205,2019-04-23,Assembly,"Do pass and be re-referred to the Committee on [Appropriations]",9,1,2,0,12
1214306,865872,2019-05-16,Assembly,"Do pass as amended",15,1,2,0,18
1214306,873931,2019-05-28,Assembly,"AB 963 Petrie-Norris Assembly Third Reading",63,7,10,0,80
1214306,884570,2019-06-19,Senate,"Do pass, but first be re-referred to the Committee on [Elections and Constitutional Amendments]",7,0,0,0,7
1214306,892860,2019-07-02,Senate,"Do pass as amended, but first amend, and re-refer to the Committee on [Appropriations]",4,1,0,0,5
1214306,892861,2019-08-12,Senate,"Placed on suspense file",7,0,0,0,7
1214306,892862,2019-08-30,Senate,"Do pass as amended",5,1,1,0,7
1214306,892863,2019-09-10,Senate,"Assembly 3rd Reading AB963 Petrie-Norris et al. By Durazo",29,9,2,0,40
1214306,892864,2019-09-11,Assembly,"AB 963 Petrie-Norris Concurrence in Senate Amendments",67,7,5,0,79
1214307,851897,2019-04-23,Senate,"Do pass, but first be re-referred to the Committee on [Appropriations]",2,6,1,0,9
1214307,851898,2019-04-23,Senate,"[First] hearing set for [04-24-2019]: Failed passage in Committee. Reconsideration granted",9,0,0,0,9
1214308,842908,2019-04-10,Senate,"Do pass as amended, but first amend, and re-refer to the Committee on [Appropriations]",6,0,1,0,7
1214308,859516,2019-05-06,Senate,"Senate 3rd Reading SB450 Umberg",38,0,0,0,38
1214308,891083,2019-07-08,Assembly,"Do pass and be re-referred to the Committee on [Appropriations]",8,1,2,0,11
1214308,891084,2019-08-21,Assembly,"Do pass",17,0,1,0,18
1214308,891085,2019-09-09,Assembly,"SB 450 Umberg Senate Third Reading By Daly",74,2,3,0,79
1214308,891086,2019-09-10,Senate,"Unfinished Business SB450 Umberg Concurrence",40,0,0,0,40
1214309,824097,2019-03-18,Senate,"Senate 3rd Reading SCR20 Pan",36,0,2,0,38
1214309,833452,2019-04-01,Assembly,"Be adopted. To Consent Calendar",10,0,2,0,12
1214309,836459,2019-04-04,Assembly,"SCR 20 Pan Consent Calendar Second Day Regular Session",75,0,5,0,80
1214311,829469,2019-03-26,Assembly,"Do pass and be re-referred to the Committee on [Appropriations]",10,0,2,0,12
1214311,851333,2019-04-24,Assembly,"Do pass",17,0,1,0,18
1214312,829288,2019-03-26,Assembly,"Do pass and be re-referred to the Committee on [Appropriations]",13,0,1,0,14
1214312,866826,2019-05-16,Assembly,"Do pass as amended",17,0,1,0,18
1214312,874627,2019-05-29,Assembly,"AB 1111 Friedman Assembly Third Reading",72,3,5,0,80
1214312,887685,2019-06-25,Senate,"Do pass as amended, but first amend, and re-refer to the Committee on [Governmental Organization]",9,0,0,0,9
1214312,891144,2019-07-09,Senate,"Do pass as amended, but first amend, and re-refer to the Committee on [Appropriations]",15,0,1,0,16
1214312,891145,2019-08-19,Senate,"Placed on suspense file",5,0,2,0,7
1214314,901393,2020-01-07,Assembly,"Do pass and be re-referred to the Committee on [Appropriations]",12,0,0,0,12
1214315,887416,2019-06-25,Senate,"Do pass and be ordered to the Consent Calendar",16,0,0,0,16
1214315,889310,2019-07-01,Senate,"Consent Calendar SB432 Nielsen Urgency Clause",39,0,1,0,40
1214315,974797,2020-08-03,Assembly,"Do pass. To Consent Calendar",17,0,2,0,19
1214315,978008,2020-08-30,Assembly,"SB 432 Nielsen Consent Calendar Second Day Regular Session",75,0,4,0,79
1214317,851257,2019-04-23,Assembly,"Do pass and be re-referred to the Committee on [Appropriations] with recommendation: To Consent Calendar",8,0,0,0,8
1214317,856830,2019-05-01,Assembly,"Do pass. To Consent Calendar",18,0,0,0,18
1214317,862114,2019-05-09,Assembly,"AB 1009 Gabriel Consent Calendar Second Day Regular Session",76,0,4,0,80
1214317,887507,2019-06-25,Senate,"Do pass, but first be re-referred to the Committee on [Appropriations]",6,1,0,0,7
1214317,890679,2019-08-19,Senate,"Assembly 3rd Reading AB1009 Gabriel By Portantino",33,3,4,0,40
1214317,890680,2019-08-22,Assembly,"AB 1009 Gabriel Concurrence in Senate Amendments",61,3,15,0,79
1214318,858046,2019-05-01,Assembly,"Do pass",8,0,0,0,8
1214318,863279,2019-05-13,Assembly,"AB 1053 Dahle Assembly Third Reading",76,0,4,0,80
1214319,837063,2019-04-03,Assembly,"Do pass",20,0,1,0,21
1214319,853654,2019-04-25,Assembly,"AB 1082 Low Assembly Third Reading",76,0,4,0,80
1214319,893657,2019-07-09,Senate,"Do pass and be ordered to the Consent Calendar",15,0,1,0,16
1214319,978190,2020-08-30,Senate,"Assembly 3rd Reading AB1082 Low By Rubio",39,0,1,0,40
1214324,901396,2020-01-07,Assembly,"Do pass and be re-referred to the Committee on [Appropriations]",11,1,0,0,12
1214324,905385,2020-01-23,Assembly,"Do pass",18,0,0,0,18
1214324,912033,2020-01-30,Assembly,"AB 1155 Rodriguez Assembly Third Reading",76,0,4,0,80
1214325,834448,2019-04-02,Senate,"Do pass, but first be re-referred to the Committee on [Appropriations]",3,0,2,0,5
1214325,852752,2019-04-25,Senate,"Senate 3rd Reading SB505 Umberg Urgency Clause",33,0,5,0,38
1214325,885304,2019-06-19,Assembly,"Do pass and be re-referred to the Committee on [Appropriations]",7,0,0,0,7
1214325,894032,2019-07-03,Assembly,"Do pass. To Consent Calendar",17,0,1,0,18
1214325,894033,2019-07-08,Assembly,"SB 505 Umberg Third Reading Urgency By Gonzalez",75,0,4,0,79
1214325,894034,2019-07-11,Senate,"Unfinished Business SB505 Umberg Urgency Clause Concurrence",37,0,3,0,40
1214326,834079,2019-04-02,Assembly,"Do pass and be re-referred to the Committee on [Judiciary] with recommendation: To Consent Calendar",8,0,0,0,8
1214326,849998,2019-04-23,Assembly,"Do pass and be re-referred to the Committee on [Appropriations]",9,0,3,0,12
1214326,856839,2019-05-01,Assembly,"Do pass",14,0,4,0,18
1214326,862307,2019-05-09,Assembly,"AB 1073 Blanca Rubio Assembly Third Reading",64,0,16,0,80
1214326,883773,2019-06-18,Senate,"Do pass, but first be re-referred to the Committee on [Appropriations]",5,1,1,0,7
1214327,834886,2019-04-03,Assembly,"Do pass and be re-referred to the Committee on [Appropriations] with recommendation: To Consent Calendar",14,0,1,0,15
1214327,864682,2019-05-15,Assembly,"Do pass. To Consent Calendar",16,0,2,0,18
1214327,869759,2019-05-22,Assembly,"AB 1054 Holden Consent Calendar Second Day Regular Session",77,0,3,0,80
1214327,892343,2019-07-08,Senate,"Do pass",5,1,1,0,7
1214327,892344,2019-07-08,Senate,"Do pass, but first be re-referred to the Committee on [Appropriations]",9,2,2,0,13
1214327,892345,2019-07-08,Senate,"Assembly 3rd Reading AB1054 Holden et al. By Dodd Urgency Clause",31,7,2,0,40
1214327,892346,2019-07-10,Assembly,"With recommendation: That Senate amendments be concurred in",11,1,3,0,15
1214327,892347,2019-07-11,Assembly,"AB 1054 Holden Concurrence - Urgency Added",63,10,6,0,79
1214332,856682,2019-04-30,Senate,"Do pass and be ordered to the Consent Calendar",9,0,0,0,9
1214332,862347,2019-05-09,Senate,"Consent Calendar SB479",38,0,0,0,38
1214332,892436,2019-07-09,Assembly,"Do pass. To Consent Calendar",12,0,0,0,12
1214332,976934,2020-08-26,Assembly,"Do pass",13,0,2,0,15
1214332,978076,2020-08-31,Assembly,"SB 479 Atkins Senate Third Reading By Gloria",76,0,3,0,79
1214337,841805,2019-04-09,Senate,"Do pass, but first be re-referred to the Committee on [Appropriations]",11,0,1,0,12
1214337,854329,2019-04-29,Senate,"Placed on suspense file",6,0,0,0,6
1214338,840194,2019-04-09,Senate,"Do pass, but first be re-referred to the Committee on [Rules]",6,1,0,0,7
1214338,850016,2019-04-22,Senate,"Do pass, but first be re-referred to the Committee on [Appropriations]",6,0,0,0,6
1214338,859491,2019-05-06,Senate,"Placed on suspense file",5,0,1,0,6
1214339,842720,2019-04-10,Senate,"Do pass, but first be re-referred to the Committee on [Housing]",5,2,0,0,7
1214339,850777,2019-04-22,Senate,"Do pass as amended, but first amend, and re-refer to the Committee on [Appropriations]",9,2,0,0,11
1214339,863226,2019-05-13,Senate,"Placed on suspense file",6,0,0,0,6
1214339,866308,2019-05-16,Senate,"Do pass",5,1,0,0,6
1214339,870237,2019-05-22,Senate,"Senate 3rd Reading SB532 Portantino",32,4,2,0,38
1214339,885470,2019-06-19,Assembly,"Do pass as amended and be re-referred to the Committee on [Local Government]",8,0,0,0,8
1214339,890614,2019-07-03,Assembly,"Do pass and be re-referred to the Committee on [Appropriations]",8,0,0,0,8
1214339,890615,2019-08-30,Assembly,"Do pass",16,0,2,0,18
1214339,890616,2019-09-10,Assembly,"SB 532 Portantino Senate Third Reading By Mark Stone",76,0,3,0,79
1214339,893765,2019-09-12,Senate,"Unfinished Business SB532 Portantino Concurrence",35,1,4,0,40
1214341,836892,2019-04-02,Assembly,"Do pass as amended and be re-referred to the Committee on [Appropriations]",6,2,0,0,8
1214342,831371,2019-03-27,Assembly,"Do pass and be re-referred to the Committee on [Health] with recommendation: To Consent Calendar",6,0,0,0,6
1214342,839886,2019-04-09,Assembly,"Do pass and be re-referred to the Committee on [Appropriations] with recommendation: To Consent Calendar",15,0,0,0,15
1214342,865801,2019-05-16,Assembly,"Do pass",18,0,0,0,18
1214342,874479,2019-05-29,Assembly,"AB 1085 McCarty Assembly Third Reading",78,0,2,0,80
1214342,887961,2019-06-26,Senate,"Do pass, but first be re-referred to the Committee on [Health] with the recommendation: To Consent Calendar",7,0,0,0,7
1214342,892779,2019-07-10,Senate,"Do pass, but first be re-referred to the Committee on [Appropriations] with the recommendation: To Consent Calendar",8,0,1,0,9
1214342,892780,2019-08-12,Senate,"Placed on suspense file",7,0,0,0,7
1214342,892781,2019-08-30,Senate,"Do pass",7,0,0,0,7
1214342,892782,2019-09-09,Senate,"Assembly 3rd Reading AB1085 McCarty By Umberg",40,0,0,0,40
1214344,849007,2019-04-10,Senate,"Do pass as amended",5,1,1,0,7
1214344,862236,2019-05-09,Senate,"Senate 3rd Reading SB527 Caballero",30,7,1,0,38
1214344,890327,2019-07-03,Assembly,"Do pass",6,2,3,0,11
1214344,890328,2019-08-12,Assembly,"SB 527 Caballero Senate Third Reading By Aguiar-Curry",58,10,11,0,79
1214344,890329,2019-08-26,Senate,"Unfinished Business SB527 Caballero Concurrence",30,7,3,0,40
1214345,841744,2019-04-09,Assembly,"Do pass and be re-referred to the Committee on [Appropriations]",12,0,0,0,12
1214345,865780,2019-05-16,Assembly,"Do pass as amended",18,0,0,0,18
1214345,873837,2019-05-28,Assembly,"AB 1075 Holden Assembly Third Reading",75,0,5,0,80
1214345,888043,2019-06-26,Senate,"Do pass, but first be re-referred to the Committee on [Appropriations] with the recommendation: To Consent Calendar",7,0,0,0,7
1214345,893810,2019-07-08,Senate,"Placed on suspense file",7,0,0,0,7
1214345,893811,2019-08-30,Senate,"Do pass",7,0,0,0,7
1214345,893812,2019-09-09,Senate,"Special Consent AB1075",40,0,0,0,40
1214346,829825,2019-03-26,Assembly,"Do pass and be re-referred to the Committee on [Appropriations]",20,0,0,0,20
1214346,842476,2019-04-10,Assembly,"Do pass. To Consent Calendar",17,0,1,0,18
1214346,853282,2019-04-25,Assembly,"AB 973 Irwin Consent Calendar Second Day Regular Session",76,0,4,0,80
1214346,877391,2019-06-03,Senate,"Do pass, but first be re-referred to the Committee on [Appropriations]",9,0,0,0,9
1214346,891848,2019-07-11,Senate,"Assembly 3rd Reading AB973 Irwin By Hill",39,0,1,0,40
1214346,891849,2019-08-12,Assembly,"AB 973 Irwin Concurrence in Senate Amendments",76,0,3,0,79
1214347,842809,2019-04-08,Assembly,"Do pass as amended and be re-referred to the Committee on [Appropriations]",8,3,0,0,11
1214347,866028,2019-05-16,Assembly,"Do pass as amended",13,5,0,0,18
1214347,872271,2019-05-24,Assembly,"AB 1057 Limón Assembly Third Reading",43,19,18,0,80
1214347,890359,2019-07-09,Senate,"Do pass, but first be re-referred to the Committee on [Appropriations]",7,1,1,0,9
1214347,890360,2019-08-12,Senate,"Placed on suspense file",7,0,0,0,7
1214347,890361,2019-08-30,Senate,"Do pass",5,2,0,0,7
1214347,890362,2019-09-10,Senate,"Assembly 3rd Reading AB1057 Limón et al. By Stern",27,6,7,0,40
1214347,890363,2019-09-11,Assembly,"AB 1057 Limón Concurrence in Senate Amendments",55,13,11,0,79
1214348,829256,2019-03-26,Assembly,"Do pass and be re-referred to the Committee on [Appropriations] with recommendation: To Consent Calendar",8,0,0,0,8
1214348,865709,2019-05-16,Assembly,"Do pass",18,0,0,0,18
1214348,874366,2019-05-29,Assembly,"AB 1052 Chu Assembly Third Reading",78,0,2,0,80
1214348,891584,2019-07-02,Senate,"Do pass, but first be re-referred to the Committee on [Appropriations]",6,0,1,0,7
1214348,891585,2019-08-12,Senate,"Placed on suspense file",7,0,0,0,7
1214348,894553,2019-05-16,Assembly,"Asm Appro",18,0,0,0,18
1214350,853123,2019-04-24,Senate,"Do pass and be ordered to the Consent Calendar",13,0,0,0,13
1214350,857938,2019-05-02,Senate,"Consent Calendar SB508",38,0,0,0,38
1214350,887925,2019-06-26,Assembly,"Do pass. To Consent Calendar",14,0,0,0,14
1214350,893330,2019-07-05,Assembly,"SB 508 Leyva Consent Calendar Second Day Regular Session",70,0,9,0,79
1214351,901167,2019-04-02,Assembly,"Do pass and be re-referred to the Committee on [Appropriations]",2,6,0,0,8
1214352,836655,2019-04-02,Senate,"Do pass as amended, but first amend, and re-refer to the Committee on [Rules]",13,0,0,0,13
1214352,850239,2019-04-23,Senate,"Do pass, but first be re-referred to the Committee on [Appropriations]",9,0,0,0,9
1214352,863171,2019-05-13,Senate,"Senate 3rd Reading SB515 Caballero et al",37,0,1,0,38
1214352,888049,2019-06-26,Assembly,"Do pass as amended and be re-referred to the Committee on [Natural Resources]",13,0,2,0,15
1214352,891195,2019-07-08,Assembly,"Do pass and be re-referred to the Committee on [Appropriations] with recommendation: To Consent Calendar",11,0,0,0,11
1214355,841351,2019-04-10,Senate,"Do pass",6,0,1,0,7
1214355,848843,2019-04-22,Senate,"Senate 3rd Reading SB419 Skinner",30,8,0,0,38
1214355,893397,2019-07-10,Assembly,"Do pass as amended",5,2,0,0,7
1214355,893398,2019-08-19,Assembly,"SB 419 Skinner Senate Third Reading By Gloria",58,17,4,0,79
1214355,893399,2019-08-22,Senate,"Unfinished Business SB419 Skinner Concurrence",31,8,1,0,40
1214355,894781,2019-04-22,Senate,Date,6,0,0,0,6
1214356,842951,2019-04-09,Assembly,"Do pass as amended and be re-referred to the Committee on [Privacy and Consumer Protection]",5,2,1,0,8
1214357,850518,2019-04-23,Senate,"Do pass, but first be re-referred to the Committee on [Appropriations] with the recommendation: To Consent Calendar",9,0,0,0,9
1214357,859607,2019-05-06,Senate,"Do pass",5,0,1,0,6
1214357,862336,2019-05-09,Senate,"Senate 3rd Reading SB442 Dodd",38,0,0,0,38
1214357,891028,2019-07-02,Assembly,"Do pass as amended and be re-referred to the Committee on [Appropriations]",14,0,0,0,14
1214357,891029,2019-08-30,Assembly,"Do pass as amended",18,0,0,0,18
1214357,893926,2019-09-13,Assembly,"SB 442 Dodd Senate Third Reading By Medina",79,0,0,0,79
1214357,894157,2019-09-13,Senate,"Unfinished Business SB442 Dodd",40,0,0,0,40
1214357,894376,2019-09-14,Senate,"Unfinished Business SB442 Dodd",40,0,0,0,40
1214358,833165,2019-03-27,Assembly,"Do pass as amended and be re-referred to the Committee on [Appropriations]",5,1,1,0,7
1214358,865736,2019-05-16,Assembly,"Do pass as amended",14,4,0,0,18
1214358,874434,2019-05-29,Assembly,"AB 1036 Aguiar-Curry Assembly Third Reading",59,16,5,0,80
1214358,891113,2019-07-02,Senate,"Do pass, but first be re-referred to the Committee on [Education]",4,1,0,0,5
1214358,891114,2019-07-10,Senate,"Do pass as amended, but first amend, and re-refer to the Committee on [Appropriations]",7,0,0,0,7
1214358,891115,2019-08-19,Senate,"Placed on suspense file",5,0,2,0,7
1214358,891116,2019-08-30,Senate,"Do pass as amended",5,1,1,0,7
1214358,891117,2019-09-04,Senate,"Assembly 3rd Reading AB1036 Aguiar-Curry et al. By Pan",31,9,0,0,40
1214358,891118,2019-09-09,Assembly,"AB 1036 Aguiar-Curry Concurrence in Senate Amendments",61,15,3,0,79
1214359,842994,2019-04-10,Senate,"Do pass, but first be re-referred to the Committee on [Health]",6,1,0,0,7
1214359,856637,2019-05-01,Senate,"Do pass as amended",9,0,0,0,9
1214359,870302,2019-05-22,Senate,"Senate 3rd Reading SB438 Hertzberg et al",32,4,2,0,38
1214359,891376,2019-07-09,Assembly,"Do pass as amended",13,0,2,0,15
1214359,891377,2019-09-03,Assembly,"SB 438 Hertzberg Senate Third Reading By Eggman",68,4,7,0,79
1214359,891378,2019-09-04,Senate,"Unfinished Business SB438 Hertzberg et al. Concurrence",33,6,1,0,40
1214361,833989,2019-03-26,Assembly,"Do pass as amended and be re-referred to the Committee on [Appropriations]",8,0,0,0,8
1214361,865895,2019-05-16,Assembly,"Do pass as amended",16,0,2,0,18
1214361,873867,2019-05-28,Assembly,"AB 960 Maienschein Assembly Third Reading",73,0,7,0,80
1214361,892509,2019-07-08,Senate,"Do pass, but first be re-referred to the Committee on [Appropriations]",6,0,0,0,6
1214361,892510,2019-08-12,Senate,"Placed on suspense file",7,0,0,0,7
1214361,892511,2019-08-30,Senate,"Do pass as amended",7,0,0,0,7
1214361,892512,2019-09-04,Senate,"Assembly 3rd Reading AB960 Maienschein et al. By Portantino",40,0,0,0,40
1214361,892513,2019-09-09,Assembly,"AB 960 Maienschein Concurrence in Senate Amendments",78,0,1,0,79
1214362,840259,2019-04-08,Senate,"Do pass, but first be re-referred to the Committee on [Governmental Organization]",6,0,0,0,6
1214362,850097,2019-04-23,Senate,"Do pass, but first be re-referred to the Committee on [Appropriations]",13,3,0,0,16
1214362,863164,2019-05-13,Senate,"Placed on suspense file",6,0,0,0,6
1214363,901319,2020-01-06,Assembly,"Be re-referred to the Committee on [Natural Resources]",12,0,0,0,12
1214363,902198,2020-01-13,Assembly,"Do pass and be re-referred to the Committee on [Appropriations] with recommendation: To Consent Calendar",11,0,0,0,11
1214363,905431,2020-01-23,Assembly,"Do pass",18,0,0,0,18
1214363,905432,2020-01-23,Assembly,"Set, [First] hearing. Referred to suspense file",18,0,0,0,18
1214363,906370,2020-01-27,Assembly,"AB 1071 Limón Assembly Third Reading",78,0,2,0,80
1214363,974898,2020-08-05,Senate,"Do pass as amended, but first amend, and re-refer to the Committee on [Appropriations] with the recommendation: To Consent Calendar",9,0,0,0,9
1214363,975852,2020-08-13,Senate,"Placed on suspense file",7,0,0,0,7
1214364,830539,2019-03-27,Assembly,"Do pass and be re-referred to the Committee on [Appropriations] with recommendation: To Consent Calendar",7,0,0,0,7
1214364,851704,2019-04-24,Assembly,"Do pass. To Consent Calendar",18,0,0,0,18
1214364,858409,2019-05-02,Assembly,"AB 1044 Irwin Consent Calendar Second Day Regular Session",76,0,4,0,80
1214364,877873,2019-06-04,Senate,"Do pass, but first be re-referred to the Committee on [Appropriations]",5,0,0,0,5
1214364,893945,2019-07-01,Senate,"Assembly 3rd Reading AB1044 Irwin By Gonzalez",39,0,1,0,40
1214365,830734,2019-03-26,Assembly,"Do pass as amended and be re-referred to the Committee on [Appropriations]",10,1,1,0,12
1214365,866597,2019-05-16,Assembly,"Do pass",14,3,1,0,18
1214365,874407,2019-05-29,Assembly,"AB 1092 Jones-Sawyer Assembly Third Reading",42,28,10,0,80
1214365,888188,2019-06-25,Senate,"Do pass, but first be re-referred to the Committee on [Appropriations]",7,1,1,0,9
1214365,890424,2019-07-08,Senate,"Placed on suspense file",7,0,0,0,7
1214365,890425,2019-08-30,Senate,"Do pass as amended",5,2,0,0,7
1214365,890426,2019-09-10,Senate,"Assembly 3rd Reading AB1092 Jones-Sawyer By Skinner",27,13,0,0,40
1214365,890427,2019-09-11,Assembly,"AB 1092 Jones-Sawyer Concurrence in Senate Amendments",49,25,5,0,79
1214367,839744,2019-04-08,Assembly,"Do pass and be re-referred to the Committee on [Appropriations]",9,1,1,0,11
1214367,852219,2019-04-24,Assembly,"Do pass",14,0,4,0,18
1214367,859888,2019-05-06,Assembly,"AB 975 Calderon Assembly Third Reading",66,2,12,0,80
1214367,887616,2019-06-25,Senate,"Do pass as amended, but first amend, and re-refer to the Committee on [Environmental Quality]",7,1,1,0,9
1214367,892884,2019-07-03,Senate,"Do pass, but first be re-referred to the Committee on [Appropriations]",5,0,2,0,7
1214367,892885,2019-08-12,Senate,"Placed on suspense file",7,0,0,0,7
1214368,851290,2019-04-23,Assembly,"Do pass as amended and be re-referred to the Committee on [Appropriations]",7,1,0,0,8
1214368,865587,2019-05-16,Assembly,"Do pass",13,3,2,0,18
1214368,871394,2019-05-23,Assembly,"AB 1022 Wicks Assembly Third Reading",65,2,13,0,80
1214368,887688,2019-06-24,Senate,"Do pass as amended, but first amend, and re-refer to the Committee on [Appropriations]",5,0,1,0,6
1214368,974992,2020-08-07,Senate,"Do pass, but first be re-referred to the Committee on [Appropriations]",5,1,1,0,7
1214368,976030,2020-08-17,Senate,"Placed on suspense file",7,0,0,0,7
1214369,858134,2019-05-01,Assembly,"Do pass as amended",6,0,0,0,6
1214369,863115,2019-05-13,Assembly,"AB 1062 Limón Assembly Third Reading",76,0,4,0,80
1214369,878566,2019-06-05,Senate,"Do pass as amended, and be ordered to the Consent Calendar",7,0,0,0,7
1214369,882782,2019-06-17,Senate,"Consent Calendar AB1062",40,0,0,0,40
1214369,889219,2019-07-01,Assembly,"AB 1062 Limón Concurrence in Senate Amendments",78,0,1,0,79
1214371,834157,2019-03-27,Assembly,"Do pass as amended and be re-referred to the Committee on [Appropriations]",6,0,0,0,6
1214371,851633,2019-04-24,Assembly,"Do pass. To Consent Calendar",18,0,0,0,18
1214371,858164,2019-05-02,Assembly,"AB 982 Holden Consent Calendar Second Day Regular Session",76,0,4,0,80
1214371,878555,2019-06-05,Senate,"Do pass as amended, but first amend, and re-refer to the Committee on [Appropriations] with the recommendation: To Consent Calendar",7,0,0,0,7
1214371,892021,2019-09-03,Senate,"Assembly 3rd Reading AB982 Holden By Leyva",40,0,0,0,40
1214371,892022,2019-09-09,Assembly,"AB 982 Holden Concurrence in Senate Amendments",79,0,0,0,79
1214373,852222,2019-04-22,Senate,"Do pass as amended, but first amend, and re-refer to the Committee on [Appropriations]",6,0,0,0,6
1214373,863231,2019-05-13,Senate,"Placed on suspense file",6,0,0,0,6
1214373,866350,2019-05-16,Senate,"Do pass",6,0,0,0,6
1214373,871279,2019-05-23,Senate,"Special Consent SB490",38,0,0,0,38
1214373,893607,2019-07-02,Assembly,"Do pass as amended and be re-referred to the Committee on [Appropriations]",8,0,0,0,8
1214373,893608,2019-08-30,Assembly,"Do pass as amended",18,0,0,0,18
1214373,893609,2019-09-10,Assembly,"SB 490 Hurtado Senate Third Reading By Reyes",78,0,1,0,79
1214373,893610,2019-09-11,Senate,"Unfinished Business SB490 Hurtado et al. Concurrence",40,0,0,0,40
1214374,850356,2019-04-22,Assembly,"Do pass and be re-referred to the Committee on [Appropriations]",10,4,1,0,15
1214374,865839,2019-05-16,Assembly,"Do pass",13,5,0,0,18
1214374,874490,2019-05-29,Assembly,"AB 1046 Ting Assembly Third Reading",55,21,4,0,80
1214374,891119,2019-07-03,Senate,"Do pass as amended, but first amend, and re-refer to the Committee on [Transportation]",5,2,0,0,7
1214374,891120,2019-07-09,Senate,"Do pass as amended, but first amend, and re-refer to the Committee on [Appropriations]",9,4,0,0,13
1214374,891121,2019-08-19,Senate,"Placed on suspense file",5,0,2,0,7
1214375,842835,2019-04-10,Assembly,"Do pass",7,0,1,0,8
1214375,853096,2019-04-25,Assembly,"AB 1100 Kamlager-Dove Assembly Third Reading",75,0,5,0,80
1214375,881024,2019-06-12,Senate,"Do pass as amended, but first amend, and re-refer to the Committee on [Transportation]",5,1,1,0,7
1214375,892948,2019-07-09,Senate,"Do pass",11,2,0,0,13
1214375,892949,2019-08-26,Senate,"Assembly 3rd Reading AB1100 Kamlager-Dove By Hertzberg",34,4,2,0,40
1214375,892950,2019-08-30,Assembly,"AB 1100 Kamlager-Dove Concurrence in Senate Amendments",68,3,8,0,79
1214376,835347,2019-04-02,Assembly,"Do pass as amended",7,3,2,0,12
1214377,852836,2019-04-24,Senate,"Do pass as amended, but first amend, and re-refer to the Committee on [Appropriations]",7,0,0,0,7
1214377,867736,2019-05-20,Senate,"Senate 3rd Reading SB535 Moorlach",38,0,0,0,38
1214377,886952,2019-06-24,Assembly,"Do pass as amended and be re-referred to the Committee on [Appropriations]",9,1,1,0,11
1214379,837293,2019-04-02,Assembly,"Do pass as amended and be re-referred to the Committee on [Appropriations]",11,0,4,0,15
1214379,866255,2019-05-16,Assembly,"Do pass",13,3,2,0,18
1214379,874406,2019-05-29,Assembly,"AB 962 Burke Assembly Third Reading",55,16,9,0,80
1214379,893392,2019-07-10,Senate,"Do pass as amended, but first amend, and re-refer to the Committee on [Appropriations]",7,1,1,0,9
1214379,893393,2019-08-12,Senate,"Placed on suspense file",7,0,0,0,7
1214379,893394,2019-08-30,Senate,"Do pass as amended",5,2,0,0,7
1214379,893395,2019-09-06,Senate,"Assembly 3rd Reading AB962 Burke et al. By Bradford",29,10,1,0,40
1214379,893396,2019-09-09,Assembly,"AB 962 Burke Concurrence in Senate Amendments",56,16,7,0,79
1214380,859194,2019-05-01,Assembly,"Do pass as amended. To Consent Calendar",12,0,3,0,15
1214380,863173,2019-05-13,Assembly,"AB 1083 Burke Consent Calendar Second Day",74,0,6,0,80
1214380,890344,2019-07-10,Senate,"Do pass as amended",12,0,1,0,13
1214380,890345,2019-09-11,Senate,"Assembly 3rd Reading AB1083 Burke By Hueso",39,0,1,0,40
1214380,893754,2019-09-12,Assembly,"AB 1083 Burke Concurrence in Senate Amendments",77,0,2,0,79
1214381,853408,2019-04-24,Senate,"Do pass, but first be re-referred to the Committee on [Appropriations] with the recommendation: To Consent Calendar",9,0,0,0,9
1214381,863265,2019-05-13,Senate,"Placed on suspense file",6,0,0,0,6
1214381,866379,2019-05-16,Senate,"Do pass",6,0,0,0,6
1214381,871297,2019-05-23,Senate,"Special Consent SB452",38,0,0,0,38
1214381,890659,2019-07-09,Assembly,"Do pass and be re-referred to the Committee on [Appropriations]",12,0,3,0,15
1214382,828415,2019-03-25,Assembly,"Be re-referred to the Committee on [Revenue and Taxation]",12,0,0,0,12
1214382,850087,2019-04-22,Assembly,"Do pass as amended and be re-referred to the Committee on [Appropriations]",11,0,0,0,11
1214382,856965,2019-05-01,Assembly,"Do pass. To Consent Calendar",18,0,0,0,18
1214382,862159,2019-05-09,Assembly,"AB 984 Lackey Consent Calendar Second Day Regular Session",76,0,4,0,80
1214382,890473,2019-07-03,Senate,"Do pass, but first be re-referred to the Committee on [Appropriations]",6,1,0,0,7
1214382,890474,2019-08-12,Senate,"Do pass",7,0,0,0,7
1214382,890475,2019-08-19,Senate,"Assembly 3rd Reading AB984 Lackey et al. By Portantino",39,1,0,0,40
1214382,890476,2019-08-22,Assembly,"AB 984 Lackey Concurrence in Senate Amendments",76,0,3,0,79
1214383,830459,2019-03-26,Assembly,"Do pass and be re-referred to the Committee on [Accountability and Administrative Review]",11,0,0,0,11
1214383,842076,2019-04-10,Assembly,"Do pass and be re-referred to the Committee on [Appropriations]",7,0,0,0,7
1214383,866221,2019-05-16,Assembly,"Do pass",18,0,0,0,18
1214383,870226,2019-05-22,Assembly,"AB 976 Chau Assembly Third Reading",78,0,2,0,80
1214383,887698,2019-06-25,Senate,"Do pass as amended, but first amend, and re-refer to the Committee on [Appropriations]",16,0,0,0,16
1214383,890398,2019-08-12,Senate,"Placed on suspense file",7,0,0,0,7
1214385,851755,2019-04-23,Senate,"Do pass, but first be re-referred to the Committee on [Appropriations]",10,1,1,0,12
1214385,859779,2019-05-06,Senate,"Placed on suspense file",5,0,1,0,6
1214385,866441,2019-05-16,Senate,"Do pass as amended",6,0,0,0,6
1214385,873922,2019-05-28,Senate,"Senate 3rd Reading SB498 Hurtado",31,0,7,0,38
1214386,851770,2019-04-23,Assembly,"Do pass and be re-referred to the Committee on [Appropriations]",7,0,0,0,7
1214386,865634,2019-05-16,Assembly,"Do pass",18,0,0,0,18
1214386,869971,2019-05-22,Assembly,"AB 1137 Nazarian Assembly Third Reading",78,0,2,0,80
1214386,880692,2019-06-10,Senate,"Do pass, but first be re-referred to the Committee on [Appropriations]",5,0,1,0,6
1214386,889254,2019-07-01,Senate,"Placed on suspense file",7,0,0,0,7
1214387,851180,2019-04-23,Assembly,"Do pass as amended and be re-referred to the Committee on [Revenue and Taxation]",5,0,2,0,7
1214387,861283,2019-05-06,Assembly,"Do pass and be re-referred to the Committee on [Appropriations]",10,0,1,0,11
1214387,866365,2019-05-16,Assembly,"Do pass",13,1,4,0,18
1214387,871649,2019-05-23,Assembly,"AB 1027 Burke Assembly Third Reading",67,0,13,0,80
1214387,893840,2019-08-14,Senate,"Do pass, but first be re-referred to the Committee on [Appropriations]",6,0,1,0,7
1214387,893841,2019-08-26,Senate,"Placed on suspense file",6,0,1,0,7
1214388,850637,2019-04-23,Senate,"Do pass, but first be re-referred to the Committee on [Appropriations]",16,0,0,0,16
1214388,862097,2019-05-09,Senate,"Senate 3rd Reading SB469 Dodd et al. Urgency Clause",38,0,0,0,38
1214388,881455,2019-06-13,Assembly,"Do pass as amended and be re-referred to the Committee on [Appropriations]",20,0,1,0,21
1214388,884663,2019-06-19,Assembly,"Do pass. To Consent Calendar",17,0,1,0,18
1214388,886916,2019-06-24,Senate,"Unfinished Business SB469 Dodd et al. Urgency Clause Concurrence",40,0,0,0,40
1214388,886917,2019-06-24,Assembly,"SB 469 Dodd Third Reading Urgency By Gray",78,0,1,0,79
1214392,837052,2019-04-03,Assembly,"Do pass and be re-referred to the Committee on [Appropriations]",7,0,0,0,7
1214392,851727,2019-04-24,Assembly,"Do pass",14,4,0,0,18
1214392,859880,2019-05-06,Assembly,"AB 1124 Maienschein Third Reading Urgency",66,0,14,0,80
1214392,880967,2019-06-12,Senate,"Do pass, but first be re-referred to the Committee on [Appropriations]",5,0,0,0,5
1214392,975347,2020-08-10,Senate,"Do pass as amended, but first amend, and re-refer to the Committee on [Appropriations]",7,0,2,0,9
1214392,976050,2020-08-17,Senate,"Placed on suspense file",7,0,0,0,7
1214392,976323,2020-08-20,Senate,"Do pass",5,2,0,0,7
1214392,977476,2020-08-31,Assembly,"With recommendation: That Senate amendments be concurred in",10,0,5,0,15
1214392,977962,2020-08-30,Senate,"Assembly 3rd Reading AB1124 Maienschein By Portantino",29,6,5,0,40
1214392,977963,2020-08-31,Assembly,"AB 1124 Maienschein Concurrence in Senate Amendments",71,0,8,0,79
1214394,851826,2019-04-23,Assembly,"Do pass as amended and be re-referred to the Committee on [Appropriations]",11,0,0,0,11
1214394,861456,2019-05-08,Assembly,"Do pass",17,0,1,0,18
1214394,863126,2019-05-13,Assembly,"AB 1181 Limón Assembly Third Reading",69,1,10,0,80
1214394,891834,2019-07-09,Senate,"Do pass, but first be re-referred to the Committee on [Appropriations]",7,1,1,0,9
1214394,891835,2019-09-11,Senate,"Assembly 3rd Reading AB1181 Limón By Wieckowski",31,8,1,0,40
1214394,893806,2019-09-12,Assembly,"AB 1181 Limón Concurrence in Senate Amendments",68,1,10,0,79
1214395,829595,2019-03-26,Assembly,"Do pass",20,0,0,0,20
1214395,833144,2019-04-01,Assembly,"AB 1289 Chen Assembly Third Reading",77,0,3,0,80
1214395,878857,2019-06-05,Senate,"Do pass as amended",7,0,0,0,7
1214395,885991,2019-06-20,Senate,"Special Consent AB1289",40,0,0,0,40
1214395,888561,2019-06-27,Assembly,"AB 1289 Chen Concurrence in Senate Amendments",72,0,7,0,79
1214396,903160,2020-01-15,Assembly,"Do pass and be re-referred to the Committee on [Appropriations] with recommendation: To Consent Calendar",11,0,0,0,11
1214396,905347,2020-01-23,Assembly,"Do pass. To Consent Calendar",18,0,0,0,18
1214396,912008,2020-01-30,Assembly,"AB 1205 Limón Consent Calendar Second Day Regular Session",76,0,4,0,80
1214396,975349,2020-08-10,Senate,"Do pass, but first be re-referred to the Committee on [Appropriations]",5,0,0,0,5
1214396,976630,2020-08-24,Senate,"Assembly 3rd Reading AB1205 Limón By Caballero",40,0,0,0,40
1214396,977165,2020-08-27,Assembly,"AB 1205 Limón Concurrence in Senate Amendments",74,0,5,0,79
1214398,851716,2019-04-23,Assembly,"Do pass as amended",7,1,0,0,8
1214398,862238,2019-05-09,Assembly,"AB 1215 Ting Assembly Third Reading",45,17,18,0,80
1214398,880579,2019-06-11,Senate,"Do pass",5,2,0,0,7
1214398,891666,2019-09-11,Senate,"Assembly 3rd Reading AB1215 Ting By Bradford",22,15,3,0,40
1214398,893587,2019-09-12,Assembly,"AB 1215 Ting Concurrence in Senate Amendments",47,21,11,0,79
1214399,836856,2019-04-02,Assembly,"Do pass as amended, and be re-referred to the Committee on [Public Employment and Retirement] with recommendation: To Consent Calendar",12,0,0,0,12
1214399,851886,2019-04-24,Assembly,"Do pass as amended and be re-referred to the Committee on [Appropriations]",7,0,0,0,7
1214400,853259,2019-04-24,Assembly,"Do pass as amended and be re-referred to the Committee on [Appropriations]",8,0,0,0,8
1214400,864913,2019-05-15,Assembly,"Do pass. To Consent Calendar",16,0,2,0,18
1214400,870256,2019-05-22,Assembly,"AB 1269 Blanca Rubio Consent Calendar Second Day Regular Session",77,0,3,0,80
1214402,841777,2019-04-10,Assembly,"Be re-referred to the Committee on [Health]",8,0,4,0,12
1214402,851137,2019-04-23,Assembly,"Do pass as amended and be re-referred to the Committee on [Appropriations]",15,0,0,0,15
1214403,841632,2019-04-08,Assembly,"Do pass as amended and be re-referred to the Committee on [Appropriations]",7,2,2,0,11
1214403,864918,2019-05-15,Assembly,"Do pass",16,0,2,0,18
1214403,870129,2019-05-22,Assembly,"AB 1195 O'Donnell Assembly Third Reading",62,5,13,0,80
1214403,884729,2019-06-19,Senate,"Do pass as amended, but first amend, and re-refer to the Committee on [Transportation]",7,0,0,0,7
1214403,890521,2019-07-09,Senate,"Do pass, but first be re-referred to the Committee on [Appropriations]",13,0,0,0,13
1214403,890522,2019-09-05,Senate,"Assembly 3rd Reading AB1195 O'Donnell By Umberg",35,1,0,0,36
1214403,890523,2019-09-05,Senate,"Assembly 3rd Reading AB1195 O'Donnell By Umberg Reconsider",39,0,1,0,40
1214403,890524,2019-09-05,Senate,"Assembly 3rd Reading AB1195 O'Donnell By Umberg",33,6,0,0,39
1214403,890525,2019-09-10,Assembly,"AB 1195 O'Donnell Concurrence in Senate Amendments",61,14,4,0,79
1214403,894787,2019-09-05,Senate,Date,13,0,0,0,13
1214404,841318,2019-04-09,Assembly,"Do pass and be re-referred to the Committee on [Appropriations] with recommendation: To Consent Calendar",8,0,0,0,8
1214404,851650,2019-04-24,Assembly,"Do pass. To Consent Calendar",18,0,0,0,18
1214404,858211,2019-05-02,Assembly,"AB 1294 Salas Consent Calendar Second Day Regular Session",76,0,4,0,80
1214404,887517,2019-06-25,Senate,"Do pass, but first be re-referred to the Committee on [Appropriations]",7,0,0,0,7
1214404,892490,2019-08-19,Senate,"Assembly 3rd Reading AB1294 Salas et al. By Umberg",40,0,0,0,40
1214404,892491,2019-08-22,Assembly,"AB 1294 Salas Concurrence in Senate Amendments",76,0,3,0,79
1214405,852917,2019-04-24,Assembly,"Do pass as amended and be re-referred to the Committee on [Appropriations]",5,2,0,0,7
1214405,866341,2019-05-16,Assembly,"Do pass",13,4,1,0,18
1214405,912015,2020-01-30,Assembly,"AB 1196 Gipson Assembly Third Reading",61,12,7,0,80
1214405,974979,2020-08-07,Senate,"Do pass, but first be re-referred to the Committee on [Appropriations]",6,1,0,0,7
1214405,975983,2020-08-17,Senate,"Placed on suspense file",7,0,0,0,7
1214405,976461,2020-08-20,Senate,"Do pass",5,1,1,0,7
1214405,978093,2020-08-30,Senate,"Assembly 3rd Reading AB1196 Gipson et al. By Durazo",33,1,6,0,40
1214405,978094,2020-08-31,Assembly,"AB 1196 GIPSON Concurrence in Senate Amendments",67,0,12,0,79
1214406,853589,2019-04-24,Assembly,"Do pass as amended and be re-referred to the Committee on [Appropriations]",8,0,0,0,8
1214406,861604,2019-05-08,Assembly,"Do pass. To Consent Calendar",18,0,0,0,18
1214406,865935,2019-05-16,Assembly,"AB 1290 Gloria Consent Calendar Second Day Regular Session",74,0,6,0,80
1214406,884152,2019-06-18,Senate,"Do pass as amended, but first amend, and re-refer to the Committee on [Appropriations] with the recommendation: To Consent Calendar",11,0,0,0,11
1214406,891895,2019-09-11,Senate,"Do pass, but first be re-referred to the Committee on [Appropriations]",6,1,0,0,7
1214406,893885,2019-09-13,Assembly,"With recommendation: That Senate amendments be concurred in",6,2,0,0,8
1214406,893984,2019-09-13,Assembly,"AB 1290 Gloria Concurrence in Senate Amendments",62,17,0,0,79
1214406,894158,2019-09-13,Senate,"Assembly 3rd Reading AB1290 Gloria et al. By Atkins",28,9,3,0,40
1214406,894396,2019-09-14,Senate,"Assembly 3rd Reading AB1290 Gloria et al. By Atkins",28,9,0,0,37
1214407,850255,2019-04-23,Assembly,"Do pass as amended and be re-referred to the Committee on [Appropriations]",10,1,1,0,12
1214407,865924,2019-05-16,Assembly,"Do pass as amended",14,4,0,0,18
1214407,873930,2019-05-28,Assembly,"AB 1184 Gloria Assembly Third Reading",59,8,13,0,80
1214407,892929,2019-07-09,Senate,"Do pass, but first be re-referred to the Committee on [Appropriations]",7,1,1,0,9
1214407,892930,2019-08-12,Senate,"Placed on suspense file",7,0,0,0,7
1214407,892931,2019-08-30,Senate,"Do pass as amended",6,1,0,0,7
1214407,892932,2019-09-09,Senate,"Assembly 3rd Reading AB1184 Gloria By Jackson",32,4,4,0,40
1214407,892933,2019-09-10,Assembly,"AB 1184 Gloria Concurrence in Senate Amendments",63,11,5,0,79
1214409,841331,2019-04-08,Assembly,"Do pass as amended and be re-referred to the Committee on [Judiciary]",6,3,2,0,11
1214409,850277,2019-04-23,Assembly,"Do pass and be re-referred to the Committee on [Appropriations]",9,3,0,0,12
1214409,865969,2019-05-16,Assembly,"Do pass as amended",12,4,2,0,18
1214409,874614,2019-05-29,Assembly,"AB 1162 Kalra Assembly Third Reading",50,24,6,0,80
1214409,884723,2019-06-19,Senate,"Do pass, but first be re-referred to the Committee on [Governance and Finance]",5,2,0,0,7
1214409,888026,2019-06-26,Senate,"Do pass, but first be re-referred to the Committee on [Judiciary]",4,0,3,0,7
1214409,892190,2019-07-09,Senate,"Do pass as amended, but first amend, and re-refer to the Committee on [Appropriations]",7,1,1,0,9
1214409,892191,2019-08-12,Senate,"Placed on suspense file",7,0,0,0,7
1214409,892192,2019-08-30,Senate,"Do pass as amended",5,2,0,0,7
1214409,892193,2019-09-05,Senate,"Assembly 3rd Reading AB1162 Kalra et al. By Wiener",25,11,4,0,40
1214409,892194,2019-09-09,Assembly,"AB 1162 Kalra Concurrence in Senate Amendments",53,21,5,0,79
1214410,850193,2019-04-22,Assembly,"Be adopted. To Consent Calendar",15,0,0,0,15
1214410,852750,2019-04-25,Assembly,"ACR 38 Salas Consent Calendar Second Day Regular Session",76,0,4,0,80
1214410,880429,2019-06-11,Senate,"Be adopted, but first be re-referred to the Committee on [Appropriations] with recommendation: To Consent Calendar",10,0,2,0,12
1214410,889279,2019-07-01,Senate,"Special Consent ACR38",38,0,2,0,40
1214410,896516,2019-07-01,Senate,Date,10,0,0,0,10
1214412,851804,2019-04-23,Assembly,"Do pass as amended and be re-referred to the Committee on [Appropriations]",15,0,0,0,15
1214412,865732,2019-05-16,Assembly,"Do pass as amended",18,0,0,0,18
1214412,874424,2019-05-29,Assembly,"AB 1275 Santiago Assembly Third Reading",77,0,3,0,80
1214412,888102,2019-06-26,Senate,"Do pass, but first be re-referred to the Committee on [Appropriations]",8,0,1,0,9
1214412,893159,2019-07-08,Senate,"Placed on suspense file",7,0,0,0,7
1214412,893160,2019-08-30,Senate,"Do pass",7,0,0,0,7
1214413,833100,2019-03-26,Assembly,"Do pass as amended",8,3,0,0,11
1214413,852957,2019-04-25,Assembly,"AB 1281 Chau Assembly Third Reading",61,13,6,0,80
1214413,893236,2019-07-02,Senate,"Do pass as amended, but first amend, and re-refer to the Committee on [Appropriations]",7,2,0,0,9
1214413,893237,2019-08-12,Senate,"Placed on suspense file",7,0,0,0,7
1214413,893238,2019-08-30,Senate,"Do pass",5,2,0,0,7
1214413,975812,2020-08-13,Senate,"Do pass, but first be re-referred to the Committee on [Appropriations] with the recommendation: To Consent Calendar",9,0,0,0,9
1214413,977297,2020-08-28,Senate,"Consent Calendar AB1281",39,0,1,0,40
1214413,978086,2020-08-30,Assembly,"AB 1281 Chau Concurrence in Senate Amendments",75,0,4,0,79
1214414,834340,2019-04-02,Assembly,"Do pass. To Consent Calendar",8,0,0,0,8
1214414,838612,2019-04-08,Assembly,"AB 1292 Bauer-Kahan Consent Calendar Second Day Regular Session",73,0,7,0,80
1214414,883829,2019-06-18,Senate,"Do pass and be ordered to the Consent Calendar",7,0,0,0,7
1214414,888557,2019-06-27,Senate,"Assembly 3rd Reading AB1292 Bauer-Kahan et al. By Portantino",37,0,3,0,40
1214414,889306,2019-07-01,Assembly,"AB 1292 Bauer-Kahan Concurrence in Senate Amendments",77,0,2,0,79
1214415,833804,2019-04-01,Assembly,"Do pass",12,0,0,0,12
1214415,838482,2019-04-08,Assembly,"AB 1186 Medina Assembly Third Reading",72,0,8,0,80
1214415,878845,2019-06-05,Senate,"Do pass, but first be re-referred to the Committee on [Judiciary]",7,0,0,0,7
1214415,888226,2019-06-25,Senate,"Do pass",9,0,0,0,9
1214415,894048,2019-08-12,Senate,"Assembly 3rd Reading AB1186 Medina et al. By Bradford",39,0,1,0,40
1214416,903157,2020-01-15,Assembly,"Do pass and be re-referred to the Committee on [Appropriations]",1,4,3,0,8
1214417,828000,2019-03-25,Assembly,"Be re-referred to the Committees on [Housing and Community Development] and [Local Government]",12,0,0,0,12
1214418,860843,2019-05-06,Assembly,"Do pass and be re-referred to the Committee on [Appropriations]",11,0,0,0,11
1214418,864921,2019-05-15,Assembly,"Do pass. To Consent Calendar",16,0,2,0,18
1214418,870261,2019-05-22,Assembly,"AB 1257 Salas Consent Calendar Second Day Regular Session",77,0,3,0,80
1214418,884728,2019-06-19,Senate,"Do pass, but first be re-referred to the Committee on [Veterans Affairs] with the recommendation: To Consent Calendar",6,0,1,0,7
1214418,888133,2019-06-25,Senate,"Do pass, but first be re-referred to the Committee on [Appropriations] with the recommendation: To Consent Calendar",6,0,1,0,7
1214418,891718,2019-07-08,Senate,"Placed on suspense file",7,0,0,0,7
1214418,891719,2019-08-30,Senate,"Do pass as amended",7,0,0,0,7
1214418,891720,2019-09-05,Senate,"Assembly 3rd Reading AB1257 Salas et al. By Archuleta",40,0,0,0,40
1214418,891721,2019-09-09,Assembly,"AB 1257 Salas Concurrence in Senate Amendments",78,0,1,0,79
1214419,852867,2019-04-24,Assembly,"Do pass. To Consent Calendar",19,0,2,0,21
1214419,858121,2019-05-02,Assembly,"AB 1265 Robert Rivas Consent Calendar Second Day Regular Session",76,0,4,0,80
1214419,880338,2019-06-11,Senate,"Do pass and be ordered to the Consent Calendar",14,0,2,0,16
1214419,882776,2019-06-17,Senate,"Consent Calendar AB1265 Robert Rivas Urgency Clause",40,0,0,0,40
1214420,853149,2019-04-24,Assembly,"Do pass. To Consent Calendar",8,0,0,0,8
1214420,857997,2019-05-02,Assembly,"AB 1220 Cristina Garcia Consent Calendar Second Day Regular Session",76,0,4,0,80
1214420,881195,2019-06-12,Senate,"Do pass",6,0,1,0,7
1214420,888720,2019-06-27,Senate,"Assembly 3rd Reading AB1220 Cristina Garcia By Bradford",37,0,3,0,40
1214422,830488,2019-03-26,Assembly,"Do pass and be re-referred to the Committee on [Appropriations]",9,2,0,0,11
1214422,865752,2019-05-16,Assembly,"Do pass as amended",13,4,1,0,18
1214422,873737,2019-05-28,Assembly,"AB 1202 Chau Assembly Third Reading",56,13,11,0,80
1214422,890780,2019-07-02,Senate,"Do pass as amended, but first amend, and re-refer to the Committee on [Appropriations]",7,1,1,0,9
1214422,890781,2019-08-12,Senate,"Placed on suspense file",7,0,0,0,7
1214422,890782,2019-08-30,Senate,"Do pass as amended",5,2,0,0,7
1214422,893915,2019-09-14,Assembly,"AB 1202 Chau Concurrence in Senate Amendments",63,14,2,0,79
1214422,894171,2019-09-13,Senate,"Assembly 3rd Reading AB1202 Chau By Jackson",29,10,1,0,40
1214423,895153,2019-04-23,Assembly,"Do pass and be re-referred to the Committee on [Appropriations]",2,4,2,0,8
1214423,895154,2019-04-23,Assembly,Reconsideration,8,0,0,0,8
1214425,830482,2019-03-26,Assembly,"Do pass as amended and be re-referred to the Committee on [Appropriations]",8,0,1,0,9
1214425,866087,2019-05-16,Assembly,"Do pass",18,0,0,0,18
1214425,869742,2019-05-22,Assembly,"AB 1180 Friedman Assembly Third Reading",78,0,2,0,80
1214425,878571,2019-06-05,Senate,"Do pass, but first be re-referred to the Committee on [Appropriations]",7,0,0,0,7
1214425,887060,2019-06-24,Senate,"Placed on suspense file",7,0,0,0,7
1214425,890669,2019-08-30,Senate,"Do pass",7,0,0,0,7
1214425,890670,2019-09-09,Senate,"Special Consent AB1180",40,0,0,0,40
1214425,890671,2019-09-10,Assembly,"AB 1180 Friedman Concurrence in Senate Amendments",79,0,0,0,79
1214425,895705,2019-06-24,Senate,Result,7,0,0,0,7
1214427,850162,2019-04-22,Assembly,"Do pass and be re-referred to the Committee on [Appropriations]",10,0,1,0,11
1214428,829250,2019-03-25,Assembly,"Be adopted. To Consent Calendar",14,0,1,0,15
1214428,831448,2019-03-28,Assembly,"ACR 37 Eduardo Garcia Consent Calendar Second Day Regular Session",72,0,8,0,80
1214428,887719,2019-06-25,Senate,"Be adopted, but first be re-referred to the Committee on [Appropriations] with recommendation: To Consent Calendar",12,0,1,0,13
1214428,893621,2019-07-11,Senate,"Consent Calendar ACR37 Eduardo Garcia",38,0,2,0,40
1214429,835996,2019-04-02,Assembly,"Do pass as amended, and be re-referred to the Committee on [Appropriations] with recommendation: To Consent Calendar",12,0,0,0,12
1214429,852293,2019-04-24,Assembly,"Do pass. To Consent Calendar",18,0,0,0,18
1214429,858086,2019-05-02,Assembly,"AB 1213 Chen Consent Calendar Second Day Regular Session",76,0,4,0,80
1214429,877640,2019-06-04,Senate,"Do pass, but first be re-referred to the Committee on [Appropriations] with the recommendation: To Consent Calendar",9,0,0,0,9
1214429,887285,2019-06-24,Senate,"Do pass",7,0,0,0,7
1214429,889293,2019-07-01,Senate,"Assembly 3rd Reading AB1213 Chen By Jones",39,0,1,0,40
1214429,893999,2019-07-08,Assembly,"AB 1213 Chen Concurrence in Senate Amendments",77,0,2,0,79
1214429,895049,2019-07-01,Senate,"Assembly 3rd Reading AB1213 Che",7,0,0,0,7
1214431,853231,2019-04-24,Assembly,"Do pass and be re-referred to the Committee on [Appropriations]",12,0,1,0,13
1214431,861523,2019-05-08,Assembly,"Do pass. To Consent Calendar",18,0,0,0,18
1214431,865574,2019-05-16,Assembly,"AB 1168 Mullin Consent Calendar Second Day Regular Session",74,0,6,0,80
1214431,883939,2019-06-18,Senate,"Do pass, but first be re-referred to the Committee on [Governmental Organization]",13,0,0,0,13
1214431,887533,2019-06-25,Senate,"Do pass, but first be re-referred to the Committee on [Appropriations] with the recommendation: To Consent Calendar",16,0,0,0,16
1214431,892372,2019-08-15,Senate,"Assembly 3rd Reading AB1168 Mullin et al. By Stone",37,0,3,0,40
1214431,892373,2019-08-22,Assembly,"AB 1168 Mullin Concurrence in Senate Amendments",76,0,3,0,79
1214434,851720,2019-04-23,Assembly,"Do pass and be re-referred to the Committee on [Appropriations]",16,0,4,0,20
1214434,856962,2019-05-01,Assembly,"Do pass",16,0,2,0,18
1214434,863236,2019-05-13,Assembly,"AB 1264 Petrie-Norris Third Reading Urgency",64,0,16,0,80
1214434,883082,2019-06-17,Senate,"Do pass, but first be re-referred to the Committee on [Appropriations]",8,0,1,0,9
1214434,893083,2019-09-03,Senate,"Assembly 3rd Reading AB1264 Petrie-Norris et al. By Leyva Urgency Clause",35,2,3,0,40
1214434,893084,2019-09-10,Assembly,"With recommendation: That Senate amendments be concurred in",14,0,5,0,19
1214434,893085,2019-09-11,Assembly,"AB 1264 Petrie-Norris Concurrence in Senate Amendments",71,0,8,0,79
1214435,816580,2019-03-07,Assembly,"Be adopted. To third reading",10,0,2,0,12
1214435,831308,2019-03-28,Senate,"Special Consent ACR34",35,0,3,0,38
1214436,851686,2019-04-23,Assembly,"Do pass and be re-referred to the Committee on [Appropriations]",8,0,0,0,8
1214437,834281,2019-04-02,Assembly,"Do pass",6,2,0,0,8
1214437,874557,2019-05-29,Assembly,"AB 1185 McCarty Assembly Third Reading",43,23,14,0,80
1214437,892335,2019-07-02,Senate,"Do pass",6,1,0,0,7
1214437,977292,2020-08-28,Senate,"Assembly 3rd Reading AB1185 McCarty et al. By Mitchell",27,11,2,0,40
1214437,978166,2020-08-31,Assembly,"AB 1185 McCarty Concurrence in Senate Amendments",47,21,11,0,79
1214438,808376,2019-02-25,Assembly,"Be adopted. To Consent Calendar",10,0,2,0,12
1214438,811687,2019-02-28,Assembly,"ACR 35 Choi Consent Calendar Second Day",75,0,5,0,80
1214439,834156,2019-04-02,Assembly,"Do pass and be re-referred to the Committee on [Appropriations] with recommendation: To Consent Calendar",8,0,0,0,8
1214439,851604,2019-04-24,Assembly,"Do pass",18,0,0,0,18
1214439,862229,2019-05-09,Assembly,"AB 1261 Jones-Sawyer Assembly Third Reading",71,0,9,0,80
1214439,883770,2019-06-18,Senate,"Do pass, but first be re-referred to the Committee on [Appropriations]",7,0,0,0,7
1214439,891667,2019-08-26,Senate,"Assembly 3rd Reading AB1261 Jones-Sawyer By Beall",39,0,1,0,40
1214440,830278,2019-03-26,Assembly,"Do pass. To Consent Calendar",9,0,2,0,11
1214440,836895,2019-04-04,Assembly,"AB 1203 O'Donnell Consent Calendar Second Day Regular Session",75,0,5,0,80
1214440,877818,2019-06-04,Senate,"Do pass and be ordered to the Consent Calendar",9,0,0,0,9
1214441,835538,2019-04-02,Assembly,"Do pass and be re-referred to the Committee on [Appropriations]",11,0,4,0,15
1214442,842657,2019-04-10,Assembly,"Do pass and be re-referred to the Committee on [Appropriations]",6,0,0,0,6
1214442,866579,2019-05-16,Assembly,"Do pass as amended",15,0,3,0,18
1214442,874400,2019-05-29,Assembly,"AB 1214 Melendez Assembly Third Reading",77,0,3,0,80
1214442,888268,2019-06-26,Senate,"Do pass, but first be re-referred to the Committee on [Appropriations] with the recommendation: To Consent Calendar",7,0,0,0,7
1214442,893730,2019-07-08,Senate,"Placed on suspense file",7,0,0,0,7
1214442,893731,2019-08-30,Senate,"Do pass",7,0,0,0,7
1214442,893732,2019-09-09,Senate,"Assembly 3rd Reading AB1214 Melendez By Hertzberg",40,0,0,0,40
1214442,893733,2019-09-10,Assembly,"AB 1214 Melendez Concurrence in Senate Amendments",79,0,0,0,79
1214443,835579,2019-04-03,Assembly,"Do pass and be re-referred to the Committee on [Local Government]",8,0,0,0,8
1214443,841630,2019-04-10,Assembly,"Do pass and be re-referred to the Committee on [Appropriations]",7,0,1,0,8
1214443,866387,2019-05-16,Assembly,"Do pass",18,0,0,0,18
1214443,871641,2019-05-23,Assembly,"AB 1255 Robert Rivas Assembly Third Reading",78,0,2,0,80
1214443,893624,2019-07-02,Senate,"Do pass, but first be re-referred to the Committee on [Appropriations]",10,0,1,0,11
1214443,893625,2019-08-12,Senate,"Placed on suspense file",7,0,0,0,7
1214443,893626,2019-08-30,Senate,"Do pass as amended",7,0,0,0,7
1214443,893627,2019-09-09,Senate,"Assembly 3rd Reading AB1255 Robert Rivas et al. By Skinner",40,0,0,0,40
1214443,893628,2019-09-10,Assembly,"AB 1255 Robert Rivas Concurrence in Senate Amendments",79,0,0,0,79
1214444,851871,2019-04-24,Assembly,"Do pass and be re-referred to the Committee on [Appropriations]",7,0,0,0,7
1214444,861987,2019-05-08,Assembly,"Do pass. To Consent Calendar",18,0,0,0,18
1214444,866518,2019-05-16,Assembly,"AB 1164 Gloria Consent Calendar Second Day Regular Session",74,0,6,0,80
1214444,880605,2019-06-11,Senate,"Do pass, but first be re-referred to the Committee on [Appropriations] with the recommendation: To Consent Calendar",14,0,2,0,16
1214444,889303,2019-07-01,Senate,"Do pass",7,0,0,0,7
1214444,893556,2019-08-22,Senate,"Special Consent AB1164",39,0,1,0,40
1214444,893557,2019-08-30,Assembly,"AB 1164 Gloria Concurrence in Senate Amendments",75,0,4,0,79
1214445,841657,2019-04-09,Assembly,"Do pass and be re-referred to the Committee on [Insurance]",15,0,0,0,15
1214445,851250,2019-04-24,Assembly,"Do pass and be re-referred to the Committee on [Appropriations] with recommendation: To Consent Calendar",14,0,0,0,14
1214445,861398,2019-05-08,Assembly,"Do pass",18,0,0,0,18
1214445,863083,2019-05-13,Assembly,"AB 1209 Nazarian Assembly Third Reading",74,0,6,0,80
1214445,891622,2019-07-10,Senate,"Do pass, but first be re-referred to the Committee on [Appropriations]",9,0,4,0,13
1214445,891623,2019-09-10,Senate,"Assembly 3rd Reading AB1209 Nazarian et al. By Rubio",37,0,3,0,40
1214445,891624,2019-09-11,Assembly,"AB 1209 Nazarian Concurrence in Senate Amendments",78,0,1,0,79
1214445,895055,2019-05-13,Assembly,"Bill Votes",18,0,0,0,18
1214446,828009,2019-03-25,Assembly,"Be re-referred to the Committees on [Housing and Community Development] and [Local Government]",12,0,0,0,12
1214446,841734,2019-04-10,Assembly,"Do pass and be re-referred to the Committee on [Local Government]",6,1,1,0,8
1214446,853098,2019-04-24,Assembly,"Do pass and be re-referred to the Committee on [Appropriations]",5,2,1,0,8
1214446,866151,2019-05-16,Assembly,"Do pass",12,6,0,0,18
1214446,874373,2019-05-29,Assembly,"AB 1279 Bloom Assembly Third Reading",46,20,14,0,80
1214446,894778,2019-05-16,Assembly,Result,12,6,0,0,18
1214446,895254,2019-04-24,Assembly,Date,6,1,0,0,7
1214447,829239,2019-03-26,Assembly,"Do pass and be re-referred to the Committee on [Labor and Employment]",15,3,2,0,20
1214447,852801,2019-04-24,Assembly,"Do pass and be re-referred to the Committee on [Appropriations]",6,1,0,0,7
1214447,861419,2019-05-08,Assembly,"Do pass",13,5,0,0,18
1214447,866324,2019-05-16,Assembly,"AB 1291 Jones-Sawyer Assembly Third Reading",57,15,8,0,80
1214447,882935,2019-06-17,Senate,"Do pass as amended, but first amend, and re-refer to the Committee on [Labor, Public Employment and Retirement ]",8,0,1,0,9
1214447,888044,2019-06-26,Senate,"Do pass, but first be re-referred to the Committee on [Appropriations]",4,1,0,0,5
1214447,892704,2019-08-12,Senate,"Placed on suspense file",7,0,0,0,7
1214447,892705,2019-08-30,Senate,"Do pass as amended",5,2,0,0,7
1214447,892706,2019-09-05,Senate,"Assembly 3rd Reading AB1291 Jones-Sawyer By Caballero",31,9,0,0,40
1214447,892707,2019-09-09,Assembly,"AB 1291 Jones-Sawyer Concurrence in Senate Amendments",63,14,2,0,79
1214448,837230,2019-04-04,Assembly,"Be adopted. To third reading",9,0,3,0,12
1214448,862289,2019-05-09,Senate,"Special Consent ACR36",38,0,0,0,38
1214451,856249,2019-04-24,Assembly,"Do pass as amended and be re-referred to the Committee on [Appropriations]",15,0,0,0,15
1214451,861666,2019-05-08,Assembly,"Do pass. To Consent Calendar",18,0,0,0,18
1214451,866934,2019-05-16,Assembly,"AB 1166 Levine Consent Calendar Second Day Regular Session",74,0,6,0,80
1214451,890672,2019-07-09,Senate,"Do pass, but first be re-referred to the Committee on [Appropriations] with the recommendation: To Consent Calendar",15,0,1,0,16
1214451,890673,2019-08-12,Senate,"Placed on suspense file",7,0,0,0,7
1214451,890674,2019-08-30,Senate,"Do pass as amended",7,0,0,0,7
1214451,890675,2019-09-09,Senate,"Assembly 3rd Reading AB1166 Levine By Hill",40,0,0,0,40
1214451,890676,2019-09-10,Assembly,"AB 1166 Levine Concurrence in Senate Amendments",79,0,0,0,79
1214451,894015,2019-09-09,Senate,Result,40,0,0,0,40
1214452,855982,2019-04-30,Assembly,"Do pass as amended",12,0,0,0,12
1214452,862172,2019-05-09,Assembly,"AB 1188 Gabriel Assembly Third Reading",76,0,4,0,80
1214452,888139,2019-06-25,Senate,"Do pass as amended, and be ordered to the Consent Calendar",9,0,0,0,9
1214452,892727,2019-09-04,Senate,"Assembly 3rd Reading AB1188 Gabriel By Gonzalez",39,0,1,0,40
1214452,892728,2019-09-09,Assembly,"AB 1188 Gabriel Concurrence in Senate Amendments",78,1,0,0,79
1214453,851186,2019-04-23,Assembly,"Do pass and be re-referred to the Committee on [Governmental Organization]",11,0,0,0,11
1214453,852918,2019-04-24,Assembly,"Do pass as amended and be re-referred to the Committee on [Appropriations]",19,0,2,0,21
1214454,841607,2019-04-10,Assembly,"Be re-referred to the Committee on [Revenue and Taxation]",8,0,4,0,12
1214456,851157,2019-04-22,Assembly,"Do pass and be re-referred to the Committee on [Appropriations]",12,1,2,0,15
1214456,862018,2019-05-08,Assembly,"Do pass",15,0,3,0,18
1214456,863324,2019-05-13,Assembly,"AB 1226 Holden Assembly Third Reading",62,5,13,0,80
1214456,893835,2019-07-09,Senate,"Do pass, but first be re-referred to the Committee on [Appropriations]",9,3,1,0,13
1214456,893836,2019-08-19,Senate,"Placed on suspense file",5,0,2,0,7
1214456,894833,2019-08-19,Senate,Result,9,0,0,0,9
1214457,858087,2019-05-01,Assembly,"Do pass as amended",8,0,0,0,8
1214457,863278,2019-05-13,Assembly,"AB 1208 Ting Assembly Third Reading",76,0,4,0,80
1214457,885070,2019-06-19,Senate,"Do pass",6,0,1,0,7
1214457,891836,2019-08-22,Senate,"Assembly 3rd Reading AB1208 Ting et al. By McGuire",39,0,1,0,40
1214459,837169,2019-04-03,Assembly,"Do pass and be re-referred to the Committee on [Insurance]",7,0,0,0,7
1214459,852153,2019-04-24,Assembly,"Do pass and be re-referred to the Committee on [Appropriations] with recommendation: To Consent Calendar",14,0,0,0,14
1214459,856945,2019-05-01,Assembly,"Do pass as amended. To Consent Calendar",18,0,0,0,18
1214459,862268,2019-05-09,Assembly,"AB 1223 Aguiar-Curry Consent Calendar Second Day Regular Session",76,0,4,0,80
1214459,881187,2019-06-12,Senate,"Do pass, but first be re-referred to the Committee on [Insurance]",5,0,0,0,5
1214459,888696,2019-06-26,Senate,"Do pass, but first be re-referred to the Committee on [Appropriations]",13,0,0,0,13
1214459,892403,2019-09-03,Senate,"Assembly 3rd Reading AB1223 Arambula et al. By Rubio",40,0,0,0,40
1214459,892404,2019-09-05,Assembly,"AB 1223 Arambula Concurrence Vote: Final Form",79,0,0,0,79
1214460,841512,2019-04-09,Assembly,"Do pass and be re-referred to the Committee on [Judiciary]",6,1,1,0,8
1214460,851517,2019-04-24,Assembly,"Do pass",13,4,1,0,18
1214460,859504,2019-05-06,Assembly,"AB 1282 Kalra Assembly Third Reading",59,15,6,0,80
1214460,887583,2019-06-25,Senate,"Do pass, but first be re-referred to the Committee on [Appropriations]",5,1,1,0,7
1214460,891902,2019-08-12,Senate,"Placed on suspense file",7,0,0,0,7
1214460,891903,2019-08-30,Senate,"Do pass as amended",5,2,0,0,7
1214460,891904,2019-09-05,Senate,"Assembly 3rd Reading AB1282 Kalra By Skinner",29,10,1,0,40
1214460,891905,2019-09-09,Assembly,"AB 1282 Kalra Concurrence in Senate Amendments",61,16,2,0,79
1214461,850658,2019-04-22,Assembly,"Do pass and be re-referred to the Committee on [Appropriations]",13,0,2,0,15
1214461,861665,2019-05-08,Assembly,"Do pass",16,0,2,0,18
1214461,863129,2019-05-13,Assembly,"AB 1266 Robert Rivas Assembly Third Reading",68,0,12,0,80
1214461,880686,2019-06-11,Senate,"Do pass as amended, but first amend, and re-refer to the Committee on [Appropriations]",9,2,1,0,12
1214461,894058,2019-08-12,Senate,"Assembly 3rd Reading AB1266 Robert Rivas By Beall",30,4,6,0,40
1214461,894059,2019-08-19,Assembly,"AB 1266 Robert Rivas Concurrence in Senate Amendments",70,0,9,0,79
1214462,842851,2019-04-10,Assembly,"Do pass and be re-referred to the Committee on [Appropriations] with recommendation: To Consent Calendar",6,0,0,0,6
1214462,851615,2019-04-24,Assembly,"Do pass. To Consent Calendar",18,0,0,0,18
1214462,858167,2019-05-02,Assembly,"AB 1240 Weber Consent Calendar Second Day Regular Session",76,0,4,0,80
1214462,878545,2019-06-05,Senate,"Do pass as amended, but first amend, and re-refer to the Committee on [Appropriations] with the recommendation: To Consent Calendar",7,0,0,0,7
1214462,891572,2019-09-10,Senate,"Assembly 3rd Reading AB1240 Weber By Wilk",40,0,0,0,40
1214462,891573,2019-09-11,Assembly,"AB 1240 Weber Concurrence in Senate Amendments",79,0,0,0,79
1214463,831376,2019-03-27,Assembly,"Do pass and be re-referred to the Committee on [Appropriations]",6,2,0,0,8
1214463,866398,2019-05-16,Assembly,"Do pass",13,4,1,0,18
1214463,871692,2019-05-23,Assembly,"AB 1253 Robert Rivas Assembly Third Reading",59,17,4,0,80
1214465,835500,2019-04-02,Assembly,"Do pass as amended and be re-referred to the Committee on [Appropriations]",11,0,1,0,12
1214465,853092,2019-04-24,Assembly,"Do pass",18,0,0,0,18
1214465,860345,2019-05-06,Assembly,"AB 1251 Santiago Assembly Third Reading",76,0,4,0,80
1214465,893491,2019-07-09,Senate,"Do pass, but first be re-referred to the Committee on [Appropriations] with the recommendation: To Consent Calendar",8,0,1,0,9
1214465,893492,2019-08-15,Senate,"Consent Calendar AB1251",37,0,3,0,40
1214466,840304,2019-04-08,Assembly,"Do pass and be re-referred to the Committee on [Appropriations] with recommendation: To Consent Calendar",11,0,0,0,11
1214466,852235,2019-04-24,Assembly,"Do pass as amended",18,0,0,0,18
1214466,862083,2019-05-09,Assembly,"AB 1252 Robert Rivas Assembly Third Reading",76,0,4,0,80
1214466,878704,2019-06-05,Senate,"Do pass, but first be re-referred to the Committee on [Appropriations]",7,0,0,0,7
1214466,887055,2019-06-24,Senate,"Do pass",7,0,0,0,7
1214466,892333,2019-09-03,Senate,"Assembly 3rd Reading AB1252 Robert Rivas et al. By Durazo",40,0,0,0,40
1214466,892334,2019-09-05,Assembly,"AB 1252 Robert Rivas Concurrence in Senate Amendments",79,0,0,0,79
1214467,851265,2019-04-23,Assembly,"Do pass as amended and be re-referred to the Committee on [Judiciary]",11,0,0,0,11
1214467,855961,2019-04-30,Assembly,"Do pass as amended",11,0,1,0,12
1214467,871557,2019-05-23,Assembly,"AB 1190 Irwin Assembly Third Reading",77,0,3,0,80
1214469,839808,2019-04-09,Assembly,"Do pass as amended and be re-referred to the Committee on [Appropriations]",12,0,0,0,12
1214469,865688,2019-05-16,Assembly,"Do pass",18,0,0,0,18
1214469,872212,2019-05-24,Assembly,"AB 1165 Bauer-Kahan Assembly Third Reading",77,0,3,0,80
1214469,885329,2019-06-18,Senate,"Do pass, but first be re-referred to the Committee on [Appropriations] with the recommendation: To Consent Calendar",9,0,0,0,9
1214469,890484,2019-07-01,Senate,"Placed on suspense file",7,0,0,0,7
1214469,890485,2019-08-30,Senate,"Do pass as amended",7,0,0,0,7
1214469,890486,2019-09-04,Senate,"Assembly 3rd Reading AB1165 Bauer-Kahan et al. By Skinner",40,0,0,0,40
1214469,890487,2019-09-09,Assembly,"AB 1165 Bauer-Kahan Concurrence in Senate Amendments",77,0,2,0,79
1214472,850475,2019-04-23,Assembly,"Do pass as amended and be re-referred to the Committee on [Revenue and Taxation]",7,0,0,0,7
1214472,860595,2019-05-06,Assembly,"Do pass and be re-referred to the Committee on [Appropriations]",10,0,1,0,11
1214473,849872,2019-04-22,Assembly,"Do pass and be re-referred to the Committee on [Appropriations]",10,0,1,0,11
1214473,864916,2019-05-15,Assembly,"Do pass. To Consent Calendar",16,0,2,0,18
1214473,870246,2019-05-22,Assembly,"AB 1160 Dahle Consent Calendar Second Day Regular Session",77,0,3,0,80
1214473,880770,2019-06-11,Senate,"Do pass, but first be re-referred to the Committee on [Appropriations] with the recommendation: To Consent Calendar",8,0,1,0,9
1214473,891842,2019-07-01,Senate,"Consent Calendar AB1160",39,0,1,0,40
1214474,851766,2019-04-22,Assembly,"Do pass as amended and be re-referred to the Committee on [Appropriations]",7,2,2,0,11
1214474,866381,2019-05-16,Assembly,"Do pass",14,4,0,0,18
1214474,870952,2019-05-23,Assembly,"AB 1232 Gloria Assembly Third Reading",58,18,4,0,80
1214474,891199,2019-07-09,Senate,"Do pass as amended, but first amend, and re-refer to the Committee on [Environmental Quality]",8,0,1,0,9
1214474,891200,2019-08-12,Senate,"Placed on suspense file",7,0,0,0,7
1214474,891201,2019-08-30,Senate,"Do pass as amended",7,0,0,0,7
1214474,891202,2019-09-06,Senate,"Assembly 3rd Reading AB1232 Gloria et al. By Monning",39,0,1,0,40
1214474,891203,2019-09-09,Assembly,"AB 1232 Gloria Concurrence in Senate Amendments",69,5,5,0,79
1214474,894092,2019-09-06,Senate,"Assembly 3rd Reading AB1232 Gloria et al. By Monninss=""statusLabel"">Noes",7,0,0,0,7
1214476,841411,2019-04-09,Assembly,"Do pass and be re-referred to the Committee on [Appropriations]",11,3,1,0,15
1214476,865811,2019-05-16,Assembly,"Do pass as amended",13,4,1,0,18
1214476,874646,2019-05-29,Assembly,"AB 1246 Limón Assembly Third Reading",58,19,3,0,80
1214476,891708,2019-08-19,Senate,"Placed on suspense file",5,0,2,0,7
1214476,893600,2019-07-10,Senate,"Do pass as amended",7,1,1,0,9
1214477,854388,2019-04-23,Assembly,"Do pass as amended and be re-referred to the Committee on [Appropriations]",15,0,0,0,15
1214478,841555,2019-04-09,Assembly,"Do pass and be re-referred to the Committee on [Higher Education]",8,0,0,0,8
1214478,851289,2019-04-23,Assembly,"Do pass and be re-referred to the Committee on [Appropriations]",11,0,1,0,12
1214478,866045,2019-05-16,Assembly,"Do pass as amended",17,0,1,0,18
1214478,874364,2019-05-29,Assembly,"AB 1229 Wicks Assembly Third Reading",78,0,2,0,80
1214478,887526,2019-06-24,Senate,"Do pass as amended, but first amend, and re-refer to the Committee on [Education] with the recommendation: To Consent Calendar",6,0,0,0,6
1214478,892493,2019-07-10,Senate,"Do pass as amended, but first amend, and re-refer to the Committee on [Appropriations] with the recommendation: To Consent Calendar",7,0,0,0,7
1214478,892494,2019-08-12,Senate,"Placed on suspense file",7,0,0,0,7
1214480,841495,2019-04-09,Assembly,"Do pass",12,0,0,0,12
1214480,849314,2019-04-22,Assembly,"AB 1234 Patterson Assembly Third Reading",78,0,2,0,80
1214480,878883,2019-06-05,Senate,"Do pass as amended, and be ordered to the Consent Calendar",7,0,0,0,7
1214480,882824,2019-06-17,Senate,"Consent Calendar AB1234",40,0,0,0,40
1214480,890987,2019-08-26,Senate,"Assembly 3rd Reading AB1234 Patterson et al. By Wilk",39,0,1,0,40
1214480,890988,2019-08-30,Assembly,"AB 1234 Patterson Concurrence in Senate Amendments",73,0,6,0,79
1214481,901166,2019-04-01,Assembly,"Do pass and be re-referred to the Committee on [Natural Resources]",4,10,1,0,15
1214483,840036,2019-04-08,Assembly,"Do pass and be re-referred to the Committee on [Appropriations] with recommendation: To Consent Calendar",11,0,0,0,11
1214483,851653,2019-04-24,Assembly,"Do pass. To Consent Calendar",18,0,0,0,18
1214483,858206,2019-05-02,Assembly,"AB 1237 Aguiar-Curry Consent Calendar Second Day Regular Session",76,0,4,0,80
1214483,878264,2019-06-05,Senate,"Do pass, but first be re-referred to the Committee on [Appropriations] with the recommendation: To Consent Calendar",7,0,0,0,7
1214483,893010,2019-08-26,Senate,"Assembly 3rd Reading AB1237 Aguiar-Curry By Beall",39,0,1,0,40
1214483,893011,2019-08-30,Assembly,"AB 1237 Aguiar-Curry Concurrence in Senate Amendments",75,0,4,0,79
1214484,839972,2019-04-08,Assembly,"Do pass and be re-referred to the Committee on [Natural Resources]",14,0,1,0,15
1214484,849151,2019-04-22,Assembly,"Do pass as amended and be re-referred to the Committee on [Appropriations]",11,0,0,0,11
1214486,841735,2019-04-09,Assembly,"Do pass and be re-referred to the Committee on [Education]",12,0,0,0,12
1214486,852826,2019-04-24,Assembly,"Do pass and be re-referred to the Committee on [Appropriations]",7,0,0,0,7
1214487,852511,2019-04-23,Assembly,"Do pass and be re-referred to the Committee on [Appropriations]",11,0,1,0,12
1214487,861968,2019-05-08,Assembly,"Do pass. To Consent Calendar",18,0,0,0,18
1214487,865518,2019-05-16,Assembly,"AB 1278 Gabriel Consent Calendar Second Day Regular Session",74,0,6,0,80
1214487,884559,2019-06-19,Senate,"Do pass, but first be re-referred to the Committee on [Appropriations] with the recommendation: To Consent Calendar",6,0,1,0,7
1214487,893065,2019-09-03,Senate,"Assembly 3rd Reading AB1278 Gabriel By Hurtado",40,0,0,0,40
1214487,893066,2019-09-05,Assembly,"AB 1278 Gabriel Concurrence in Senate Amendments",78,0,1,0,79
1214489,851349,2019-04-23,Assembly,"Do pass and be re-referred to the Committee on [Appropriations]",6,2,0,0,8
1214492,860861,2019-05-06,Assembly,"Do pass and be re-referred to the Committee on [Appropriations]",11,0,0,0,11
1214495,831564,2019-03-27,Senate,"Do pass as amended, but first amend, and re-refer to the Committee on [Appropriations]",13,0,0,0,13
1214495,852956,2019-04-25,Senate,"Senate 3rd Reading SB497 Bradford",37,0,1,0,38
1214495,881022,2019-06-12,Assembly,"Do pass and be re-referred to the Committee on [Appropriations] with recommendation: To Consent Calendar",14,0,1,0,15
1214496,839999,2019-04-09,Assembly,"Do pass and be re-referred to the Committee on [Appropriations] with recommendation: To Consent Calendar",12,0,0,0,12
1214496,851868,2019-04-24,Assembly,"Do pass. To Consent Calendar",18,0,0,0,18
1214496,858210,2019-05-02,Assembly,"AB 1179 Blanca Rubio Consent Calendar Second Day Regular Session",76,0,4,0,80
1214496,878216,2019-06-04,Senate,"Do pass, but first be re-referred to the Committee on [Appropriations] with the recommendation: To Consent Calendar",9,0,0,0,9
1214496,889223,2019-07-01,Senate,"Consent Calendar AB1179",39,0,1,0,40
1214496,893887,2019-07-08,Assembly,"AB 1179 Blanca Rubio Concurrence in Senate Amendments",76,0,3,0,79
1214497,839760,2019-04-08,Assembly,"Do pass and be re-referred to the Committee on [Appropriations]",15,0,0,0,15
1214497,851637,2019-04-24,Assembly,"Do pass as amended. To Consent Calendar",18,0,0,0,18
1214497,859520,2019-05-06,Assembly,"AB 1183 Ramos Consent Calendar Second Day",77,0,3,0,80
1214497,880363,2019-06-11,Senate,"Do pass, but first be re-referred to the Committee on [Appropriations] with the recommendation: To Consent Calendar",11,0,1,0,12
1214497,889247,2019-07-01,Senate,"Consent Calendar AB1183",39,0,1,0,40
1214498,851554,2019-04-24,Assembly,"Do pass and be re-referred to the Committee on [Appropriations]",4,1,2,0,7
1214498,866275,2019-05-16,Assembly,"Do pass as amended",14,3,1,0,18
1214498,874620,2019-05-29,Assembly,"AB 1212 Levine Assembly Third Reading",58,15,7,0,80
1214498,888234,2019-06-26,Senate,"Do pass, but first be re-referred to the Committee on [Appropriations]",4,0,1,0,5
1214498,893710,2019-09-05,Senate,"Assembly 3rd Reading AB1212 Levine By Umberg",32,8,0,0,40
1214498,893711,2019-09-09,Assembly,"AB 1212 Levine Concurrence in Senate Amendments",60,17,2,0,79
1214500,841515,2019-04-09,Assembly,"Do pass and be re-referred to the Committee on [Accountability and Administrative Review]",8,0,0,0,8
1214500,852187,2019-04-24,Assembly,"Do pass and be re-referred to the Committee on [Appropriations] with recommendation: To Consent Calendar",7,0,0,0,7
1214500,862030,2019-05-08,Assembly,"Do pass. To Consent Calendar",18,0,0,0,18
1214500,865569,2019-05-16,Assembly,"AB 1199 Petrie-Norris",74,0,6,0,80
1214500,887759,2019-06-25,Senate,"Do pass, but first be re-referred to the Committee on [Appropriations] with the recommendation: To Consent Calendar",16,0,0,0,16
1214500,890873,2019-09-05,Senate,"Assembly 3rd Reading AB1199 Petrie-Norris By McGuire",40,0,0,0,40
1214501,834141,2019-04-02,Assembly,"Do pass and be re-referred to the Committee on [Appropriations]",19,0,1,0,20
1214501,865966,2019-05-16,Assembly,"Do pass",18,0,0,0,18
1214501,874504,2019-05-29,Assembly,"AB 1288 Cooley Assembly Third Reading By LACKEY",77,0,3,0,80
1214501,887038,2019-06-24,Senate,"Do pass, but first be re-referred to the Committee on [Agriculture]",9,0,0,0,9
1214501,892205,2019-07-02,Senate,"Do pass, but first be re-referred to the Committee on [Appropriations]",5,0,0,0,5
1214501,892206,2019-08-12,Senate,"Placed on suspense file",7,0,0,0,7
1214502,841099,2019-04-09,Assembly,"Do pass as amended and be re-referred to the Committee on [Appropriations]",9,3,0,0,12
1214502,866894,2019-05-16,Assembly,"Do pass",13,5,0,0,18
1214502,871396,2019-05-23,Assembly,"AB 1270 Mark Stone Assembly Third Reading",56,19,5,0,80
1214502,891496,2019-07-02,Senate,"Do pass, but first be re-referred to the Committee on [Governance and Finance]",7,2,0,0,9
1214502,891497,2019-07-10,Senate,"Do pass as amended, but first amend, and re-refer to the Committee on [Appropriations]",5,2,0,0,7
1214502,891498,2019-08-19,Senate,"Placed on suspense file",5,0,2,0,7
1214504,834382,2019-04-01,Assembly,"Do pass and be re-referred to the Committee on [Appropriations]",11,1,3,0,15
1214505,853095,2019-04-24,Assembly,"Do pass as amended and be re-referred to the Committee on [Appropriations]",7,0,0,0,7
1214505,865699,2019-05-16,Assembly,"Do pass",18,0,0,0,18
1214505,874565,2019-05-29,Assembly,"AB 1172 Frazier Assembly Third Reading",78,0,2,0,80
1214505,892276,2019-07-03,Senate,"Do pass, but first be re-referred to the Committee on [Appropriations] with the recommendation: To Consent Calendar",7,0,0,0,7
1214505,892277,2019-08-12,Senate,"Placed on suspense file",7,0,0,0,7
1214505,892278,2019-08-30,Senate,"Do pass as amended",7,0,0,0,7
1214505,892279,2019-09-04,Senate,"Assembly 3rd Reading AB1172 Frazier By Wilk",40,0,0,0,40
1214505,892280,2019-09-09,Assembly,"AB 1172 Frazier Concurrence in Senate Amendments",79,0,0,0,79
1214506,903166,2020-01-15,Assembly,"Do pass and be re-referred to the Committee on [Local Government]",4,0,3,0,7
1214506,903167,2020-01-15,Assembly,"Do pass",6,0,2,0,8
1214506,905358,2020-01-23,Assembly,"AB 1276 Bonta Assembly Third Reading",56,0,24,0,80
1214506,974817,2020-08-04,Senate,"Do pass",4,1,0,0,5
1214506,976609,2020-08-24,Senate,"Assembly 3rd Reading AB1276 Bonta By Umberg",29,11,0,0,40
1214506,976917,2020-08-26,Assembly,"AB 1276 Bonta Concurrence in Senate Amendments",58,14,7,0,79
1214508,834816,2019-03-27,Assembly,"Do pass as amended and be re-referred to the Committee on [Appropriations]",6,0,0,0,6
1214508,866513,2019-05-16,Assembly,"Do pass as amended",18,0,0,0,18
1214508,874545,2019-05-29,Assembly,"AB 1233 Smith Assembly Third Reading",78,0,2,0,80
1214508,891614,2019-07-10,Senate,"Do pass, but first be re-referred to the Committee on [Appropriations] with the recommendation: To Consent Calendar",7,0,0,0,7
1214508,891615,2019-08-12,Senate,"Placed on suspense file",7,0,0,0,7
1214508,891616,2019-08-30,Senate,"Do pass",7,0,0,0,7
1214508,891617,2019-09-09,Senate,"Special Consent AB1233",40,0,0,0,40
1214508,891618,2019-09-10,Assembly,"AB 1233 Smith Concurrence in Senate Amendments",79,0,0,0,79
1214509,841516,2019-04-09,Assembly,"Do pass and be re-referred to the Committee on [Aging and Long-Term Care] with recommendation: To Consent Calendar",8,0,0,0,8
1214509,850073,2019-04-23,Assembly,"Do pass and be re-referred to the Committee on [Appropriations]",7,0,0,0,7
1214509,865724,2019-05-16,Assembly,"Do pass",18,0,0,0,18
1214509,871423,2019-05-23,Assembly,"AB 1287 Nazarian Assembly Third Reading",77,0,3,0,80
1214509,890817,2019-07-08,Senate,"Do pass, but first be re-referred to the Committee on [Appropriations] with the recommendation: To Consent Calendar",6,0,0,0,6
1214509,890818,2019-08-12,Senate,"Placed on suspense file",7,0,0,0,7
1214509,890819,2019-08-30,Senate,"Do pass as amended",7,0,0,0,7
1214509,890820,2019-09-06,Senate,"Assembly 3rd Reading AB1287 Nazarian et al. By Hurtado",39,0,1,0,40
1214509,890821,2019-09-09,Assembly,"AB 1287 Nazarian Concurrence in Senate Amendments",79,0,0,0,79
1214509,894770,2019-08-12,Senate,Result,6,0,0,0,6
1214510,834401,2019-03-27,Assembly,"Do pass as amended and be re-referred to the Committee on [Appropriations]",5,0,1,0,6
1214510,867003,2019-05-16,Assembly,"Do pass",15,1,2,0,18
1214510,874548,2019-05-29,Assembly,"AB 1219 Jones-Sawyer Assembly Third Reading",68,0,12,0,80
1214510,891868,2019-07-10,Senate,"Do pass, but first be re-referred to the Committee on [Appropriations]",5,0,2,0,7
1214510,891869,2019-08-19,Senate,"Placed on suspense file",5,0,2,0,7
1214510,891870,2019-08-30,Senate,"Do pass as amended",5,2,0,0,7
1214510,891871,2019-09-11,Senate,"Assembly 3rd Reading AB1219 Jones-Sawyer By Durazo",31,5,4,0,40
1214510,893750,2019-09-12,Assembly,"AB 1219 Jones-Sawyer Concurrence in Senate Amendments",75,0,4,0,79
1214514,849930,2019-04-22,Assembly,"Do pass and be re-referred to the Committee on [Local Government]",7,0,4,0,11
1214514,853118,2019-04-24,Assembly,"Do pass and be re-referred to the Committee on [Appropriations]",7,0,1,0,8
1214514,865830,2019-05-16,Assembly,"Do pass",18,0,0,0,18
1214514,870103,2019-05-22,Assembly,"AB 1191 Bonta Assembly Third Reading",69,1,10,0,80
1214514,887603,2019-06-25,Senate,"Do pass as amended, but first amend, and re-refer to the Committee on [Appropriations]",9,0,0,0,9
1214514,890804,2019-08-12,Senate,"Placed on suspense file",7,0,0,0,7
1214514,890805,2019-08-30,Senate,"Do pass",7,0,0,0,7
1214514,890806,2019-09-09,Senate,"Assembly 3rd Reading AB1191 Bonta et al. By Wieckowski",40,0,0,0,40
1214514,890807,2019-09-11,Assembly,"With recommendation: That Senate amendments be concurred in",9,0,2,0,11
1214514,893776,2019-09-12,Assembly,"AB 1191 Bonta Concurrence in Senate Amendments",72,1,6,0,79
1214515,836555,2019-04-03,Assembly,"Do pass and be re-referred to the Committee on [Insurance]",5,1,1,0,7
1214515,851649,2019-04-24,Assembly,"Do pass and be re-referred to the Committee on [Appropriations]",14,0,0,0,14
1214516,853125,2019-04-25,Assembly,"Do pass as amended and be re-referred to the Committee on [Appropriations]",6,0,1,0,7
1214516,866003,2019-05-16,Assembly,"Do pass",15,2,1,0,18
1214516,874575,2019-05-29,Assembly,"AB 1217 Mullin Assembly Third Reading",65,4,11,0,80
1214518,834212,2019-04-02,Assembly,"Do pass and be re-referred to the Committee on [Human Services]",8,0,0,0,8
1214518,849974,2019-04-23,Assembly,"Do pass",8,0,0,0,8
1214518,858279,2019-05-02,Assembly,"AB 1221 Cooley Assembly Third Reading",77,0,3,0,80
1214518,880505,2019-06-11,Senate,"Do pass, but first be re-referred to the Committee on [Human Services] with the recommendation: To Consent Calendar",7,0,0,0,7
1214518,887515,2019-06-24,Senate,"Do pass and be ordered to the Consent Calendar",6,0,0,0,6
1214518,889314,2019-07-01,Senate,"Consent Calendar AB1221",39,0,1,0,40
1214518,892425,2019-07-08,Assembly,"AB 1221 Cooley Concurrence in Senate Amendments",77,0,2,0,79
1214519,841543,2019-04-09,Assembly,"Do pass as amended and be re-referred to the Committee on [Appropriations]",9,4,1,0,14
1214519,865902,2019-05-16,Assembly,"Do pass",13,5,0,0,18
1214519,871457,2019-05-23,Assembly,"AB 1254 Kamlager-Dove Assembly Third Reading",54,21,5,0,80
1214519,892137,2019-07-09,Senate,"Do pass as amended, but first amend, and re-refer to the Committee on [Appropriations]",5,2,2,0,9
1214519,892138,2019-08-12,Senate,"Placed on suspense file",7,0,0,0,7
1214519,892139,2019-08-30,Senate,"Do pass as amended",5,1,1,0,7
1214519,892140,2019-09-09,Senate,"Assembly 3rd Reading AB1254 Kamlager-Dove et al. By Allen",31,8,1,0,40
1214519,892141,2019-09-10,Assembly,"AB 1254 Kamlager-Dove Concurrence in Senate Amendments",57,20,2,0,79
1214520,831784,2019-03-28,Assembly,"Be re-referred to the Committees on [Human Services] and [Health]",10,0,2,0,12
1214520,840242,2019-04-09,Assembly,"Do pass and be re-referred to the Committee on [Health] with recommendation: To Consent Calendar",8,0,0,0,8
1214520,850892,2019-04-23,Assembly,"Do pass and be re-referred to the Committee on [Appropriations] with recommendation: To Consent Calendar",15,0,0,0,15
1214520,866313,2019-05-16,Assembly,"Do pass",18,0,0,0,18
1214520,871082,2019-05-23,Assembly,"AB 1227 Obernolte Assembly Third Reading",78,0,2,0,80
1214520,887821,2019-06-24,Senate,"Do pass, but first be re-referred to the Committee on [Appropriations]",6,0,0,0,6
1214520,890814,2019-08-12,Senate,"Placed on suspense file",7,0,0,0,7
1214520,890815,2019-08-30,Senate,"Do pass",7,0,0,0,7
1214520,890816,2019-09-09,Senate,"Special Consent AB1227",40,0,0,0,40
1214521,853691,2019-04-24,Assembly,"Do pass as amended and be re-referred to the Committee on [Appropriations]",8,0,0,0,8
1214521,864908,2019-05-15,Assembly,"Do pass. To Consent Calendar",16,0,2,0,18
1214521,870025,2019-05-22,Assembly,"AB 1248 Eduardo Garcia Consent Calendar Second Day Regular Session",77,0,3,0,80
1214521,885033,2019-06-19,Senate,"Do pass as amended, but first amend, and re-refer to the Committee on [Appropriations]",5,0,2,0,7
1214521,890677,2019-07-08,Senate,"Placed on suspense file",7,0,0,0,7
1214521,890678,2019-08-30,Senate,"Do pass as amended",7,0,0,0,7
1214524,841964,2019-04-09,Assembly,"Do pass and be re-referred to the Committee on [Appropriations] with recommendation: To Consent Calendar",8,0,0,0,8
1214525,852129,2019-04-23,Assembly,"Do pass as amended",15,0,0,0,15
1214525,861669,2019-05-08,Assembly,"Do pass. To Consent Calendar",18,0,0,0,18
1214525,865991,2019-05-16,Assembly,"AB 1161 Calderon Consent Calendar Second Day Regular Session",74,0,6,0,80
1214525,975357,2020-08-10,Senate,"Do pass, but first be re-referred to the Committee on [Appropriations]",8,0,1,0,9
1214525,976028,2020-08-17,Senate,"Placed on suspense file",7,0,0,0,7
1214525,976469,2020-08-20,Senate,"Do pass",7,0,0,0,7
1214525,977331,2020-08-28,Senate,"Special Consent AB1161",39,0,1,0,40
1214525,977875,2020-08-30,Assembly,"AB 1161 Calderon Concurrence in Senate Amendments",75,0,4,0,79
1214526,860671,2019-05-07,Assembly,"Be adopted as amended",9,3,0,0,12
1214526,867766,2019-05-20,Assembly,"AJR 9 Cristina Garcia Assembly Third Reading",55,11,14,0,80
1214526,880279,2019-06-11,Senate,"Be adopted. Ordered to third reading",7,2,0,0,9
1214526,888436,2019-06-27,Senate,"Assembly 3rd Reading AJR9 Cristina Garcia et a By Caballero",27,8,5,0,40
1214529,851810,2019-04-23,Assembly,"Do pass as amended and be re-referred to the Committee on [Judiciary]",8,3,0,0,11
1214529,855788,2019-04-30,Assembly,"Do pass as amended",9,3,0,0,12
1214529,867862,2019-05-20,Assembly,"AB 1286 Muratsuchi Assembly Third Reading",49,12,19,0,80
1214529,976080,2020-08-18,Senate,"Do pass",7,2,0,0,9
1214529,978149,2020-08-30,Senate,"Assembly 3rd Reading AB1286 Muratsuchi By Jackson",32,4,4,0,40
1214529,978150,2020-08-30,Assembly,"AB 1286 Muratsuchi Concurrence in Senate Amendments",57,15,7,0,79
1214530,835498,2019-04-02,Assembly,"Do pass and be re-referred to the Committee on [Appropriations]",14,1,0,0,15
1214530,841647,2019-04-10,Assembly,"Do pass",17,0,1,0,18
1214530,848901,2019-04-22,Assembly,"AB 1178 Quirk Assembly Third Reading",74,1,5,0,80
1214530,893249,2019-07-03,Senate,"Do pass, but first be re-referred to the Committee on [Appropriations]",7,0,2,0,9
1214530,893250,2019-08-12,Senate,"Placed on suspense file",7,0,0,0,7
1214531,841920,2019-04-09,Assembly,"Do pass as amended, and be re-referred to the Committee on [Appropriations] with recommendation: To Consent Calendar",8,0,0,0,8
1214531,851391,2019-04-24,Assembly,"Do pass. To Consent Calendar",18,0,0,0,18
1214531,858269,2019-05-02,Assembly,"AB 1235 Chu Consent Calendar Second Day Regular Session",76,0,4,0,80
1214531,880434,2019-06-10,Senate,"Do pass, but first be re-referred to the Committee on [Appropriations]",5,0,1,0,6
1214531,890419,2019-08-26,Senate,"Assembly 3rd Reading AB1235 Chu et al. By Caballero",39,0,1,0,40
1214531,890420,2019-08-30,Assembly,"AB 1235 Chu Concurrence in Senate Amendments",74,0,5,0,79
1214532,853100,2019-04-23,Assembly,"Do pass as amended",7,0,0,0,7
1214532,874420,2019-05-29,Assembly,"AB 1274 Arambula Assembly Third Reading",77,0,3,0,80
1214534,902195,2020-01-13,Assembly,"Be re-referred to the Committees on [Business and Professions] and [Privacy and Consumer Protection]",12,0,0,0,12
1214534,902809,2020-01-14,Assembly,"Do pass and be re-referred to the Committee on [Privacy and Consumer Protection]",18,0,1,0,19
1214534,902810,2020-01-14,Assembly,"Do pass and be re-referred to the Committee on [Appropriations] with recommendation: To Consent Calendar",11,0,0,0,11
1214534,905337,2020-01-23,Assembly,"Do pass. To Consent Calendar",18,0,0,0,18
1214534,912002,2020-01-30,Assembly,"AB 1263 Low Consent Calendar Second Day Regular Session",76,0,4,0,80
1214535,811753,2019-02-28,Assembly,"Be adopted. To Consent Calendar",11,0,1,0,12
1214535,816767,2019-03-07,Assembly,"ACR 39 Gabriel Consent Calendar Second Day Regular Session",74,0,6,0,80
1214535,831628,2019-03-28,Senate,"Special Consent ACR39",35,0,3,0,38
1214535,833155,2019-04-01,Assembly,"ACR 39 Gabriel Concurrence in Senate Amendments",76,0,4,0,80
1214536,849489,2019-04-09,Assembly,"Do pass as amended and be re-referred to the Committee on [Appropriations]",15,0,0,0,15
1214536,865821,2019-05-16,Assembly,"Do pass as amended",18,0,0,0,18
1214536,873757,2019-05-28,Assembly,"AB 1175 Wood Assembly Third Reading",75,0,5,0,80
1214536,891787,2019-07-03,Senate,"Do pass, but first be re-referred to the Committee on [Rules]",8,0,1,0,9
1214536,891788,2019-08-19,Senate,"Placed on suspense file",5,0,2,0,7
1214536,891789,2019-08-30,Senate,"Do pass as amended",7,0,0,0,7
1214536,891790,2019-09-04,Senate,"Assembly 3rd Reading AB1175 Wood By Pan",40,0,0,0,40
1214536,891791,2019-09-06,Assembly,"With recommendation: That Senate amendments be concurred in",12,0,3,0,15
1214536,891792,2019-09-09,Assembly,"AB 1175 Wood Concurrence in Senate Amendments",79,0,0,0,79
1214537,902824,2020-01-14,Assembly,"Do pass as amended and be re-referred to the Committee on [Appropriations]",6,0,2,0,8
1214538,855888,2019-04-23,Assembly,"Do pass as amended and be re-referred to the Committee on [Appropriations]",14,0,1,0,15
1214538,865880,2019-05-16,Assembly,"Do pass",16,0,2,0,18
1214538,874486,2019-05-29,Assembly,"AB 1249 Maienschein Assembly Third Reading",76,0,4,0,80
1214538,892501,2019-07-10,Senate,"Do pass as amended, but first amend, and re-refer to the Committee on [Appropriations]",8,0,1,0,9
1214538,892502,2019-08-12,Senate,"Placed on suspense file",7,0,0,0,7
1214538,892503,2019-08-30,Senate,"Do pass as amended",5,2,0,0,7
1214538,892504,2019-09-10,Senate,"Assembly 3rd Reading AB1249 Maienschein By Hertzberg",31,8,1,0,40
1214538,892505,2019-09-11,Assembly,"AB 1249 Maienschein Concurrence in Senate Amendments",77,0,2,0,79
1214538,896052,2019-09-10,Senate,"l"">Noes",5,8,0,0,13
1214540,850443,2019-04-22,Assembly,"Do pass and be re-referred to the Committee on [Housing and Community Development]",8,1,2,0,11
1214540,851230,2019-04-24,Assembly,"Do pass as amended and be re-referred to the Committee on [Appropriations]",7,0,1,0,8
1214540,864903,2019-05-15,Assembly,"Do pass",16,0,2,0,18
1214540,873891,2019-05-28,Assembly,"AB 1197 Santiago Assembly Third Reading",72,0,8,0,80
1214540,884738,2019-06-19,Senate,"Do pass as amended, but first amend, and re-refer to the Committee on [Appropriations]",7,0,0,0,7
1214540,893138,2019-09-10,Senate,"Assembly 3rd Reading AB1197 Santiago et al. By Hertzberg Urgency Clause",35,0,5,0,40
1214540,893139,2019-09-11,Assembly,"AB 1197 Santiago Concurrence - Urgency Added",76,0,3,0,79
1214542,841357,2019-04-09,Assembly,"Do pass as amended and be re-referred to the Committee on [Appropriations]",11,3,0,0,14
1214542,866083,2019-05-16,Assembly,"Do pass",14,4,0,0,18
1214542,871302,2019-05-23,Assembly,"AB 1260 Maienschein Assembly Third Reading",63,12,5,0,80
1214542,887525,2019-06-25,Senate,"Do pass, but first be re-referred to the Committee on [Appropriations]",7,2,0,0,9
1214542,891005,2019-07-08,Senate,"Placed on suspense file",7,0,0,0,7
1214542,891006,2019-08-30,Senate,"Do pass",5,1,1,0,7
1214542,891007,2019-09-04,Senate,"Assembly 3rd Reading AB1260 Maienschein By Stern",31,8,1,0,40
1214544,842918,2019-04-10,Assembly,"Do pass as amended and be re-referred to the Committee on [Appropriations]",13,0,2,0,15
1215195,841684,2019-04-10,Senate,"Do pass, but first be re-referred to the Committee on [Appropriations]",3,0,2,0,5
1215195,849739,2019-04-22,Senate,"Placed on suspense file",6,0,0,0,6
1215195,866363,2019-05-16,Senate,"Do pass",5,0,1,0,6
1215195,868927,2019-05-21,Senate,"Senate 3rd Reading SB542 Stern",33,3,2,0,38
1215195,892381,2019-07-10,Assembly,"Do pass as amended and be re-referred to the Committee on [Appropriations]",13,0,1,0,14
1215195,892382,2019-08-30,Assembly,"Do pass",18,0,0,0,18
1215195,892383,2019-09-10,Assembly,"SB 542 Stern Senate Third Reading By Irwin",77,0,2,0,79
1215195,892384,2019-09-11,Senate,"Unfinished Business SB542 Stern et al. Concurrence",39,0,1,0,40
1215199,840053,2019-04-03,Senate,"Do pass as amended, but first amend, and re-refer to the Committee on [Appropriations]",7,0,0,0,7
1215199,854871,2019-04-29,Senate,"Placed on suspense file",6,0,0,0,6
1215199,865645,2019-05-16,Senate,"Do pass",6,0,0,0,6
1215199,871001,2019-05-23,Senate,"Special Consent SB554",38,0,0,0,38
1215199,886022,2019-06-19,Assembly,"Do pass and be re-referred to the Committee on [Higher Education]",7,0,0,0,7
1215199,888001,2019-06-25,Assembly,"Do pass and be re-referred to the Committee on [Appropriations]",12,0,0,0,12
1215199,893178,2019-08-30,Assembly,"Do pass",18,0,0,0,18
1215199,893179,2019-09-05,Assembly,"SB 554 Roth Senate Third Reading By Gabriel",79,0,0,0,79
1215199,896081,2019-05-23,Senate,"Senate F",38,0,0,0,38
1215203,892774,2019-09-05,Assembly,"Be re-referred to the Committees on [Water, Parks, and Wildlife] and [Natural Resources]",11,0,1,0,12
1215207,856742,2019-04-30,Senate,"Do pass",9,0,0,0,9
1215207,862246,2019-05-09,Senate,"Senate 3rd Reading SB544 Umberg",37,0,1,0,38
1215207,877865,2019-06-04,Assembly,"Do pass as amended",11,0,1,0,12
1215207,894076,2019-07-08,Assembly,"SB 544 Umberg Senate Third Reading By Wicks",77,0,2,0,79
1215207,894077,2019-07-11,Senate,"Unfinished Business SB544 Umberg Concurrence",39,0,1,0,40
1215215,850276,2019-04-23,Senate,"Do pass, but first be re-referred to the Committee on [Appropriations]",6,3,0,0,9
1215215,859518,2019-05-06,Senate,"Placed on suspense file",5,0,1,0,6
1215215,865735,2019-05-16,Senate,"Do pass as amended",4,2,0,0,6
1215215,874540,2019-05-29,Senate,"Senate 3rd Reading SB551 Jackson",22,13,3,0,38
1215215,892545,2019-07-08,Assembly,"Do pass as amended and be re-referred to the Committee on [Appropriations]",8,3,0,0,11
1215215,892546,2019-08-30,Assembly,"Do pass as amended",13,5,0,0,18
1215215,892547,2019-09-10,Assembly,"SB 551 Jackson Senate Third Reading By Muratsuchi",50,17,12,0,79
1215215,893689,2019-09-12,Senate,"Unfinished Business SB551 Jackson Concurrence",29,11,0,0,40
1215220,851451,2019-04-24,Senate,"Do pass, but first be re-referred to the Committee on [Appropriations]",12,1,0,0,13
1215220,859568,2019-05-06,Senate,"Placed on suspense file",5,0,1,0,6
1215220,865796,2019-05-16,Senate,"Do pass",4,1,1,0,6
1215220,868731,2019-05-21,Senate,"Senate 3rd Reading SB550 Hill",34,3,1,0,38
1215220,891095,2019-07-10,Assembly,"Do pass as amended and be re-referred to the Committee on [Appropriations]",14,0,1,0,15
1215220,891096,2019-08-21,Assembly,"Do pass",17,0,1,0,18
1215220,891097,2019-09-10,Assembly,"SB 550 Hill Senate Third Reading By Holden",79,0,0,0,79
1215220,893794,2019-09-12,Senate,"That the Assembly amendments be concurred in",11,0,2,0,13
1215220,894229,2019-09-13,Senate,"Unfinished Business SB550 Hill et al. Concurrence",39,1,0,0,40
1215233,852224,2019-04-23,Assembly,"Do pass and be re-referred to the Committee on [Appropriations]",8,0,0,0,8
1215233,861981,2019-05-08,Assembly,"Do pass. To Consent Calendar",18,0,0,0,18
1215233,865993,2019-05-16,Assembly,"AB 1379 Quirk Consent Calendar Second Day Regular Session",74,0,6,0,80
1215238,834043,2019-04-02,Assembly,"Do pass",5,2,1,0,8
1215238,863117,2019-05-13,Assembly,"AB 1297 McCarty Assembly Third Reading",48,21,11,0,80
1215238,892742,2019-07-02,Senate,"Do pass",5,2,0,0,7
1215238,892743,2019-09-09,Senate,"Assembly 3rd Reading AB1297 McCarty By Skinner",27,12,1,0,40
1215245,840458,2019-04-09,Senate,"Do pass, but first be re-referred to the Committee on [Appropriations]",7,0,0,0,7
1215245,855235,2019-04-29,Senate,"Placed on suspense file",6,0,0,0,6
1215245,866246,2019-05-16,Senate,"Do pass",5,1,0,0,6
1215245,869958,2019-05-22,Senate,"Senate 3rd Reading SB545 Hill et al. Urgency Clause",35,1,2,0,38
1215251,835896,2019-04-03,Senate,"Do pass, but first be re-referred to the Committee on [Appropriations] with the recommendation: To Consent Calendar",7,0,0,0,7
1215251,854918,2019-04-29,Senate,"Do pass",6,0,0,0,6
1215251,859511,2019-05-06,Senate,"Senate 3rd Reading SB552 Archuleta",38,0,0,0,38
1215251,877657,2019-06-04,Assembly,"Do pass and be re-referred to the Committee on [Appropriations] with recommendation: To Consent Calendar",8,0,1,0,9
1215251,892907,2019-08-21,Assembly,"Do pass. To Consent Calendar",17,0,1,0,18
1215251,892908,2019-09-10,Assembly,"SB 552 Archuleta Senate Third Reading By Luz Rivas",79,0,0,0,79
1215251,892909,2019-09-11,Senate,"Unfinished Business SB552 Archuleta Concurrence",40,0,0,0,40
1215257,842808,2019-04-10,Assembly,"Do pass and be re-referred to the Committee on [Appropriations]",6,0,0,0,6
1215257,865976,2019-05-16,Assembly,"Do pass",18,0,0,0,18
1215257,874461,2019-05-29,Assembly,"AB 1303 O'Donnell Assembly Third Reading",78,0,2,0,80
1215257,891925,2019-07-03,Senate,"Do pass",7,0,0,0,7
1215257,891926,2019-08-22,Senate,"Special Consent AB1303",39,0,1,0,40
1215257,891927,2019-09-11,Assembly,"With recommendation: That Senate amendments be concurred in",6,0,1,0,7
1215257,893742,2019-09-12,Assembly,"AB 1303 O'Donnell Concurrence in Senate Amendments",79,0,0,0,79
1215261,851442,2019-04-23,Assembly,"Do pass and be re-referred to the Committee on [Appropriations]",6,0,2,0,8
1215261,864897,2019-05-15,Assembly,"Do pass",12,0,6,0,18
1215261,874839,2019-05-29,Assembly,"AB 1301 Cooley Assembly Third Reading By REYES",60,0,20,0,80
1215261,891255,2019-07-08,Senate,"Do pass, but first be re-referred to the Committee on [Judiciary]",6,0,0,0,6
1215261,891256,2019-07-09,Senate,"Do pass, but first be re-referred to the Committee on [Appropriations] with the recommendation: To Consent Calendar",8,0,1,0,9
1215261,891257,2019-09-09,Senate,"Assembly 3rd Reading AB1301 Cooley By Hurtado",40,0,0,0,40
1215261,891258,2019-09-10,Assembly,"AB 1301 Cooley Concurrence in Senate Amendments",79,0,0,0,79
1215274,841856,2019-04-09,Senate,"Do pass, but first be re-referred to the Committee on [Public Safety] with the recommendation: To Consent Calendar",8,0,0,0,8
1215274,852039,2019-04-23,Senate,"Do pass, but first be re-referred to the Committee on [Appropriations]",6,0,1,0,7
1215274,859663,2019-05-06,Senate,"Placed on suspense file",5,0,1,0,6
1215274,866328,2019-05-16,Senate,"Do pass as amended",6,0,0,0,6
1215274,871565,2019-05-23,Senate,"Senate 3rd Reading SB591 Galgiani",38,0,0,0,38
1215274,887457,2019-06-25,Assembly,"Do pass and be re-referred to the Committee on [Appropriations]",8,0,0,0,8
1215274,891651,2019-08-14,Assembly,"Do pass",18,0,0,0,18
1215274,891652,2019-09-10,Assembly,"SB 591 Galgiani Senate Third Reading By Lackey",78,0,1,0,79
1215274,891653,2019-09-11,Senate,"Unfinished Business SB591 Galgiani Concurrence",40,0,0,0,40
1215289,836763,2019-04-03,Senate,"Do pass, but first be re-referred to the Committee on [Judiciary]",8,0,1,0,9
1215289,851472,2019-04-23,Senate,"Do pass, but first be re-referred to the Committee on [Appropriations] with the recommendation: To Consent Calendar",9,0,0,0,9
1215289,859472,2019-05-06,Senate,"Placed on suspense file",5,0,1,0,6
1215289,865594,2019-05-16,Senate,"Do pass",6,0,0,0,6
1215289,870088,2019-05-22,Senate,"Senate 3rd Reading SB590 Stone",38,0,0,0,38
1215289,891474,2019-07-02,Assembly,"Do pass and be re-referred to the Committee on [Appropriations]",14,0,1,0,15
1215297,851338,2019-04-24,Senate,"Do pass, but first be re-referred to the Committee on [Appropriations]",11,1,1,0,13
1215297,863189,2019-05-13,Senate,"Placed on suspense file",6,0,0,0,6
1215302,834302,2019-04-02,Assembly,"Do pass and be re-referred to the Committee on [Revenue and Taxation] with recommendation: To Consent Calendar",8,0,0,0,8
1215302,850446,2019-04-22,Assembly,"Do pass as amended and be re-referred to the Committee on [Appropriations]",10,0,1,0,11
1215302,866080,2019-05-16,Assembly,"Do pass",18,0,0,0,18
1215302,874463,2019-05-29,Assembly,"AB 1296 Gonzalez Assembly Third Reading",77,0,3,0,80
1215302,892201,2019-07-02,Senate,"Do pass, but first be re-referred to the Committee on [Governance and Finance]",7,0,0,0,7
1215302,892202,2019-07-10,Senate,"Do pass as amended, but first amend, and re-refer to the Committee on [Appropriations]",7,0,0,0,7
1215302,892203,2019-08-19,Senate,"Placed on suspense file",5,0,2,0,7
1215302,892204,2019-08-30,Senate,"Do pass",7,0,0,0,7
1215302,893917,2019-09-14,Assembly,"AB 1296 Gonzalez Concurrence in Senate Amendments",78,0,1,0,79
1215302,894162,2019-09-13,Senate,"Assembly 3rd Reading AB1296 Gonzalez By Galgiani",40,0,0,0,40
1215302,894954,2019-07-10,Senate,"Bill Votes",7,0,0,0,7
1215310,839986,2019-04-09,Senate,"Do pass, but first be re-referred to the Committee on [Appropriations]",6,4,6,0,16
1215310,839987,2019-04-09,Senate,"[First] hearing set for [04-09-2019]: Failed passage in Committee. Reconsideration granted",16,0,0,0,16
1215314,839783,2019-04-08,Assembly,"Do pass and be re-referred to the Committee on [Appropriations] with recommendation: To Consent Calendar",11,0,0,0,11
1215321,839859,2019-04-03,Senate,"Do pass as amended, but first amend, and re-refer to the Committee on [Appropriations]",6,0,1,0,7
1215321,854819,2019-04-29,Senate,"Placed on suspense file",6,0,0,0,6
1215321,865646,2019-05-16,Senate,"Do pass as amended",6,0,0,0,6
1215321,871531,2019-05-23,Senate,"Senate 3rd Reading SB541 Bates et al",38,0,0,0,38
1215321,885716,2019-06-19,Assembly,"Do pass and be re-referred to the Committee on [Appropriations]",7,0,0,0,7
1215321,891271,2019-09-10,Assembly,"SB 541 Bates Senate Third Reading By Gonzalez",79,0,0,0,79
1215321,891272,2019-09-11,Senate,"Unfinished Business SB541 Bates et al. Concurrence",40,0,0,0,40
1215321,893520,2019-08-30,Assembly,"Do pass as amended",18,0,0,0,18
1215328,834104,2019-04-02,Senate,"Do pass, but first be re-referred to the Committee on [Appropriations]",13,0,0,0,13
1215328,862207,2019-05-09,Senate,"Senate 3rd Reading SB548 Hill",38,0,0,0,38
1215328,890864,2019-07-10,Assembly,"Do pass and be re-referred to the Committee on [Appropriations] with recommendation: To Consent Calendar",15,0,0,0,15
1215328,890865,2019-08-14,Assembly,"Do pass",18,0,0,0,18
1215332,851774,2019-04-23,Senate,"Do pass, but first be re-referred to the Committee on [Appropriations] with the recommendation: To Consent Calendar",12,0,0,0,12
1215332,859818,2019-05-06,Senate,"Do pass",5,0,1,0,6
1215332,863307,2019-05-13,Senate,"Senate 3rd Reading SB543 Pan",37,0,1,0,38
1215332,894111,2019-07-01,Assembly,"Do pass and be re-referred to the Committee on [Governmental Organization]",14,0,1,0,15
1215332,894112,2019-07-10,Assembly,"Do pass and be re-referred to the Committee on [Appropriations] with recommendation: To Consent Calendar",19,0,2,0,21
1215332,894113,2019-08-14,Assembly,"Do pass",18,0,0,0,18
1215332,894114,2019-08-22,Assembly,"SB 543 Pan Senate Third Reading By McCarty",72,0,7,0,79
1215336,851786,2019-04-23,Assembly,"Do pass and be re-referred to the Committee on [Appropriations]",6,2,0,0,8
1215432,851908,2019-04-24,Senate,"Do pass, but first be re-referred to the Committee on [Appropriations]",1,2,2,0,5
1215432,851909,2019-04-24,Senate,"[First] hearing set for [04-24-2019]: Failed passage in Committee. Reconsideration granted",5,0,0,0,5
1215433,841637,2019-04-10,Assembly,"Do pass and be re-referred to the Committee on [Local Government]",8,0,0,0,8
1215433,853327,2019-04-24,Assembly,"Do pass and be re-referred to the Committee on [Appropriations] with recommendation: To Consent Calendar",8,0,0,0,8
1215433,866344,2019-05-16,Assembly,"Do pass",18,0,0,0,18
1215433,874673,2019-05-29,Assembly,"AB 1437 Chen Assembly Third Reading",78,0,2,0,80
1215433,884833,2019-06-19,Senate,"Do pass as amended, but first amend, and re-refer to the Committee on [Appropriations]",6,0,1,0,7
1215433,894006,2019-07-08,Senate,"Placed on suspense file",7,0,0,0,7
1215433,894007,2019-08-30,Senate,"Do pass",7,0,0,0,7
1215433,894008,2019-09-05,Senate,"Assembly 3rd Reading AB1437 Chen By Wiener",38,1,1,0,40
1215433,894009,2019-09-10,Assembly,"AB 1437 Chen Concurrence in Senate Amendments",79,0,0,0,79
1215434,841451,2019-04-10,Assembly,"Do pass and be re-referred to the Committee on [Higher Education]",7,0,0,0,7
1215434,852171,2019-04-23,Assembly,"Do pass and be re-referred to the Committee on [Appropriations]",11,0,1,0,12
1215434,856647,2019-05-01,Assembly,"Do pass. To Consent Calendar",18,0,0,0,18
1215434,862174,2019-05-09,Assembly,"AB 1662 Ramos Consent Calendar Second Day Regular Session",76,0,4,0,80
1215434,881291,2019-06-12,Senate,"Do pass, but first be re-referred to the Committee on [Appropriations] with the recommendation: To Consent Calendar",7,0,0,0,7
1215434,893959,2019-07-01,Senate,"Consent Calendar AB1662",39,0,1,0,40
1215436,902850,2020-01-14,Assembly,"Do pass",18,0,1,0,19
1215436,905394,2020-01-23,Assembly,"AB 1470 Quirk Assembly Third Reading",76,0,4,0,80
1215436,975348,2020-08-08,Senate,"Do pass",9,0,0,0,9
1215436,978003,2020-08-30,Senate,"Assembly 3rd Reading AB1470 Quirk By Leyva",39,0,1,0,40
1215436,978004,2020-08-31,Assembly,"AB 1470 Quirk Concurrence in Senate Amendments",76,0,3,0,79
1215437,850257,2019-04-22,Assembly,"Do pass and be re-referred to the Committee on [Appropriations]",12,2,1,0,15
1215437,856833,2019-05-01,Assembly,"Do pass",13,5,0,0,18
1215437,863056,2019-05-13,Assembly,"AB 1618 Jones-Sawyer Assembly Third Reading",55,19,6,0,80
1215437,891676,2019-07-02,Senate,"Do pass as amended, but first amend, and re-refer to the Committee on [Appropriations]",5,1,1,0,7
1215437,891677,2019-09-04,Senate,"Assembly 3rd Reading AB1618 Jones-Sawyer By Umberg",36,2,2,0,40
1215437,891678,2019-09-11,Assembly,"With recommendation: That Senate amendments be concurred in",7,0,1,0,8
1215437,893748,2019-09-12,Assembly,"AB 1618 Jones-Sawyer Concurrence in Senate Amendments",73,2,4,0,79
1215437,893991,2019-09-12,Assembly,Date,7,2,0,0,9
1215437,895128,2019-09-04,Senate,Ass,5,1,0,0,6
1215439,841794,2019-04-10,Senate,"Do pass, but first be re-referred to the Committee on [Judiciary]",3,1,1,0,5
1215439,851539,2019-04-23,Senate,"Do pass as amended, but first amend, and re-refer to the Committee on [Appropriations]",8,1,0,0,9
1215439,867849,2019-05-20,Senate,"Senate 3rd Reading SB688 Monning",32,6,0,0,38
1215439,888463,2019-06-26,Assembly,"Do pass and be re-referred to the Committee on [Judiciary]",7,0,0,0,7
1215439,890617,2019-07-09,Assembly,"Do pass and be re-referred to the Committee on [Appropriations]",9,1,2,0,12
1215439,890618,2019-08-14,Assembly,"Do pass",14,4,0,0,18
1215439,893430,2019-09-03,Assembly,"SB 688 Monning Senate Third Reading By Kalra",63,13,3,0,79
1215439,893868,2019-07-09,Assembly,Date,7,0,0,0,7
1215439,894627,2019-09-03,Assembly,08/14/19,14,13,0,0,27
1215440,851929,2019-04-23,Assembly,"Do pass and be re-referred to the Committee on [Appropriations] with recommendation: To Consent Calendar",8,0,0,0,8
1215440,857086,2019-05-01,Assembly,"Do pass",18,0,0,0,18
1215440,862282,2019-05-09,Assembly,"AB 1421 Bauer-Kahan Assembly Third Reading",75,0,5,0,80
1215440,880587,2019-06-11,Senate,"Do pass, but first be re-referred to the Committee on [Appropriations] with the recommendation: To Consent Calendar",7,0,0,0,7
1215440,889238,2019-07-01,Senate,"Consent Calendar AB1421",39,0,1,0,40
1215441,902826,2020-01-14,Senate,"Do pass and be ordered to the Consent Calendar",7,0,0,0,7
1215441,904104,2020-01-21,Senate,"Consent Calendar SB723",38,0,1,0,39
1215441,974960,2020-08-05,Assembly,"Do pass. To Consent Calendar",8,0,0,0,8
1215441,977995,2020-08-30,Assembly,"SB 723 Jones Consent Calendar Second Day Regular Session",75,0,4,0,79
1215444,840288,2019-04-08,Assembly,"Do pass and be re-referred to the Committee on [Appropriations] with recommendation: To Consent Calendar",15,0,0,0,15
1215444,866235,2019-05-16,Assembly,"Do pass",18,0,0,0,18
1215444,871627,2019-05-23,Assembly,"AB 1614 Gipson Assembly Third Reading",78,0,2,0,80
1215444,887641,2019-06-25,Senate,"Do pass, but first be re-referred to the Committee on [Appropriations] with the recommendation: To Consent Calendar",13,0,0,0,13
1215444,891819,2019-07-08,Senate,"Do pass",7,0,0,0,7
1215444,891820,2019-09-09,Senate,"Assembly 3rd Reading AB1614 Gipson By Hueso",40,0,0,0,40
1215445,849856,2019-04-09,Senate,"Do pass as amended, but first amend, and re-refer to the Committee on [Rules] with the recommendation: To Consent Calendar",12,0,0,0,12
1215445,862239,2019-05-09,Senate,"Consent Calendar SB648",38,0,0,0,38
1215445,887768,2019-06-25,Assembly,"Do pass as amended and be re-referred to the Committee on [Transportation]",11,0,0,0,11
1215446,856315,2019-04-24,Senate,"Do pass as amended, but first amend, and re-refer to the Committee on [Appropriations]",11,1,1,0,13
1215446,863250,2019-05-13,Senate,"Placed on suspense file",6,0,0,0,6
1215446,866411,2019-05-16,Senate,"Do pass",4,2,0,0,6
1215446,871553,2019-05-23,Senate,"Senate 3rd Reading SB774 Stern",30,7,1,0,38
1215447,856016,2019-04-29,Assembly,"Do pass",28,0,3,0,31
1215447,859619,2019-05-06,Assembly,"AB 1587 Obernolte Assembly Third Reading",77,0,3,0,80
1215448,854876,2019-04-24,Senate,"Do pass as amended, but first amend, and re-refer to the Committee on [Appropriations]",4,3,0,0,7
1215449,841793,2019-04-09,Assembly,"Do pass as amended, and be re-referred to the Committee on [Appropriations] with recommendation: To Consent Calendar",15,0,0,0,15
1215449,865707,2019-05-16,Assembly,"Do pass as amended",18,0,0,0,18
1215449,874680,2019-05-29,Assembly,"AB 1494 Aguiar-Curry Assembly Third Reading",77,0,3,0,80
1215449,890436,2019-07-10,Senate,"Do pass as amended, but first amend, and re-refer to the Committee on [Appropriations]",8,0,1,0,9
1215449,890437,2019-08-12,Senate,"Placed on suspense file",7,0,0,0,7
1215449,890438,2019-08-30,Senate,"Do pass as amended",7,0,0,0,7
1215449,890439,2019-09-05,Senate,"Assembly 3rd Reading AB1494 Aguiar-Curry et al. By McGuire",40,0,0,0,40
1215449,890440,2019-09-09,Assembly,"AB 1494 Aguiar-Curry Concurrence in Senate Amendments",79,0,0,0,79
1215449,894897,2019-08-12,Senate,Result,8,0,0,0,8
1215451,902838,2020-01-14,Assembly,"Do pass and be re-referred to the Committee on [Appropriations] with recommendation: To Consent Calendar",8,0,0,0,8
1215451,905350,2020-01-23,Assembly,"Do pass",17,0,1,0,18
1215451,906424,2020-01-27,Assembly,"AB 1599 Cunningham Assembly Third Reading",63,2,15,0,80
1215451,974622,2020-07-31,Senate,"Do pass, but first be re-referred to the Committee on [Appropriations]",6,0,1,0,7
1215451,975848,2020-08-13,Senate,"Placed on suspense file",7,0,0,0,7
1215453,851267,2019-04-23,Assembly,"Do pass",7,1,0,0,8
1215453,859837,2019-05-06,Assembly,"AB 1652 Wicks Assembly Third Reading",63,10,7,0,80
1215453,884181,2019-06-18,Senate,"Do pass",6,0,1,0,7
1215456,840062,2019-04-08,Senate,"Do pass as amended, but first amend, and re-refer to the Committee on [Appropriations]",8,0,1,0,9
1215456,854661,2019-04-29,Senate,"Placed on suspense file",6,0,0,0,6
1215456,866352,2019-05-16,Senate,"Do pass as amended",4,2,0,0,6
1215456,871586,2019-05-23,Senate,"Senate 3rd Reading SB595 Bradford",28,8,2,0,38
1215456,891190,2019-07-02,Assembly,"Do pass and be re-referred to the Committee on [Appropriations]",15,1,3,0,19
1215456,891191,2019-08-30,Assembly,"Do pass as amended",15,2,1,0,18
1215456,893935,2019-09-13,Assembly,"SB 595 Bradford Senate Third Reading By Bonta",57,13,9,0,79
1215456,894131,2019-09-13,Senate,"Unfinished Business SB595 Bradford",30,8,0,0,38
1215456,894423,2019-09-14,Senate,"Unfinished Business SB595 Bradford",30,8,2,0,40
1215457,853128,2019-04-25,Assembly,"Do pass and be re-referred to the Committee on [Appropriations]",6,1,1,0,8
1215457,861667,2019-05-08,Assembly,"Do pass",12,4,2,0,18
1215457,874568,2019-05-29,Assembly,"AB 1482 Chiu Assembly Third Reading",43,31,6,0,80
1215457,891528,2019-07-09,Senate,"Do pass as amended, but first amend, and re-refer to the Committee on [Appropriations]",6,1,2,0,9
1215457,891529,2019-08-19,Senate,"Placed on suspense file",5,0,2,0,7
1215457,891530,2019-08-30,Senate,"Do pass, but first be re-referred to the Committee on [Rules]",5,2,0,0,7
1215457,891531,2019-09-10,Senate,"Assembly 3rd Reading AB1482 Chiu et al. By Atkins",25,10,5,0,40
1215457,891532,2019-09-11,Assembly,"AB 1482 Chiu Concurrence in Senate Amendments",48,26,5,0,79
1215458,841445,2019-04-10,Assembly,"Do pass as amended and be re-referred to the Committee on [Local Government]",7,0,1,0,8
1215458,852953,2019-04-24,Assembly,"Do pass",7,0,1,0,8
1215458,862094,2019-05-09,Assembly,"AB 1485 Wicks Assembly Third Reading",72,0,8,0,80
1215458,883703,2019-06-18,Senate,"Do pass as amended, but first amend, and re-refer to the Committee on [Governance and Finance]",10,0,1,0,11
1215458,893782,2019-07-10,Senate,"Do pass as amended, but first amend, and re-refer to the Committee on [Appropriations]",7,0,0,0,7
1215458,893783,2019-09-12,Senate,"Assembly 3rd Reading AB1485 Wicks By McGuire",40,0,0,0,40
1215458,893971,2019-09-13,Assembly,"AB 1485 Wicks Concurrence in Senate Amendments",76,3,0,0,79
1215459,841851,2019-04-09,Assembly,"Do pass as amended and be re-referred to the Committee on [Appropriations]",12,0,0,0,12
1215459,866447,2019-05-16,Assembly,"Do pass",18,0,0,0,18
1215459,871411,2019-05-23,Assembly,"AB 1774 Bonta Third Reading Urgency",78,0,2,0,80
1215459,890707,2019-07-03,Senate,"Do pass as amended, but first amend, and re-refer to the Committee on [Appropriations]",7,0,0,0,7
1215459,890708,2019-09-03,Senate,"Assembly 3rd Reading AB1774 Bonta By Leyva Urgency Clause",40,0,0,0,40
1215459,890709,2019-09-09,Assembly,"AB 1774 Bonta Concurrence in Senate Amendments",79,0,0,0,79
1215461,850462,2019-04-22,Assembly,"Do pass and be re-referred to the Committee on [Privacy and Consumer Protection] with recommendation: To Consent Calendar",12,0,0,0,12
1215461,855879,2019-04-30,Assembly,"Do pass. To Consent Calendar",11,0,0,0,11
1215461,862079,2019-05-09,Assembly,"AB 1428 Calderon Consent Calendar Second Day Regular Session",76,0,4,0,80
1215461,885305,2019-06-18,Senate,"Do pass and be ordered to the Consent Calendar",9,0,0,0,9
1215461,893997,2019-07-01,Senate,"Consent Calendar AB1428",39,0,1,0,40
1215461,893998,2019-07-08,Assembly,"AB 1428 Calderon Concurrence in Senate Amendments",76,0,3,0,79
1215462,850725,2019-04-22,Senate,"Do pass, but first be re-referred to the Committee on [Appropriations] with the recommendation: To Consent Calendar",9,0,0,0,9
1215462,862190,2019-05-09,Senate,"Consent Calendar SB569",38,0,0,0,38
1215462,887640,2019-06-25,Assembly,"Do pass as amended and be re-referred to the Committee on [Appropriations]",19,0,0,0,19
1215462,891959,2019-08-14,Assembly,"Do pass",18,0,0,0,18
1215462,891960,2019-09-03,Assembly,"SB 569 Stone Senate Third Reading By Gallagher",77,0,2,0,79
1215462,891961,2019-09-04,Senate,"Unfinished Business SB569 Stone Concurrence",40,0,0,0,40
1215465,836867,2019-04-03,Assembly,"Do pass and be re-referred to the Committee on [Appropriations]",20,0,1,0,21
1215465,851689,2019-04-24,Assembly,"Do pass. To Consent Calendar",18,0,0,0,18
1215465,857987,2019-05-02,Assembly,"AB 1473 Gray Consent Calendar Second Day Regular Session",76,0,4,0,80
1215465,893224,2019-07-09,Senate,"Do pass, but first be re-referred to the Committee on [Appropriations] with the recommendation: To Consent Calendar",15,0,1,0,16
1215466,841521,2019-04-09,Assembly,"Do pass and be re-referred to the Committee on [Appropriations] with recommendation: To Consent Calendar",8,0,0,0,8
1215466,866026,2019-05-16,Assembly,"Do pass",18,0,0,0,18
1215466,871399,2019-05-23,Assembly,"AB 1603 Wicks Assembly Third Reading",78,0,2,0,80
1215466,887661,2019-06-25,Senate,"Do pass, but first be re-referred to the Committee on [Appropriations]",7,0,0,0,7
1215466,890898,2019-08-12,Senate,"Placed on suspense file",7,0,0,0,7
1215466,890899,2019-08-30,Senate,"Do pass as amended",7,0,0,0,7
1215466,890900,2019-09-10,Senate,"Assembly 3rd Reading AB1603 Wicks et al. By Portantino",40,0,0,0,40
1215466,890901,2019-09-11,Assembly,"AB 1603 Wicks Concurrence in Senate Amendments",79,0,0,0,79
1215467,833061,2019-04-01,Assembly,"Be re-referred to the Committee on [Judiciary]",10,0,2,0,12
1215467,849915,2019-04-23,Assembly,"Do pass as amended, and be re-referred to the Committee on [Appropriations] with recommendation: To Consent Calendar",12,0,0,0,12
1215467,856840,2019-05-01,Assembly,"Do pass",18,0,0,0,18
1215467,862242,2019-05-09,Assembly,"AB 1737 Obernolte Assembly Third Reading",77,0,3,0,80
1215467,880313,2019-06-11,Senate,"Do pass, but first be re-referred to the Committee on [Appropriations] with the recommendation: To Consent Calendar",9,0,0,0,9
1215467,887014,2019-06-24,Senate,"Placed on suspense file",7,0,0,0,7
1215468,851580,2019-04-23,Assembly,"Do pass and be re-referred to the Committee on [Appropriations]",6,1,1,0,8
1215469,902827,2020-01-14,Senate,"Do pass as amended, but first amend, and re-refer to the Committee on [Appropriations]",8,0,1,0,9
1215469,906425,2020-01-27,Senate,"Senate 3rd Reading SB753 Stern",39,0,0,0,39
1215472,831526,2019-03-27,Senate,"Do pass as amended, but first amend, and re-refer to the Committee on [Veterans Affairs]",7,0,0,0,7
1215472,852042,2019-04-23,Senate,"Do pass as amended, but first amend, and re-refer to the Committee on [Appropriations]",7,0,0,0,7
1215472,863239,2019-05-13,Senate,"Placed on suspense file",6,0,0,0,6
1215472,866362,2019-05-16,Senate,"Do pass",6,0,0,0,6
1215472,871327,2019-05-23,Senate,"Special Consent SB663",38,0,0,0,38
1215472,887529,2019-06-24,Assembly,"Do pass and be re-referred to the Committee on [Veterans Affairs]",11,0,0,0,11
1215472,891969,2019-07-09,Assembly,"Do pass and be re-referred to the Committee on [Appropriations]",10,0,1,0,11
1215472,893881,2019-05-16,Senate,Result,6,0,0,0,6
1215473,855899,2019-04-30,Assembly,"Do pass",9,3,0,0,12
1215473,863167,2019-05-13,Assembly,"AB 1795 Kamlager-Dove Assembly Third Reading",43,22,15,0,80
1215474,901478,2020-01-08,Assembly,"Do pass and be re-referred to the Committee on [Judiciary]",14,6,1,0,21
1215474,902829,2020-01-14,Assembly,"Do pass and be re-referred to the Committee on [Appropriations]",9,2,0,0,11
1215474,905396,2020-01-23,Assembly,"Do pass",13,5,0,0,18
1215474,906395,2020-01-27,Assembly,"AB 1627 Robert Rivas Assembly Third Reading",56,15,9,0,80
1215476,841988,2019-04-09,Assembly,"Do pass and be re-referred to the Committee on [Appropriations]",14,0,0,0,14
1215476,852402,2019-04-24,Assembly,"Do pass. To Consent Calendar",18,0,0,0,18
1215476,858286,2019-05-02,Assembly,"AB 1414 Friedman Consent Calendar Second Day Regular Session",76,0,4,0,80
1215476,880379,2019-06-11,Senate,"Do pass, but first be re-referred to the Committee on [Appropriations]",8,0,1,0,9
1215476,892281,2019-08-19,Senate,"Assembly 3rd Reading AB1414 Friedman By Hertzberg",40,0,0,0,40
1215476,892282,2019-08-22,Assembly,"AB 1414 Friedman Concurrence in Senate Amendments",76,0,3,0,79
1215476,896091,2019-08-19,Senate,"Assembly 3rd Reading AB1414 Friedman By Hertzbespan class=""statusLabel"">Noes",8,0,0,0,8
1215477,853035,2019-04-24,Assembly,"Do pass and be re-referred to the Committee on [Natural Resources]",8,0,0,0,8
1215477,854900,2019-04-29,Assembly,"Do pass as amended",9,1,1,0,11
1215477,859556,2019-05-06,Assembly,"AB 1515 Friedman Assembly Third Reading",73,1,6,0,80
1215477,878257,2019-06-05,Senate,"Do pass as amended, but first amend, and re-refer to the Committee on [Judiciary]",7,0,0,0,7
1215477,888156,2019-06-25,Senate,"Do pass",9,0,0,0,9
1215477,891534,2019-08-22,Senate,"Assembly 3rd Reading AB1515 Friedman By Allen",39,0,1,0,40
1215477,891535,2019-08-26,Assembly,"AB 1515 Friedman Concurrence in Senate Amendments",75,0,4,0,79
1215478,838744,2019-04-08,Senate,"Do pass, but first be re-referred to the Committee on [Appropriations]",9,0,0,0,9
1215478,859478,2019-05-06,Senate,"Senate 3rd Reading SB679 Bates et al",38,0,0,0,38
1215478,892062,2019-07-09,Assembly,"Do pass as amended and be re-referred to the Committee on [Appropriations]",19,0,0,0,19
1215478,892063,2019-08-14,Assembly,"Do pass",18,0,0,0,18
1215478,892064,2019-09-03,Assembly,"SB 679 Bates Senate Third Reading By Patterson",77,0,2,0,79
1215478,892065,2019-09-04,Senate,"Unfinished Business SB679 Bates et al. Concurrence",40,0,0,0,40
1215479,852270,2019-04-23,Assembly,"Do pass as amended, and be re-referred to the Committee on [Appropriations] with recommendation: To Consent Calendar",8,0,0,0,8
1215479,866417,2019-05-16,Assembly,"Do pass as amended",18,0,0,0,18
1215479,874705,2019-05-29,Assembly,"AB 1687 Jones-Sawyer Assembly Third Reading",78,0,2,0,80
1215480,853051,2019-04-24,Senate,"Do pass",7,0,0,0,7
1215480,856132,2019-04-30,Senate,"Do pass and be ordered to the Consent Calendar",11,0,0,0,11
1215480,859612,2019-05-06,Senate,"Consent Calendar SB751",38,0,0,0,38
1215480,885029,2019-06-19,Assembly,"Do pass. To Consent Calendar",8,0,0,0,8
1215480,890334,2019-09-05,Assembly,"SB 751 Rubio Senate Third Reading By Blanca Rubio",79,0,0,0,79
1215480,890335,2019-09-06,Senate,"Unfinished Business SB751 Rubio et al. Concurrence",39,0,1,0,40
1215481,842317,2019-04-09,Assembly,"Do pass. To Consent Calendar",14,0,0,0,14
1215481,853315,2019-04-25,Assembly,"AB 1432 Dahle Consent Calendar Second Day",76,0,4,0,80
1215481,880680,2019-06-11,Senate,"Do pass and be ordered to the Consent Calendar",8,0,1,0,9
1215481,883196,2019-06-17,Senate,"Consent Calendar AB1432",40,0,0,0,40
1215482,902202,2020-01-13,Senate,"Do pass as amended, but first amend, and re-refer to the Committee on [Appropriations]",5,0,0,0,5
1215482,904113,2020-01-21,Senate,"Placed on suspense file",7,0,0,0,7
1215482,905367,2020-01-23,Senate,"Do pass as amended",7,0,0,0,7
1215482,910483,2020-01-29,Senate,"Senate 3rd Reading SB596 Stern",38,0,1,0,39
1215482,974741,2020-08-03,Assembly,"Do pass and be re-referred to the Committee on [Appropriations] with recommendation: To Consent Calendar",6,0,2,0,8
1215482,976495,2020-08-20,Assembly,"Do pass as amended",18,0,0,0,18
1215482,976925,2020-08-26,Assembly,"SB 596 Stern Senate Third Reading By Arambula",73,0,6,0,79
1215482,977422,2020-08-29,Senate,"Unfinished Business SB596 Stern Concurrence",38,0,2,0,40
1215485,842940,2019-04-10,Assembly,"Do pass and be re-referred to the Committee on [Appropriations]",4,1,1,0,6
1215485,866076,2019-05-16,Assembly,"Do pass as amended",11,2,5,0,18
1215485,902216,2020-01-13,Assembly,"Do pass as amended",11,0,0,0,11
1215485,904109,2020-01-21,Assembly,"AB 1506 McCarty Third Reading Urgency",71,0,9,0,80
1215485,975646,2020-08-12,Senate,"Do pass as amended, but first amend, and re-refer to the Committee on [Appropriations]",6,0,1,0,7
1215485,976178,2020-08-19,Senate,"Placed on suspense file",7,0,0,0,7
1215485,976428,2020-08-20,Senate,"Do pass",5,1,1,0,7
1215485,978043,2020-08-30,Senate,"Assembly 3rd Reading AB1506 McCarty et al. By Dodd",33,1,6,0,40
1215485,978044,2020-08-31,Assembly,"AB 1506 MCCARTY Concurrence in Senate Amendments",60,0,19,0,79
1215486,849880,2019-04-22,Assembly,"Do pass and be re-referred to the Committee on [Appropriations] with recommendation: To Consent Calendar",11,0,0,0,11
1215486,864909,2019-05-15,Assembly,"Do pass. To Consent Calendar",16,0,2,0,18
1215486,870113,2019-05-22,Assembly,"AB 1560 Friedman Consent Calendar Second Day Regular Session",77,0,3,0,80
1215486,884661,2019-06-19,Senate,"Do pass as amended, but first amend, and re-refer to the Committee on [Housing]",6,0,1,0,7
1215486,890783,2019-07-02,Senate,"Do pass, but first be re-referred to the Committee on [Appropriations] with the recommendation: To Consent Calendar",11,0,0,0,11
1215486,890787,2019-09-04,Senate,"Assembly 3rd Reading AB1560 Friedman et al. By McGuire",40,0,0,0,40
1215486,890790,2019-09-09,Assembly,"AB 1560 Friedman Concurrence in Senate Amendments",79,0,0,0,79
1215487,839732,2019-04-08,Assembly,"Do pass and be re-referred to the Committee on [Appropriations]",15,0,0,0,15
1215487,865858,2019-05-16,Assembly,"Do pass",17,0,1,0,18
1215487,871228,2019-05-23,Assembly,"AB 1424 Berman Assembly Third Reading",75,1,4,0,80
1215487,887417,2019-06-25,Senate,"Do pass as amended, but first amend, and re-refer to the Committee on [Energy, Utilities and Communications]",13,0,0,0,13
1215487,891471,2019-07-10,Senate,"Do pass as amended, but first amend, and re-refer to the Committee on [Appropriations]",11,0,2,0,13
1215487,891472,2019-08-19,Senate,"Placed on suspense file",5,0,2,0,7
1215488,851437,2019-04-23,Assembly,"Do pass and be re-referred to the Committee on [Appropriations] with recommendation: To Consent Calendar",11,0,0,0,11
1215488,856741,2019-05-01,Assembly,"Do pass. To Consent Calendar",18,0,0,0,18
1215488,862293,2019-05-09,Assembly,"AB 1355 Chau Consent Calendar Second Day Regular Session",76,0,4,0,80
1215488,892071,2019-07-09,Senate,"Do pass, but first be re-referred to the Committee on [Appropriations] with the recommendation: To Consent Calendar",8,0,1,0,9
1215488,893650,2019-09-12,Senate,"Assembly 3rd Reading AB1355 Chau By Hertzberg",40,0,0,0,40
1215488,893906,2019-09-13,Assembly,"AB 1355 Chau Concurrence in Senate Amendments",79,0,0,0,79
1215490,841722,2019-04-09,Assembly,"Do pass and be re-referred to the Committee on [Appropriations] with recommendation: To Consent Calendar",9,0,0,0,9
1215490,866345,2019-05-16,Assembly,"Do pass",18,0,0,0,18
1215490,871322,2019-05-23,Assembly,"AB 1596 E.S. & T.M. Assembly Third Reading By QUIRK",77,0,3,0,80
1215490,886265,2019-06-19,Senate,"Do pass, but first be re-referred to the Committee on [Appropriations] with the recommendation: To Consent Calendar",7,0,0,0,7
1215490,891220,2019-07-01,Senate,"Placed on suspense file",7,0,0,0,7
1215490,891221,2019-08-30,Senate,"Do pass as amended",7,0,0,0,7
1215490,891222,2019-09-06,Senate,"Assembly 3rd Reading AB1596 E.S. & T.M. (Quirk) By Hill",39,0,1,0,40
1215490,891223,2019-09-10,Assembly,"AB 1596 E.S. & T.M. Concurrence in Senate Amendments By QUIRK",79,0,0,0,79
1215491,839845,2019-04-09,Senate,"Do pass, but first be re-referred to the Committee on [Appropriations]",16,0,0,0,16
1215491,848844,2019-04-22,Senate,"Placed on suspense file",6,0,0,0,6
1215491,866139,2019-05-16,Senate,"Do pass",6,0,0,0,6
1215491,869888,2019-05-22,Senate,"Senate 3rd Reading SB558 Hueso et al",38,0,0,0,38
1215491,893100,2019-07-09,Assembly,"Do pass as amended and be re-referred to the Committee on [Appropriations]",7,0,0,0,7
1215491,893101,2019-08-30,Assembly,"Do pass",17,0,1,0,18
1215491,893102,2019-09-10,Assembly,"SB 558 Hueso Senate Third Reading By Eduardo Garcia",76,1,2,0,79
1215491,893103,2019-09-11,Senate,"Unfinished Business SB558 Hueso et al. Concurrence",40,0,0,0,40
1215492,852986,2019-04-24,Senate,"Do pass as amended, but first amend, and re-refer to the Committee on [Appropriations]",9,0,0,0,9
1215492,867832,2019-05-20,Senate,"Senate 3rd Reading SB583 Jackson",38,0,0,0,38
1215492,887631,2019-06-25,Assembly,"Do pass and be re-referred to the Committee on [Appropriations] with recommendation: To Consent Calendar",15,0,0,0,15
1215492,891295,2019-08-30,Assembly,"Do pass",18,0,0,0,18
1215492,891296,2019-09-09,Assembly,"SB 583 Jackson Senate Third Reading By Wood",79,0,0,0,79
1215492,891297,2019-09-10,Senate,"Unfinished Business SB583 Jackson Concurrence",40,0,0,0,40
1215493,852451,2019-04-23,Senate,"Do pass, but first be re-referred to the Committee on [Appropriations]",12,0,0,0,12
1215493,867826,2019-05-20,Senate,"Senate 3rd Reading SB742 Allen",37,0,1,0,38
1215493,892483,2019-07-08,Assembly,"Do pass and be re-referred to the Committee on [Appropriations]",15,0,0,0,15
1215493,892484,2019-08-21,Assembly,"Do pass",17,0,1,0,18
1215493,892485,2019-09-10,Assembly,"SB 742 Allen Senate Third Reading By Gray",76,0,3,0,79
1215493,892486,2019-09-11,Senate,"Unfinished Business SB742 Allen et al. Concurrence",40,0,0,0,40
1215495,841695,2019-04-10,Assembly,"Do pass and be re-referred to the Committee on [Local Government]",6,1,1,0,8
1215495,853025,2019-04-24,Assembly,"Do pass and be re-referred to the Committee on [Appropriations]",6,2,0,0,8
1215496,834820,2019-04-03,Assembly,"Do pass as amended and be re-referred to the Committee on [Appropriations]",4,2,1,0,7
1215496,866215,2019-05-16,Assembly,"Do pass",14,0,4,0,18
1215496,870996,2019-05-23,Assembly,"AB 1320 Nazarian Assembly Third Reading",63,0,17,0,80
1215496,887950,2019-06-26,Senate,"Do pass as amended, but first amend, and re-refer to the Committee on [Judiciary]",5,0,0,0,5
1215496,891430,2019-07-02,Senate,"Do pass, but first be re-referred to the Committee on [Appropriations]",8,0,1,0,9
1215496,891431,2019-08-12,Senate,"Placed on suspense file",7,0,0,0,7
1215496,891432,2019-08-30,Senate,"Do pass as amended",7,0,0,0,7
1215496,891433,2019-09-11,Senate,"Assembly 3rd Reading AB1320 Nazarian et al. By Borgeas",33,0,7,0,40
1215496,893939,2019-09-13,Assembly,"AB 1320 Nazarian Concurrence in Senate Amendments",60,0,19,0,79
1215498,837030,2019-04-02,Assembly,"Do pass as amended. To Consent Calendar",12,0,0,0,12
1215498,849730,2019-04-22,Assembly,"AB 1349 Obernolte Consent Calendar Second Day",78,0,2,0,80
1215498,888064,2019-06-25,Senate,"Do pass and be ordered to the Consent Calendar",9,0,0,0,9
1215498,891699,2019-07-11,Senate,"Consent Calendar AB1349 Obernolte",39,0,1,0,40
1215498,891700,2019-08-12,Assembly,"AB 1349 Obernolte Concurrence in Senate Amendments",77,0,2,0,79
1215498,894960,2019-04-22,Assembly,"Bill Votes",12,0,0,0,12
1215499,829251,2019-03-26,Assembly,"Do pass as amended. To Consent Calendar",12,0,0,0,12
1215499,836659,2019-04-04,Assembly,"AB 1735 Bauer-Kahan Consent Calendar Second Day Regular Session",75,0,5,0,80
1215499,883962,2019-06-18,Senate,"Do pass, but first be re-referred to the Committee on [Judiciary] with the recommendation: To Consent Calendar",7,0,0,0,7
1215499,890938,2019-07-02,Senate,"Do pass and be ordered to the Consent Calendar",9,0,0,0,9
1215499,890939,2019-07-11,Senate,"Consent Calendar AB1735",39,0,1,0,40
1215499,890940,2019-08-15,Assembly,"AB 1735 Bauer-Kahan Concurrence in Senate Amendments",75,0,4,0,79
1215500,851587,2019-04-24,Assembly,"Do pass and be re-referred to the Committee on [Appropriations] with recommendation: To Consent Calendar",14,0,0,0,14
1215500,856727,2019-05-01,Assembly,"Do pass. To Consent Calendar",18,0,0,0,18
1215500,862177,2019-05-09,Assembly,"AB 1591 Cooley Consent Calendar Second Day Regular Session",76,0,4,0,80
1215500,887904,2019-06-26,Senate,"Do pass, but first be re-referred to the Committee on [Appropriations]",13,0,0,0,13
1215500,892076,2019-07-08,Senate,"Placed on suspense file",7,0,0,0,7
1215500,892077,2019-08-30,Senate,"Do pass as amended",7,0,0,0,7
1215500,892078,2019-09-06,Senate,"Assembly 3rd Reading AB1591 Cooley By Rubio",39,0,1,0,40
1215500,892079,2019-09-09,Assembly,"AB 1591 Cooley Concurrence in Senate Amendments",78,0,1,0,79
1215501,851198,2019-04-23,Senate,"Do pass, but first be re-referred to the Committee on [Appropriations] with the recommendation: To Consent Calendar",7,0,0,0,7
1215501,859572,2019-05-06,Senate,"Placed on suspense file",5,0,1,0,6
1215501,866445,2019-05-16,Senate,"Do pass",6,0,0,0,6
1215501,871156,2019-05-23,Senate,"Special Consent SB618",38,0,0,0,38
1215504,842533,2019-04-09,Assembly,"Do pass and be re-referred to the Committee on [Appropriations]",14,0,0,0,14
1215504,866399,2019-05-16,Assembly,"Do pass",18,0,0,0,18
1215504,875798,2019-05-30,Assembly,"AB 1657 Eduardo Garcia Assembly Third Reading",76,0,4,0,80
1215504,974753,2020-08-03,Senate,"Do pass, but first be re-referred to the Committee on [Appropriations]",11,0,2,0,13
1215504,975783,2020-08-13,Senate,"Placed on suspense file",7,0,0,0,7
1215504,976374,2020-08-20,Senate,"Do pass",5,1,1,0,7
1215504,977473,2020-08-31,Assembly,"With recommendation: That Senate amendments be concurred in",13,0,2,0,15
1215504,977843,2020-08-30,Senate,"Assembly 3rd Reading AB1657 Eduardo Garcia By Hueso",32,4,4,0,40
1215504,977844,2020-08-31,Assembly,"AB 1657 GARCIA, E. Concurrence in Senate Amendments",70,0,9,0,79
1215505,853084,2019-04-24,Assembly,"Do pass and be re-referred to the Committee on [Local Government]",8,0,0,0,8
1215505,856982,2019-05-01,Assembly,"Do pass",8,0,0,0,8
1215505,862370,2019-05-09,Assembly,"AB 1730 Gonzalez Assembly Third Reading",77,0,3,0,80
1215505,878062,2019-06-04,Senate,"Do pass, but first be re-referred to the Committee on [Environmental Quality]",9,0,2,0,11
1215505,885477,2019-06-19,Senate,"Do pass, but first be re-referred to the Committee on [Appropriations]",6,0,1,0,7
1215505,891351,2019-09-11,Senate,"Assembly 3rd Reading AB1730 Gonzalez By Hueso",30,8,2,0,40
1215505,893726,2019-09-12,Assembly,"AB 1730 Gonzalez Concurrence in Senate Amendments",64,13,2,0,79
1215506,841342,2019-04-10,Senate,"Do pass, but first be re-referred to the Committee on [Appropriations]",6,0,1,0,7
1215506,854366,2019-04-29,Senate,"Placed on suspense file",6,0,0,0,6
1215506,866473,2019-05-16,Senate,"Do pass",5,0,1,0,6
1215506,868835,2019-05-21,Senate,"Senate 3rd Reading SB575 Bradford",35,2,1,0,38
1215506,887959,2019-06-25,Assembly,"Do pass and be re-referred to the Committee on [Appropriations]",11,0,1,0,12
1215506,893186,2019-08-30,Assembly,"Do pass",14,1,3,0,18
1215506,893187,2019-09-09,Assembly,"SB 575 Bradford Senate Third Reading By Carrillo",65,5,9,0,79
1215506,893188,2019-09-11,Senate,"Unfinished Business SB575 Bradford et al. Concurrence",38,1,1,0,40
1215508,841845,2019-04-10,Senate,"Do pass, but first be re-referred to the Committee on [Appropriations]",6,0,1,0,7
1215508,856017,2019-04-29,Senate,"Placed on suspense file",6,0,0,0,6
1215508,866384,2019-05-16,Senate,"Do pass as amended",4,2,0,0,6
1215508,873755,2019-05-28,Senate,"Senate 3rd Reading SB686 Allen et al",32,4,2,0,38
1215508,886065,2019-06-19,Assembly,"Do pass and be re-referred to the Committee on [Appropriations]",5,0,2,0,7
1215510,838671,2019-04-08,Assembly,"Do pass and be re-referred to the Committee on [Appropriations] with recommendation: To Consent Calendar",11,0,0,0,11
1215510,865958,2019-05-16,Assembly,"Do pass",18,0,0,0,18
1215510,871236,2019-05-23,Assembly,"AB 1770 Frazier Assembly Third Reading",78,0,2,0,80
1215511,842992,2019-04-10,Assembly,"Do pass and be re-referred to the Committee on [Natural Resources]",13,0,2,0,15
1215511,849119,2019-04-22,Assembly,"Do pass and be re-referred to the Committee on [Appropriations] with recommendation: To Consent Calendar",11,0,0,0,11
1215512,851407,2019-04-23,Assembly,"Do pass and be re-referred to the Committee on [Appropriations]",9,1,2,0,12
1215512,866109,2019-05-16,Assembly,"Do pass",13,5,0,0,18
1215512,871455,2019-05-23,Assembly,"AB 1460 Weber Assembly Third Reading",59,17,4,0,80
1215512,888162,2019-06-26,Senate,"Do pass, but first be re-referred to the Committee on [Appropriations]",3,0,4,0,7
1215512,888163,2019-06-26,Senate,"[First] hearing set for [06-26-2019]: Failed passage in Committee. Reconsideration granted",7,0,0,0,7
1215512,890499,2019-07-10,Senate,"Do pass, but first be re-referred to the Committee on [Appropriations]",4,0,3,0,7
1215512,890500,2019-08-19,Senate,"Placed on suspense file",5,0,2,0,7
1215512,905366,2020-01-23,Senate,"Do pass",5,2,0,0,7
1215512,967427,2020-06-18,Senate,"Assembly 3rd Reading AB1460 Weber et al. By Bradford",30,5,5,0,40
1215512,974752,2020-08-03,Assembly,"AB 1460 Weber Concurrence in Senate Amendments",57,13,9,0,79
1215513,859638,2019-05-01,Senate,"Do pass as amended",7,0,0,0,7
1215513,863147,2019-05-13,Senate,"Senate 3rd Reading SB646 Morrell",37,0,1,0,38
1215513,886216,2019-06-19,Assembly,"Do pass. To Consent Calendar",8,0,0,0,8
1215513,888460,2019-06-27,Assembly,"SB 646 Morrell Consent Calendar Second Day Regular Session",71,0,8,0,79
1215514,850853,2019-04-23,Assembly,"Do pass and be re-referred to the Committee on [Education]",8,0,0,0,8
1215514,852885,2019-04-24,Assembly,"Do pass and be re-referred to the Committee on [Appropriations] with recommendation: To Consent Calendar",7,0,0,0,7
1215514,866918,2019-05-16,Assembly,"Do pass",18,0,0,0,18
1215514,871445,2019-05-23,Assembly,"AB 1377 Wicks Assembly Third Reading",78,0,2,0,80
1215514,887765,2019-06-24,Senate,"Do pass, but first be re-referred to the Committee on [Appropriations]",6,0,0,0,6
1215514,893530,2019-07-08,Senate,"Placed on suspense file",7,0,0,0,7
1215514,893531,2019-08-30,Senate,"Do pass",7,0,0,0,7
1215514,893532,2019-09-09,Senate,"Special Consent AB1377",40,0,0,0,40
1215514,893533,2019-09-10,Assembly,"AB 1377 Wicks Concurrence in Senate Amendments",79,0,0,0,79
1215515,834698,2019-04-02,Senate,"Do pass, but first be re-referred to the Committee on [Governance and Finance]",3,0,2,0,5
1215515,841797,2019-04-10,Senate,"Do pass, but first be re-referred to the Committee on [Appropriations]",7,0,0,0,7
1215515,859552,2019-05-06,Senate,"Senate 3rd Reading SB681 Stern",38,0,0,0,38
1215515,885284,2019-06-19,Assembly,"Do pass and be re-referred to the Committee on [Appropriations] with recommendation: To Consent Calendar",7,0,0,0,7
1215515,892951,2019-07-03,Assembly,"Do pass. To Consent Calendar",17,0,1,0,18
1215515,892952,2019-09-03,Assembly,"SB 681 Stern Third Reading Urgency By Calderon",77,0,2,0,79
1215515,892953,2019-09-04,Senate,"Unfinished Business SB681 Stern Urgency Clause Concurrence",40,0,0,0,40
1215516,851739,2019-04-24,Assembly,"Do pass and be re-referred to the Committee on [Appropriations]",5,2,0,0,7
1215516,866401,2019-05-16,Assembly,"Do pass as amended",14,4,0,0,18
1215516,874638,2019-05-29,Assembly,"AB 1681 Gonzalez Assembly Third Reading",76,0,4,0,80
1215516,891950,2019-07-10,Senate,"Do pass, but first be re-referred to the Committee on [Appropriations]",5,0,0,0,5
1215516,891951,2019-08-12,Senate,"Placed on suspense file",7,0,0,0,7
1215516,891952,2019-08-30,Senate,"Do pass",7,0,0,0,7
1215516,891953,2019-09-10,Senate,"Assembly 3rd Reading AB1681 Gonzalez By Caballero",36,2,2,0,40
1215516,891954,2019-09-11,Assembly,"AB 1681 Gonzalez Concurrence in Senate Amendments",79,0,0,0,79
1215517,854077,2019-04-09,Assembly,"Do pass and be re-referred to the Committee on [Judiciary]",5,0,7,0,12
1215518,852112,2019-04-23,Assembly,"Do pass. To Consent Calendar",7,0,0,0,7
1215518,858298,2019-05-02,Assembly,"AB 1533 Eggman Consent Calendar Second Day Regular Session",76,0,4,0,80
1215518,878541,2019-06-05,Senate,"Do pass",7,0,0,0,7
1215518,886198,2019-06-20,Senate,"Special Consent AB1533",40,0,0,0,40
1215520,851575,2019-04-23,Assembly,"Do pass and be re-referred to the Committee on [Appropriations]",9,2,1,0,12
1215522,841346,2019-04-09,Assembly,"Do pass as amended and be re-referred to the Committee on [Appropriations]",9,0,0,0,9
1215523,841918,2019-04-09,Assembly,"Do pass as amended and be re-referred to the Committee on [Appropriations]",8,5,2,0,15
1215523,860870,2019-05-06,Assembly,"Do pass and be re-referred to the Committee on [Appropriations]",7,1,3,0,11
1215523,866262,2019-05-16,Assembly,"Do pass",13,4,1,0,18
1215524,837972,2019-04-03,Senate,"Do pass as amended, and be ordered to the Consent Calendar",7,0,0,0,7
1215524,848835,2019-04-22,Senate,"Consent Calendar SB586",38,0,0,0,38
1215524,880404,2019-06-11,Assembly,"Do pass as amended and be re-referred to the Committee on [Education]",11,0,1,0,12
1215524,892800,2019-07-10,Assembly,"Do pass as amended",7,0,0,0,7
1215524,892801,2019-08-22,Assembly,"SB 586 Roth Senate Third Reading By Holden",76,0,3,0,79
1215524,892802,2019-09-10,Assembly,"SB 586 Roth Senate Third Reading By Holden",79,0,0,0,79
1215524,892803,2019-09-11,Senate,"Unfinished Business SB586 Roth Concurrence",40,0,0,0,40
1215525,853126,2019-04-24,Senate,"Do pass as amended, but first amend, and re-refer to the Committee on [Rules]",7,0,0,0,7
1215525,867813,2019-05-20,Senate,"Senate 3rd Reading SB632 Galgiani et al",37,1,0,0,38
1215525,893060,2019-07-08,Assembly,"Do pass as amended and be re-referred to the Committee on [Appropriations]",11,0,0,0,11
1215525,893061,2019-08-14,Assembly,"Do pass",18,0,0,0,18
1215525,893062,2019-09-03,Assembly,"SB 632 Galgiani Senate Third Reading By Gallagher",76,0,3,0,79
1215525,893063,2019-09-04,Senate,"Unfinished Business SB632 Galgiani et al. Concurrence",40,0,0,0,40
1215526,903140,2020-01-15,Senate,"Do pass as amended",11,0,2,0,13
1215526,905411,2020-01-23,Senate,"Senate 3rd Reading SB755 Rubio",37,0,2,0,39
1215527,854844,2019-04-24,Assembly,"Do pass as amended and be re-referred to the Committee on [Appropriations]",7,0,0,0,7
1215527,865555,2019-05-16,Assembly,"Do pass as amended",17,1,0,0,18
1215527,874441,2019-05-29,Assembly,"AB 1578 Luz Rivas Assembly Third Reading",74,1,5,0,80
1215527,892231,2019-07-03,Senate,"Do pass, but first be re-referred to the Committee on [Appropriations]",7,0,0,0,7
1215527,892232,2019-08-12,Senate,"Placed on suspense file",7,0,0,0,7
1215527,892233,2019-08-30,Senate,"Do pass as amended",6,1,0,0,7
1215527,892234,2019-09-11,Senate,"Assembly 3rd Reading AB1578 Luz Rivas et al. By Hertzberg",37,2,1,0,40
1215527,893774,2019-09-12,Assembly,"AB 1578 Luz Rivas Concurrence in Senate Amendments",69,3,7,0,79
1215528,851269,2019-04-24,Senate,"Do pass, but first be re-referred to the Committee on [Appropriations] with the recommendation: To Consent Calendar",5,0,0,0,5
1215528,859521,2019-05-06,Senate,"Placed on suspense file",5,0,1,0,6
1215528,865695,2019-05-16,Senate,"Do pass as amended",6,0,0,0,6
1215528,871425,2019-05-23,Senate,"Senate 3rd Reading SB698 Leyva et al",38,0,0,0,38
1215528,888511,2019-06-26,Assembly,"Do pass and be re-referred to the Committee on [Appropriations] with recommendation: To Consent Calendar",7,0,0,0,7
1215528,893727,2019-08-30,Assembly,"Do pass",18,0,0,0,18
1215528,893728,2019-09-10,Assembly,"SB 698 Leyva Senate Third Reading By Wicks",79,0,0,0,79
1215529,835990,2019-04-02,Assembly,"Do pass and be re-referred to the Committee on [Revenue and Taxation]",10,1,1,0,12
1215529,860854,2019-05-06,Assembly,"Do pass and be re-referred to the Committee on [Appropriations]",8,0,3,0,11
1215529,866296,2019-05-16,Assembly,"Do pass",13,0,5,0,18
1215531,851662,2019-04-23,Assembly,"Do pass and be re-referred to the Committee on [Appropriations] with recommendation: To Consent Calendar",8,0,0,0,8
1215532,850435,2019-04-22,Senate,"Do pass as amended, but first amend, and re-refer to the Committee on [Appropriations]",9,0,0,0,9
1215532,863215,2019-05-13,Senate,"Placed on suspense file",6,0,0,0,6
1215533,842199,2019-04-09,Assembly,"Do pass as amended, and be re-referred to the Committee on [Appropriations] with recommendation: To Consent Calendar",15,0,0,0,15
1215533,856925,2019-05-01,Assembly,"Do pass. To Consent Calendar",18,0,0,0,18
1215533,862344,2019-05-09,Assembly,"AB 1532 Bauer-Kahan Consent Calendar Second Day Regular Session",76,0,4,0,80
1215533,881127,2019-06-12,Senate,"Do pass, but first be re-referred to the Committee on [Appropriations] with the recommendation: To Consent Calendar",9,0,0,0,9
1215533,889307,2019-07-01,Senate,"Consent Calendar AB1532",39,0,1,0,40
1215533,893969,2019-07-08,Assembly,"AB 1532 Bauer-Kahan Concurrence in Senate Amendments",77,0,2,0,79
1215534,851773,2019-04-23,Assembly,"Do pass and be re-referred to the Committee on [Appropriations] with recommendation: To Consent Calendar",8,0,0,0,8
1215534,866375,2019-05-16,Assembly,"Do pass",18,0,0,0,18
1215534,874684,2019-05-29,Assembly,"AB 1766 Bloom Assembly Third Reading",77,0,3,0,80
1215534,975379,2020-08-10,Senate,"Do pass, but first be re-referred to the Committee on [Appropriations] with the recommendation: To Consent Calendar",7,0,0,0,7
1215534,975998,2020-08-17,Senate,"Placed on suspense file",7,0,0,0,7
1215534,976470,2020-08-20,Senate,"Do pass as amended",7,0,0,0,7
1215534,977339,2020-08-28,Senate,"Special Consent AB1766",39,0,1,0,40
1215534,978218,2020-08-30,Assembly,"AB 1766 Bloom Concurrence in Senate Amendments",75,0,4,0,79
1215535,841453,2019-04-10,Senate,"Do pass, but first be re-referred to the Committee on [Governmental Organization]",3,0,2,0,5
1215535,849925,2019-04-23,Senate,"Do pass as amended, but first amend, and re-refer to the Committee on [Appropriations]",16,0,0,0,16
1215535,863203,2019-05-13,Senate,"Placed on suspense file",6,0,0,0,6
1215535,865687,2019-05-16,Senate,"Do pass as amended",6,0,0,0,6
1215535,873973,2019-05-28,Senate,"Senate 3rd Reading SB730 Stern et al",38,0,0,0,38
1215535,888496,2019-06-26,Assembly,"Do pass and be re-referred to the Committee on [Privacy and Consumer Protection]",7,0,0,0,7
1215535,892639,2019-07-09,Assembly,"Do pass and be re-referred to the Committee on [Appropriations]",8,0,3,0,11
1215536,853349,2019-04-24,Senate,"Do pass, but first be re-referred to the Committee on [Appropriations]",7,0,0,0,7
1215536,859540,2019-05-06,Senate,"Placed on suspense file",5,0,1,0,6
1215536,866434,2019-05-16,Senate,"Do pass",6,0,0,0,6
1215536,871354,2019-05-23,Senate,"Special Consent SB647",38,0,0,0,38
1215536,884657,2019-06-18,Assembly,"Do pass as amended and be re-referred to the Committee on [Appropriations]",8,0,0,0,8
1215536,891455,2019-08-30,Assembly,"Do pass as amended",18,0,0,0,18
1215536,891456,2019-09-10,Assembly,"SB 647 Mitchell Senate Third Reading By Muratsuchi",78,0,1,0,79
1215536,891457,2019-09-11,Senate,"Unfinished Business SB647 Mitchell et al. Concurrence",40,0,0,0,40
1215537,830681,2019-03-27,Assembly,"Do pass and be re-referred to the Committee on [Appropriations] with recommendation: To Consent Calendar",7,0,0,0,7
1215538,830667,2019-03-26,Assembly,"Do pass and be re-referred to the Committee on [Jobs, Economic Development, and the Economy]",11,0,0,0,11
1215538,850876,2019-04-23,Assembly,"Do pass and be re-referred to the Committee on [Appropriations] with recommendation: To Consent Calendar",7,0,0,0,7
1215538,866310,2019-05-16,Assembly,"Do pass",18,0,0,0,18
1215538,874482,2019-05-29,Assembly,"AB 1365 V. A. Assembly Third Reading By IRWIN",78,0,2,0,80
1215538,887378,2019-06-25,Senate,"Do pass, but first be re-referred to the Committee on [Veterans Affairs] with the recommendation: To Consent Calendar",16,0,0,0,16
1215538,891907,2019-07-09,Senate,"Do pass, but first be re-referred to the Committee on [Appropriations] with the recommendation: To Consent Calendar",6,0,1,0,7
1215538,891908,2019-08-12,Senate,"Placed on suspense file",7,0,0,0,7
1215538,891909,2019-08-30,Senate,"Do pass",7,0,0,0,7
1215538,891910,2019-09-10,Senate,"Assembly 3rd Reading AB1365 Veterans Aff By Archuleta",40,0,0,0,40
1215538,891911,2019-09-11,Assembly,"AB 1365 V. A. Concurrence in Senate Amendments",79,0,0,0,79
1215539,842236,2019-04-10,Assembly,"Do pass as amended and be re-referred to the Committee on [Housing and Community Development]",8,0,0,0,8
1215539,856865,2019-05-01,Assembly,"Do pass. To Consent Calendar",7,0,1,0,8
1215539,862374,2019-05-09,Assembly,"AB 1732 Flora Consent Calendar Second Day",76,0,4,0,80
1215539,878573,2019-06-05,Senate,"Do pass, but first be re-referred to the Committee on [Housing]",7,0,0,0,7
1215539,890975,2019-07-02,Senate,"Do pass, but first be re-referred to the Committee on [Rules]",11,0,0,0,11
1215539,890976,2019-08-12,Senate,"Placed on suspense file",7,0,0,0,7
1215539,890977,2019-08-30,Senate,"Do pass",7,0,0,0,7
1215539,890978,2019-09-05,Senate,"Assembly 3rd Reading AB1732 Flora By Galgiani",40,0,0,0,40
1215539,890979,2019-09-09,Assembly,"AB 1732 Flora Concurrence in Senate Amendments",79,0,0,0,79
1215539,895253,2019-06-05,Senate,Sen,7,0,0,0,7
1215540,841428,2019-04-10,Assembly,"Do pass as amended and be re-referred to the Committee on [Appropriations]",12,0,1,0,13
1215540,851605,2019-04-24,Assembly,"Do pass. To Consent Calendar",18,0,0,0,18
1215540,858163,2019-05-02,Assembly,"AB 1514 Patterson Consent Calendar Second Day Regular Session",76,0,4,0,80
1215540,877719,2019-06-04,Senate,"Do pass, but first be re-referred to the Committee on [Business, Professions and Economic Development]",11,0,2,0,13
1215540,893307,2019-07-08,Senate,"Do pass, but first be re-referred to the Committee on [Appropriations] with the recommendation: To Consent Calendar",9,0,0,0,9
1215540,893308,2019-08-26,Senate,"Assembly 3rd Reading AB1514 Patterson et al. By Wilk Urgency Clause",39,0,1,0,40
1215540,893309,2019-08-30,Assembly,"AB 1514 Patterson Concurrence in Senate Amendments",73,0,6,0,79
1215541,841644,2019-04-09,Senate,"Do pass, but first be re-referred to the Committee on [Appropriations]",6,2,0,0,8
1215541,854307,2019-04-29,Senate,"Placed on suspense file",6,0,0,0,6
1215542,833832,2019-04-01,Assembly,"Do pass and be re-referred to the Committee on [Appropriations]",15,0,0,0,15
1215542,866289,2019-05-16,Assembly,"Do pass",18,0,0,0,18
1215542,871634,2019-05-23,Assembly,"AB 1310 Reyes Assembly Third Reading",78,0,2,0,80
1215542,887664,2019-06-25,Senate,"Do pass, but first be re-referred to the Committee on [Public Safety] with the recommendation: To Consent Calendar",13,0,0,0,13
1215542,890984,2019-07-09,Senate,"Do pass, but first be re-referred to the Committee on [Appropriations] with the recommendation: To Consent Calendar",7,0,0,0,7
1215542,890985,2019-08-12,Senate,"Placed on suspense file",7,0,0,0,7
1215543,841729,2019-04-10,Senate,"Do pass, but first be re-referred to the Committee on [Appropriations]",4,2,1,0,7
1215543,854332,2019-04-29,Senate,"Placed on suspense file",6,0,0,0,6
1215543,865567,2019-05-16,Senate,"Do pass as amended",4,2,0,0,6
1215543,874590,2019-05-29,Senate,"Senate 3rd Reading SB777 Rubio",28,10,0,0,38
1215543,894350,2019-05-29,Senate,05/16/19,6,10,0,0,16
1215545,851512,2019-04-23,Assembly,"Do pass and be re-referred to the Committee on [Appropriations]",7,0,0,0,7
1215545,866062,2019-05-16,Assembly,"Do pass",18,0,0,0,18
1215545,871432,2019-05-23,Assembly,"AB 1382 Aguiar-Curry Assembly Third Reading",78,0,2,0,80
1215545,893316,2019-07-08,Senate,"Do pass, but first be re-referred to the Committee on [Appropriations] with the recommendation: To Consent Calendar",6,0,0,0,6
1215545,893317,2019-08-12,Senate,"Placed on suspense file",7,0,0,0,7
1215545,893318,2019-08-30,Senate,"Do pass",7,0,0,0,7
1215545,893319,2019-09-09,Senate,"Special Consent AB1382",40,0,0,0,40
1215546,834675,2019-04-02,Assembly,"Do pass and be re-referred to the Committee on [Appropriations]",9,1,2,0,12
1215546,865926,2019-05-16,Assembly,"Do pass",13,3,2,0,18
1215546,871555,2019-05-23,Assembly,"AB 1645 Blanca Rubio Assembly Third Reading",60,14,6,0,80
1215546,887964,2019-06-26,Senate,"Do pass, but first be re-referred to the Committee on [Appropriations]",6,0,1,0,7
1215546,890331,2019-07-08,Senate,"Placed on suspense file",7,0,0,0,7
1215546,890332,2019-08-30,Senate,"Do pass",5,2,0,0,7
1215546,890333,2019-09-09,Senate,"Assembly 3rd Reading AB1645 Blanca Rubio et al. By Caballero",30,10,0,0,40
1215547,851342,2019-04-23,Senate,"Do pass, but first be re-referred to the Committee on [Appropriations]",7,0,0,0,7
1215547,863249,2019-05-13,Senate,"Placed on suspense file",6,0,0,0,6
1215547,865795,2019-05-16,Senate,"Do pass",6,0,0,0,6
1215547,871380,2019-05-23,Senate,"Special Consent SB725",38,0,0,0,38
1215548,841685,2019-04-09,Assembly,"Do pass and be re-referred to the Committee on [Appropriations]",5,1,2,0,8
1215551,843786,2019-04-10,Assembly,"Do pass as amended and be re-referred to the Committee on [Appropriations]",7,0,0,0,7
1215551,865916,2019-05-16,Assembly,"Do pass",18,0,0,0,18
1215551,871249,2019-05-23,Assembly,"AB 1391 Bonta Assembly Third Reading",76,0,4,0,80
1215551,890825,2019-07-02,Senate,"Do pass, but first be re-referred to the Committee on [Appropriations] with the recommendation: To Consent Calendar",5,0,0,0,5
1215551,890826,2019-08-12,Senate,"Placed on suspense file",7,0,0,0,7
1215551,890827,2019-08-30,Senate,"Do pass as amended",7,0,0,0,7
1215551,890828,2019-09-04,Senate,"Assembly 3rd Reading AB1391 Bonta By Pan",39,0,1,0,40
1215551,890829,2019-09-10,Assembly,"AB 1391 Bonta Concurrence in Senate Amendments",78,0,1,0,79
1215552,831043,2019-03-26,Assembly,"Do pass and be re-referred to the Committee on [Appropriations] with recommendation: To Consent Calendar",8,0,1,0,9
1215552,834656,2019-04-03,Assembly,"Do pass",17,0,1,0,18
1215552,838261,2019-04-08,Assembly,"AB 1357 Quirk Assembly Third Reading",72,0,8,0,80
1215552,893722,2019-07-03,Senate,"Do pass, but first be re-referred to the Committee on [Appropriations] with the recommendation: To Consent Calendar",7,0,0,0,7
1215552,893723,2019-08-12,Senate,"Do pass",7,0,0,0,7
1215553,853027,2019-04-24,Assembly,"Do pass and be re-referred to the Committee on [Appropriations]",18,1,2,0,21
1215553,861404,2019-05-08,Assembly,"Do pass",18,0,0,0,18
1215553,863277,2019-05-13,Assembly,"AB 1308 Cunningham Assembly Third Reading",69,4,7,0,80
1215553,892969,2019-07-09,Senate,"Do pass, but first be re-referred to the Committee on [Appropriations]",13,1,2,0,16
1215553,892970,2019-09-10,Senate,"Assembly 3rd Reading AB1308 Cunningham By Jones",38,0,2,0,40
1215554,836748,2019-04-03,Assembly,"Do pass",20,0,1,0,21
1215554,854863,2019-04-29,Assembly,"AB 1541 Gray Assembly Third Reading",74,0,6,0,80
1215555,841785,2019-04-10,Senate,"Do pass, but first be re-referred to the Committee on [Appropriations] with the recommendation: To Consent Calendar",4,0,1,0,5
1215555,859415,2019-05-06,Senate,"Senate 3rd Reading SB671 Hertzberg",38,0,0,0,38
1215555,881312,2019-06-12,Assembly,"Do pass and be re-referred to the Committee on [Appropriations] with recommendation: To Consent Calendar",7,0,0,0,7
1215555,888215,2019-06-26,Assembly,"Do pass. To Consent Calendar",15,0,3,0,18
1215555,892628,2019-08-12,Assembly,"SB 671 Hertzberg Third Reading Urgency By Calderon",78,0,1,0,79
1215555,892629,2019-08-22,Senate,"Special Consent SB671 Hertzberg Urgency Clause",39,0,1,0,40
1215557,841425,2019-04-08,Assembly,"Do pass as amended and be re-referred to the Committee on [Appropriations]",11,0,0,0,11
1215558,841524,2019-04-09,Assembly,"Do pass and be re-referred to the Committee on [Privacy and Consumer Protection]",10,0,1,0,11
1215558,852241,2019-04-23,Assembly,"Do pass as amended, and be re-referred to the Committee on [Appropriations] with recommendation: To Consent Calendar",11,0,0,0,11
1215558,861468,2019-05-08,Assembly,"Do pass. To Consent Calendar",18,0,0,0,18
1215558,865941,2019-05-16,Assembly,"AB 1376 Ramos Consent Calendar Second Day Regular Session",74,0,6,0,80
1215558,880773,2019-06-11,Senate,"Do pass as amended, but first amend, and re-refer to the Committee on [Labor, Public Employment and Retirement ]",7,0,0,0,7
1215558,888299,2019-06-26,Senate,"Do pass, but first be re-referred to the Committee on [Appropriations] with the recommendation: To Consent Calendar",5,0,0,0,5
1215558,891818,2019-08-12,Senate,"Placed on suspense file",7,0,0,0,7
1215559,857100,2019-04-30,Assembly,"Do pass as amended",9,3,0,0,12
1215559,862335,2019-05-09,Assembly,"AB 1477 Gloria Assembly Third Reading",58,15,7,0,80
1215559,884694,2019-06-18,Senate,"Do pass",7,2,0,0,9
1215559,890701,2019-09-05,Senate,"Assembly 3rd Reading AB1477 Gloria et al. By Allen",28,12,0,0,40
1215559,890702,2019-09-09,Assembly,"AB 1477 Gloria Concurrence in Senate Amendments",61,18,0,0,79
1215560,851453,2019-04-24,Assembly,"Do pass and be re-referred to the Committee on [Appropriations] with recommendation: To Consent Calendar",7,0,0,0,7
1215560,856822,2019-05-01,Assembly,"Do pass. To Consent Calendar",18,0,0,0,18
1215560,862267,2019-05-09,Assembly,"AB 1452 O'Donnell Consent Calendar Second Day Regular Session",76,0,4,0,80
1215560,881100,2019-06-12,Senate,"Do pass, but first be re-referred to the Committee on [Appropriations] with the recommendation: To Consent Calendar",5,0,0,0,5
1215560,887088,2019-06-24,Senate,"Placed on suspense file",7,0,0,0,7
1215560,891168,2019-08-30,Senate,"Do pass",7,0,0,0,7
1215560,891169,2019-09-09,Senate,"Special Consent AB1452",40,0,0,0,40
1215561,852665,2019-04-24,Assembly,"Do pass as amended, and be re-referred to the Committee on [Appropriations] with recommendation: To Consent Calendar",7,0,0,0,7
1215562,808284,2019-02-25,Assembly,"Be adopted. To Consent Calendar",10,0,2,0,12
1215562,811710,2019-02-28,Assembly,"HR 16 Petrie-Norris Consent Calendar Second Day Regular Session",75,0,5,0,80
1215563,860527,2019-05-01,Senate,"Do pass as amended",7,0,0,0,7
1215563,863105,2019-05-13,Senate,"Senate 3rd Reading SB560 McGuire",37,0,1,0,38
1215563,893641,2019-07-10,Assembly,"Do pass as amended, and be re-referred to the Committee on [Appropriations] with recommendation: To Consent Calendar",15,0,0,0,15
1215563,893642,2019-08-21,Assembly,"Do pass. To Consent Calendar",17,0,1,0,18
1215563,893643,2019-09-10,Assembly,"SB 560 McGuire Senate Third Reading By Wood",79,0,0,0,79
1215563,893644,2019-09-11,Senate,"That the Assembly amendments be concurred in",13,0,0,0,13
1215563,893645,2019-09-12,Senate,"Unfinished Business SB560 McGuire Concurrence",40,0,0,0,40
1215564,902831,2020-01-14,Senate,"Do pass as amended, but first amend, and re-refer to the Committee on [Appropriations]",10,0,2,0,12
1215564,904103,2020-01-21,Senate,"Placed on suspense file",7,0,0,0,7
1215564,905345,2020-01-23,Senate,"Do pass as amended",6,1,0,0,7
1215564,910507,2020-01-29,Senate,"Senate 3rd Reading SB757 Allen",37,0,2,0,39
1215564,974958,2020-08-06,Assembly,"Do pass as amended and be re-referred to the Committee on [Appropriations]",8,1,2,0,11
1215564,976384,2020-08-20,Assembly,"Do pass",18,0,0,0,18
1215564,978176,2020-08-30,Assembly,"SB 757 Allen Senate Third Reading By Friedman",72,1,6,0,79
1215564,978177,2020-08-31,Senate,"Unfinished Business SB757 Allen et al. Concurrence",35,0,5,0,40
1215565,840031,2019-04-09,Senate,"Do pass, but first be re-referred to the Committee on [Appropriations]",16,0,0,0,16
1215565,848775,2019-04-22,Senate,"Do pass",6,0,0,0,6
1215565,862116,2019-05-09,Senate,"Senate 3rd Reading SB748 Stern et al",38,0,0,0,38
1215565,884740,2019-06-19,Assembly,"Do pass and be re-referred to the Committee on [Appropriations]",7,0,0,0,7
1215565,888067,2019-06-26,Assembly,"Do pass. To Consent Calendar",15,0,3,0,18
1215565,894097,2019-07-05,Assembly,"SB 748 Stern Consent Calendar Second Day Regular Session",70,0,9,0,79
1215566,833795,2019-04-01,Assembly,"Do pass and be re-referred to the Committee on [Appropriations]",15,0,0,0,15
1215566,841788,2019-04-10,Assembly,"Do pass. To Consent Calendar",17,0,1,0,18
1215566,853236,2019-04-25,Assembly,"AB 1633 Grayson Consent Calendar Second Day Regular Session",76,0,4,0,80
1215566,887887,2019-06-25,Senate,"Do pass as amended, but first amend, and re-refer to the Committee on [Environmental Quality] with the recommendation: To Consent Calendar",13,0,0,0,13
1215566,891646,2019-09-03,Senate,"Assembly 3rd Reading AB1633 Grayson By Skinner",40,0,0,0,40
1215566,891647,2019-09-05,Assembly,"AB 1633 Grayson Concurrence in Senate Amendments",79,0,0,0,79
1215567,840081,2019-04-09,Senate,"Do pass, but first be re-referred to the Committee on [Veterans Affairs] with the recommendation: To Consent Calendar",16,0,0,0,16
1215567,852292,2019-04-23,Senate,"Do pass, but first be re-referred to the Committee on [Appropriations]",7,0,0,0,7
1215567,859442,2019-05-06,Senate,"Placed on suspense file",5,0,1,0,6
1215567,866413,2019-05-16,Senate,"Do pass",6,0,0,0,6
1215567,871378,2019-05-23,Senate,"Special Consent SB588",38,0,0,0,38
1215567,893593,2019-07-09,Assembly,"Do pass as amended and be re-referred to the Committee on [Appropriations]",7,0,0,0,7
1215567,893594,2019-08-30,Assembly,"Do pass",18,0,0,0,18
1215567,894545,2019-05-16,Senate,Result,6,0,0,0,6
1215567,976624,2020-08-24,Assembly,"SB 588 Archuleta Senate Third Reading By Irwin",71,0,8,0,79
1215567,977180,2020-08-27,Senate,"Unfinished Business SB588 Archuleta et al. Concurrence",29,0,11,0,40
1215568,851896,2019-04-24,Assembly,"Do pass as amended and be re-referred to the Committee on [Appropriations]",14,0,0,0,14
1215568,863096,2019-05-13,Assembly,"AB 1400 Kamlager-Dove Assembly Third Reading",73,0,7,0,80
1215568,891383,2019-07-10,Senate,"Do pass, but first be re-referred to the Committee on [Appropriations]",4,0,1,0,5
1215568,891384,2019-08-12,Senate,"Placed on suspense file",7,0,0,0,7
1215568,891385,2019-08-30,Senate,"Do pass",5,2,0,0,7
1215568,891386,2019-09-11,Senate,"Assembly 3rd Reading AB1400 Kamlager-Dove et al. By Durazo",35,0,5,0,40
1215568,893878,2019-09-13,Assembly,"With recommendation: That Senate amendments be concurred in",6,0,1,0,7
1215568,893947,2019-09-13,Assembly,"AB 1400 Kamlager-Dove Concurrence in Senate Amendments",79,0,0,0,79
1215568,894864,2019-08-12,Senate,"Bill Votes",4,0,0,0,4
1215569,854354,2019-04-22,Senate,"Do pass as amended, but first amend, and re-refer to the Committee on [Appropriations]",9,0,0,0,9
1215569,863158,2019-05-13,Senate,"Placed on suspense file",6,0,0,0,6
1215569,866322,2019-05-16,Senate,"Do pass",4,1,1,0,6
1215569,871019,2019-05-23,Senate,"Senate 3rd Reading SB627 Galgiani",33,0,5,0,38
1215569,891137,2019-07-09,Assembly,"Do pass as amended and be re-referred to the Committee on [Appropriations]",17,2,0,0,19
1215570,853042,2019-04-24,Senate,"Do pass as amended, but first amend, and re-refer to the Committee on [Judiciary]",5,1,1,0,7
1215570,856983,2019-04-30,Senate,"Do pass as amended",5,4,0,0,9
1215570,863119,2019-05-13,Senate,"Placed on suspense file",6,0,0,0,6
1215572,841299,2019-04-10,Assembly,"Do pass as amended and be re-referred to the Committee on [Housing and Community Development]",6,2,0,0,8
1215572,851693,2019-04-24,Assembly,"Do pass and be re-referred to the Committee on [Appropriations]",5,1,2,0,8
1215572,865548,2019-05-16,Assembly,"Do pass as amended",12,4,2,0,18
1215572,874593,2019-05-29,Assembly,"AB 1486 Ting Assembly Third Reading",53,20,7,0,80
1215572,887933,2019-06-26,Senate,"Do pass as amended, but first amend, and re-refer to the Committee on [Housing]",4,3,0,0,7
1215572,892617,2019-07-02,Senate,"Do pass, but first be re-referred to the Committee on [Governmental Organization]",8,3,0,0,11
1215572,892618,2019-08-12,Senate,"Placed on suspense file",7,0,0,0,7
1215572,892619,2019-08-30,Senate,"Do pass as amended",5,2,0,0,7
1215572,892620,2019-09-11,Senate,"Assembly 3rd Reading AB1486 Ting et al. By Beall",28,12,0,0,40
1215572,893694,2019-09-12,Assembly,"AB 1486 Ting Concurrence in Senate Amendments",60,17,2,0,79
1215572,894163,2019-09-11,Senate,NVR,5,2,0,0,7
1215573,859563,2019-04-30,Assembly,"Do pass as amended",9,0,2,0,11
1215573,866274,2019-05-16,Assembly,"AB 1790 Wicks Assembly Third Reading",70,0,10,0,80
1215573,892836,2019-07-09,Senate,"Do pass as amended",7,1,1,0,9
1215573,892837,2019-09-11,Senate,"Assembly 3rd Reading AB1790 Wicks et al. By Jackson",32,8,0,0,40
1215573,893712,2019-09-12,Assembly,"AB 1790 Wicks Concurrence in Senate Amendments",75,0,4,0,79
1215573,894811,2019-09-11,Senate,"Assembly 3rd Reading AB1790 Wi",7,8,0,0,15
1215575,855245,2019-04-24,Senate,"Do pass as amended, but first amend, and re-refer to the Committee on [Appropriations]",13,0,0,0,13
1215575,863049,2019-05-13,Senate,"Placed on suspense file",6,0,0,0,6
1215575,865952,2019-05-16,Senate,"Do pass as amended",6,0,0,0,6
1215575,871309,2019-05-23,Senate,"Senate 3rd Reading SB603 Borgeas et al",38,0,0,0,38
1215575,892579,2019-07-10,Assembly,"Do pass as amended and be re-referred to the Committee on [Appropriations]",12,0,1,0,13
1215576,902235,2020-01-13,Assembly,"Be re-referred to the Committee on [Business and Professions]",12,0,0,0,12
1215576,902819,2020-01-14,Assembly,"Do pass and be re-referred to the Committee on [Appropriations]",18,0,1,0,19
1215576,905390,2020-01-23,Assembly,"Do pass",18,0,0,0,18
1215576,912007,2020-01-30,Assembly,"AB 1616 Low Assembly Third Reading",76,0,4,0,80
1215577,842847,2019-04-10,Senate,"Do pass as amended, but first amend, and re-refer to the Committee on [Transportation]",11,1,1,0,13
1215577,850110,2019-04-23,Senate,"Do pass as amended, but first amend, and re-refer to the Committee on [Appropriations]",9,3,0,0,12
1215577,863204,2019-05-13,Senate,"Placed on suspense file",6,0,0,0,6
1215577,866598,2019-05-16,Senate,"Do pass",5,1,0,0,6
1215577,870121,2019-05-22,Senate,"Senate 3rd Reading SB662 Archuleta et al",31,5,2,0,38
1215578,858281,2019-05-01,Assembly,"Do pass as amended. To Consent Calendar",6,0,0,0,6
1215578,862160,2019-05-09,Assembly,"AB 1595 ED. Consent Calendar Second Day Regular Session",76,0,4,0,80
1215578,887966,2019-06-26,Senate,"Do pass as amended, and be ordered to the Consent Calendar",7,0,0,0,7
1215578,891009,2019-09-10,Senate,"Assembly 3rd Reading AB1595 ED. (O'Donnell) By Leyva",40,0,0,0,40
1215578,891010,2019-09-11,Assembly,"AB 1595 ED. Concurrence in Senate Amendments By O'DONNELL",79,0,0,0,79
1215579,833506,2019-03-27,Senate,"Do pass as amended, but first amend, and re-refer to the Committee on [Education]",9,0,0,0,9
1215579,841564,2019-04-10,Senate,"Do pass, but first be re-referred to the Committee on [Appropriations]",7,0,0,0,7
1215579,854297,2019-04-29,Senate,"Placed on suspense file",6,0,0,0,6
1215579,865775,2019-05-16,Senate,"Do pass as amended",6,0,0,0,6
1215579,871159,2019-05-23,Senate,"Senate 3rd Reading SB582 Beall et al",38,0,0,0,38
1215579,883778,2019-06-18,Assembly,"Do pass and be re-referred to the Committee on [Education]",14,0,1,0,15
1215579,891989,2019-07-10,Assembly,"Do pass and be re-referred to the Committee on [Appropriations] with recommendation: To Consent Calendar",7,0,0,0,7
1215580,835503,2019-04-02,Assembly,"Do pass and be re-referred to the Committee on [Education]",12,0,0,0,12
1215580,842965,2019-04-10,Assembly,"Do pass and be re-referred to the Committee on [Appropriations] with recommendation: To Consent Calendar",6,0,0,0,6
1215580,866260,2019-05-16,Assembly,"Do pass as amended",18,0,0,0,18
1215580,874609,2019-05-29,Assembly,"AB 1623 Robert Rivas Assembly Third Reading",78,0,2,0,80
1215581,842168,2019-04-10,Assembly,"Do pass as amended and be re-referred to the Committee on [Appropriations]",7,0,0,0,7
1215583,856060,2019-04-22,Assembly,"Do pass and be re-referred to the Committee on [Judiciary]",4,4,3,0,11
1215583,856061,2019-04-22,Assembly,Reconsideration,11,0,0,0,11
1215584,901397,2020-01-07,Senate,"Do pass, but first be re-referred to the Committee on [Appropriations] with the recommendation: To Consent Calendar",5,0,0,0,5
1215584,906402,2020-01-27,Senate,"Consent Calendar SB684 Umberg",39,0,0,0,39
1215584,973993,2020-07-27,Assembly,"Do pass. To Consent Calendar",7,0,0,0,7
1215584,974760,2020-08-03,Assembly,"SB 684 Hertzberg Consent Calendar Second Day Regular Session",72,0,7,0,79
1215585,854814,2019-04-23,Assembly,"Do pass as amended and be re-referred to the Committee on [Appropriations]",10,0,1,0,11
1215585,861442,2019-05-08,Assembly,"Do pass",18,0,0,0,18
1215585,863154,2019-05-13,Assembly,"AB 1564 Berman Assembly Third Reading",73,0,7,0,80
1215585,890950,2019-07-09,Senate,"Do pass as amended, but first amend, and re-refer to the Committee on [Appropriations]",8,0,1,0,9
1215585,890951,2019-09-11,Senate,"Assembly 3rd Reading AB1564 Berman By Dodd",40,0,0,0,40
1215585,893786,2019-09-12,Assembly,"AB 1564 Berman Concurrence in Senate Amendments",78,0,1,0,79
1215586,835156,2019-04-02,Assembly,"Do pass as amended, and be re-referred to the Committee on [Appropriations] with recommendation: To Consent Calendar",15,0,0,0,15
1215586,851764,2019-04-24,Assembly,"Do pass. To Consent Calendar",18,0,0,0,18
1215586,858194,2019-05-02,Assembly,"AB 1327 Petrie-Norris Consent Calendar Second Day Regular Session",76,0,4,0,80
1215586,974654,2020-08-01,Senate,"Do pass, but first be re-referred to the Committee on [Appropriations] with the recommendation: To Consent Calendar",8,0,1,0,9
1215586,975844,2020-08-13,Senate,"Placed on suspense file",7,0,0,0,7
1215586,976476,2020-08-20,Senate,"Do pass",7,0,0,0,7
1215586,977316,2020-08-28,Senate,"Special Consent AB1327",39,0,1,0,40
1215586,977477,2020-08-31,Assembly,"With recommendation: That Senate amendments be concurred in, but first be re-referred to Com. on [Appropriations]",12,0,3,0,15
1215586,977478,2020-08-31,Assembly,"With recommendation: That Senate amendments be concurred in",16,0,1,0,17
1215586,977849,2020-08-31,Assembly,"AB 1327 Petrie-Norris Concurrence in Senate Amendments",76,0,3,0,79
1215589,841605,2019-04-10,Assembly,"Do pass and be re-referred to the Committee on [Local Government]",8,0,0,0,8
1215589,853045,2019-04-24,Assembly,"Do pass and be re-referred to the Committee on [Appropriations]",7,0,1,0,8
1215589,856795,2019-05-01,Assembly,"Do pass. To Consent Calendar",18,0,0,0,18
1215589,863227,2019-05-13,Assembly,"AB 1763 Chiu Assembly Third Reading",72,0,8,0,80
1215589,884022,2019-06-18,Senate,"Do pass as amended, but first amend, and re-refer to the Committee on [Governance and Finance]",8,1,2,0,11
1215589,892979,2019-07-10,Senate,"Do pass as amended, but first amend, and re-refer to the Committee on [Appropriations]",5,0,2,0,7
1215589,892980,2019-09-03,Senate,"Assembly 3rd Reading AB1763 Chiu By Beall",28,11,1,0,40
1215589,892981,2019-09-05,Assembly,"AB 1763 Chiu Concurrence in Senate Amendments",61,12,6,0,79
1215591,842932,2019-04-10,Assembly,"Do pass and be re-referred to the Committee on [Appropriations] with recommendation: To Consent Calendar",6,0,0,0,6
1215591,865900,2019-05-16,Assembly,"Do pass",18,0,0,0,18
1215591,871152,2019-05-23,Assembly,"AB 1658 Carrillo Assembly Third Reading",78,0,2,0,80
1215591,881037,2019-06-12,Senate,"Do pass, but first be re-referred to the Committee on [Appropriations] with the recommendation: To Consent Calendar",7,0,0,0,7
1215591,886986,2019-06-24,Senate,"Placed on suspense file",7,0,0,0,7
1215591,891039,2019-08-30,Senate,"Do pass as amended",7,0,0,0,7
1215591,891040,2019-09-05,Senate,"Assembly 3rd Reading AB1658 Carrillo By Durazo",40,0,0,0,40
1215591,891041,2019-09-09,Assembly,"AB 1658 Carrillo Concurrence in Senate Amendments",79,0,0,0,79
1215591,894573,2019-09-05,Senate,"Assembly 3rd Reading AB16lass=""statusCell"">",7,0,0,0,7
1215591,896515,2019-08-30,Senate,Date,7,0,0,0,7
1215592,835527,2019-04-02,Senate,"Do pass, but first be re-referred to the Committee on [Governance and Finance] with the recommendation: To Consent Calendar",8,0,0,0,8
1215592,852650,2019-04-24,Senate,"Do pass and be ordered to the Consent Calendar",7,0,0,0,7
1215592,858251,2019-05-02,Senate,"Consent Calendar SB630",38,0,0,0,38
1215592,877616,2019-06-04,Assembly,"Do pass",11,0,1,0,12
1215592,882969,2019-06-17,Assembly,"SB 630 Stern Senate Third Reading By Santiago",76,0,3,0,79
1215594,841334,2019-04-10,Assembly,"Be re-referred to the Committee on [Revenue and Taxation]",8,0,4,0,12
1215595,848995,2019-04-10,Senate,"Do pass as amended, but first amend, and re-refer to the Committee on [Appropriations]",7,0,0,0,7
1215595,859512,2019-05-06,Senate,"Placed on suspense file",5,0,1,0,6
1215595,866439,2019-05-16,Senate,"Do pass as amended",4,2,0,0,6
1215595,871313,2019-05-23,Senate,"Senate 3rd Reading SB568 Portantino et al",31,2,5,0,38
1215595,887905,2019-06-25,Assembly,"Do pass",12,0,0,0,12
1215595,891449,2019-07-08,Assembly,"SB 568 Portantino Senate Third Reading By Friedman",77,0,2,0,79
1215595,891450,2019-08-28,Senate,"That the Assembly amendments be concurred in",7,0,0,0,7
1215595,891451,2019-09-03,Senate,"Unfinished Business SB568 Portantino et al. Concurrence",39,0,1,0,40
1215596,851715,2019-04-23,Assembly,"Do pass and be re-referred to the Committee on [Appropriations] with recommendation: To Consent Calendar",19,0,1,0,20
1215596,865653,2019-05-16,Assembly,"Do pass",18,0,0,0,18
1215596,871126,2019-05-23,Assembly,"AB 1520 B. & P. Assembly Third Reading By LOW",78,0,2,0,80
1215596,891232,2019-07-08,Senate,"Do pass as amended, but first amend, and re-refer to the Committee on [Appropriations]",9,0,0,0,9
1215596,891233,2019-08-12,Senate,"Placed on suspense file",7,0,0,0,7
1215596,891234,2019-08-30,Senate,"Do pass as amended",7,0,0,0,7
1215596,891235,2019-09-11,Senate,"Assembly 3rd Reading AB1520 Low By Glazer",40,0,0,0,40
1215596,893877,2019-09-13,Assembly,"With recommendation: That Senate amendments be concurred in",19,0,0,0,19
1215596,893943,2019-09-13,Assembly,"AB 1520 Low Concurrence in Senate Amendments",78,0,1,0,79
1215597,852044,2019-04-24,Senate,"Do pass, but first be re-referred to the Committee on [Appropriations]",5,0,0,0,5
1215597,860394,2019-05-06,Senate,"Placed on suspense file",5,0,1,0,6
1215597,866160,2019-05-16,Senate,"Do pass",6,0,0,0,6
1215597,868767,2019-05-21,Senate,"Senate 3rd Reading SB731 Bradford",38,0,0,0,38
1215597,976626,2020-08-24,Assembly,"Be re-referred to the Committee on [Judiciary]",8,1,3,0,12
1215597,976905,2020-08-26,Assembly,"Do pass",7,3,1,0,11
1215598,841542,2019-04-09,Senate,"Do pass, but first be re-referred to the Committee on [Rules]",7,0,1,0,8
1215598,851450,2019-04-24,Senate,"Do pass as amended, but first amend, and re-refer to the Committee on [Appropriations]",6,0,1,0,7
1215598,863116,2019-05-13,Senate,"Placed on suspense file",6,0,0,0,6
1215598,866034,2019-05-16,Senate,"Do pass",5,0,1,0,6
1215598,868792,2019-05-21,Senate,"Senate 3rd Reading SB619 Hueso et al",38,0,0,0,38
1215599,851443,2019-04-24,Senate,"Do pass, but first be re-referred to the Committee on [Appropriations]",9,1,3,0,13
1215599,859474,2019-05-06,Senate,"Placed on suspense file",5,0,1,0,6
1215599,866361,2019-05-16,Senate,"Do pass as amended",6,0,0,0,6
1215599,874430,2019-05-29,Senate,"Senate 3rd Reading SB772 Bradford et al",11,11,16,0,38
1215599,874431,2019-05-29,Senate,"Senate 3rd Reading SB772 Bradford et al. Reconsider",38,0,0,0,38
1215600,841818,2019-04-09,Senate,"Do pass, but first be re-referred to the Committee on [Health]",7,1,0,0,8
1215600,853202,2019-04-24,Senate,"Do pass as amended, but first amend, and re-refer to the Committee on [Appropriations]",7,2,0,0,9
1215600,867749,2019-05-20,Senate,"Senate 3rd Reading SB741 Galgiani",30,8,0,0,38
1215600,887541,2019-06-25,Assembly,"Do pass and be re-referred to the Committee on [Health]",9,2,1,0,12
1215600,975012,2020-08-04,Assembly,"Do pass and be re-referred to the Committee on [Appropriations]",13,1,1,0,15
1215600,976457,2020-08-20,Assembly,"Do pass as amended",13,4,1,0,18
1215600,977840,2020-08-31,Senate,"Unfinished Business SB741 Galgiani Concurrence",30,7,3,0,40
1215600,977841,2020-08-31,Assembly,"SB 741 Galgiani Senate Third Reading By Low",63,10,6,0,79
1215601,903153,2020-01-15,Assembly,"Do pass and be re-referred to the Committee on [Appropriations]",6,0,1,0,7
1215601,905382,2020-01-23,Assembly,"Do pass",18,0,0,0,18
1215601,905383,2020-01-23,Assembly,"Set, [First] hearing. Referred to suspense file",18,0,0,0,18
1215601,906378,2020-01-27,Assembly,"AB 1552 Limón Assembly Third Reading",78,0,2,0,80
1215602,837192,2019-04-02,Assembly,"Do pass as amended, and be re-referred to the Committee on [Appropriations] with recommendation: To Consent Calendar",11,0,0,0,11
1215602,852785,2019-04-25,Assembly,"AB 1472 Mark Stone Assembly Third Reading",75,0,5,0,80
1215602,892097,2019-07-02,Senate,"Do pass, but first be re-referred to the Committee on [Judiciary]",5,0,0,0,5
1215602,892098,2019-07-09,Senate,"Do pass, but first be re-referred to the Committee on [Appropriations] with the recommendation: To Consent Calendar",8,0,1,0,9
1215602,892099,2019-08-12,Senate,"Do pass",7,0,0,0,7
1215602,893853,2019-09-12,Senate,"Assembly 3rd Reading AB1472 Mark Stone By Galgiani",40,0,0,0,40
1215602,893854,2019-09-12,Senate,"Assembly 3rd Reading AB1472 Mark Stone By Galgiani Reconsider",40,0,0,0,40
1215603,842945,2019-04-10,Assembly,"Do pass and be re-referred to the Committee on [Appropriations]",8,0,0,0,8
1215603,851652,2019-04-24,Assembly,"Do pass. To Consent Calendar",18,0,0,0,18
1215603,858203,2019-05-02,Assembly,"AB 1720 Carrillo Consent Calendar Second Day Regular Session",76,0,4,0,80
1215603,878291,2019-06-05,Senate,"Do pass, but first be re-referred to the Committee on [Appropriations]",7,0,0,0,7
1215603,887063,2019-06-24,Senate,"Placed on suspense file",7,0,0,0,7
1215603,892207,2019-08-30,Senate,"Do pass",7,0,0,0,7
1215604,852824,2019-04-24,Assembly,"Do pass and be re-referred to the Committee on [Appropriations]",7,0,0,0,7
1215604,856736,2019-05-01,Assembly,"Do pass",18,0,0,0,18
1215604,862362,2019-05-09,Assembly,"AB 1748 Bonta Assembly Third Reading",76,0,4,0,80
1215604,880987,2019-06-12,Senate,"Do pass, but first be re-referred to the Committee on [Appropriations]",5,0,0,0,5
1215604,891216,2019-09-09,Senate,"Assembly 3rd Reading AB1748 Bonta By Hill",40,0,0,0,40
1215604,891217,2019-09-10,Assembly,"AB 1748 Bonta Concurrence in Senate Amendments",79,0,0,0,79
1215605,852367,2019-04-23,Assembly,"Do pass and be re-referred to the Committee on [Appropriations]",11,0,1,0,12
1215605,865571,2019-05-16,Assembly,"Do pass",18,0,0,0,18
1215605,874623,2019-05-29,Assembly,"AB 1383 McCarty Assembly Third Reading",78,0,2,0,80
1215605,884752,2019-06-19,Senate,"Do pass as amended, but first amend, and re-refer to the Committee on [Appropriations]",6,0,1,0,7
1215605,890396,2019-09-10,Senate,"Assembly 3rd Reading AB1383 McCarty By Glazer",40,0,0,0,40
1215605,890397,2019-09-11,Assembly,"AB 1383 McCarty Concurrence in Senate Amendments",79,0,0,0,79
1215607,855257,2019-04-23,Assembly,"Do pass as amended",19,0,1,0,20
1215607,873958,2019-05-28,Assembly,"AB 1710 Wood Assembly Third Reading",71,0,9,0,80
1215607,975323,2020-08-08,Senate,"Do pass as amended, but first amend, and re-refer to the Committee on [Appropriations]",9,0,0,0,9
1215607,977174,2020-08-27,Senate,"Assembly 3rd Reading AB1710 Wood By Roth",30,0,10,0,40
1215607,977445,2020-08-30,Assembly,"With recommendation: That Senate amendments be concurred in",17,0,2,0,19
1215607,977835,2020-08-30,Assembly,"AB 1710 Wood Concurrence in Senate Amendments",75,0,4,0,79
1215608,853129,2019-04-24,Assembly,"Do pass and be re-referred to the Committee on [Appropriations]",5,2,0,0,7
1215608,866371,2019-05-16,Assembly,"Do pass as amended",13,5,0,0,18
1215608,874700,2019-05-29,Assembly,"AB 1677 Weber Assembly Third Reading",54,20,6,0,80
1215608,888078,2019-06-26,Senate,"Do pass, but first be re-referred to the Committee on [Judiciary]",4,1,0,0,5
1215608,893423,2019-07-02,Senate,"Do pass, but first be re-referred to the Committee on [Appropriations]",7,2,0,0,9
1215608,893424,2019-08-12,Senate,"Placed on suspense file",7,0,0,0,7
1215608,893425,2019-08-30,Senate,"Do pass as amended",5,2,0,0,7
1215608,893426,2019-09-11,Senate,"Assembly 3rd Reading AB1677 Weber By Durazo",28,11,1,0,40
1215608,893825,2019-09-12,Assembly,"AB 1677 Weber Concurrence in Senate Amendments",58,19,2,0,79
1215609,902821,2020-01-14,Senate,"Do pass, but first be re-referred to the Committee on [Appropriations]",9,0,0,0,9
1215609,904107,2020-01-21,Senate,"Placed on suspense file",7,0,0,0,7
1215609,905364,2020-01-23,Senate,"Do pass",7,0,0,0,7
1215609,906430,2020-01-27,Senate,"Senate 3rd Reading SB739 Stern et al",39,0,0,0,39
1215609,973991,2020-07-27,Assembly,"Do pass as amended and be re-referred to the Committee on [Appropriations]",7,0,0,0,7
1215609,976394,2020-08-20,Assembly,"Do pass",16,0,2,0,18
1215609,977867,2020-08-30,Assembly,"SB 739 Stern Third Reading Urgency By Mullin",72,1,6,0,79
1215609,977868,2020-08-31,Senate,"Unfinished Business SB739 Stern et al. Urgency Clause Concurrence",32,0,8,0,40
1215611,850109,2019-04-22,Senate,"Do pass, but first be re-referred to the Committee on [Judiciary]",10,0,1,0,11
1215611,856823,2019-04-30,Senate,"Do pass as amended",9,0,0,0,9
1215611,867825,2019-05-20,Senate,"Senate 3rd Reading SB754 Moorlach",38,0,0,0,38
1215611,891082,2019-07-03,Assembly,"Do pass as amended",8,0,0,0,8
1215611,893934,2019-09-13,Assembly,"SB 754 Moorlach Senate Third Reading By Petrie-Norris",77,1,1,0,79
1215611,894161,2019-09-13,Senate,"Unfinished Business SB754 Moorlach",36,0,0,0,36
1215611,894387,2019-09-14,Senate,"Unfinished Business SB754 Moorlach",36,0,4,0,40
1215612,841370,2019-04-09,Assembly,"Do pass and be re-referred to the Committee on [Appropriations]",8,4,2,0,14
1215612,866317,2019-05-16,Assembly,"Do pass",13,4,1,0,18
1215612,874498,2019-05-29,Assembly,"AB 1415 Friedman Assembly Third Reading",52,20,8,0,80
1215612,887774,2019-06-25,Senate,"Do pass, but first be re-referred to the Committee on [Judiciary]",5,3,1,0,9
1215612,890765,2019-07-09,Senate,"Do pass, but first be re-referred to the Committee on [Appropriations]",7,1,1,0,9
1215612,890766,2019-08-12,Senate,"Placed on suspense file",7,0,0,0,7
1215613,853252,2019-04-24,Assembly,"Do pass as amended and be re-referred to the Committee on [Appropriations]",4,1,2,0,7
1215614,853151,2019-04-23,Senate,"Do pass as amended, but first amend, and re-refer to the Committee on [Appropriations]",9,0,0,0,9
1215614,863549,2019-05-13,Senate,"Placed on suspense file",6,0,0,0,6
1215614,866248,2019-05-16,Senate,"Do pass",6,0,0,0,6
1215614,871299,2019-05-23,Senate,"Special Consent SB668",38,0,0,0,38
1215614,888738,2019-06-26,Assembly,"Do pass and be re-referred to the Committee on [Appropriations]",19,0,2,0,21
1215614,891000,2019-08-30,Assembly,"Do pass",18,0,0,0,18
1215615,830312,2019-03-26,Assembly,"Do pass and be re-referred to the Committee on [Water, Parks, and Wildlife]",6,2,1,0,9
1215615,839833,2019-04-09,Assembly,"Do pass and be re-referred to the Committee on [Appropriations]",8,5,1,0,14
1215615,851564,2019-04-24,Assembly,"Do pass",12,5,1,0,18
1215615,859566,2019-05-06,Assembly,"AB 1788 Bloom Assembly Third Reading",49,16,15,0,80
1215615,884881,2019-06-19,Senate,"Do pass as amended, but first amend, and re-refer to the Committee on [Natural Resources and Water]",4,0,3,0,7
1215615,892638,2019-07-09,Senate,"Do pass, but first be re-referred to the Committee on [Appropriations]",7,1,1,0,9
1215615,976163,2020-08-19,Senate,"Placed on suspense file",7,0,0,0,7
1215615,976509,2020-08-20,Senate,"Do pass as amended",5,2,0,0,7
1215615,977781,2020-08-31,Senate,"Assembly 3rd Reading AB1788 Bloom et al. By Allen",23,7,10,0,40
1215615,977782,2020-08-31,Assembly,"AB 1788 BLOOM Concurrence in Senate Amendments",53,17,9,0,79
1215616,834852,2019-04-02,Assembly,"Do pass and be re-referred to the Committee on [Appropriations] with recommendation: To Consent Calendar",15,0,0,0,15
1215616,866477,2019-05-16,Assembly,"Do pass",18,0,0,0,18
1215616,871339,2019-05-23,Assembly,"AB 1443 Maienschein Assembly Third Reading",78,0,2,0,80
1215616,884840,2019-06-19,Senate,"Do pass, but first be re-referred to the Committee on [Appropriations] with the recommendation: To Consent Calendar",9,0,0,0,9
1215616,893819,2019-07-08,Senate,"Placed on suspense file",7,0,0,0,7
1215617,855877,2019-04-30,Assembly,"Do pass",10,1,1,0,12
1215617,859582,2019-05-06,Assembly,"AB 1394 Daly Assembly Third Reading",72,2,6,0,80
1215617,880364,2019-06-11,Senate,"Do pass, but first be re-referred to the Committee on [Appropriations]",6,1,0,0,7
1215617,886920,2019-06-24,Senate,"Placed on suspense file",7,0,0,0,7
1215617,890577,2019-08-30,Senate,"Do pass",7,0,0,0,7
1215617,890578,2019-09-05,Senate,"Assembly 3rd Reading AB1394 Daly By Umberg",37,3,0,0,40
1215617,890579,2019-09-09,Assembly,"AB 1394 Daly Concurrence in Senate Amendments",77,2,0,0,79
1215618,834213,2019-04-02,Senate,"Do pass, but first be re-referred to the Committee on [Governmental Organization]",13,0,0,0,13
1215618,839913,2019-04-09,Senate,"Do pass, but first be re-referred to the Committee on [Appropriations]",16,0,0,0,16
1215618,859471,2019-05-06,Senate,"Placed on suspense file",5,0,1,0,6
1215618,866153,2019-05-16,Senate,"Do pass",6,0,0,0,6
1215618,870069,2019-05-22,Senate,"Senate 3rd Reading SB670 McGuire et al",38,0,0,0,38
1215618,884813,2019-06-19,Assembly,"Do pass and be re-referred to the Committee on [Governmental Organization]",11,0,2,0,13
1215618,890916,2019-07-10,Assembly,"Do pass as amended and be re-referred to the Committee on [Appropriations]",21,0,0,0,21
1215618,890917,2019-08-30,Assembly,"Do pass as amended",18,0,0,0,18
1215618,890918,2019-09-10,Assembly,"SB 670 McGuire Third Reading Urgency",78,0,1,0,79
1215618,890919,2019-09-11,Senate,"Unfinished Business SB670 McGuire et al. Urgency Clause Concurrence",40,0,0,0,40
1215619,903177,2020-01-15,Senate,"Do pass, but first be re-referred to the Committee on [Appropriations]",11,0,1,0,12
1215619,905348,2020-01-23,Senate,"Senate 3rd Reading SB702 Hill",37,0,2,0,39
1215619,974888,2020-08-05,Assembly,"Do pass and be re-referred to the Committee on [Appropriations] with recommendation: To Consent Calendar",14,0,1,0,15
1215619,975528,2020-08-11,Assembly,"Do pass. To Consent Calendar",17,0,0,0,17
1215619,978083,2020-08-30,Senate,"Unfinished Business SB702 Hill Concurrence",39,0,1,0,40
1215619,978084,2020-08-30,Assembly,"SB 702 Hill Consent Calendar Second Day Regular Session",75,0,4,0,79
1215620,840626,2019-04-09,Senate,"Do pass, but first be re-referred to the Committee on [Appropriations]",7,0,0,0,7
1215620,848852,2019-04-22,Senate,"Placed on suspense file",6,0,0,0,6
1215620,865519,2019-05-16,Senate,"Do pass as amended",6,0,0,0,6
1215620,873893,2019-05-28,Senate,"Senate 3rd Reading SB580 Wilk et al",38,0,0,0,38
1215620,974968,2020-08-05,Assembly,"Do pass as amended and be re-referred to the Committee on [Appropriations]",6,0,2,0,8
1215621,839980,2019-04-09,Assembly,"Do pass. To Consent Calendar",12,0,0,0,12
1215621,849722,2019-04-22,Assembly,"AB 1361 Obernolte Consent Calendar Second Day Regular Session",78,0,2,0,80
1215621,877950,2019-06-04,Senate,"Do pass and be ordered to the Consent Calendar",9,0,0,0,9
1215621,883608,2019-06-17,Senate,"Consent Calendar AB1361",40,0,0,0,40
1215621,886109,2019-06-20,Assembly,"AB 1361 Obernolte Concurrence in Senate Amendments",78,0,1,0,79
1215624,841948,2019-04-09,Assembly,"Do pass and be re-referred to the Committee on [Appropriations] with recommendation: To Consent Calendar",8,0,0,0,8
1215624,851616,2019-04-24,Assembly,"Do pass. To Consent Calendar",18,0,0,0,18
1215624,858212,2019-05-02,Assembly,"AB 1794 Jones-Sawyer Consent Calendar Second Day Regular Session",76,0,4,0,80
1215624,877721,2019-06-04,Senate,"Do pass as amended, but first amend, and re-refer to the Committee on [Appropriations]",6,0,1,0,7
1215624,887047,2019-06-24,Senate,"Placed on suspense file",7,0,0,0,7
1215625,850644,2019-04-22,Senate,"Do pass as amended, but first amend, and re-refer to the Committee on [Appropriations]",9,0,0,0,9
1215625,863224,2019-05-13,Senate,"Placed on suspense file",6,0,0,0,6
1215625,866314,2019-05-16,Senate,"Do pass",6,0,0,0,6
1215625,871268,2019-05-23,Senate,"Special Consent SB608",38,0,0,0,38
1215625,893738,2019-07-09,Assembly,"Do pass and be re-referred to the Committee on [Appropriations]",19,0,0,0,19
1215625,893739,2019-08-30,Assembly,"Do pass",18,0,0,0,18
1215625,893740,2019-09-10,Assembly,"SB 608 Glazer Senate Third Reading By Low",79,0,0,0,79
1215625,893741,2019-09-11,Senate,"Unfinished Business SB608 Glazer Concurrence",40,0,0,0,40
1215626,840038,2019-04-03,Senate,"Do pass as amended, but first amend, and re-refer to the Committee on [Appropriations]",7,0,0,0,7
1215626,854383,2019-04-29,Senate,"Placed on suspense file",6,0,0,0,6
1215626,865667,2019-05-16,Senate,"Do pass",6,0,0,0,6
1215626,870911,2019-05-23,Senate,"Special Consent SB563",38,0,0,0,38
1215627,853694,2019-04-24,Senate,"Do pass, but first be re-referred to the Committee on [Appropriations]",5,1,1,0,7
1215627,863247,2019-05-13,Senate,"Placed on suspense file",6,0,0,0,6
1215627,866354,2019-05-16,Senate,"Do pass",4,2,0,0,6
1215627,870238,2019-05-22,Senate,"Senate 3rd Reading SB613 Stern",29,8,1,0,38
1215627,886981,2019-06-24,Assembly,"Do pass as amended and be re-referred to the Committee on [Appropriations]",7,3,1,0,11
1215627,894696,2019-05-13,Senate,Result,6,0,0,0,6
1215629,850206,2019-04-22,Senate,"Do pass, but first be re-referred to the Committee on [Appropriations]",9,0,0,0,9
1215629,859542,2019-05-06,Senate,"Placed on suspense file",5,0,1,0,6
1215629,866197,2019-05-16,Senate,"Do pass",6,0,0,0,6
1215629,868878,2019-05-21,Senate,"Senate 3rd Reading SB610 Glazer",38,0,0,0,38
1215629,892258,2019-07-09,Assembly,"Do pass and be re-referred to the Committee on [Appropriations]",19,0,0,0,19
1215629,892259,2019-08-30,Assembly,"Do pass",18,0,0,0,18
1215629,892260,2019-09-10,Assembly,"SB 610 Glazer Senate Third Reading By Low",78,0,1,0,79
1215629,892261,2019-09-11,Senate,"Unfinished Business SB610 Glazer Concurrence",40,0,0,0,40
1215631,834573,2019-04-02,Assembly,"Do pass as amended and be re-referred to the Committee on [Business and Professions]",15,0,0,0,15
1215631,839861,2019-04-09,Assembly,"Do pass and be re-referred to the Committee on [Appropriations]",20,0,0,0,20
1215631,851529,2019-04-24,Assembly,"Do pass. To Consent Calendar",18,0,0,0,18
1215631,873972,2019-05-28,Assembly,"AB 1622 Carrillo Assembly Third Reading",76,0,4,0,80
1215631,890341,2019-07-08,Senate,"Do pass, but first be re-referred to the Committee on [Appropriations]",9,0,0,0,9
1215631,890342,2019-09-10,Senate,"Assembly 3rd Reading AB1622 Carrillo By Hurtado",40,0,0,0,40
1215631,890343,2019-09-11,Assembly,"AB 1622 Carrillo Concurrence in Senate Amendments",79,0,0,0,79
1215632,841739,2019-04-09,Senate,"Do pass, but first be re-referred to the Committee on [Energy, Utilities and Communications]",12,0,0,0,12
1215632,851242,2019-04-24,Senate,"Do pass",13,0,0,0,13
1215632,858263,2019-05-02,Senate,"Senate 3rd Reading SB625 Hill",38,0,0,0,38
1215632,884876,2019-06-19,Assembly,"Do pass and be re-referred to the Committee on [Transportation]",7,3,3,0,13
1215632,893420,2019-07-08,Assembly,"Do pass and be re-referred to the Committee on [Appropriations]",11,4,0,0,15
1215632,893421,2019-08-21,Assembly,"Do pass",10,6,2,0,18
1215632,895117,2019-05-02,Senate,Result,38,0,0,0,38
1215632,962041,2020-06-01,Assembly,"Do pass as amended and be re-referred to the Committee on [Appropriations]",8,0,0,0,8
1215632,962742,2020-06-03,Assembly,"Do pass as amended",18,0,0,0,18
1215632,966446,2020-06-15,Assembly,"SB 625 Bradford Third Reading Urgency By CARRILLO",70,2,7,0,79
1215633,833111,2019-04-01,Senate,"Do pass, but first be re-referred to the Committee on [Judiciary]",9,0,0,0,9
1215633,841711,2019-04-09,Senate,"Do pass as amended, but first amend, and re-refer to the Committee on [Appropriations] with the recommendation: To Consent Calendar",8,0,0,0,8
1215633,867828,2019-05-20,Senate,"Senate 3rd Reading SB639 Mitchell",27,10,1,0,38
1215633,887496,2019-06-25,Assembly,"Do pass as amended and be re-referred to the Committee on [Judiciary]",14,1,4,0,19
1215633,892729,2019-07-09,Assembly,"Do pass as amended and be re-referred to the Committee on [Appropriations]",12,0,0,0,12
1215633,892730,2019-08-21,Assembly,"Do pass",14,0,4,0,18
1215633,892731,2019-09-10,Assembly,"SB 639 Mitchell Senate Third Reading By Mark Stone",69,1,9,0,79
1215633,893702,2019-09-12,Senate,"Unfinished Business SB639 Mitchell Concurrence",31,6,3,0,40
1215634,853002,2019-04-22,Senate,"Do pass as amended, but first amend, and re-refer to the Committee on [Appropriations]",9,0,0,0,9
1215634,863050,2019-05-13,Senate,"Placed on suspense file",6,0,0,0,6
1215634,865915,2019-05-16,Senate,"Do pass as amended",5,0,1,0,6
1215634,873839,2019-05-28,Senate,"Senate 3rd Reading SB556 Pan et al",35,1,2,0,38
1215635,840365,2019-04-08,Assembly,"Do pass and be re-referred to the Committee on [Appropriations] with recommendation: To Consent Calendar",15,0,0,0,15
1215636,834078,2019-04-02,Senate,"Do pass, but first be re-referred to the Committee on [Appropriations]",7,0,0,0,7
1215636,848931,2019-04-22,Senate,"Placed on suspense file",6,0,0,0,6
1215636,866353,2019-05-16,Senate,"Do pass",6,0,0,0,6
1215636,871581,2019-05-23,Senate,"Special Consent SB651",38,0,0,0,38
1215636,887637,2019-06-25,Assembly,"Do pass and be re-referred to the Committee on [Appropriations]",7,0,1,0,8
1215636,890477,2019-08-30,Assembly,"Do pass",18,0,0,0,18
1215636,890478,2019-09-09,Assembly,"SB 651 Glazer Senate Third Reading By Bauer-Kahan",77,0,2,0,79
1215637,841656,2019-04-10,Senate,"Do pass, but first be re-referred to the Committee on [Appropriations]",7,0,0,0,7
1215637,854809,2019-04-29,Senate,"Placed on suspense file",6,0,0,0,6
1215637,866138,2019-05-16,Senate,"Do pass as amended",6,0,0,0,6
1215637,871429,2019-05-23,Senate,"Senate 3rd Reading SB660 Pan et al",38,0,0,0,38
1215637,888158,2019-06-25,Assembly,"Do pass and be re-referred to the Committee on [Appropriations]",11,0,1,0,12
1215638,851328,2019-04-23,Assembly,"Do pass and be re-referred to the Committee on [Appropriations]",11,0,4,0,15
1215639,852719,2019-04-24,Assembly,"Do pass and be re-referred to the Committee on [Appropriations]",8,0,0,0,8
1215640,851427,2019-04-22,Senate,"Do pass as amended, but first amend, and re-refer to the Committee on [Appropriations]",11,0,0,0,11
1215640,867654,2019-05-20,Senate,"Senate 3rd Reading SB672 Hill",38,0,0,0,38
1215640,891346,2019-07-03,Assembly,"Do pass and be re-referred to the Committee on [Local Government]",8,0,0,0,8
1215640,891347,2019-07-10,Assembly,"Do pass and be re-referred to the Committee on [Appropriations]",8,0,0,0,8
1215645,842253,2019-04-09,Assembly,"Do pass and be re-referred to the Committee on [Appropriations]",14,0,0,0,14
1215646,850093,2019-04-22,Senate,"Do pass as amended, but first amend, and re-refer to the Committee on [Appropriations]",8,0,1,0,9
1215646,863207,2019-05-13,Senate,"Placed on suspense file",6,0,0,0,6
1215646,865745,2019-05-16,Senate,"Do pass",6,0,0,0,6
1215646,871575,2019-05-23,Senate,"Senate 3rd Reading SB697 Caballero et al",37,0,1,0,38
1215646,890796,2019-07-09,Assembly,"Do pass as amended and be re-referred to the Committee on [Appropriations]",19,0,0,0,19
1215646,890797,2019-08-30,Assembly,"Do pass as amended",18,0,0,0,18
1215646,890798,2019-09-09,Assembly,"SB 697 Caballero Senate Third Reading By Friedman",79,0,0,0,79
1215646,890799,2019-09-11,Senate,"Unfinished Business SB697 Caballero et al. Concurrence",40,0,0,0,40
1215647,836897,2019-04-02,Assembly,"Do pass as amended and be re-referred to the Committee on [Accountability and Administrative Review]",6,0,1,0,7
1215647,851241,2019-04-24,Assembly,"Do pass and be re-referred to the Committee on [Appropriations]",6,0,1,0,7
1215648,851005,2019-04-22,Assembly,"Do pass and be re-referred to the Committee on [Appropriations]",9,0,2,0,11
1215648,866360,2019-05-16,Assembly,"Do pass",14,0,4,0,18
1215648,871632,2019-05-23,Assembly,"AB 1680 Limón Assembly Third Reading",67,1,12,0,80
1215648,893440,2019-07-09,Senate,"Do pass as amended, but first amend, and re-refer to the Committee on [Appropriations]",7,1,1,0,9
1215648,893441,2019-08-19,Senate,"Placed on suspense file",5,0,2,0,7
1215648,893442,2019-08-30,Senate,"Do pass as amended",5,0,2,0,7
1215648,893443,2019-09-04,Senate,"Assembly 3rd Reading AB1680 Limón By Jackson",30,2,8,0,40
1215648,893444,2019-09-09,Assembly,"AB 1680 Limón Concurrence in Senate Amendments",69,1,9,0,79
1215649,861239,2019-04-24,Senate,"Do pass, but first be re-referred to the Committee on [Appropriations]",2,5,2,0,9
1215649,861240,2019-04-24,Senate,"[First] hearing set for [04-25-2019]: Failed passage in Committee. Reconsideration granted",9,0,0,0,9
1215651,841545,2019-04-10,Assembly,"Do pass and be re-referred to the Committee on [Judiciary]",8,0,0,0,8
1215651,851036,2019-04-23,Assembly,"Do pass and be re-referred to the Committee on [Appropriations]",12,0,0,0,12
1215651,862031,2019-05-08,Assembly,"Do pass. To Consent Calendar",18,0,0,0,18
1215651,865605,2019-05-16,Assembly,"AB 1497 Holden Consent Calendar Second Day Regular Session",74,0,6,0,80
1215651,880657,2019-06-11,Senate,"Do pass as amended, but first amend, and re-refer to the Committee on [Appropriations] with the recommendation: To Consent Calendar",9,0,0,0,9
1215651,891428,2019-09-03,Senate,"Assembly 3rd Reading AB1497 Holden et al. By Wiener",40,0,0,0,40
1215651,891429,2019-09-09,Assembly,"AB 1497 Holden Concurrence in Senate Amendments",79,0,0,0,79
1215652,835197,2019-04-02,Senate,"Do pass, but first be re-referred to the Committee on [Housing] with the recommendation: To Consent Calendar",8,0,0,0,8
1215652,855828,2019-04-30,Senate,"Do pass and be ordered to the Consent Calendar",11,0,0,0,11
1215652,859499,2019-05-06,Senate,"Consent Calendar SB652",38,0,0,0,38
1215652,884973,2019-06-19,Assembly,"Do pass and be re-referred to the Committee on [Judiciary] with recommendation: To Consent Calendar",8,0,0,0,8
1215652,894055,2019-07-02,Assembly,"Do pass. To Consent Calendar",12,0,0,0,12
1215652,894056,2019-07-08,Assembly,"SB 652 Allen Consent Calendar Second Day Regular Session",76,0,3,0,79
1215653,853107,2019-04-24,Assembly,"Do pass and be re-referred to the Committee on [Appropriations]",6,1,1,0,8
1215654,852732,2019-04-24,Assembly,"Do pass and be re-referred to the Committee on [Appropriations] with recommendation: To Consent Calendar",19,0,2,0,21
1215655,835760,2019-04-02,Senate,"Do pass, but first be re-referred to the Committee on [Governance and Finance]",8,1,2,0,11
1215655,841660,2019-04-10,Senate,"Do pass, but first be re-referred to the Committee on [Environmental Quality]",6,1,0,0,7
1215655,851276,2019-04-24,Senate,"Do pass as amended, but first amend, and re-refer to the Committee on [Appropriations]",5,1,1,0,7
1215655,867730,2019-05-20,Senate,"Senate 3rd Reading SB744 Caballero",34,2,2,0,38
1215655,890561,2019-07-03,Assembly,"Do pass and be re-referred to the Committee on [Natural Resources]",7,0,1,0,8
1215655,890562,2019-07-08,Assembly,"Do pass as amended and be re-referred to the Committee on [Appropriations]",9,0,2,0,11
1215655,890563,2019-08-14,Assembly,"Do pass",17,1,0,0,18
1215655,890564,2019-09-09,Assembly,"SB 744 Caballero Senate Third Reading By Salas",68,2,9,0,79
1215655,890565,2019-09-11,Senate,"Unfinished Business SB744 Caballero Concurrence",35,1,4,0,40
1215656,868797,2019-04-09,Assembly,"Do pass and be re-referred to the Committee on [Public Safety]",7,7,6,0,20
1215657,850433,2019-04-22,Assembly,"Do pass and be re-referred to the Committee on [Business and Professions]",8,1,3,0,12
1215657,902842,2020-01-14,Assembly,"Do pass as amended and be re-referred to the Committee on [Appropriations]",18,0,1,0,19
1215657,905391,2020-01-23,Assembly,"Do pass",17,0,1,0,18
1215657,906408,2020-01-27,Assembly,"AB 1525 Jones-Sawyer Assembly Third Reading",68,1,11,0,80
1215657,975840,2020-08-13,Senate,"Do pass, but first be re-referred to the Committee on [Appropriations]",7,0,0,0,7
1215657,975992,2020-08-17,Senate,"Placed on suspense file",7,0,0,0,7
1215657,976350,2020-08-20,Senate,"Do pass as amended",7,0,0,0,7
1215657,977183,2020-08-27,Senate,"Assembly 3rd Reading AB1525 Jones-Sawyer et al. By Hertzberg",28,2,10,0,40
1215657,977964,2020-08-30,Assembly,"AB 1525 Jones-Sawyer Concurrence in Senate Amendments",70,0,9,0,79
1215660,840153,2019-04-09,Assembly,"Do pass as amended and be re-referred to the Committee on [Privacy and Consumer Protection]",9,1,2,0,12
1215660,851386,2019-04-23,Assembly,"Do pass as amended and be re-referred to the Committee on [Appropriations]",8,1,2,0,11
1215660,861492,2019-05-08,Assembly,"Do pass",13,4,1,0,18
1215660,874667,2019-05-29,Assembly,"AB 1782 Chau Assembly Third Reading",49,18,13,0,80
1215660,975841,2020-08-13,Senate,"Do pass, but first be re-referred to the Committee on [Appropriations]",5,0,4,0,9
1215660,976168,2020-08-19,Senate,"Placed on suspense file",7,0,0,0,7
1215661,850820,2019-04-23,Assembly,"Do pass as amended and be re-referred to the Committee on [Appropriations]",12,0,0,0,12
1215661,856723,2019-05-01,Assembly,"Do pass. To Consent Calendar",18,0,0,0,18
1215661,862155,2019-05-09,Assembly,"AB 1667 Santiago Consent Calendar Second Day Regular Session",76,0,4,0,80
1215661,975770,2020-08-13,Senate,"Do pass, but first be re-referred to the Committee on [Appropriations] with the recommendation: To Consent Calendar",9,0,0,0,9
1215661,976160,2020-08-19,Senate,"Placed on suspense file",7,0,0,0,7
1215662,851095,2019-04-22,Assembly,"Do pass and be re-referred to the Committee on [Appropriations]",11,0,0,0,11
1215662,866230,2019-05-16,Assembly,"Do pass",18,0,0,0,18
1215662,874710,2019-05-29,Assembly,"AB 1511 Bloom Assembly Third Reading",78,0,2,0,80
1215662,891499,2019-07-09,Senate,"Do pass, but first be re-referred to the Committee on [Appropriations]",8,0,1,0,9
1215662,891500,2019-08-12,Senate,"Placed on suspense file",7,0,0,0,7
1215662,891501,2019-08-30,Senate,"Do pass",7,0,0,0,7
1215662,891502,2019-09-09,Senate,"Special Consent AB1511",40,0,0,0,40
1215663,851552,2019-04-23,Assembly,"Do pass and be re-referred to the Committee on [Appropriations] with recommendation: To Consent Calendar",19,0,1,0,20
1215663,856825,2019-05-01,Assembly,"Do pass. To Consent Calendar",18,0,0,0,18
1215663,862286,2019-05-09,Assembly,"AB 1467 Salas Consent Calendar Second Day Regular Session",76,0,4,0,80
1215664,848961,2019-04-09,Senate,"Do pass as amended, but first amend, and re-refer to the Committee on [Appropriations]",7,1,1,0,9
1215664,863222,2019-05-13,Senate,"Placed on suspense file",6,0,0,0,6
1215664,866269,2019-05-16,Senate,"Do pass as amended",5,1,0,0,6
1215664,873935,2019-05-28,Senate,"Senate 3rd Reading SB576 Umberg",31,5,2,0,38
1215664,893212,2019-07-08,Assembly,"Do pass and be re-referred to the Committee on [Appropriations]",9,1,1,0,11
1215664,893213,2019-08-30,Assembly,"Do pass",14,4,0,0,18
1215664,893214,2019-09-10,Assembly,"SB 576 Umberg Senate Third Reading By Petrie-Norris",68,0,11,0,79
1215664,893743,2019-09-12,Senate,"Unfinished Business SB576 Umberg Concurrence",33,5,2,0,40
1215669,840670,2019-04-09,Assembly,"Do pass",20,0,0,0,20
1215669,858030,2019-05-02,Assembly,"AB 1540 Holden Assembly Third Reading",75,0,5,0,80
1215669,886982,2019-06-24,Senate,"Do pass",9,0,0,0,9
1215669,892298,2019-07-11,Senate,"Special Consent AB1540",39,0,1,0,40
1215672,852754,2019-04-24,Assembly,"Do pass and be re-referred to the Committee on [Appropriations]",7,0,0,0,7
1215672,866012,2019-05-16,Assembly,"Do pass",15,3,0,0,18
1215672,874489,2019-05-29,Assembly,"AB 1459 Arambula Assembly Third Reading",60,17,3,0,80
1215672,887912,2019-06-26,Senate,"Do pass as amended, but first amend, and re-refer to the Committee on [Appropriations]",4,1,0,0,5
1215672,892001,2019-07-08,Senate,"Placed on suspense file",7,0,0,0,7
1215673,841413,2019-04-10,Assembly,"Do pass and be re-referred to the Committee on [Business and Professions]",5,2,0,0,7
1215674,833009,2019-04-01,Senate,"Do pass, but first be re-referred to the Committee on [Education] with the recommendation: To Consent Calendar",9,0,0,0,9
1215674,851320,2019-04-24,Senate,"Do pass, but first be re-referred to the Committee on [Appropriations] with the recommendation: To Consent Calendar",7,0,0,0,7
1215674,859530,2019-05-06,Senate,"Placed on suspense file",5,0,1,0,6
1215674,865580,2019-05-16,Senate,"Do pass",6,0,0,0,6
1215674,871537,2019-05-23,Senate,"Special Consent SB634",38,0,0,0,38
1215675,852814,2019-04-25,Assembly,"Do pass and be re-referred to the Committee on [Appropriations]",7,0,0,0,7
1215675,861954,2019-05-08,Assembly,"Do pass. To Consent Calendar",18,0,0,0,18
1215675,866024,2019-05-16,Assembly,"AB 1666 Reyes Consent Calendar Second Day Regular Session",74,0,6,0,80
1215675,891068,2019-07-10,Senate,"Do pass, but first be re-referred to the Committee on [Appropriations]",7,0,0,0,7
1215675,891069,2019-09-11,Senate,"Assembly 3rd Reading AB1666 Reyes By Durazo Urgency Clause",38,0,2,0,40
1215675,893695,2019-09-12,Assembly,"AB 1666 Reyes Concurrence - Urgency Added",78,0,1,0,79
1215679,850549,2019-04-22,Senate,"Do pass, but first be re-referred to the Committee on [Appropriations]",9,0,0,0,9
1215679,859922,2019-05-06,Senate,"Placed on suspense file",5,0,1,0,6
1215679,866465,2019-05-16,Senate,"Do pass",6,0,0,0,6
1215679,870953,2019-05-23,Senate,"Special Consent SB738",38,0,0,0,38
1215679,892804,2019-07-09,Assembly,"Do pass as amended and be re-referred to the Committee on [Appropriations]",7,0,0,0,7
1215679,894577,2019-05-06,Senate,Result,5,0,0,0,5
1215679,895643,2019-05-16,Senate,"Bill Votes",6,0,0,0,6
1215681,841813,2019-04-09,Assembly,"Do pass. To Consent Calendar",9,0,0,0,9
1215681,853299,2019-04-25,Assembly,"AB 1429 Chen Consent Calendar Second Day Regular Session",76,0,4,0,80
1215681,878693,2019-06-05,Senate,"Do pass and be ordered to the Consent Calendar",7,0,0,0,7
1215681,883445,2019-06-17,Senate,"Consent Calendar AB1429",40,0,0,0,40
1215681,888608,2019-06-27,Assembly,"AB 1429 Chen Concurrence in Senate Amendments",72,0,7,0,79
1215682,851518,2019-04-23,Senate,"Do pass as amended, but first amend, and re-refer to the Committee on [Appropriations]",2,4,1,0,7
1215682,851519,2019-04-23,Senate,"[First] hearing set for [04-24-2019]: Failed passage in Committee. Reconsideration granted",6,0,1,0,7
1215683,842930,2019-04-09,Assembly,"Do pass as amended and be re-referred to the Committee on [Appropriations]",8,0,0,0,8
1215684,902204,2020-01-13,Assembly,"Do pass as amended and be re-referred to the Committee on [Appropriations]",11,0,0,0,11
1215684,905422,2020-01-23,Assembly,"Do pass",18,0,0,0,18
1215684,906382,2020-01-27,Assembly,"AB 1567 Aguiar-Curry Assembly Third Reading",78,0,2,0,80
1215685,854203,2019-04-24,Senate,"Do pass as amended, but first amend, and re-refer to the Committee on [Appropriations]",8,0,1,0,9
1215685,863100,2019-05-13,Senate,"Placed on suspense file",6,0,0,0,6
1215685,866110,2019-05-16,Senate,"Do pass",4,2,0,0,6
1215685,868789,2019-05-21,Senate,"Senate 3rd Reading SB600 Portantino",38,0,0,0,38
1215685,890432,2019-07-09,Assembly,"Do pass and be re-referred to the Committee on [Appropriations]",10,0,5,0,15
1215685,890433,2019-08-30,Assembly,"Do pass",14,1,3,0,18
1215685,890434,2019-09-09,Assembly,"SB 600 Portantino Senate Third Reading By Wicks",56,2,21,0,79
1215685,890435,2019-09-11,Senate,"Unfinished Business SB600 Portantino Concurrence",38,0,2,0,40
1215686,857009,2019-05-01,Senate,"Do pass, but first be re-referred to the Committee on [Appropriations]",4,0,3,0,7
1215686,863240,2019-05-13,Senate,"Placed on suspense file",6,0,0,0,6
1215688,840643,2019-04-09,Assembly,"Do pass as amended and be re-referred to the Committee on [Aging and Long-Term Care]",12,0,0,0,12
1215688,850665,2019-04-23,Assembly,"Do pass and be re-referred to the Committee on [Appropriations]",7,0,0,0,7
1215688,856811,2019-05-01,Assembly,"Do pass. To Consent Calendar",18,0,0,0,18
1215688,873984,2019-05-28,Assembly,"AB 1396 Obernolte Assembly Third Reading",76,0,4,0,80
1215688,885364,2019-06-18,Senate,"Do pass, but first be re-referred to the Committee on [Appropriations] with the recommendation: To Consent Calendar",9,0,0,0,9
1215688,892825,2019-08-26,Senate,"Assembly 3rd Reading AB1396 Obernolte By Durazo",39,0,1,0,40
1215688,892826,2019-08-30,Assembly,"AB 1396 Obernolte Concurrence in Senate Amendments",75,0,4,0,79
1215689,854905,2019-04-23,Senate,"Do pass as amended, but first amend, and re-refer to the Committee on [Appropriations]",8,0,1,0,9
1215689,873942,2019-05-28,Senate,"Senate 3rd Reading SB707 Wieckowski et al",29,8,1,0,38
1215689,884067,2019-06-18,Assembly,"Do pass",8,3,1,0,12
1215689,892405,2019-09-11,Assembly,"SB 707 Wieckowski Senate Third Reading By Bonta",51,21,7,0,79
1215691,835702,2019-04-02,Assembly,"Do pass and be re-referred to the Committee on [Appropriations]",12,1,2,0,15
1215691,865877,2019-05-16,Assembly,"Do pass as amended",15,1,2,0,18
1215691,873840,2019-05-28,Assembly,"AB 1309 Bauer-Kahan Assembly Third Reading",66,5,9,0,80
1215691,893052,2019-07-03,Senate,"Do pass as amended, but first amend, and re-refer to the Committee on [Appropriations]",7,0,2,0,9
1215691,893053,2019-08-12,Senate,"Do pass",7,0,0,0,7
1215691,893054,2019-09-03,Senate,"Assembly 3rd Reading AB1309 Bauer-Kahan et al. By Jackson",40,0,0,0,40
1215691,893055,2019-09-05,Assembly,"AB 1309 Bauer-Kahan Concurrence in Senate Amendments",74,0,5,0,79
1215692,830362,2019-03-26,Assembly,"Do pass as amended and be re-referred to the Committee on [Appropriations]",6,0,3,0,9
1215692,865768,2019-05-16,Assembly,"Do pass",14,0,4,0,18
1215692,871504,2019-05-23,Assembly,"AB 1500 Carrillo Assembly Third Reading",66,0,14,0,80
1215692,890558,2019-07-03,Senate,"Do pass, but first be re-referred to the Committee on [Judiciary]",5,1,1,0,7
1215692,890559,2019-07-09,Senate,"Do pass, but first be re-referred to the Committee on [Appropriations]",8,0,1,0,9
1215692,890560,2019-08-12,Senate,"Placed on suspense file",7,0,0,0,7
1215693,842644,2019-04-10,Assembly,"Do pass and be re-referred to the Committee on [Appropriations] with recommendation: To Consent Calendar",6,0,0,0,6
1215693,851607,2019-04-24,Assembly,"Do pass. To Consent Calendar",18,0,0,0,18
1215693,871009,2019-05-23,Assembly,"AB 1319 Arambula Assembly Third Reading",78,0,2,0,80
1215693,888031,2019-06-26,Senate,"Do pass, but first be re-referred to the Committee on [Appropriations] with the recommendation: To Consent Calendar",7,0,0,0,7
1215693,892170,2019-09-03,Senate,"Assembly 3rd Reading AB1319 Arambula et al. By Hurtado",40,0,0,0,40
1215693,892171,2019-09-05,Assembly,"AB 1319 Arambula Concurrence in Senate Amendments",79,0,0,0,79
1215694,835758,2019-04-02,Assembly,"Do pass and be re-referred to the Committee on [Appropriations]",8,0,4,0,12
1215694,851538,2019-04-24,Assembly,"Do pass",13,2,3,0,18
1215694,859559,2019-05-06,Assembly,"AB 1504 Medina Assembly Third Reading",58,12,10,0,80
1215694,878560,2019-06-05,Senate,"Do pass as amended, but first amend, and re-refer to the Committee on [Appropriations]",5,0,2,0,7
1215694,887075,2019-06-24,Senate,"Do pass",5,2,0,0,7
1215694,891063,2019-08-22,Senate,"Assembly 3rd Reading AB1504 Medina By Leyva",28,10,2,0,40
1215694,891064,2019-08-26,Assembly,"AB 1504 Medina Concurrence in Senate Amendments",59,12,8,0,79
1215695,834336,2019-04-02,Assembly,"Do pass and be re-referred to the Committee on [Appropriations]",19,0,1,0,20
1215695,851711,2019-04-24,Assembly,"Do pass. To Consent Calendar",18,0,0,0,18
1215695,858021,2019-05-02,Assembly,"AB 1651 Medina Consent Calendar Second Day Regular Session",76,0,4,0,80
1215695,876966,2019-06-03,Senate,"Do pass, but first be re-referred to the Committee on [Appropriations]",9,0,0,0,9
1215695,891725,2019-08-26,Senate,"Assembly 3rd Reading AB1651 Medina By Roth",39,0,1,0,40
1215695,891726,2019-08-30,Assembly,"AB 1651 Medina Concurrence in Senate Amendments",75,0,4,0,79
1215697,834534,2019-04-03,Senate,"Do pass, but first be re-referred to the Committee on [Veterans Affairs]",6,0,1,0,7
1215697,836843,2019-04-03,Senate,"Do pass, but first be re-referred to the Committee on [Veterans old"" title=""No Votes Recorded"">No Votes Recorded:",0,0,1,0,1
1215697,852285,2019-04-23,Senate,"Do pass, but first be re-referred to the Committee on [Appropriations]",7,0,0,0,7
1215697,860588,2019-05-06,Senate,"Placed on suspense file",5,0,1,0,6
1215697,865980,2019-05-16,Senate,"Do pass",6,0,0,0,6
1215697,871695,2019-05-23,Senate,"Special Consent SB562",38,0,0,0,38
1215698,841320,2019-04-09,Assembly,"Do pass and be re-referred to the Committee on [Appropriations]",10,3,1,0,14
1215698,905340,2020-01-23,Assembly,"Do pass as amended",13,2,3,0,18
1215698,906422,2020-01-27,Assembly,"AB 1426 Boerner Horvath Assembly Third Reading",58,16,6,0,80
1215698,974915,2020-08-05,Senate,"Do pass, but first be re-referred to the Committee on [Appropriations]",7,1,1,0,9
1215698,976611,2020-08-24,Senate,"Assembly 3rd Reading AB1426 Boerner Horvath et al. By Monning",30,4,6,0,40
1215698,976926,2020-08-26,Assembly,"AB 1426 Boerner Horvath Concurrence in Senate Amendments",61,10,8,0,79
1215700,850604,2019-04-23,Assembly,"Do pass as amended and be re-referred to the Committee on [Appropriations]",12,6,2,0,20
1215701,834348,2019-04-02,Senate,"Do pass as amended, but first amend, and re-refer to the Committee on [Appropriations]",3,0,2,0,5
1215701,848804,2019-04-22,Senate,"Placed on suspense file",6,0,0,0,6
1215702,853036,2019-04-23,Assembly,"Do pass as amended and be re-referred to the Committee on [Appropriations]",9,3,0,0,12
1215704,849963,2019-04-22,Senate,"Do pass, but first be re-referred to the Committee on [Appropriations]",11,0,0,0,11
1215704,859553,2019-05-06,Senate,"Placed on suspense file",5,0,1,0,6
1215704,865650,2019-05-16,Senate,"Do pass",6,0,0,0,6
1215704,871529,2019-05-23,Senate,"Special Consent SB611",38,0,0,0,38
1215704,884653,2019-06-19,Assembly,"Do pass as amended and be re-referred to the Committee on [Aging and Long-Term Care]",8,0,0,0,8
1215704,891335,2019-07-09,Assembly,"Do pass and be re-referred to the Committee on [Appropriations]",7,0,0,0,7
1215704,891336,2019-08-30,Assembly,"Do pass",18,0,0,0,18
1215704,891337,2019-09-05,Assembly,"SB 611 Caballero Senate Third Reading By Aguiar-Curry",79,0,0,0,79
1215704,891338,2019-09-06,Senate,"Unfinished Business SB611 Caballero et al. Concurrence",39,0,1,0,40
1215705,850113,2019-04-22,Assembly,"Do pass",11,3,1,0,15
1215705,858132,2019-05-02,Assembly,"AB 1605 Ting Assembly Third Reading",51,18,11,0,80
1215705,881035,2019-06-12,Senate,"Do pass as amended, but first amend, and re-refer to the Committee on [Transportation]",4,1,2,0,7
1215705,891823,2019-07-09,Senate,"Do pass",8,4,1,0,13
1215705,891824,2019-09-03,Senate,"Assembly 3rd Reading AB1605 Ting et al. By Wiener",29,11,0,0,40
1215705,891825,2019-09-05,Assembly,"AB 1605 Ting Concurrence in Senate Amendments",54,23,2,0,79
1215706,851805,2019-04-22,Senate,"Do pass as amended, but first amend, and re-refer to the Committee on [Appropriations]",5,2,2,0,9
1215706,863234,2019-05-13,Senate,"Placed on suspense file",6,0,0,0,6
1215708,852807,2019-04-24,Senate,"Do pass, but first be re-referred to the Committee on [Appropriations]",7,0,0,0,7
1215708,863266,2019-05-13,Senate,"Placed on suspense file",6,0,0,0,6
1215708,866368,2019-05-16,Senate,"Do pass",6,0,0,0,6
1215708,871272,2019-05-23,Senate,"Special Consent SB633",38,0,0,0,38
1215708,892414,2019-07-02,Assembly,"Do pass and be re-referred to the Committee on [Appropriations] with recommendation: To Consent Calendar",9,0,0,0,9
1215708,892415,2019-08-30,Assembly,"Do pass",18,0,0,0,18
1215708,896254,2019-05-16,Senate,Result,6,0,0,0,6
1215710,840139,2019-04-09,Senate,"Do pass, but first be re-referred to the Committee on [Appropriations]",7,0,2,0,9
1215710,859760,2019-05-06,Senate,"Placed on suspense file",5,0,1,0,6
1215710,866471,2019-05-16,Senate,"Do pass as amended",6,0,0,0,6
1215710,870941,2019-05-23,Senate,"Senate 3rd Reading SB559 Hurtado et al",34,3,1,0,38
1215710,892354,2019-07-02,Assembly,"Do pass as amended and be re-referred to the Committee on [Appropriations]",10,0,4,0,14
1215710,976472,2020-08-20,Assembly,"Do pass as amended",16,0,2,0,18
1215710,978060,2020-08-30,Assembly,"SB 559 Hurtado Senate Third Reading By Arambula",68,0,11,0,79
1215710,978061,2020-08-31,Senate,"Unfinished Business SB559 Hurtado et al. Concurrence",37,2,1,0,40
1215711,833179,2019-03-27,Assembly,"Do pass as amended and be re-referred to the Committee on [Appropriations]",5,0,1,0,6
1215711,865791,2019-05-16,Assembly,"Do pass as amended",15,3,0,0,18
1215711,874624,2019-05-29,Assembly,"AB 1354 Gipson Assembly Third Reading",64,8,8,0,80
1215711,888076,2019-06-26,Senate,"Do pass, but first be re-referred to the Committee on [Public Safety]",7,0,0,0,7
1215711,893617,2019-07-09,Senate,"Do pass, but first be re-referred to the Committee on [Appropriations]",5,1,1,0,7
1215711,893618,2019-08-12,Senate,"Placed on suspense file",7,0,0,0,7
1215711,893619,2019-08-30,Senate,"Do pass",5,2,0,0,7
1215711,893620,2019-09-04,Senate,"Assembly 3rd Reading AB1354 Gipson et al. By Portantino",31,8,1,0,40
1215712,903143,2020-01-15,Senate,"Do pass, but first be re-referred to the Committee on [Appropriations]",12,0,0,0,12
1215712,906387,2020-01-27,Senate,"Senate 3rd Reading SB605 Hueso",39,0,0,0,39
1215713,840402,2019-04-09,Senate,"Do pass, but first be re-referred to the Committee on [Education]",7,0,0,0,7
1215713,851346,2019-04-24,Senate,"Do pass, but first be re-referred to the Committee on [Appropriations]",6,0,1,0,7
1215713,859485,2019-05-06,Senate,"Placed on suspense file",5,0,1,0,6
1215713,865798,2019-05-16,Senate,"Do pass as amended",6,0,0,0,6
1215713,871507,2019-05-23,Senate,"Senate 3rd Reading SB716 Mitchell et al",37,0,1,0,38
1215713,888021,2019-06-25,Assembly,"Do pass and be re-referred to the Committee on [Public Safety]",12,0,0,0,12
1215713,892971,2019-07-09,Assembly,"Do pass as amended and be re-referred to the Committee on [Appropriations]",8,0,0,0,8
1215713,892972,2019-08-30,Assembly,"Do pass as amended",18,0,0,0,18
1215713,892973,2019-09-10,Assembly,"SB 716 Mitchell Senate Third Reading By BLOOM",79,0,0,0,79
1215713,892974,2019-09-11,Senate,"Unfinished Business SB716 Mitchell et al. Concurrence",40,0,0,0,40
1215714,839708,2019-04-03,Senate,"Do pass as amended, but first amend, and re-refer to the Committee on [Governmental Organization]",6,0,1,0,7
1215715,841620,2019-04-09,Assembly,"Do pass and be re-referred to the Committee on [Business and Professions]",9,0,3,0,12
1215715,850414,2019-04-23,Assembly,"Do pass and be re-referred to the Committee on [Appropriations]",16,0,4,0,20
1215715,856921,2019-05-01,Assembly,"Do pass",13,0,5,0,18
1215715,869769,2019-05-22,Assembly,"AB 1345 McCarty Assembly Third Reading",69,0,11,0,80
1215715,889286,2019-07-01,Senate,"Do pass, but first be re-referred to the Committee on [Education]",5,0,4,0,9
1215715,891821,2019-07-10,Senate,"Do pass as amended, but first amend, and re-refer to the Committee on [Appropriations]",5,0,2,0,7
1215715,891822,2019-08-19,Senate,"Placed on suspense file",5,0,2,0,7
1215718,902206,2020-01-13,Assembly,"Do pass as amended and be re-referred to the Committee on [Appropriations]",15,0,0,0,15
1215718,905370,2020-01-23,Assembly,"Do pass",18,0,0,0,18
1215718,906390,2020-01-27,Assembly,"AB 1350 Gonzalez Assembly Third Reading",75,0,5,0,80
1215718,974282,2020-07-29,Senate,"Do pass as amended, and be ordered to the Consent Calendar",7,0,0,0,7
1215718,977357,2020-08-28,Senate,"Consent Calendar AB1350",39,0,1,0,40
1215718,978005,2020-08-30,Assembly,"AB 1350 Gonzalez Concurrence in Senate Amendments",75,0,4,0,79
1215719,858156,2019-04-30,Assembly,"Do pass as amended",9,0,2,0,11
1215719,874661,2019-05-29,Assembly,"AB 1416 Cooley Assembly Third Reading By DALY",47,17,16,0,80
1215721,848758,2019-04-09,Senate,"Do pass as amended, but first amend, and re-refer to the Committee on [Appropriations]",7,0,1,0,8
1215721,874405,2019-05-29,Senate,"Senate 3rd Reading SB638 Allen",34,0,4,0,38
1215721,887432,2019-06-25,Assembly,"Do pass as amended and be re-referred to the Committee on [Appropriations]",12,0,0,0,12
1215721,892466,2019-08-14,Assembly,"Do pass",18,0,0,0,18
1215721,892467,2019-09-09,Assembly,"SB 638 Allen Senate Third Reading By Gallagher",77,1,1,0,79
1215721,892468,2019-09-11,Senate,"Unfinished Business SB638 Allen Concurrence",38,0,2,0,40
1215722,842259,2019-04-10,Assembly,"Do pass and be re-referred to the Committee on [Business and Professions]",7,0,0,0,7
1215722,851110,2019-04-23,Assembly,"Do pass and be re-referred to the Committee on [Appropriations] with recommendation: To Consent Calendar",19,0,1,0,20
1215722,866218,2019-05-16,Assembly,"Do pass",18,0,0,0,18
1215722,871608,2019-05-23,Assembly,"AB 1523 B. & P. Assembly Third Reading By LOW",78,0,2,0,80
1215722,892235,2019-07-08,Senate,"Do pass, but first be re-referred to the Committee on [Appropriations]",9,0,0,0,9
1215722,892236,2019-08-12,Senate,"Placed on suspense file",7,0,0,0,7
1215722,892237,2019-08-30,Senate,"Do pass",7,0,0,0,7
1215722,892238,2019-09-09,Senate,"Special Consent AB1523",40,0,0,0,40
1215722,892239,2019-09-10,Assembly,"AB 1523 Low Concurrence in Senate Amendments",79,0,0,0,79
1215722,894243,2019-09-09,Senate,Result,40,0,0,0,40
1215724,841939,2019-04-09,Assembly,"Do pass and be re-referred to the Committee on [Appropriations] with recommendation: To Consent Calendar",5,0,3,0,8
1215724,866050,2019-05-16,Assembly,"Do pass as amended",14,1,3,0,18
1215724,874603,2019-05-29,Assembly,"AB 1321 Gipson Assembly Third Reading",66,5,9,0,80
1215724,890722,2019-07-09,Senate,"Do pass as amended, but first amend, and re-refer to the Committee on [Appropriations]",7,1,1,0,9
1215724,890723,2019-08-19,Senate,"Placed on suspense file",5,0,2,0,7
1215724,890724,2019-08-30,Senate,"Do pass",5,2,0,0,7
1215726,850262,2019-04-22,Assembly,"Do pass and be re-referred to the Committee on [Appropriations]",7,2,2,0,11
1215726,866611,2019-05-16,Assembly,"Do pass",12,4,2,0,18
1215726,872076,2019-05-24,Assembly,"AB 1593 Reyes Assembly Third Reading",55,18,7,0,80
1215727,891777,2019-07-10,Senate,"Do pass, but first be re-referred to the Committee on [Appropriations]",8,0,1,0,9
1215727,891778,2019-08-12,Senate,"Placed on suspense file",7,0,0,0,7
1215727,891779,2019-08-30,Senate,"Do pass as amended",5,0,2,0,7
1215727,891780,2019-09-05,Senate,"Senate 3rd Reading SB665 Umberg Urgency Clause",40,0,0,0,40
1215727,975006,2020-08-04,Assembly,"Do pass and be re-referred to the Committee on [Appropriations]",14,0,1,0,15
1215728,852832,2019-04-24,Senate,"Do pass, but first be re-referred to the Committee on [Appropriations]",7,0,0,0,7
1215728,862277,2019-05-09,Senate,"Senate 3rd Reading SB726 Caballero et al",38,0,0,0,38
1215728,891001,2019-07-02,Assembly,"Do pass and be re-referred to the Committee on [Appropriations] with recommendation: To Consent Calendar",9,0,0,0,9
1215728,891002,2019-08-21,Assembly,"Do pass. To Consent Calendar",17,0,1,0,18
1215728,891003,2019-09-09,Assembly,"SB 726 Caballero Senate Third Reading By Quirk",79,0,0,0,79
1215728,891004,2019-09-10,Senate,"Unfinished Business SB726 Caballero et al. Concurrence",40,0,0,0,40
1215729,860585,2019-05-06,Assembly,"Do pass and be re-referred to the Committee on [Appropriations]",11,0,0,0,11
1215730,851559,2019-04-24,Assembly,"Do pass",5,2,0,0,7
1215730,866168,2019-05-16,Assembly,"AB 1353 Wicks Assembly Third Reading",52,18,10,0,80
1215730,884897,2019-06-19,Senate,"Do pass as amended",4,1,0,0,5
1215730,890599,2019-08-22,Senate,"Assembly 3rd Reading AB1353 Wicks By Monning",26,11,3,0,40
1215730,890600,2019-09-03,Assembly,"AB 1353 Wicks Concurrence in Senate Amendments",57,19,3,0,79
1215731,841303,2019-04-09,Assembly,"Do pass and be re-referred to the Committee on [Appropriations] with recommendation: To Consent Calendar",8,0,0,0,8
1215734,839721,2019-04-09,Senate,"Do pass, but first be re-referred to the Committee on [Appropriations]",16,0,0,0,16
1215734,853011,2019-04-25,Senate,"Senate 3rd Reading SB717 Jones",37,0,1,0,38
1215734,891463,2019-07-10,Assembly,"Do pass and be re-referred to the Committee on [Appropriations]",21,0,0,0,21
1215734,891464,2019-08-14,Assembly,"Do pass",18,0,0,0,18
1215734,891465,2019-09-03,Assembly,"SB 717 Jones Senate Third Reading By Boerner Horvath",76,0,3,0,79
1215735,903147,2020-01-15,Assembly,"Do pass and be re-referred to the Committee on [Appropriations]",6,2,0,0,8
1215735,905407,2020-01-23,Assembly,"Do pass",13,5,0,0,18
1215735,906394,2020-01-27,Assembly,"AB 1775 Reyes Assembly Third Reading",55,19,6,0,80
1215735,974986,2020-08-07,Senate,"Do pass, but first be re-referred to the Committee on [Appropriations]",7,0,0,0,7
1215735,976021,2020-08-17,Senate,"Placed on suspense file",7,0,0,0,7
1215735,976498,2020-08-20,Senate,"Do pass as amended",7,0,0,0,7
1215735,977170,2020-08-27,Senate,"Assembly 3rd Reading AB1775 Jones-Sawyer et al. By Skinner",30,0,10,0,40
1215735,977725,2020-08-31,Assembly,"AB 1775 JONES-SAWYER Concurrence in Senate Amendments",74,0,5,0,79
1215736,850691,2019-04-23,Senate,"Do pass and be ordered to the Consent Calendar",5,0,0,0,5
1215736,858154,2019-05-02,Senate,"Consent Calendar SB696 Umberg",38,0,0,0,38
1215736,890906,2019-07-03,Assembly,"Do pass as amended and be re-referred to the Committee on [Appropriations]",6,1,0,0,7
1215736,890907,2019-08-30,Assembly,"Do pass as amended",14,4,0,0,18
1215736,890908,2019-09-10,Assembly,"SB 696 Umberg Third Reading Urgency By Low",64,14,1,0,79
1215736,893688,2019-09-12,Senate,"That the Assembly amendments be concurred in",4,1,0,0,5
1215736,894219,2019-09-13,Senate,"Unfinished Business SB696 Umberg Urgency Clause Concurrence",29,11,0,0,40
1215736,894271,2019-09-13,Senate,09/12/19,4,11,0,0,15
1215737,849870,2019-04-22,Assembly,"Do pass and be re-referred to the Committee on [Appropriations]",13,0,2,0,15
1215737,864900,2019-05-15,Assembly,"Do pass. To Consent Calendar",16,0,2,0,18
1215737,870190,2019-05-22,Assembly,"AB 1406 O'Donnell Consent Calendar Second Day Regular Session",77,0,3,0,80
1215737,887627,2019-06-25,Senate,"Do pass as amended, but first amend, and re-refer to the Committee on [Appropriations]",11,1,1,0,13
1215737,891448,2019-08-12,Senate,"Placed on suspense file",7,0,0,0,7
1215739,856976,2019-04-30,Senate,"Do pass as amended, but first amend, and re-refer to the Committee on [Appropriations]",9,0,0,0,9
1215739,863052,2019-05-13,Senate,"Placed on suspense file",6,0,0,0,6
1215741,854812,2019-04-23,Assembly,"Do pass as amended and be re-referred to the Committee on [Appropriations]",14,0,1,0,15
1215741,866446,2019-05-16,Assembly,"Do pass as amended",18,0,0,0,18
1215741,874671,2019-05-29,Assembly,"AB 1550 Bonta Assembly Third Reading",78,0,2,0,80
1215741,893453,2019-07-10,Senate,"Do pass, but first be re-referred to the Committee on [Appropriations]",8,0,1,0,9
1215741,893454,2019-08-12,Senate,"Placed on suspense file",7,0,0,0,7
1215741,893455,2019-08-30,Senate,"Do pass",7,0,0,0,7
1215745,853554,2019-04-24,Senate,"Do pass, but first be re-referred to the Committee on [Appropriations] with the recommendation: To Consent Calendar",7,0,0,0,7
1215745,862128,2019-05-09,Senate,"Consent Calendar SB577",38,0,0,0,38
1215745,887645,2019-06-24,Assembly,"Do pass and be re-referred to the Committee on [Appropriations] with recommendation: To Consent Calendar",11,0,0,0,11
1215745,890927,2019-08-14,Assembly,"Do pass",18,0,0,0,18
1215745,890928,2019-09-11,Assembly,"SB 577 Hueso Senate Third Reading By Burke",79,0,0,0,79
1215745,895156,2019-09-11,Assembly,08/14/19,18,0,0,0,18
1215747,851210,2019-04-23,Assembly,"Do pass and be re-referred to the Committee on [Appropriations] with recommendation: To Consent Calendar",8,0,0,0,8
1215747,865733,2019-05-16,Assembly,"Do pass",18,0,0,0,18
1215747,871049,2019-05-23,Assembly,"AB 1688 Calderon Assembly Third Reading",78,0,2,0,80
1215747,893293,2019-07-09,Senate,"Do pass as amended, but first amend, and re-refer to the Committee on [Appropriations]",7,0,0,0,7
1215747,893294,2019-08-12,Senate,"Placed on suspense file",7,0,0,0,7
1215747,893295,2019-08-30,Senate,"Do pass as amended",7,0,0,0,7
1215747,893296,2019-09-09,Senate,"Assembly 3rd Reading AB1688 Calderon et al. By Hertzberg",40,0,0,0,40
1215747,893297,2019-09-10,Assembly,"AB 1688 Calderon Concurrence in Senate Amendments",79,0,0,0,79
1215747,894116,2019-08-12,Senate,"Sen Appropriations",7,0,0,0,7
1215749,852006,2019-04-24,Senate,"Do pass",2,4,1,0,7
1215749,852007,2019-04-24,Senate,"[First] hearing set for [04-24-2019]: Failed passage in Committee. Reconsideration granted",7,0,0,0,7
1215750,841730,2019-04-09,Assembly,"Do pass and be re-referred to the Committee on [Judiciary]",10,1,1,0,12
1215750,850523,2019-04-23,Assembly,"Do pass and be re-referred to the Committee on [Appropriations]",9,3,0,0,12
1215750,865748,2019-05-16,Assembly,"Do pass",13,5,0,0,18
1215750,869846,2019-05-22,Assembly,"AB 1342 Low Assembly Third Reading",62,14,4,0,80
1215750,884747,2019-06-19,Senate,"Do pass, but first be re-referred to the Committee on [Judiciary]",5,1,1,0,7
1215750,888159,2019-06-25,Senate,"Do pass, but first be re-referred to the Committee on [Appropriations]",7,1,1,0,9
1215750,890883,2019-07-08,Senate,"Placed on suspense file",7,0,0,0,7
1215750,895176,2019-05-22,Assembly,05/16/19,13,14,0,0,27
1215751,841714,2019-04-09,Assembly,"Do pass as amended and be re-referred to the Committee on [Judiciary]",6,3,0,0,9
1215751,850108,2019-04-23,Assembly,"Do pass as amended and be re-referred to the Committee on [Appropriations]",9,2,1,0,12
1215751,905368,2020-01-23,Assembly,"Do pass as amended",13,4,1,0,18
1215751,912012,2020-01-30,Assembly,"AB 1672 Bloom Assembly Third Reading",56,16,8,0,80
1215751,975505,2020-08-11,Senate,"Do pass, but first be re-referred to the Committee on [Appropriations] with the recommendation: To Consent Calendar",5,0,2,0,7
1215751,976047,2020-08-17,Senate,"Placed on suspense file",7,0,0,0,7
1215752,892819,2019-07-10,Assembly,"Do pass as amended and be re-referred to the Committee on [Health]",16,0,5,0,21
1215752,892820,2019-08-20,Assembly,"Do pass and be re-referred to the Committee on [Appropriations]",15,0,0,0,15
1215752,892821,2019-08-30,Assembly,"Do pass",18,0,0,0,18
1215752,892822,2019-09-03,Assembly,"AB 1639 GRAY Third Reading Urgency",76,0,3,0,79
1215753,839918,2019-04-09,Assembly,"Do pass as amended and be re-referred to the Committee on [Appropriations]",9,3,0,0,12
1215754,841933,2019-04-09,Assembly,"Do pass and be re-referred to the Committee on [Appropriations] with recommendation: To Consent Calendar",8,0,0,0,8
1215754,851684,2019-04-24,Assembly,"Do pass. To Consent Calendar",18,0,0,0,18
1215754,857886,2019-05-02,Assembly,"AB 1493 Ting Consent Calendar Second Day Regular Session",76,0,4,0,80
1215754,883885,2019-06-18,Senate,"Do pass, but first be re-referred to the Committee on [Appropriations] with the recommendation: To Consent Calendar",7,0,0,0,7
1215754,889252,2019-07-01,Senate,"Placed on suspense file",7,0,0,0,7
1215754,890460,2019-08-30,Senate,"Do pass as amended",7,0,0,0,7
1215754,890461,2019-09-04,Senate,"Assembly 3rd Reading AB1493 Ting By Skinner",40,0,0,0,40
1215754,890462,2019-09-09,Assembly,"AB 1493 Ting Concurrence in Senate Amendments",79,0,0,0,79
1215755,862868,2019-04-23,Assembly,"Do pass",2,6,0,0,8
1215756,855864,2019-04-24,Assembly,"Do pass as amended and be re-referred to the Committee on [Appropriations]",14,0,1,0,15
1215756,864878,2019-05-15,Assembly,"Do pass",16,0,2,0,18
1215756,870273,2019-05-22,Assembly,"AB 1584 Quirk Assembly Third Reading",77,0,3,0,80
1215756,891368,2019-07-02,Senate,"Do pass as amended, but first amend, and re-refer to the Committee on [Appropriations]",11,0,2,0,13
1215756,891369,2019-09-06,Senate,"Assembly 3rd Reading AB1584 Quirk By Hertzberg",34,0,6,0,40
1215756,891370,2019-09-10,Assembly,"AB 1584 Quirk Concurrence in Senate Amendments",79,0,0,0,79
1215760,852968,2019-04-23,Assembly,"Do pass as amended, and be re-referred to the Committee on [Appropriations] with recommendation: To Consent Calendar",15,0,0,0,15
1215761,851413,2019-04-23,Senate,"Do pass, but first be re-referred to the Committee on [Appropriations] with the recommendation: To Consent Calendar",12,0,0,0,12
1215761,859443,2019-05-06,Senate,"Placed on suspense file",5,0,1,0,6
1215762,834354,2019-04-02,Senate,"Do pass, but first be re-referred to the Committee on [Appropriations] with the recommendation: To Consent Calendar",6,0,1,0,7
1215762,853214,2019-04-25,Senate,"Consent Calendar SB557",37,0,1,0,38
1215762,880457,2019-06-11,Assembly,"Do pass and be re-referred to the Committee on [Appropriations] with recommendation: To Consent Calendar",8,0,0,0,8
1215762,888289,2019-06-26,Assembly,"Do pass. To Consent Calendar",15,0,3,0,18
1215762,892831,2019-08-12,Assembly,"SB 557 Jones Senate Third Reading By Gabriel",78,0,1,0,79
1215762,892832,2019-08-22,Senate,"Special Consent SB557",39,0,1,0,40
1215763,838523,2019-04-08,Senate,"Do pass, but first be re-referred to the Committee on [Appropriations] with the recommendation: To Consent Calendar",9,0,0,0,9
1215763,854940,2019-04-29,Senate,"Placed on suspense file",6,0,0,0,6
1215763,866397,2019-05-16,Senate,"Do pass",6,0,0,0,6
1215763,871572,2019-05-23,Senate,"Special Consent SB592",38,0,0,0,38
1215763,892603,2019-07-03,Assembly,"Do pass and be re-referred to the Committee on [Local Government]",6,0,2,0,8
1215763,892604,2019-07-10,Assembly,"Do pass as amended and be re-referred to the Committee on [Appropriations]",8,0,0,0,8
1215763,892605,2019-08-28,Assembly,"Do pass",16,0,2,0,18
1215763,970006,2020-06-29,Assembly,"Be re-referred to the Committee on [Judiciary]",7,0,5,0,12
1215763,975668,2020-08-12,Assembly,"Do pass and be re-referred to the Committee on [Appropriations]",8,0,3,0,11
1215763,976486,2020-08-20,Assembly,"Do pass as amended",13,5,0,0,18
1215763,978055,2020-08-30,Assembly,"SB 592 Wiener Senate Third Reading By Kalra",59,12,8,0,79
1215763,978056,2020-08-31,Senate,"Unfinished Business SB592 Wiener et al. Concurrence",30,5,5,0,40
1215764,850043,2019-04-22,Assembly,"Do pass. To Consent Calendar",15,0,0,0,15
1215764,854803,2019-04-29,Assembly,"AB 1442 Luz Rivas Consent Calendar Second Day Regular Session",76,0,4,0,80
1215764,893098,2019-08-14,Senate,"Do pass as amended, but first amend, and re-refer to the Committee on [Appropriations]",5,2,0,0,7
1215764,893099,2019-08-26,Senate,"Placed on suspense file",6,0,1,0,7
1215765,851330,2019-04-23,Assembly,"Do pass as amended, and be re-referred to the Committee on [Appropriations] with recommendation: To Consent Calendar",8,0,0,0,8
1215765,866531,2019-05-16,Assembly,"Do pass as amended",13,0,5,0,18
1215765,874580,2019-05-29,Assembly,"AB 1436 Mark Stone Assembly Third Reading",78,0,2,0,80
1215765,976070,2020-08-18,Senate,"Do pass, but first be re-referred to the Committee on [Rules]",6,0,3,0,9
1215765,976156,2020-08-19,Senate,"Placed on suspense file",7,0,0,0,7
1215765,976403,2020-08-20,Senate,"Do pass",5,2,0,0,7
1215765,976404,2020-08-20,Senate,"[08-20-2020] set for [First] hearing: Reconsideration of favorable vote granted",7,0,0,0,7
1215765,976405,2020-08-20,Senate,"Do pass, but first be re-referred to the Committee on [Rules]",5,2,0,0,7
1215767,854807,2019-04-24,Assembly,"Do pass as amended and be re-referred to the Committee on [Revenue and Taxation]",8,0,0,0,8
1215767,860821,2019-05-06,Assembly,"Do pass and be re-referred to the Committee on [Appropriations]",11,0,0,0,11
1215768,835274,2019-04-02,Senate,"Do pass",7,0,1,0,8
1215768,838281,2019-04-08,Senate,"Senate 3rd Reading SB645 Monning",31,4,3,0,38
1215768,877590,2019-06-04,Assembly,"Do pass",9,0,3,0,12
1215768,892655,2019-08-12,Assembly,"SB 645 Monning Senate Third Reading By Mark Stone",65,0,14,0,79
1215768,892656,2019-08-15,Senate,"Unfinished Business SB645 Monning Concurrence",37,0,3,0,40
1215769,853324,2019-04-24,Assembly,"Do pass and be re-referred to the Committee on [Appropriations] with recommendation: To Consent Calendar",19,0,2,0,21
1215769,866339,2019-05-16,Assembly,"Do pass",18,0,0,0,18
1215769,871943,2019-05-23,Assembly,"AB 1548 Gabriel Assembly Third Reading",78,0,2,0,80
1215769,887858,2019-06-25,Senate,"Do pass, but first be re-referred to the Committee on [Appropriations]",15,0,1,0,16
1215769,891280,2019-07-08,Senate,"Placed on suspense file",7,0,0,0,7
1215769,891281,2019-08-30,Senate,"Do pass",7,0,0,0,7
1215769,891282,2019-09-09,Senate,"Assembly 3rd Reading AB1548 Gabriel et al. By Allen Urgency Clause",40,0,0,0,40
1215769,891283,2019-09-10,Assembly,"AB 1548 Gabriel Concurrence - Urgency Added",79,0,0,0,79
1215771,842544,2019-04-10,Assembly,"Do pass and be re-referred to the Committee on [Appropriations]",7,0,0,0,7
1215772,856654,2019-05-01,Senate,"Do pass, but first be re-referred to the Committee on [Appropriations]",7,0,0,0,7
1215772,863233,2019-05-13,Senate,"Placed on suspense file",6,0,0,0,6
1215772,865893,2019-05-16,Senate,"Do pass",6,0,0,0,6
1215772,871410,2019-05-23,Senate,"Special Consent SB763",38,0,0,0,38
1215772,892161,2019-07-08,Assembly,"Do pass and be re-referred to the Committee on [Appropriations]",10,0,1,0,11
1215773,850442,2019-04-23,Assembly,"Do pass and be re-referred to the Committee on [Appropriations]",12,0,0,0,12
1215773,856831,2019-05-01,Assembly,"Do pass",18,0,0,0,18
1215773,862143,2019-05-09,Assembly,"AB 1607 Boerner Horvath Assembly Third Reading",77,0,3,0,80
1215773,880575,2019-06-11,Senate,"Do pass as amended, but first amend, and re-refer to the Committee on [Governance and Finance] with the recommendation: To Consent Calendar",9,0,0,0,9
1215773,892708,2019-07-03,Senate,"Do pass as amended, but first amend, and re-refer to the Committee on [Appropriations]",7,0,0,0,7
1215773,892709,2019-08-26,Senate,"Assembly 3rd Reading AB1607 Boerner Horvath et a By Stern",38,0,2,0,40
1215773,892710,2019-08-30,Assembly,"AB 1607 Boerner Horvath Concurrence in Senate Amendments",72,0,7,0,79
1215775,842912,2019-04-09,Assembly,"Do pass as amended and be re-referred to the Committee on [Appropriations]",15,0,0,0,15
1215775,866541,2019-05-16,Assembly,"Do pass as amended",15,3,0,0,18
1215775,874594,2019-05-29,Assembly,"AB 1544 Gipson Assembly Third Reading",68,3,9,0,80
1215775,892865,2019-07-03,Senate,"Do pass, but first be re-referred to the Committee on [Judiciary]",6,0,3,0,9
1215775,892866,2019-07-09,Senate,"Do pass as amended, but first amend, and re-refer to the Committee on [Appropriations]",7,1,1,0,9
1215775,892867,2019-08-12,Senate,"Placed on suspense file",7,0,0,0,7
1215775,892868,2019-08-30,Senate,"Do pass as amended",5,2,0,0,7
1215775,978103,2020-08-30,Senate,"Assembly 3rd Reading AB1544 Gipson et al. By Wiener",31,5,4,0,40
1215775,978104,2020-08-30,Assembly,"AB 1544 Gipson Concurrence in Senate Amendments",65,6,8,0,79
1215777,835312,2019-04-03,Assembly,"Do pass. To Consent Calendar",14,0,0,0,14
1215777,842824,2019-04-11,Assembly,"AB 1538 Weber Consent Calendar Second Day Regular Session",72,0,8,0,80
1215777,881276,2019-06-12,Senate,"Do pass",13,0,0,0,13
1215777,889222,2019-07-01,Senate,"Assembly 3rd Reading AB1538 Weber By Mitchell",39,0,1,0,40
1215777,891473,2019-07-08,Assembly,"AB 1538 Weber Concurrence in Senate Amendments",77,0,2,0,79
1215778,842799,2019-04-10,Assembly,"Do pass and be re-referred to the Committee on [Appropriations]",6,0,0,0,6
1215779,901468,2020-01-08,Assembly,"Do pass and be re-referred to the Committee on [Appropriations]",14,6,1,0,21
1215779,905349,2020-01-23,Assembly,"Do pass",13,4,1,0,18
1215779,906418,2020-01-27,Assembly,"AB 1626 Robert Rivas Assembly Third Reading",62,10,8,0,80
1215780,841706,2019-04-10,Assembly,"Do pass and be re-referred to the Committee on [Higher Education]",7,0,0,0,7
1215780,851937,2019-04-23,Assembly,"Do pass and be re-referred to the Committee on [Appropriations]",11,0,1,0,12
1215780,861672,2019-05-08,Assembly,"Do pass. To Consent Calendar",18,0,0,0,18
1215780,865948,2019-05-16,Assembly,"AB 1573 Holden Consent Calendar Second Day Regular Session",74,0,6,0,80
1215780,884987,2019-06-19,Senate,"Do pass, but first be re-referred to the Committee on [Judiciary] with the recommendation: To Consent Calendar",6,0,1,0,7
1215780,891625,2019-07-02,Senate,"Do pass as amended, but first amend, and re-refer to the Committee on [Appropriations] with the recommendation: To Consent Calendar",9,0,0,0,9
1215780,891626,2019-08-26,Senate,"Consent Calendar AB1573",39,0,1,0,40
1215780,891627,2019-09-05,Assembly,"AB 1573 Holden Concurrence in Senate Amendments",79,0,0,0,79
1215783,842659,2019-04-10,Assembly,"Do pass and be re-referred to the Committee on [Higher Education]",6,0,0,0,6
1215783,851701,2019-04-23,Assembly,"Do pass and be re-referred to the Committee on [Appropriations]",9,2,1,0,12
1215783,865723,2019-05-16,Assembly,"Do pass",18,0,0,0,18
1215783,871414,2019-05-23,Assembly,"AB 1466 Irwin Assembly Third Reading",77,0,3,0,80
1215783,888099,2019-06-26,Senate,"Do pass, but first be re-referred to the Committee on [Appropriations] with the recommendation: To Consent Calendar",5,0,0,0,5
1215783,893169,2019-09-04,Senate,"Assembly 3rd Reading AB1466 Irwin By Durazo",40,0,0,0,40
1215783,893170,2019-09-09,Assembly,"With recommendation: That Senate amendments be concurred in",7,0,0,0,7
1215783,893171,2019-09-10,Assembly,"AB 1466 Irwin Concurrence in Senate Amendments",78,0,1,0,79
1215784,841536,2019-04-10,Senate,"Do pass, but first be re-referred to the Committee on [Appropriations]",7,0,0,0,7
1215784,855238,2019-04-29,Senate,"Placed on suspense file",6,0,0,0,6
1215784,865598,2019-05-16,Senate,"Do pass",6,0,0,0,6
1215784,869008,2019-05-21,Senate,"Senate 3rd Reading SB729 Portantino",38,0,0,0,38
1215784,969991,2020-06-29,Assembly,"Be re-referred to the Committee on [Labor and Employment]",7,0,5,0,12
1215784,974291,2020-07-29,Assembly,"Do pass and be re-referred to the Committee on [Appropriations]",6,1,0,0,7
1215784,976443,2020-08-20,Assembly,"Do pass as amended",14,4,0,0,18
1215786,860167,2019-05-01,Senate,"Do pass as amended, but first amend, and re-refer to the Committee on [Appropriations]",7,0,0,0,7
1215786,863200,2019-05-13,Senate,"Placed on suspense file",6,0,0,0,6
1215788,841015,2019-04-08,Assembly,"Do pass and be re-referred to the Committee on [Appropriations] with recommendation: To Consent Calendar",15,0,0,0,15
1215788,864910,2019-05-15,Assembly,"Do pass. To Consent Calendar",16,0,2,0,18
1215788,870085,2019-05-22,Assembly,"AB 1456 Kiley Consent Calendar Second Day Regular Session",77,0,3,0,80
1215788,887647,2019-06-25,Senate,"Do pass, but first be re-referred to the Committee on [Appropriations] with the recommendation: To Consent Calendar",13,0,0,0,13
1215788,892283,2019-07-08,Senate,"Placed on suspense file",7,0,0,0,7
1215788,892284,2019-08-30,Senate,"Do pass",7,0,0,0,7
1215788,892285,2019-09-09,Senate,"Special Consent AB1456",40,0,0,0,40
1215790,841804,2019-04-09,Senate,"Do pass, but first be re-referred to the Committee on [Appropriations] with the recommendation: To Consent Calendar",12,0,0,0,12
1215790,849616,2019-04-22,Senate,"Placed on suspense file",6,0,0,0,6
1215790,866420,2019-05-16,Senate,"Do pass",6,0,0,0,6
1215790,871385,2019-05-23,Senate,"Special Consent SB628",38,0,0,0,38
1215790,892049,2019-07-01,Assembly,"Do pass and be re-referred to the Committee on [Appropriations]",15,0,0,0,15
1215790,892050,2019-08-30,Assembly,"Do pass",18,0,0,0,18
1215790,892051,2019-09-09,Assembly,"SB 628 Caballero Senate Third Reading By Robert Rivas",78,0,1,0,79
1215792,834121,2019-04-02,Assembly,"Do pass and be re-referred to the Committee on [Appropriations] with recommendation: To Consent Calendar",8,0,0,0,8
1215792,851631,2019-04-24,Assembly,"Do pass. To Consent Calendar",18,0,0,0,18
1215792,858275,2019-05-02,Assembly,"AB 1372 Grayson Consent Calendar Second Day Regular Session",76,0,4,0,80
1215793,836771,2019-04-03,Assembly,"Do pass and be re-referred to the Committee on [Judiciary]",5,2,0,0,7
1215793,855932,2019-04-30,Assembly,"Do pass",9,3,0,0,12
1215793,870254,2019-05-22,Assembly,"AB 1478 Carrillo Assembly Third Reading",44,21,15,0,80
1215793,888267,2019-06-26,Senate,"Do pass, but first be re-referred to the Committee on [Judiciary]",4,1,0,0,5
1215793,893109,2019-07-09,Senate,"Do pass as amended, but first amend, and re-refer to the Committee on [Appropriations]",7,1,1,0,9
1215793,893110,2019-08-12,Senate,"Placed on suspense file",7,0,0,0,7
1215793,893111,2019-08-30,Senate,"Do pass as amended",5,2,0,0,7
1215793,893112,2019-09-10,Senate,"Assembly 3rd Reading AB1478 Carrillo By Jackson",24,11,5,0,40
1215793,893113,2019-09-11,Assembly,"AB 1478 Carrillo Concurrence in Senate Amendments",45,23,11,0,79
1215793,894546,2019-08-12,Senate,Date,7,1,0,0,8
1215795,854989,2019-04-24,Assembly,"Do pass as amended and be re-referred to the Committee on [Appropriations]",19,0,2,0,21
1215796,860812,2019-05-07,Senate,"Do pass, but first be re-referred to the Committee on [Appropriations] with the recommendation: To Consent Calendar",10,0,2,0,12
1215796,874572,2019-05-29,Senate,"Senate 3rd Reading SB656 Hueso Urgency Clause",38,0,0,0,38
1215796,891521,2019-07-08,Assembly,"Do pass and be re-referred to the Committee on [Appropriations] with recommendation: To Consent Calendar",15,0,0,0,15
1215796,891522,2019-08-21,Assembly,"Do pass. To Consent Calendar",17,0,1,0,18
1215796,891523,2019-09-10,Assembly,"SB 656 Hueso Third Reading Urgency By Gloria",79,0,0,0,79
1215796,891524,2019-09-11,Senate,"Unfinished Business SB656 Hueso et al. Urgency Clause Concurrence",40,0,0,0,40
1215798,851566,2019-04-23,Assembly,"Do pass and be re-referred to the Committee on [Appropriations]",8,0,0,0,8
1215798,905398,2020-01-23,Assembly,"Do pass",18,0,0,0,18
1215798,906398,2020-01-27,Assembly,"AB 1796 Levine Assembly Third Reading",72,0,8,0,80
1215798,974487,2020-07-30,Senate,"Do pass, but first be re-referred to the Committee on [Appropriations] with the recommendation: To Consent Calendar",9,0,0,0,9
1215798,975829,2020-08-13,Senate,"Placed on suspense file",7,0,0,0,7
1215799,851592,2019-04-23,Assembly,"Do pass and be re-referred to the Committee on [Appropriations]",10,0,2,0,12
1215799,865534,2019-05-16,Assembly,"Do pass as amended",13,0,5,0,18
1215799,872321,2019-05-24,Assembly,"AB 1314 Medina Assembly Third Reading",63,0,17,0,80
1215800,852749,2019-04-24,Senate,"Do pass as amended, but first amend, and re-refer to the Committee on [Appropriations]",6,0,1,0,7
1215800,863329,2019-05-13,Senate,"Placed on suspense file",6,0,0,0,6
1215801,851771,2019-04-24,Assembly,"Do pass and be re-referred to the Committee on [Appropriations]",7,0,0,0,7
1215801,866303,2019-05-16,Assembly,"Do pass",18,0,0,0,18
1215801,871645,2019-05-23,Assembly,"AB 1580 Levine Assembly Third Reading",77,0,3,0,80
1215801,887682,2019-06-25,Senate,"Do pass as amended, but first amend, and re-refer to the Committee on [Appropriations]",16,0,0,0,16
1215801,892416,2019-08-12,Senate,"Placed on suspense file",7,0,0,0,7
1215802,860816,2019-04-30,Assembly,"Do pass as amended",10,0,1,0,11
1215802,867734,2019-05-20,Assembly,"AB 1665 Chau Assembly Third Reading",77,0,3,0,80
1215802,891436,2019-07-02,Senate,"Do pass and be ordered to the Consent Calendar",9,0,0,0,9
1215803,841676,2019-04-10,Assembly,"Do pass and be re-referred to the Committee on [Local Government]",5,2,1,0,8
1215803,852919,2019-04-24,Assembly,"Do pass as amended and be re-referred to the Committee on [Appropriations]",5,2,1,0,8
1215803,866210,2019-05-16,Assembly,"Do pass as amended",12,5,1,0,18
1215803,872259,2019-05-24,Assembly,"AB 1487 Chiu Assembly Third Reading",45,21,14,0,80
1215803,883905,2019-06-18,Senate,"Do pass, but first be re-referred to the Committee on [Governance and Finance]",6,2,3,0,11
1215803,892597,2019-07-10,Senate,"Do pass as amended, but first amend, and re-refer to the Committee on [Appropriations]",4,1,2,0,7
1215803,892598,2019-09-04,Senate,"That the measure be returned to Senate Floor for consideration. Ordered to third reading",7,1,3,0,11
1215803,892599,2019-09-06,Senate,"That the measure be returned to Senate Floor for consideration. Ordered to third reading",5,0,2,0,7
1215803,892600,2019-09-10,Senate,"Assembly 3rd Reading AB1487 Chiu et al. By Wiener",26,13,1,0,40
1215803,893784,2019-09-12,Assembly,"AB 1487 Chiu Concurrence in Senate Amendments",41,27,11,0,79
1215804,836845,2019-04-04,Senate,"Senate 3rd Reading SR21 Hill",37,0,1,0,38
1215805,841313,2019-04-09,Assembly,"Do pass and be re-referred to the Committee on [Appropriations]",5,2,1,0,8
1215805,851666,2019-04-24,Assembly,"Do pass",13,5,0,0,18
1215805,872307,2019-05-24,Assembly,"AB 1669 Bonta Assembly Third Reading Amend By BONTA Set #1",51,18,11,0,80
1215805,873974,2019-05-28,Assembly,"AB 1669 Bonta Assembly Third Reading",49,22,9,0,80
1215805,890384,2019-07-09,Senate,"Do pass, but first be re-referred to the Committee on [Appropriations]",5,2,0,0,7
1215805,890385,2019-08-19,Senate,"Placed on suspense file",5,0,2,0,7
1215805,890386,2019-08-30,Senate,"Do pass",5,2,0,0,7
1215805,890387,2019-09-09,Senate,"Assembly 3rd Reading AB1669 Bonta By Jackson",27,11,2,0,40
1215805,890388,2019-09-10,Assembly,"AB 1669 Bonta Concurrence in Senate Amendments",49,23,7,0,79
1215805,894966,2019-08-30,Senate,Result,5,0,0,0,5
1215809,841801,2019-04-09,Senate,"Do pass, but first be re-referred to the Committee on [Appropriations] with the recommendation: To Consent Calendar",12,0,0,0,12
1215809,849592,2019-04-22,Senate,"Placed on suspense file",6,0,0,0,6
1215810,835563,2019-04-02,Assembly,"Do pass and be re-referred to the Committee on [Appropriations]",15,0,0,0,15
1215810,841776,2019-04-10,Assembly,"Do pass. To Consent Calendar",17,0,1,0,18
1215810,852688,2019-04-25,Assembly,"AB 1780 Carrillo Consent Calendar Second Day Regular Session",76,0,4,0,80
1215811,839970,2019-04-09,Senate,"Do pass, but first be re-referred to the Committee on [Governmental Organization]",6,2,1,0,9
1215811,850245,2019-04-23,Senate,"Do pass, but first be re-referred to the Committee on [Appropriations]",10,3,3,0,16
1215811,859486,2019-05-06,Senate,"Placed on suspense file",5,0,1,0,6
1215811,866336,2019-05-16,Senate,"Do pass",4,2,0,0,6
1215811,870211,2019-05-22,Senate,"Senate 3rd Reading SB767 Glazer et al",28,10,0,0,38
1215811,883855,2019-06-18,Assembly,"Do pass and be re-referred to the Committee on [Accountability and Administrative Review]",9,4,0,0,13
1215811,893675,2019-07-03,Assembly,"Do pass and be re-referred to the Committee on [Appropriations]",4,2,1,0,7
1215811,894639,2019-05-16,Senate,Result,4,2,0,0,6
1215812,834106,2019-04-02,Senate,"Do pass, but first be re-referred to the Committee on [Appropriations]",4,0,0,0,4
1215812,854823,2019-04-29,Senate,"Placed on suspense file",6,0,0,0,6
1215812,866316,2019-05-16,Senate,"Do pass",5,1,0,0,6
1215812,868796,2019-05-21,Senate,"Senate 3rd Reading SB657 Monning et al",32,5,1,0,38
1215812,883780,2019-06-18,Assembly,"Do pass and be re-referred to the Committee on [Agriculture]",16,0,3,0,19
1215812,891397,2019-07-03,Assembly,"Do pass and be re-referred to the Committee on [Appropriations]",9,0,2,0,11
1215812,891398,2019-08-14,Assembly,"Do pass",15,2,1,0,18
1215812,891399,2019-08-19,Assembly,"SB 657 Monning Senate Third Reading By Mark Stone",69,7,3,0,79
1215812,891400,2019-08-22,Senate,"Unfinished Business SB657 Monning et al. Concurrence",34,5,1,0,40
1215813,841442,2019-04-08,Assembly,"Do pass as amended and be re-referred to the Committee on [Utilities and Energy]",9,0,2,0,11
1215813,851668,2019-04-24,Assembly,"Do pass as amended and be re-referred to the Committee on [Appropriations]",15,0,0,0,15
1215813,865927,2019-05-16,Assembly,"Do pass",16,1,1,0,18
1215813,871062,2019-05-23,Assembly,"AB 1516 Friedman Assembly Third Reading",74,1,5,0,80
1215813,887615,2019-06-25,Senate,"Do pass, but first be re-referred to the Committee on [Energy, Utilities and Communications]",8,1,0,0,9
1215813,892458,2019-07-10,Senate,"Do pass, but first be re-referred to the Committee on [Appropriations]",12,0,1,0,13
1215813,892459,2019-08-19,Senate,"Placed on suspense file",5,0,2,0,7
1215813,892460,2019-08-30,Senate,"Do pass as amended",5,0,2,0,7
1215813,892461,2019-09-10,Senate,"Assembly 3rd Reading AB1516 Friedman et al. By Dodd",37,1,2,0,40
1215813,892462,2019-09-11,Assembly,"AB 1516 Friedman Concurrence in Senate Amendments",76,0,3,0,79
1215813,894827,2019-08-19,Senate,Result,12,0,0,0,12
1215814,853111,2019-04-24,Assembly,"Do pass and be re-referred to the Committee on [Appropriations]",7,0,0,0,7
1215814,861693,2019-05-08,Assembly,"Do pass",14,4,0,0,18
1215814,863082,2019-05-13,Assembly,"AB 1768 Carrillo Assembly Third Reading",61,12,7,0,80
1215814,881039,2019-06-12,Senate,"Do pass, but first be re-referred to the Committee on [Appropriations]",4,1,0,0,5
1215814,893346,2019-09-10,Senate,"Assembly 3rd Reading AB1768 Carrillo By Hill",31,8,1,0,40
1215814,893347,2019-09-11,Assembly,"AB 1768 Carrillo Concurrence in Senate Amendments",64,13,2,0,79
1215815,841603,2019-04-09,Assembly,"Do pass and be re-referred to the Committee on [Business and Professions]",11,0,1,0,12
1215815,849945,2019-04-23,Assembly,"Do pass and be re-referred to the Committee on [Appropriations]",20,0,0,0,20
1215815,865749,2019-05-16,Assembly,"Do pass",18,0,0,0,18
1215815,869813,2019-05-22,Assembly,"AB 1341 Berman Assembly Third Reading",77,0,3,0,80
1215815,889231,2019-07-01,Senate,"Do pass, but first be re-referred to the Committee on [Education]",7,0,2,0,9
1215815,890357,2019-07-10,Senate,"Do pass, but first be re-referred to the Committee on [Appropriations]",6,0,1,0,7
1215815,890358,2019-08-12,Senate,"Placed on suspense file",7,0,0,0,7
1215816,841731,2019-04-09,Assembly,"Do pass and be re-referred to the Committee on [Appropriations]",12,0,0,0,12
1215816,866253,2019-05-16,Assembly,"Do pass",18,0,0,0,18
1215816,870918,2019-05-23,Assembly,"AB 1313 Luz Rivas Assembly Third Reading",78,0,2,0,80
1215816,884946,2019-06-19,Senate,"Do pass, but first be re-referred to the Committee on [Judiciary]",5,0,2,0,7
1215816,890848,2019-07-02,Senate,"Do pass, but first be re-referred to the Committee on [Appropriations]",9,0,0,0,9
1215816,890849,2019-08-12,Senate,"Placed on suspense file",7,0,0,0,7
1215816,890850,2019-08-30,Senate,"Do pass",7,0,0,0,7
1215816,890851,2019-09-05,Senate,"Assembly 3rd Reading AB1313 Luz Rivas By Roth",40,0,0,0,40
1215816,890852,2019-09-09,Assembly,"AB 1313 Luz Rivas Concurrence in Senate Amendments",79,0,0,0,79
1215817,841790,2019-04-10,Senate,"Do pass",7,0,0,0,7
1215817,859604,2019-05-06,Senate,"Senate 3rd Reading SB743 Hertzberg",38,0,0,0,38
1215817,894216,2019-07-10,Assembly,"Do pass",7,0,0,0,7
1215817,894217,2019-08-19,Assembly,"SB 743 Hertzberg Senate Third Reading By Smith",78,0,1,0,79
1215818,851487,2019-04-24,Assembly,"Do pass and be re-referred to the Committee on [Appropriations] with recommendation: To Consent Calendar",7,0,0,0,7
1215818,865754,2019-05-16,Assembly,"Do pass",18,0,0,0,18
1215818,871448,2019-05-23,Assembly,"AB 1736 Daly Assembly Third Reading",76,0,4,0,80
1215818,891243,2019-07-10,Senate,"Do pass, but first be re-referred to the Committee on [Appropriations]",7,0,0,0,7
1215818,891244,2019-08-12,Senate,"Placed on suspense file",7,0,0,0,7
1215818,891245,2019-08-30,Senate,"Do pass",7,0,0,0,7
1215818,891246,2019-09-09,Senate,"Special Consent AB1736",40,0,0,0,40
1215818,891247,2019-09-10,Assembly,"AB 1736 Daly Concurrence in Senate Amendments",78,0,1,0,79
1215819,840323,2019-04-09,Senate,"Do pass, but first be re-referred to the Committee on [Veterans Affairs] with the recommendation: To Consent Calendar",9,0,0,0,9
1215819,852403,2019-04-23,Senate,"Do pass, but first be re-referred to the Committee on [Appropriations] with the recommendation: To Consent Calendar",6,0,1,0,7
1215819,859609,2019-05-06,Senate,"Placed on suspense file",5,0,1,0,6
1215820,867688,2019-05-20,Senate,"Senate 3rd Reading SB674 McGuire et al. Urgency Clause",37,0,1,0,38
1215820,891150,2019-09-03,Assembly,"SB 674 McGuire Third Reading Urgency By Wood",77,0,2,0,79
1215821,841436,2019-04-09,Assembly,"Do pass and be re-referred to the Committee on [Business and Professions]",9,1,2,0,12
1215821,850484,2019-04-23,Assembly,"Do pass as amended and be re-referred to the Committee on [Appropriations]",15,2,3,0,20
1215821,866436,2019-05-16,Assembly,"Do pass as amended",13,4,1,0,18
1215821,869706,2019-05-22,Assembly,"AB 1343 Eggman Assembly Third Reading",66,5,9,0,80
1215823,902837,2020-01-14,Senate,"Do pass, but first be re-referred to the Committee on [Appropriations]",2,5,0,0,7
1215826,834835,2019-04-03,Senate,"Do pass, but first be re-referred to the Committee on [Natural Resources and Water]",5,1,1,0,7
1215826,850256,2019-04-23,Senate,"Do pass, but first be re-referred to the Committee on [Appropriations]",7,1,1,0,9
1215826,859524,2019-05-06,Senate,"Placed on suspense file",5,0,1,0,6
1215829,856700,2019-05-01,Senate,"Do pass, but first be re-referred to the Committee on [Appropriations]",7,0,0,0,7
1215829,863253,2019-05-13,Senate,"Placed on suspense file",6,0,0,0,6
1215829,866389,2019-05-16,Senate,"Do pass",6,0,0,0,6
1215829,871319,2019-05-23,Senate,"Special Consent SB626",38,0,0,0,38
1215829,893785,2019-07-08,Assembly,"Do pass and be re-referred to the Committee on [Appropriations]",10,0,1,0,11
1215829,894463,2019-05-16,Senate,"Sen Appropriationsclass=""statusCellData"">",6,0,0,0,6
1215831,860169,2019-05-01,Senate,"Do pass as amended, but first amend, and re-refer to the Committee on [Appropriations]",7,0,0,0,7
1215831,863268,2019-05-13,Senate,"Placed on suspense file",6,0,0,0,6
1215831,866404,2019-05-16,Senate,"Do pass",6,0,0,0,6
1215831,874024,2019-05-28,Senate,"Senate 3rd Reading SB775 Rubio",38,0,0,0,38
1215831,893808,2019-07-08,Assembly,"Do pass and be re-referred to the Committee on [Appropriations]",10,0,1,0,11
1215833,849979,2019-04-22,Senate,"Do pass, but first be re-referred to the Committee on [Appropriations]",9,0,0,0,9
1215833,859707,2019-05-06,Senate,"Placed on suspense file",5,0,1,0,6
1215833,866464,2019-05-16,Senate,"Do pass",6,0,0,0,6
1215833,871375,2019-05-23,Senate,"Special Consent SB607",38,0,0,0,38
1215834,850526,2019-04-22,Assembly,"Do pass and be re-referred to the Committee on [Appropriations]",11,0,0,0,11
1215834,866122,2019-05-16,Assembly,"Do pass as amended",13,0,5,0,18
1215834,874643,2019-05-29,Assembly,"AB 1583 Eggman Assembly Third Reading",78,0,2,0,80
1215834,892289,2019-07-03,Senate,"Do pass, but first be re-referred to the Committee on [Governance and Finance] with the recommendation: To Consent Calendar",7,0,0,0,7
1215834,892290,2019-07-10,Senate,"Do pass, but first be re-referred to the Committee on [Appropriations]",7,0,0,0,7
1215834,892291,2019-08-12,Senate,"Placed on suspense file",7,0,0,0,7
1215834,892292,2019-08-30,Senate,"Do pass",7,0,0,0,7
1215834,892293,2019-09-10,Senate,"Assembly 3rd Reading AB1583 Eggman et al. By Skinner",40,0,0,0,40
1215834,892294,2019-09-11,Assembly,"AB 1583 Eggman Concurrence in Senate Amendments",79,0,0,0,79
1215835,856582,2019-04-24,Senate,"Do pass as amended, but first amend, and re-refer to the Committee on [Appropriations]",7,0,0,0,7
1215835,863251,2019-05-13,Senate,"Placed on suspense file",6,0,0,0,6
1215836,902236,2020-01-13,Senate,"Do pass as amended, but first amend, and re-refer to the Committee on [Appropriations]",8,0,1,0,9
1215836,904114,2020-01-21,Senate,"Placed on suspense file",7,0,0,0,7
1215841,852674,2019-04-25,Assembly,"Be re-referred to the Committee on [Housing and Community Development]",10,0,2,0,12
1215842,850520,2019-04-22,Senate,"Do pass, but first be re-referred to the Committee on [Appropriations] with the recommendation: To Consent Calendar",11,0,0,0,11
1215842,862285,2019-05-09,Senate,"Consent Calendar SB623",38,0,0,0,38
1215842,891339,2019-07-03,Assembly,"Do pass and be re-referred to the Committee on [Appropriations] with recommendation: To Consent Calendar",8,0,0,0,8
1215842,891340,2019-08-14,Assembly,"Do pass",18,0,0,0,18
1215842,891341,2019-09-03,Assembly,"SB 623 Jackson Senate Third Reading By Nazarian",77,0,2,0,79
1215843,853578,2019-04-24,Assembly,"Do pass. To Consent Calendar",7,0,0,0,7
1215843,858144,2019-05-02,Assembly,"AB 1454 Jones-Sawyer Consent Calendar Second Day Regular Session",76,0,4,0,80
1215843,890692,2019-07-09,Senate,"Do pass, but first be re-referred to the Committee on [Appropriations]",5,0,2,0,7
1215843,890693,2019-09-09,Senate,"Assembly 3rd Reading AB1454 Jones-Sawyer By Dahle",39,0,1,0,40
1215843,890694,2019-09-11,Assembly,"With recommendation: That Senate amendments be concurred in",7,0,1,0,8
1215843,893672,2019-09-12,Assembly,"AB 1454 Jones-Sawyer Concurrence in Senate Amendments",79,0,0,0,79
1215844,842789,2019-04-10,Assembly,"Do pass and be re-referred to the Committee on [Higher Education] with recommendation: To Consent Calendar",6,0,0,0,6
1215844,851591,2019-04-23,Assembly,"Do pass and be re-referred to the Committee on [Appropriations]",11,0,1,0,12
1215844,865896,2019-05-16,Assembly,"Do pass as amended",13,0,5,0,18
1215844,874670,2019-05-29,Assembly,"AB 1729 Smith Assembly Third Reading",78,0,2,0,80
1215844,888045,2019-06-26,Senate,"Do pass, but first be re-referred to the Committee on [Appropriations]",7,0,0,0,7
1215844,892476,2019-07-08,Senate,"Placed on suspense file",7,0,0,0,7
1215844,892477,2019-08-30,Senate,"Do pass",7,0,0,0,7
1215844,892478,2019-09-09,Senate,"Special Consent AB1729",40,0,0,0,40
1215845,842198,2019-04-09,Assembly,"Do pass and be re-referred to the Committee on [Utilities and Energy]",9,0,0,0,9
1215845,851958,2019-04-24,Assembly,"Do pass as amended and be re-referred to the Committee on [Appropriations]",14,0,1,0,15
1215845,866333,2019-05-16,Assembly,"Do pass",18,0,0,0,18
1215845,871524,2019-05-23,Assembly,"AB 1751 Chiu Assembly Third Reading",78,0,2,0,80
1215845,883951,2019-06-18,Senate,"Do pass as amended, but first amend, and re-refer to the Committee on [Environmental Quality]",13,0,0,0,13
1215845,892756,2019-07-03,Senate,"Do pass as amended, but first amend, and re-refer to the Committee on [Appropriations]",7,0,0,0,7
1215845,892757,2019-08-12,Senate,"Placed on suspense file",7,0,0,0,7
1215846,902828,2020-01-14,Assembly,"Do pass as amended and be re-referred to the Committee on [Appropriations]",15,1,3,0,19
1215846,905341,2020-01-23,Assembly,"Do pass as amended",13,3,2,0,18
1215846,906392,2020-01-27,Assembly,"AB 1458 Quirk Assembly Third Reading",59,9,12,0,80
1215846,975325,2020-08-08,Senate,"Do pass, but first be re-referred to the Committee on [Appropriations]",9,0,0,0,9
1215846,975762,2020-08-13,Senate,"Placed on suspense file",7,0,0,0,7
1215846,976356,2020-08-20,Senate,"Do pass",5,2,0,0,7
1215846,977434,2020-08-29,Senate,"Assembly 3rd Reading AB1458 Quirk By Leyva",32,5,3,0,40
1215846,977952,2020-08-30,Assembly,"AB 1458 Quirk Concurrence in Senate Amendments",62,5,12,0,79
1215848,851526,2019-04-23,Assembly,"Do pass and be re-referred to the Committee on [Appropriations]",11,0,1,0,12
1215848,866059,2019-05-16,Assembly,"Do pass",18,0,0,0,18
1215848,871132,2019-05-23,Assembly,"AB 1307 Blanca Rubio Assembly Third Reading",78,0,2,0,80
1215848,891286,2019-07-03,Senate,"Do pass, but first be re-referred to the Committee on [Appropriations]",7,0,0,0,7
1215848,891287,2019-08-12,Senate,"Placed on suspense file",7,0,0,0,7
1215848,891288,2019-08-30,Senate,"Do pass",7,0,0,0,7
1215848,891289,2019-09-09,Senate,"Assembly 3rd Reading AB1307 Blanca Rubio et al. By Roth",40,0,0,0,40
1215848,891290,2019-09-10,Assembly,"AB 1307 Blanca Rubio Concurrence in Senate Amendments",79,0,0,0,79
1215849,851788,2019-04-23,Assembly,"Do pass as amended and be re-referred to the Committee on [Appropriations]",15,0,0,0,15
1215849,861677,2019-05-08,Assembly,"Do pass. To Consent Calendar",18,0,0,0,18
1215849,866021,2019-05-16,Assembly,"AB 1709 Jones-Sawyer Consent Calendar Second Day Regular Session",74,0,6,0,80
1215849,891167,2019-07-10,Senate,"Do pass as amended, but first amend, and re-refer to the Committee on [Appropriations]",8,0,1,0,9
1215850,850483,2019-04-23,Senate,"Do pass, but first be re-referred to the Committee on [Labor, Public Employment and Retirement ]",16,0,0,0,16
1215850,851272,2019-04-24,Senate,"Do pass, but first be re-referred to the Committee on [Appropriations]",5,0,0,0,5
1215850,863232,2019-05-13,Senate,"Placed on suspense file",6,0,0,0,6
1215851,841693,2019-04-09,Assembly,"Do pass and be re-referred to the Committee on [Appropriations] with recommendation: To Consent Calendar",9,0,0,0,9
1215851,866114,2019-05-16,Assembly,"Do pass",18,0,0,0,18
1215851,871418,2019-05-23,Assembly,"AB 1588 Gloria Assembly Third Reading",78,0,2,0,80
1215851,884824,2019-06-19,Senate,"Do pass as amended, but first amend, and re-refer to the Committee on [Veterans Affairs] with the recommendation: To Consent Calendar",7,0,0,0,7
1215851,891058,2019-07-09,Senate,"Do pass, but first be re-referred to the Committee on [Appropriations] with the recommendation: To Consent Calendar",6,0,1,0,7
1215851,891059,2019-08-26,Senate,"Assembly 3rd Reading AB1588 Gloria et al. By Wilk",38,0,2,0,40
1215851,891060,2019-09-05,Assembly,"AB 1588 Gloria Concurrence in Senate Amendments",79,0,0,0,79
1215852,855653,2019-04-24,Assembly,"Do pass as amended and be re-referred to the Committee on [Appropriations]",13,0,2,0,15
1215852,865989,2019-05-16,Assembly,"Do pass as amended",13,0,5,0,18
1215852,874659,2019-05-29,Assembly,"AB 1362 O'Donnell Assembly Third Reading",76,0,4,0,80
1215852,893161,2019-07-02,Senate,"Do pass as amended, but first amend, and re-refer to the Committee on [Appropriations]",12,0,1,0,13
1215852,893162,2019-08-19,Senate,"Placed on suspense file",5,0,2,0,7
1215852,893163,2019-08-30,Senate,"Do pass",7,0,0,0,7
1215852,893164,2019-09-05,Senate,"Assembly 3rd Reading AB1362 O'Donnell et al. By Hertzberg",40,0,0,0,40
1215852,893165,2019-09-10,Assembly,"AB 1362 O'Donnell Concurrence in Senate Amendments",79,0,0,0,79
1215853,856750,2019-05-01,Senate,"Do pass and be ordered to the Consent Calendar",7,0,0,0,7
1215853,862176,2019-05-09,Senate,"Consent Calendar SB629",38,0,0,0,38
1215853,969989,2020-06-29,Assembly,"Be re-referred to the Committee on [Public Safety]",7,0,5,0,12
1215853,974952,2020-08-05,Assembly,"Do pass and be re-referred to the Committee on [Appropriations]",7,0,1,0,8
1215853,976073,2020-08-18,Assembly,"Do pass",14,2,2,0,18
1215853,978064,2020-08-30,Assembly,"SB 629 McGuire Senate Third Reading By Kamlager",49,7,23,0,79
1215853,978065,2020-08-31,Senate,"Unfinished Business SB629 McGuire et al. Concurrence",31,2,7,0,40
1215854,842989,2019-04-10,Senate,"Do pass, but first be re-referred to the Committee on [Appropriations] with the recommendation: To Consent Calendar",7,0,0,0,7
1215854,849539,2019-04-22,Senate,"Placed on suspense file",6,0,0,0,6
1215854,865693,2019-05-16,Senate,"Do pass",6,0,0,0,6
1215854,871083,2019-05-23,Senate,"Special Consent SB637",38,0,0,0,38
1215854,887628,2019-06-24,Assembly,"Do pass and be re-referred to the Committee on [Appropriations]",11,0,0,0,11
1215854,892589,2019-08-14,Assembly,"Do pass",18,0,0,0,18
1215854,892590,2019-09-09,Assembly,"SB 637 McGuire Senate Third Reading By Maienschein",79,0,0,0,79
1215855,843545,2019-04-10,Senate,"Do pass as amended, but first amend, and re-refer to the Committee on [Environmental Quality]",5,2,2,0,9
1215855,851569,2019-04-24,Senate,"Do pass as amended, but first amend, and re-refer to the Committee on [Appropriations]",5,1,1,0,7
1215855,863260,2019-05-13,Senate,"Placed on suspense file",6,0,0,0,6
1215855,865940,2019-05-16,Senate,"Do pass",4,2,0,0,6
1215855,874459,2019-05-29,Senate,"Senate 3rd Reading SB574 Leyva",23,10,5,0,38
1215855,887500,2019-06-25,Assembly,"Do pass and be re-referred to the Committee on [Environmental Safety and Toxic Materials]",11,0,4,0,15
1215855,892023,2019-07-02,Assembly,"Do pass and be re-referred to the Committee on [Appropriations]",8,0,1,0,9
1215855,894202,2019-05-16,Senate,Result,4,2,0,0,6
1215855,894516,2019-05-13,Senate,Result,6,0,0,0,6
1215858,850058,2019-04-22,Senate,"Do pass, but first be re-referred to the Committee on [Appropriations]",9,0,0,0,9
1215858,859543,2019-05-06,Senate,"Placed on suspense file",5,0,1,0,6
1215858,865617,2019-05-16,Senate,"Do pass",6,0,0,0,6
1215858,871479,2019-05-23,Senate,"Special Consent SB736",38,0,0,0,38
1215858,884867,2019-06-19,Assembly,"Do pass and be re-referred to the Committee on [Jobs, Economic Development, and the Economy]",6,0,1,0,7
1215858,892851,2019-07-09,Assembly,"Do pass as amended and be re-referred to the Committee on [Appropriations]",7,0,0,0,7
1215860,851588,2019-04-24,Assembly,"Do pass as amended, and be re-referred to the Committee on [Appropriations] with recommendation: To Consent Calendar",14,0,0,0,14
1215860,861682,2019-05-08,Assembly,"Do pass. To Consent Calendar",18,0,0,0,18
1215860,866032,2019-05-16,Assembly,"AB 1535 Carrillo Consent Calendar Second Day Regular Session",74,0,6,0,80
1215860,888239,2019-06-26,Senate,"Do pass, but first be re-referred to the Committee on [Appropriations] with the recommendation: To Consent Calendar",13,0,0,0,13
1215860,894099,2019-07-11,Senate,"Consent Calendar AB1535",39,0,1,0,40
1215861,850445,2019-04-23,Senate,"Do pass as amended, but first amend, and re-refer to the Committee on [Appropriations]",5,0,0,0,5
1215861,863084,2019-05-13,Senate,"Senate 3rd Reading SB641 Allen",37,0,1,0,38
1215861,884743,2019-06-19,Assembly,"Do pass",5,0,2,0,7
1215861,890417,2019-08-26,Assembly,"SB 641 Allen Senate Third Reading By Berman",71,1,7,0,79
1215861,890418,2019-09-04,Senate,"Unfinished Business SB641 Allen Concurrence",40,0,0,0,40
1215863,851017,2019-04-22,Assembly,"Do pass. To Consent Calendar",15,0,0,0,15
1215863,854862,2019-04-29,Assembly,"AB 1492 Boerner Horvath Consent Calendar Second Day Regular Session",76,0,4,0,80
1215865,841549,2019-04-09,Assembly,"Do pass and be re-referred to the Committee on [Judiciary]",5,0,3,0,8
1215865,850515,2019-04-23,Assembly,"Do pass as amended and be re-referred to the Committee on [Appropriations]",9,3,0,0,12
1215865,861518,2019-05-08,Assembly,"Do pass",13,4,1,0,18
1215865,863230,2019-05-13,Assembly,"AB 1747 Gonzalez Assembly Third Reading",56,14,10,0,80
1215865,887461,2019-06-25,Senate,"Do pass, but first be re-referred to the Committee on [Judiciary]",5,1,1,0,7
1215865,891589,2019-07-09,Senate,"Do pass as amended, but first amend, and re-refer to the Committee on [Appropriations]",7,1,1,0,9
1215865,891590,2019-08-12,Senate,"Placed on suspense file",7,0,0,0,7
1215865,891591,2019-08-30,Senate,"Do pass as amended",5,2,0,0,7
1215865,893941,2019-09-14,Assembly,"AB 1747 Gonzalez Concurrence in Senate Amendments",54,19,6,0,79
1215865,894160,2019-09-13,Senate,"Assembly 3rd Reading AB1747 Gonzalez et al. By Durazo",27,11,2,0,40
1215866,832992,2019-03-27,Assembly,"Do pass as amended and be re-referred to the Committee on [Appropriations]",6,0,0,0,6
1215866,865859,2019-05-16,Assembly,"Do pass as amended",18,0,0,0,18
1215866,874658,2019-05-29,Assembly,"AB 1410 Quirk-Silva Assembly Third Reading",78,0,2,0,80
1215866,884727,2019-06-19,Senate,"Do pass, but first be re-referred to the Committee on [Appropriations] with the recommendation: To Consent Calendar",6,0,1,0,7
1215866,889241,2019-07-01,Senate,"Placed on suspense file",7,0,0,0,7
1215867,852893,2019-04-24,Senate,"Do pass as amended, but first amend, and re-refer to the Committee on [Appropriations]",7,0,0,0,7
1215867,863276,2019-05-13,Senate,"Placed on suspense file",6,0,0,0,6
1215867,866107,2019-05-16,Senate,"Do pass",6,0,0,0,6
1215867,871010,2019-05-23,Senate,"Special Consent SB690",38,0,0,0,38
1215867,890750,2019-07-02,Assembly,"Do pass and be re-referred to the Committee on [Appropriations] with recommendation: To Consent Calendar",9,0,0,0,9
1215867,890751,2019-08-21,Assembly,"Do pass",17,0,1,0,18
1215867,890752,2019-09-10,Assembly,"SB 690 Hueso Senate Third Reading By Gloria",79,0,0,0,79
1215867,890753,2019-09-11,Senate,"Unfinished Business SB690 Hueso et al. Concurrence",40,0,0,0,40
1215868,851838,2019-04-23,Assembly,"Do pass and be re-referred to the Committee on [Appropriations] with recommendation: To Consent Calendar",15,0,0,0,15
1215868,856953,2019-05-01,Assembly,"Do pass. To Consent Calendar",18,0,0,0,18
1215868,862342,2019-05-09,Assembly,"AB 1404 Santiago Consent Calendar Second Day Regular Session",76,0,4,0,80
1215868,893044,2019-07-09,Senate,"Do pass as amended, but first amend, and re-refer to the Committee on [Appropriations]",7,1,1,0,9
1215868,893045,2019-08-12,Senate,"Placed on suspense file",7,0,0,0,7
1215868,893046,2019-08-30,Senate,"Do pass as amended",5,2,0,0,7
1215871,860858,2019-05-06,Assembly,"Do pass and be re-referred to the Committee on [Appropriations]",11,0,0,0,11
1215872,851424,2019-04-22,Senate,"Do pass as amended, but first amend, and re-refer to the Committee on [Appropriations]",9,0,0,0,9
1215872,863072,2019-05-13,Senate,"Placed on suspense file",6,0,0,0,6
1215872,905371,2020-01-23,Senate,"Do pass as amended",7,0,0,0,7
1215872,910530,2020-01-29,Senate,"Senate 3rd Reading SB653 Chang",38,0,1,0,39
1215872,975367,2020-08-10,Assembly,"Do pass and be re-referred to the Committee on [Appropriations] with recommendation: To Consent Calendar",19,0,0,0,19
1215872,976096,2020-08-10,Assembly,"Do pass as amended, and be re-referred to the Committee on [Appropriations] with recommendation: To Consent Calendar",19,0,0,0,19
1215872,976097,2020-08-18,Assembly,"Do pass. To Consent Calendar",18,0,0,0,18
1215872,977985,2020-08-30,Assembly,"SB 653 Chang Consent Calendar Second Day Regular Session",75,0,4,0,79
1215873,851743,2019-04-24,Senate,"Do pass, but first be re-referred to the Committee on [Appropriations]",10,2,1,0,13
1215873,863217,2019-05-13,Senate,"Placed on suspense file",6,0,0,0,6
1215873,866499,2019-05-16,Senate,"Do pass",4,1,1,0,6
1215873,868836,2019-05-21,Senate,"Senate 3rd Reading SB704 Bradford",27,7,4,0,38
1215873,891013,2019-07-10,Assembly,"Do pass and be re-referred to the Committee on [Appropriations]",9,1,3,0,13
1215873,891014,2019-08-30,Assembly,"Do pass as amended",14,1,3,0,18
1215873,891015,2019-09-10,Assembly,"SB 704 Bradford Senate Third Reading By Eduardo Garcia",67,2,10,0,79
1215873,893790,2019-09-12,Senate,"Unfinished Business SB704 Bradford et al. Concurrence",33,7,0,0,40
1215874,841559,2019-04-09,Assembly,"Do pass and be re-referred to the Committee on [Judiciary]",10,4,1,0,15
1215874,850096,2019-04-23,Assembly,"Do pass and be re-referred to the Committee on [Appropriations]",9,3,0,0,12
1215874,865990,2019-05-16,Assembly,"Do pass",13,5,0,0,18
1215874,871301,2019-05-23,Assembly,"AB 1360 Ting Assembly Third Reading",44,25,11,0,80
1215874,890996,2019-07-03,Senate,"Do pass, but first be re-referred to the Committee on [Governmental Organization]",7,0,2,0,9
1215874,890997,2019-07-09,Senate,"Do pass as amended, but first amend, and re-refer to the Committee on [Appropriations]",5,1,3,0,9
1215874,890998,2019-08-12,Senate,"Placed on suspense file",7,0,0,0,7
1215874,890999,2019-08-30,Senate,"Do pass as amended",5,2,0,0,7
1215875,841915,2019-04-09,Assembly,"Do pass and be re-referred to the Committee on [Appropriations] with recommendation: To Consent Calendar",8,0,0,0,8
1215876,835133,2019-04-02,Senate,"Do pass as amended, and be ordered to the Consent Calendar",8,0,0,0,8
1215876,849387,2019-04-22,Senate,"Consent Calendar SB680 Wieckowski",38,0,0,0,38
1215876,877711,2019-06-04,Assembly,"Do pass as amended",10,1,1,0,12
1215878,849347,2019-04-22,Senate,"Do pass, but first be re-referred to the Committee on [Judiciary]",6,0,0,0,6
1215878,851599,2019-04-23,Senate,"Do pass as amended, but first amend, and re-refer to the Committee on [Appropriations] with the recommendation: To Consent Calendar",9,0,0,0,9
1215878,863206,2019-05-13,Senate,"Placed on suspense file",6,0,0,0,6
1215878,866125,2019-05-16,Senate,"Do pass as amended",6,0,0,0,6
1215878,873912,2019-05-28,Senate,"Senate 3rd Reading SB683 Grove",38,0,0,0,38
1215878,891268,2019-07-02,Assembly,"Do pass as amended, and be re-referred to the Committee on [Appropriations] with recommendation: To Consent Calendar",8,0,0,0,8
1215881,841724,2019-04-09,Assembly,"Do pass",6,1,1,0,8
1215881,870197,2019-05-22,Assembly,"AB 1600 Kalra Assembly Third Reading",45,27,8,0,80
1215881,891204,2019-07-09,Senate,"Do pass",6,1,0,0,7
1215881,891205,2019-09-10,Senate,"Assembly 3rd Reading AB1600 Kalra et al. By Bradford",26,14,0,0,40
1215881,891206,2019-09-11,Assembly,"AB 1600 Kalra Concurrence in Senate Amendments",42,28,9,0,79
1215882,842891,2019-04-10,Assembly,"Do pass and be re-referred to the Committee on [Appropriations] with recommendation: To Consent Calendar",6,0,0,0,6
1215882,865846,2019-05-16,Assembly,"Do pass",18,0,0,0,18
1215882,871230,2019-05-23,Assembly,"AB 1393 Weber Assembly Third Reading",78,0,2,0,80
1215882,892443,2019-07-10,Senate,"Do pass, but first be re-referred to the Committee on [Appropriations]",7,0,0,0,7
1215882,892444,2019-09-03,Senate,"Assembly 3rd Reading AB1393 Weber et al. By Chang",40,0,0,0,40
1215882,892445,2019-09-05,Assembly,"AB 1393 Weber Concurrence in Senate Amendments",79,0,0,0,79
1215882,894519,2019-09-03,Senate,"Assembly 3rd Reading AB1393 Weber et al. By Chanpan class=""statusLabel"">Noes",7,0,0,0,7
1215883,841287,2019-04-10,Assembly,"Do pass and be re-referred to the Committee on [Education]",8,0,0,0,8
1215884,840711,2019-04-08,Assembly,"Do pass and be re-referred to the Committee on [Judiciary]",8,3,0,0,11
1215884,850606,2019-04-23,Assembly,"Do pass and be re-referred to the Committee on [Appropriations]",9,3,0,0,12
1215884,861988,2019-05-08,Assembly,"Do pass",13,4,1,0,18
1215884,863322,2019-05-13,Assembly,"AB 1628 Robert Rivas Assembly Third Reading",57,15,8,0,80
1215884,878749,2019-06-05,Senate,"Do pass, but first be re-referred to the Committee on [Judiciary]",5,2,0,0,7
1215884,888383,2019-06-25,Senate,"Do pass, but first be re-referred to the Committee on [Appropriations]",7,1,1,0,9
1215884,892624,2019-09-04,Senate,"Assembly 3rd Reading AB1628 Robert Rivas et al. By Gonzalez",31,9,0,0,40
1215884,892625,2019-09-09,Assembly,"AB 1628 Robert Rivas Concurrence in Senate Amendments",61,15,3,0,79
1215886,853127,2019-04-23,Senate,"Do pass as amended, but first amend, and re-refer to the Committee on [Appropriations]",5,1,1,0,7
1215886,863241,2019-05-13,Senate,"Placed on suspense file",6,0,0,0,6
1215886,866136,2019-05-16,Senate,"Do pass",4,2,0,0,6
1215886,868832,2019-05-21,Senate,"Senate 3rd Reading SB620 Portantino",31,6,1,0,38
1215886,868833,2019-05-21,Senate,"Senate 3rd Reading SB620 Portantino Reconsider",38,0,0,0,38
1215886,868834,2019-05-21,Senate,"Senate 3rd Reading SB620 Portantino",30,8,0,0,38
1215886,887625,2019-06-25,Assembly,"Do pass and be re-referred to the Committee on [Appropriations]",7,0,1,0,8
1215886,892607,2019-08-30,Assembly,"Do pass",18,0,0,0,18
1215886,892608,2019-09-10,Assembly,"SB 620 Portantino Senate Third Reading By Gipson",79,0,0,0,79
1215886,893699,2019-09-12,Senate,"Unfinished Business SB620 Portantino Concurrence",40,0,0,0,40
1215887,850117,2019-04-22,Assembly,"Do pass and be re-referred to the Committee on [Appropriations]",8,3,0,0,11
1215887,866102,2019-05-16,Assembly,"Do pass",12,5,1,0,18
1215887,875315,2019-05-30,Assembly,"AB 1440 Levine Assembly Third Reading",48,21,11,0,80
1215887,892570,2019-07-09,Senate,"Do pass, but first be re-referred to the Committee on [Appropriations]",7,1,1,0,9
1215887,892571,2019-09-03,Senate,"Assembly 3rd Reading AB1440 Levine By Monning",27,11,2,0,40
1215887,892572,2019-09-05,Assembly,"AB 1440 Levine Concurrence Vote: Final Form",47,20,12,0,79
1215889,853160,2019-04-24,Assembly,"Do pass as amended and be re-referred to the Committee on [Appropriations]",12,0,1,0,13
1215889,865718,2019-05-16,Assembly,"Do pass as amended",13,0,5,0,18
1215889,874382,2019-05-29,Assembly,"AB 1366 Gonzalez Assembly Third Reading",64,6,10,0,80
1215889,891770,2019-07-10,Senate,"Do pass as amended, but first amend, and re-refer to the Committee on [Appropriations]",9,3,1,0,13
1215889,891771,2019-08-19,Senate,"Placed on suspense file",5,0,2,0,7
1215889,891772,2019-08-30,Senate,"Do pass",7,0,0,0,7
1215889,891773,2019-09-11,Senate,"That the measure be held in committee pursuant to Senate Rule 29.10",13,0,0,0,13
1215890,852472,2019-04-24,Senate,"Do pass, but first be re-referred to the Committee on [Appropriations]",6,0,1,0,7
1215890,860083,2019-05-06,Senate,"Placed on suspense file",5,0,1,0,6
1215891,840212,2019-04-08,Assembly,"Do pass and be re-referred to the Committee on [Appropriations]",14,0,1,0,15
1215891,851957,2019-04-24,Assembly,"Do pass",18,0,0,0,18
1215891,861287,2019-05-06,Assembly,"AB 1407 Friedman Assembly Third Reading",71,0,9,0,80
1215891,880864,2019-06-11,Senate,"Do pass, but first be re-referred to the Committee on [Public Safety]",10,0,2,0,12
1215891,892993,2019-07-02,Senate,"Do pass, but first be re-referred to the Committee on [Appropriations]",6,0,1,0,7
1215891,892994,2019-09-05,Senate,"Assembly 3rd Reading AB1407 Friedman By Umberg",39,0,1,0,40
1215891,892995,2019-09-09,Assembly,"AB 1407 Friedman Concurrence in Senate Amendments",75,0,4,0,79
1215892,839969,2019-04-08,Assembly,"Do pass and be re-referred to the Committee on [Appropriations]",8,3,0,0,11
1215892,865756,2019-05-16,Assembly,"Do pass",12,5,1,0,18
1215892,871221,2019-05-23,Assembly,"AB 1328 Holden Assembly Third Reading",47,24,9,0,80
1215892,887667,2019-06-25,Senate,"Do pass, but first be re-referred to the Committee on [Environmental Quality]",7,1,1,0,9
1215892,891843,2019-07-03,Senate,"Do pass as amended, but first amend, and re-refer to the Committee on [Appropriations]",7,0,0,0,7
1215892,891844,2019-08-12,Senate,"Placed on suspense file",7,0,0,0,7
1215892,891845,2019-08-30,Senate,"Do pass",6,1,0,0,7
1215892,891846,2019-09-11,Senate,"Assembly 3rd Reading AB1328 Holden By Stern",33,4,3,0,40
1215892,893605,2019-09-12,Assembly,"AB 1328 Holden Concurrence in Senate Amendments",60,6,13,0,79
1215893,851975,2019-04-23,Senate,"Do pass, but first be re-referred to the Committee on [Appropriations]",7,2,0,0,9
1215893,859662,2019-05-06,Senate,"Placed on suspense file",5,0,1,0,6
1215893,865608,2019-05-16,Senate,"Do pass as amended",4,2,0,0,6
1215893,871503,2019-05-23,Senate,"Senate 3rd Reading SB622 Durazo",31,7,0,0,38
1215893,883746,2019-06-18,Assembly,"Do pass as amended and be re-referred to the Committee on [Appropriations]",10,2,0,0,12
1215893,892218,2019-08-30,Assembly,"Do pass",13,4,1,0,18
1215893,892219,2019-09-10,Assembly,"SB 622 Durazo Senate Third Reading By Bonta",64,11,4,0,79
1215893,893662,2019-09-12,Senate,"Unfinished Business SB622 Durazo et al. Concurrence",31,9,0,0,40
1215894,842503,2019-04-10,Assembly,"Do pass and be re-referred to the Committee on [Higher Education]",7,0,0,0,7
1215894,851195,2019-04-23,Assembly,"Do pass and be re-referred to the Committee on [Appropriations]",11,0,1,0,12
1215894,859409,2019-05-06,Assembly,"AB 1518 Chu Assembly Third Reading",76,0,4,0,80
1215894,877224,2019-06-03,Senate,"Do pass, but first be re-referred to the Committee on [Education]",8,0,1,0,9
1215894,888142,2019-06-26,Senate,"Do pass, but first be re-referred to the Committee on [Judiciary]",7,0,0,0,7
1215894,894085,2019-07-09,Senate,"Do pass as amended, and be ordered to the Consent Calendar",8,0,1,0,9
1215894,894086,2019-08-15,Senate,"Consent Calendar AB1518 Chu",37,0,3,0,40
1215894,894087,2019-08-19,Assembly,"AB 1518 Chu Concurrence in Senate Amendments",78,0,1,0,79
1215895,841721,2019-04-09,Assembly,"Do pass and be re-referred to the Committee on [Appropriations]",12,0,0,0,12
1215895,865539,2019-05-16,Assembly,"Do pass",18,0,0,0,18
1215895,874550,2019-05-29,Assembly,"AB 1727 Weber Assembly Third Reading",78,0,2,0,80
1215895,888063,2019-06-26,Senate,"Do pass, but first be re-referred to the Committee on [Appropriations] with the recommendation: To Consent Calendar",7,0,0,0,7
1215895,893155,2019-07-08,Senate,"Placed on suspense file",7,0,0,0,7
1215895,893156,2019-08-30,Senate,"Do pass as amended",7,0,0,0,7
1215895,893734,2019-09-12,Senate,"Assembly 3rd Reading AB1727 Weber By McGuire",40,0,0,0,40
1215895,893986,2019-09-13,Assembly,"AB 1727 Weber Concurrence in Senate Amendments",79,0,0,0,79
1215896,852555,2019-04-22,Senate,"Do pass as amended, but first amend, and re-refer to the Committee on [Appropriations]",9,0,0,0,9
1215896,863272,2019-05-13,Senate,"Placed on suspense file",6,0,0,0,6
1215896,866421,2019-05-16,Senate,"Do pass",6,0,0,0,6
1215896,871264,2019-05-23,Senate,"Special Consent SB609",38,0,0,0,38
1215896,892226,2019-07-09,Assembly,"Do pass as amended and be re-referred to the Committee on [Appropriations]",17,1,1,0,19
1215896,892227,2019-08-30,Assembly,"Do pass",15,2,1,0,18
1215896,892228,2019-09-10,Assembly,"SB 609 Glazer Senate Third Reading By Low",68,2,9,0,79
1215896,893770,2019-09-12,Senate,"That the Assembly amendments be concurred in",9,0,0,0,9
1215896,894181,2019-09-13,Senate,"Unfinished Business SB609 Glazer Concurrence",40,0,0,0,40
1215897,853034,2019-04-24,Assembly,"Do pass and be re-referred to the Committee on [Appropriations]",19,0,2,0,21
1215897,861529,2019-05-08,Assembly,"Do pass. To Consent Calendar",18,0,0,0,18
1215897,866156,2019-05-16,Assembly,"AB 1370 Chiu Consent Calendar Second Day Regular Session",74,0,6,0,80
1215897,887528,2019-06-25,Senate,"Do pass, but first be re-referred to the Committee on [Appropriations]",16,0,0,0,16
1215897,891568,2019-08-12,Senate,"Assembly 3rd Reading AB1370 Chiu By Wiener",39,0,1,0,40
1215899,831367,2019-03-27,Assembly,"Do pass and be re-referred to the Committee on [Health]",5,0,1,0,6
1215899,834299,2019-04-02,Assembly,"Do pass",13,1,1,0,15
1215899,838559,2019-04-08,Assembly,"AB 1322 Berman Assembly Third Reading",60,0,20,0,80
1215899,878431,2019-06-05,Senate,"Do pass, but first be re-referred to the Committee on [Health]",5,0,2,0,7
1215899,892421,2019-07-03,Senate,"Do pass as amended, but first amend, and re-refer to the Committee on [Appropriations]",7,0,2,0,9
1215899,892422,2019-08-12,Senate,"Placed on suspense file",7,0,0,0,7
1215899,892423,2019-08-30,Senate,"Do pass as amended",5,1,1,0,7
1215899,892424,2019-09-11,Senate,"Assembly 3rd Reading AB1322 Berman et al. By Pan",32,3,5,0,40
1215899,893795,2019-09-12,Assembly,"AB 1322 Berman Concurrence in Senate Amendments",69,1,9,0,79
1215900,841897,2019-04-10,Assembly,"Do pass as amended and be re-referred to the Committee on [Transportation]",7,0,1,0,8
1215900,849251,2019-04-22,Assembly,"Do pass and be re-referred to the Committee on [Appropriations]",12,0,3,0,15
1215900,864882,2019-05-15,Assembly,"Do pass",14,0,4,0,18
1215900,874006,2019-05-28,Assembly,"AB 1457 Reyes Assembly Third Reading",65,2,13,0,80
1215900,887735,2019-06-25,Senate,"Do pass, but first be re-referred to the Committee on [Governance and Finance]",11,0,2,0,13
1215900,975340,2020-08-08,Senate,"Do pass, but first be re-referred to the Committee on [Appropriations] with the recommendation: To Consent Calendar",9,0,0,0,9
1215900,976044,2020-08-17,Senate,"Placed on suspense file",7,0,0,0,7
1215900,976390,2020-08-20,Senate,"Do pass as amended",6,0,1,0,7
1215900,977437,2020-08-29,Senate,"Assembly 3rd Reading AB1457 Cervantes et al. By Leyva",38,0,2,0,40
1215900,977456,2020-08-30,Assembly,"With recommendation: That Senate amendments be concurred in",7,0,0,0,7
1215900,978216,2020-08-30,Assembly,"AB 1457 Cervantes Concurrence in Senate Amendments",73,0,6,0,79
1215902,853137,2019-04-23,Senate,"Do pass as amended, but first amend, and re-refer to the Committee on [Appropriations]",4,1,2,0,7
1215902,863185,2019-05-13,Senate,"Placed on suspense file",6,0,0,0,6
1215904,836943,2019-04-03,Assembly,"Do pass and be re-referred to the Committee on [Appropriations]",20,0,1,0,21
1215905,841505,2019-04-09,Assembly,"Do pass and be re-referred to the Committee on [Natural Resources]",6,0,3,0,9
1215905,849298,2019-04-22,Assembly,"Do pass and be re-referred to the Committee on [Appropriations]",8,0,3,0,11
1215905,865698,2019-05-16,Assembly,"Do pass",13,0,5,0,18
1215905,871061,2019-05-23,Assembly,"AB 1509 Mullin Assembly Third Reading",63,0,17,0,80
1215907,853158,2019-04-24,Assembly,"Do pass and be re-referred to the Committee on [Appropriations]",5,0,2,0,7
1215907,866006,2019-05-16,Assembly,"Do pass as amended",13,2,3,0,18
1215907,874683,2019-05-29,Assembly,"AB 1725 Carrillo Assembly Third Reading",68,0,12,0,80
1215908,853519,2019-04-23,Assembly,"Do pass as amended. To Consent Calendar",7,0,0,0,7
1215908,858012,2019-05-02,Assembly,"AB 1577 Burke Consent Calendar Second Day Regular Session",76,0,4,0,80
1215908,876889,2019-06-03,Senate,"Do pass and be ordered to the Consent Calendar",9,0,0,0,9
1215908,974290,2020-07-29,Senate,"Do pass, but first be re-referred to the Committee on [Appropriations]",7,0,0,0,7
1215908,975826,2020-08-13,Senate,"Placed on suspense file",7,0,0,0,7
1215908,976377,2020-08-20,Senate,"Do pass",7,0,0,0,7
1215908,977367,2020-08-28,Senate,"Special Consent AB1577",39,0,1,0,40
1215908,977450,2020-08-30,Assembly,"With recommendation: That Senate amendments be concurred in",11,0,0,0,11
1215908,978203,2020-08-30,Assembly,"AB 1577 Burke Concurrence in Senate Amendments",74,0,5,0,79
1215909,855812,2019-04-30,Senate,"Do pass",11,0,2,0,13
1215909,862301,2019-05-09,Senate,"Senate 3rd Reading SB766 Stern",38,0,0,0,38
1215910,856045,2019-04-30,Assembly,"Do pass as amended",10,1,1,0,12
1215910,862210,2019-05-09,Assembly,"AB 1563 Santiago Assembly Third Reading",66,4,10,0,80
1215910,891212,2019-07-09,Senate,"Do pass as amended, but first amend, and re-refer to the Committee on [Appropriations]",5,1,1,0,7
1215910,891213,2019-08-12,Senate,"Placed on suspense file",7,0,0,0,7
1215910,891214,2019-08-30,Senate,"Do pass",5,2,0,0,7
1215910,891215,2019-09-10,Senate,"Assembly 3rd Reading AB1563 Santiago et al. By Umberg",33,2,5,0,40
1215910,893805,2019-09-12,Assembly,"With recommendation: That Senate amendments be concurred in",6,0,2,0,8
1215910,893970,2019-09-13,Assembly,"AB 1563 Santiago Concurrence in Senate Amendments",70,0,9,0,79
1215911,853456,2019-04-23,Assembly,"Do pass as amended and be re-referred to the Committee on [Appropriations]",16,1,3,0,20
1215911,865572,2019-05-16,Assembly,"Do pass as amended",15,2,1,0,18
1215911,872092,2019-05-24,Assembly,"AB 1312 Low Assembly Third Reading",63,4,13,0,80
1215911,879864,2019-06-10,Senate,"Do pass, but first be re-referred to the Committee on [Appropriations]",9,0,0,0,9
1215911,887084,2019-06-24,Senate,"Placed on suspense file",7,0,0,0,7
1215912,840444,2019-04-09,Senate,"Do pass, but first be re-referred to the Committee on [Business, Professions and Economic Development] with the recommendation: To Consent Calendar",16,0,0,0,16
1215912,850947,2019-04-22,Senate,"Do pass, but first be re-referred to the Committee on [Appropriations] with the recommendation: To Consent Calendar",9,0,0,0,9
1215912,866311,2019-05-16,Senate,"Consent Calendar SB601",37,0,1,0,38
1215912,887635,2019-06-25,Assembly,"Do pass as amended and be re-referred to the Committee on [Governmental Organization]",19,0,0,0,19
1215912,891606,2019-07-10,Assembly,"Do pass and be re-referred to the Committee on [Appropriations] with recommendation: To Consent Calendar",19,0,2,0,21
1215912,891607,2019-08-21,Assembly,"Do pass. To Consent Calendar",17,0,1,0,18
1215912,891608,2019-08-30,Assembly,"SB 601 Morrell Consent Calendar Second Day Regular Session",67,0,12,0,79
1215912,891609,2019-09-04,Senate,"Unfinished Business SB601 Morrell et al. Concurrence",40,0,0,0,40
1215915,868908,2019-05-20,Assembly,"Do pass. To Consent Calendar",9,0,3,0,12
1215915,872255,2019-05-24,Assembly,"AB 1650 Cooley Consent Calendar Second Day",78,0,2,0,80
1215915,887684,2019-06-25,Senate,"Do pass, but first be re-referred to the Committee on [Rules] with the recommendation: To Consent Calendar",16,0,0,0,16
1215915,890937,2019-08-22,Senate,"Special Consent AB1650 Cooley Urgency Clause",39,0,1,0,40
1215918,835282,2019-04-03,Assembly,"Do pass and be re-referred to the Committee on [Local Government]",8,0,0,0,8
1215918,852989,2019-04-24,Assembly,"Do pass and be re-referred to the Committee on [Appropriations]",8,0,0,0,8
1215918,861515,2019-05-08,Assembly,"Do pass. To Consent Calendar",18,0,0,0,18
1215918,866159,2019-05-16,Assembly,"AB 1484 Grayson Consent Calendar Second Day Regular Session",74,0,6,0,80
1215918,892176,2019-07-10,Senate,"Do pass as amended, but first amend, and re-refer to the Committee on [Appropriations]",6,0,1,0,7
1215920,842035,2019-04-10,Assembly,"Do pass and be re-referred to the Committee on [Appropriations]",7,0,0,0,7
1215921,833738,2019-04-01,Senate,"Do pass, but first be re-referred to the Committee on [Appropriations] with the recommendation: To Consent Calendar",9,0,0,0,9
1215921,853124,2019-04-25,Senate,"Consent Calendar SB711",37,0,1,0,38
1215922,901164,2019-04-23,Assembly,"Do pass and be re-referred to the Committee on [Appropriations]",1,5,2,0,8
1215922,901165,2019-04-23,Assembly,Reconsideration,8,0,0,0,8
1215923,841561,2019-04-10,Senate,"Do pass, but first be re-referred to the Committee on [Judiciary]",11,1,1,0,13
1215923,851214,2019-04-23,Senate,"Do pass, but first be re-referred to the Committee on [Appropriations]",7,2,0,0,9
1215923,867690,2019-05-20,Senate,"Senate 3rd Reading SB708 Hueso",31,6,1,0,38
1215925,851299,2019-04-23,Assembly,"Do pass and be re-referred to the Committee on [Appropriations] with recommendation: To Consent Calendar",19,0,1,0,20
1215925,866294,2019-05-16,Assembly,"Do pass",18,0,0,0,18
1215925,871625,2019-05-23,Assembly,"AB 1522 B. & P. Assembly Third Reading By LOW",78,0,2,0,80
1215925,893507,2019-07-08,Senate,"Do pass, but first be re-referred to the Committee on [Appropriations]",9,0,0,0,9
1215925,893508,2019-08-12,Senate,"Placed on suspense file",7,0,0,0,7
1215925,893509,2019-08-30,Senate,"Do pass",7,0,0,0,7
1215925,893510,2019-09-09,Senate,"Special Consent AB1522",40,0,0,0,40
1215925,893867,2019-09-13,Assembly,"With recommendation: That Senate amendments be concurred in",19,0,0,0,19
1215925,893968,2019-09-13,Assembly,"AB 1522 Low Concurrence in Senate Amendments",79,0,0,0,79
1215926,852744,2019-04-22,Assembly,"Do pass as amended and be re-referred to the Committee on [Appropriations]",11,0,0,0,11
1215926,864885,2019-05-15,Assembly,"Do pass. To Consent Calendar",16,0,2,0,18
1215926,870213,2019-05-22,Assembly,"AB 1644 Levine Consent Calendar Second Day Regular Session",77,0,3,0,80
1215926,887766,2019-06-25,Senate,"Do pass, but first be re-referred to the Committee on [Appropriations] with the recommendation: To Consent Calendar",9,0,0,0,9
1215926,894094,2019-07-11,Senate,"Consent Calendar AB1644",39,0,1,0,40
1215927,901395,2020-01-07,Assembly,"Do pass and be re-referred to the Committee on [Appropriations]",12,0,0,0,12
1215927,905421,2020-01-23,Assembly,"Do pass. To Consent Calendar",18,0,0,0,18
1215927,912028,2020-01-30,Assembly,"AB 1512 Carrillo Consent Calendar Second Day Regular Session",76,0,4,0,80
1215927,974910,2020-08-05,Senate,"Do pass, but first be re-referred to the Committee on [Appropriations]",5,0,0,0,5
1215927,976634,2020-08-24,Senate,"Assembly 3rd Reading AB1512 Carrillo et al. By Durazo Urgency Clause",40,0,0,0,40
1215927,977475,2020-08-31,Assembly,"With recommendation: That Senate amendments be concurred in",7,0,0,0,7
1215927,977947,2020-08-31,Assembly,"AB 1512 CARRILLO Concurrence in Senate Amendments",73,0,6,0,79
1215928,850169,2019-04-22,Assembly,"Do pass and be re-referred to the Committee on [Appropriations]",15,0,0,0,15
1215928,866054,2019-05-16,Assembly,"Do pass",18,0,0,0,18
1215928,871558,2019-05-23,Assembly,"AB 1351 Lackey Assembly Third Reading",78,0,2,0,80
1215928,893189,2019-07-09,Senate,"Do pass, but first be re-referred to the Committee on [Appropriations]",13,0,0,0,13
1215928,893190,2019-08-12,Senate,"Placed on suspense file",7,0,0,0,7
1215928,893191,2019-08-30,Senate,"Do pass as amended",7,0,0,0,7
1215928,893192,2019-09-10,Senate,"Assembly 3rd Reading AB1351 Lackey By Bates",39,0,1,0,40
1215928,893193,2019-09-11,Assembly,"AB 1351 Lackey Concurrence in Senate Amendments",79,0,0,0,79
1215932,835055,2019-04-02,Senate,"Do pass, but first be re-referred to the Committee on [Appropriations]",9,1,1,0,11
1215932,848964,2019-04-22,Senate,"Placed on suspense file",6,0,0,0,6
1215932,866409,2019-05-16,Senate,"Do pass as amended",6,0,0,0,6
1215932,873936,2019-05-28,Senate,"Senate 3rd Reading SB573 Chang",38,0,0,0,38
1215932,967397,2020-06-18,Assembly,"Be re-referred to the Committee on [Business and Professions]",9,0,3,0,12
1215932,975339,2020-08-10,Assembly,"Do pass and be re-referred to the Committee on [Appropriations] with recommendation: To Consent Calendar",19,0,0,0,19
1215932,976090,2020-08-10,Assembly,"Do pass as amended, and be re-referred to the Committee on [Appropriations] with recommendation: To Consent Calendar",19,0,0,0,19
1215932,976091,2020-08-18,Assembly,"Do pass. To Consent Calendar",18,0,0,0,18
1215932,977838,2020-08-30,Senate,"Unfinished Business SB573 Chang Concurrence",39,0,1,0,40
1215932,977839,2020-08-30,Assembly,"SB 573 Chang Consent Calendar Second Day Regular Session",75,0,4,0,79
1215934,853257,2019-04-24,Senate,"Do pass as amended, but first amend, and re-refer to the Committee on [Appropriations]",12,0,1,0,13
1215934,863370,2019-05-13,Senate,"Do pass",6,0,0,0,6
1215934,867693,2019-05-20,Senate,"Senate 3rd Reading SB570 Rubio",37,0,1,0,38
1215934,888219,2019-06-26,Assembly,"Do pass as amended, and be re-referred to the Committee on [Appropriations] with recommendation: To Consent Calendar",14,0,0,0,14
1215934,893547,2019-07-10,Assembly,"Do pass. To Consent Calendar",16,0,2,0,18
1215934,893548,2019-08-15,Assembly,"SB 570 Rubio Consent Calendar Second Day Regular Session",76,0,3,0,79
1215934,893549,2019-08-22,Senate,"Special Consent SB570",39,0,1,0,40
1215935,851232,2019-04-23,Assembly,"Do pass and be re-referred to the Committee on [Appropriations]",17,0,3,0,20
1215935,861664,2019-05-08,Assembly,"Do pass",17,0,1,0,18
1215935,866302,2019-05-16,Assembly,"AB 1420 Obernolte Assembly Third Reading",69,1,10,0,80
1215935,882954,2019-06-17,Senate,"Do pass as amended, but first amend, and re-refer to the Committee on [Appropriations]",7,0,2,0,9
1215935,891103,2019-07-08,Senate,"Placed on suspense file",7,0,0,0,7
1215936,830421,2019-03-26,Assembly,"Do pass and be re-referred to the Committee on [Appropriations] with recommendation: To Consent Calendar",8,0,1,0,9
1215936,841566,2019-04-10,Assembly,"Do pass. To Consent Calendar",17,0,1,0,18
1215936,853121,2019-04-25,Assembly,"AB 1597 E.S. & T.M. Consent Calendar Second Day Regular Session",76,0,4,0,80
1215936,878588,2019-06-05,Senate,"Do pass, but first be re-referred to the Committee on [Appropriations] with the recommendation: To Consent Calendar",7,0,0,0,7
1215936,889235,2019-07-01,Senate,"Consent Calendar AB1597 E.S. & T.M",39,0,1,0,40
1215936,893345,2019-07-08,Assembly,"AB 1597 E.S. & T.M. Concurrence in Senate Amendments By QUIRK",77,0,2,0,79
1215937,842446,2019-04-09,Assembly,"Do pass as amended and be re-referred to the Committee on [Appropriations]",6,2,0,0,8
1215937,866228,2019-05-16,Assembly,"Do pass as amended",13,3,2,0,18
1215937,874399,2019-05-29,Assembly,"AB 1403 Carrillo Assembly Third Reading",57,18,5,0,80
1215937,891880,2019-07-08,Senate,"Do pass as amended, but first amend, and re-refer to the Committee on [Appropriations]",5,0,1,0,6
1215937,891881,2019-08-12,Senate,"Placed on suspense file",7,0,0,0,7
1215938,851533,2019-04-23,Assembly,"Do pass and be re-referred to the Committee on [Arts, Entertainment, Sports, Tourism, and Internet Media]",6,0,5,0,11
1215938,856740,2019-05-01,Assembly,"Do pass",4,0,3,0,7
1215939,848406,2019-04-09,Assembly,"Do pass and be re-referred to the Committee on [Human Services]",2,4,2,0,8
1215939,848407,2019-04-09,Assembly,Reconsideration,6,0,2,0,8
1215939,902843,2020-01-14,Assembly,"Do pass and be re-referred to the Committee on [Appropriations]",6,0,2,0,8
1215939,905355,2020-01-23,Assembly,"Do pass",17,0,1,0,18
1215939,906410,2020-01-27,Assembly,"AB 1450 Lackey Assembly Third Reading",74,0,6,0,80
1215939,974990,2020-08-07,Senate,"Do pass, but first be re-referred to the Committee on [Appropriations]",2,1,4,0,7
1215939,974991,2020-08-07,Senate,"[First] hearing set for [08-07-2020]: Failed passage in Committee. Reconsideration granted",7,0,0,0,7
1215940,855647,2019-04-30,Assembly,"Do pass",7,3,2,0,12
1215941,852954,2019-04-24,Assembly,"Do pass and be re-referred to the Committee on [Judiciary]",8,0,0,0,8
1215941,852955,2019-04-25,Assembly,"Do pass as amended and be re-referred to the Committee on [Appropriations]",12,0,0,0,12
1215941,861534,2019-05-08,Assembly,"Do pass. To Consent Calendar",18,0,0,0,18
1215941,865929,2019-05-16,Assembly,"AB 1561 Cristina Garcia Consent Calendar Second Day Regular Session",74,0,6,0,80
1215941,883873,2019-06-18,Senate,"Do pass, but first be re-referred to the Committee on [Judiciary]",8,0,3,0,11
1215941,891087,2019-07-02,Senate,"Do pass, but first be re-referred to the Committee on [Appropriations]",7,0,2,0,9
1215941,977484,2020-08-31,Assembly,"With recommendation: That Senate amendments be concurred in",8,0,0,0,8
1215941,977910,2020-08-30,Senate,"Assembly 3rd Reading AB1561 Cristina Garcia et a By Wiener",39,0,1,0,40
1215941,977911,2020-08-31,Assembly,"AB 1561 GARCIA, C. Concurrence in Senate Amendments",74,1,4,0,79
1215946,841865,2019-04-10,Senate,"Do pass as amended, but first amend, and re-refer to the Committee on [Judiciary]",5,2,0,0,7
1215946,851380,2019-04-23,Senate,"Do pass as amended, but first amend, and re-refer to the Committee on [Appropriations]",5,1,3,0,9
1215946,871528,2019-05-23,Senate,"Senate 3rd Reading SB621 Glazer et al",30,5,3,0,38
1215947,857894,2019-05-01,Assembly,"Do pass. To Consent Calendar",7,0,0,0,7
1215947,862175,2019-05-09,Assembly,"AB 1752 Kalra Consent Calendar Second Day Regular Session",76,0,4,0,80
1215947,877567,2019-06-04,Senate,"Do pass and be ordered to the Consent Calendar",5,0,0,0,5
1215947,892636,2019-07-10,Senate,"Do pass as amended",7,0,0,0,7
1215947,892637,2019-08-22,Senate,"Special Consent AB1752",39,0,1,0,40
1215947,893834,2019-09-12,Assembly,"With recommendation: That Senate amendments be concurred in",8,0,0,0,8
1215947,893978,2019-09-13,Assembly,"AB 1752 Petrie-Norris Concurrence in Senate Amendments",78,0,1,0,79
1215948,858202,2019-04-30,Assembly,"Do pass as amended",9,0,2,0,11
1215948,873869,2019-05-28,Assembly,"AB 1395 Cunningham Assembly Third Reading",44,6,30,0,80
1215949,841991,2019-04-09,Senate,"Do pass as amended, but first amend, and re-refer to the Committee on [Appropriations]",7,0,1,0,8
1215949,859506,2019-05-06,Senate,"Senate 3rd Reading SB578 Jones",37,0,1,0,38
1215949,884353,2019-06-18,Assembly,"Do pass and be re-referred to the Committee on [Judiciary]",18,0,1,0,19
1215949,894052,2019-07-02,Assembly,"Do pass. To Consent Calendar",12,0,0,0,12
1215949,894053,2019-07-08,Assembly,"SB 578 Jones Consent Calendar Second Day Regular Session",76,0,3,0,79
1215950,841418,2019-04-09,Assembly,"Do pass and be re-referred to the Committee on [Appropriations]",8,0,0,0,8
1215951,853587,2019-04-24,Senate,"Do pass, but first be re-referred to the Committee on [Appropriations]",7,0,0,0,7
1215951,863637,2019-05-13,Senate,"Do pass",6,0,0,0,6
1215951,867869,2019-05-20,Senate,"Senate 3rd Reading SB699 Hill",38,0,0,0,38
1215951,894039,2019-07-03,Assembly,"Do pass and be re-referred to the Committee on [Appropriations] with recommendation: To Consent Calendar",8,0,0,0,8
1215951,894040,2019-08-14,Assembly,"Do pass",18,0,0,0,18
1215951,894041,2019-08-19,Assembly,"SB 699 Hill Senate Third Reading By Berman",76,0,3,0,79
1215953,903156,2020-01-15,Senate,"Do pass, but first be re-referred to the Committee on [Appropriations]",7,0,0,0,7
1215953,904100,2020-01-21,Senate,"Do pass",7,0,0,0,7
1215953,905361,2020-01-23,Senate,"Senate 3rd Reading SB587 Monning",37,0,2,0,39
1215953,974191,2020-07-27,Assembly,"Do pass and be re-referred to the Committee on [Appropriations] with recommendation: To Consent Calendar",9,0,1,0,10
1215953,975504,2020-08-11,Assembly,"Do pass. To Consent Calendar",17,0,0,0,17
1215953,977971,2020-08-30,Senate,"Unfinished Business SB587 Monning Concurrence",39,0,1,0,40
1215953,977972,2020-08-30,Assembly,"SB 587 Monning Consent Calendar Second Day Regular Session",75,0,4,0,79
1215954,850450,2019-04-23,Senate,"Do pass, but first be re-referred to the Committee on [Appropriations]",4,0,1,0,5
1215954,863172,2019-05-13,Senate,"Placed on suspense file",6,0,0,0,6
1215954,866359,2019-05-16,Senate,"Do pass as amended",4,1,1,0,6
1215954,871172,2019-05-23,Senate,"Senate 3rd Reading SB636 Stern",31,5,2,0,38
1215955,851734,2019-04-23,Assembly,"Do pass. To Consent Calendar",19,0,1,0,20
1215955,858182,2019-05-02,Assembly,"AB 1553 Fong Consent Calendar Second Day Regular Session",76,0,4,0,80
1215955,877337,2019-06-03,Senate,"Do pass and be ordered to the Consent Calendar",9,0,0,0,9
1215955,879166,2019-06-06,Senate,"Consent Calendar AB1553 Fong et al",37,0,1,0,38
1215957,853090,2019-04-23,Assembly,"Do pass as amended and be re-referred to the Committee on [Appropriations]",11,0,4,0,15
1215957,866163,2019-05-16,Assembly,"Do pass as amended",13,0,5,0,18
1215957,875324,2019-05-30,Assembly,"AB 1611 Chiu Assembly Third Reading",48,9,23,0,80
1215958,841935,2019-04-09,Assembly,"Do pass",6,1,1,0,8
1215958,852746,2019-04-25,Assembly,"AB 1390 Mark Stone Assembly Third Reading",54,19,7,0,80
1215958,880278,2019-06-11,Senate,"Do pass",6,1,0,0,7
1215958,891665,2019-07-08,Senate,"Assembly 3rd Reading AB1390 Mark Stone By Hill",30,8,2,0,40
1215959,851498,2019-04-23,Assembly,"Do pass and be re-referred to the Committee on [Higher Education] with recommendation: To Consent Calendar",11,0,0,0,11
1215960,855732,2019-04-24,Senate,"Do pass as amended, but first amend, and re-refer to the Committee on [Appropriations]",13,0,0,0,13
1215960,867852,2019-05-20,Senate,"Senate 3rd Reading SB676 Bradford et al",38,0,0,0,38
1215960,891940,2019-07-03,Assembly,"Do pass and be re-referred to the Committee on [Communications and Conveyance]",12,0,3,0,15
1215960,891941,2019-07-10,Assembly,"Do pass and be re-referred to the Committee on [Appropriations]",12,0,1,0,13
1215960,891942,2019-08-21,Assembly,"Do pass. To Consent Calendar",17,0,1,0,18
1215960,891943,2019-09-10,Assembly,"SB 676 Bradford Senate Third Reading By Boerner Horvath",76,0,3,0,79
1215960,891944,2019-09-11,Senate,"Unfinished Business SB676 Bradford et al. Concurrence",40,0,0,0,40
1215961,852797,2019-04-24,Senate,"Do pass, but first be re-referred to the Committee on [Appropriations]",9,0,0,0,9
1215961,868841,2019-05-21,Senate,"Senate 3rd Reading SB677 Allen",38,0,0,0,38
1215961,890530,2019-07-09,Assembly,"Do pass and be re-referred to the Committee on [Appropriations]",13,0,2,0,15
1215961,890531,2019-08-14,Assembly,"Do pass",17,0,1,0,18
1215961,890532,2019-08-22,Assembly,"SB 677 Allen Senate Third Reading By Aguiar-Curry",70,0,9,0,79
1215963,840597,2019-04-09,Assembly,"Do pass and be re-referred to the Committee on [Appropriations]",10,2,0,0,12
1215963,866340,2019-05-16,Assembly,"Do pass",13,5,0,0,18
1215963,871338,2019-05-23,Assembly,"AB 1385 Santiago Assembly Third Reading",61,15,4,0,80
1215963,893040,2019-07-02,Senate,"Do pass, but first be re-referred to the Committee on [Appropriations]",7,0,2,0,9
1215963,893041,2019-08-12,Senate,"Placed on suspense file",7,0,0,0,7
1215965,859585,2019-05-01,Assembly,"Do pass as amended. To Consent Calendar",12,0,3,0,15
1215965,863106,2019-05-13,Assembly,"AB 1513 Holden Consent Calendar Second Day Regular Session",74,0,6,0,80
1215965,890878,2019-07-02,Senate,"Do pass",12,0,1,0,13
1215965,890879,2019-08-22,Senate,"Special Consent AB1513",39,0,1,0,40
1215965,890880,2019-09-10,Senate,"That the measure be returned to Senate Floor for consideration. Ordered to third reading",13,0,0,0,13
1215965,890881,2019-09-11,Senate,"Assembly 3rd Reading AB1513 Holden By Hill",39,0,1,0,40
1215965,893777,2019-09-12,Assembly,"AB 1513 Holden Concurrence in Senate Amendments",75,0,4,0,79
1215966,842288,2019-04-08,Senate,"Do pass as amended, but first amend, and re-refer to the Committee on [Appropriations]",9,0,0,0,9
1215966,859785,2019-05-06,Senate,"Placed on suspense file",5,0,1,0,6
1215966,865532,2019-05-16,Senate,"Do pass",6,0,0,0,6
1215966,873747,2019-05-28,Senate,"Senate 3rd Reading SB655 Roth",38,0,0,0,38
1215966,887629,2019-06-25,Assembly,"Do pass and be re-referred to the Committee on [Appropriations]",19,0,0,0,19
1215966,891709,2019-07-10,Assembly,"Do pass. To Consent Calendar",16,0,2,0,18
1215966,891710,2019-08-15,Assembly,"SB 655 Roth Consent Calendar Second Day Regular Session",76,0,3,0,79
1215967,852903,2019-04-24,Assembly,"Do pass and be re-referred to the Committee on [Appropriations] with recommendation: To Consent Calendar",19,0,2,0,21
1215967,866013,2019-05-16,Assembly,"Do pass",18,0,0,0,18
1215967,874678,2019-05-29,Assembly,"AB 1464 Gray Assembly Third Reading",78,0,2,0,80
1215967,887546,2019-06-25,Senate,"Do pass, but first be re-referred to the Committee on [Appropriations] with the recommendation: To Consent Calendar",16,0,0,0,16
1215967,891477,2019-08-12,Senate,"Placed on suspense file",7,0,0,0,7
1215967,894819,2019-05-29,Assembly,Result,78,0,0,0,78
1215968,903144,2020-01-15,Senate,"Do pass, but first be re-referred to the Committee on [Appropriations] with the recommendation: To Consent Calendar",7,0,0,0,7
1215968,906391,2020-01-27,Senate,"Consent Calendar SB773",39,0,0,0,39
1215969,841708,2019-04-09,Assembly,"Do pass and be re-referred to the Committee on [Appropriations]",10,4,0,0,14
1215969,865918,2019-05-16,Assembly,"Do pass",13,3,2,0,18
1215969,871256,2019-05-23,Assembly,"AB 1718 Levine Assembly Third Reading",57,19,4,0,80
1215969,892032,2019-07-09,Senate,"Do pass, but first be re-referred to the Committee on [Appropriations]",7,1,1,0,9
1215969,892033,2019-08-12,Senate,"Placed on suspense file",7,0,0,0,7
1215969,892034,2019-08-30,Senate,"Do pass",5,2,0,0,7
1215969,892035,2019-09-11,Senate,"Assembly 3rd Reading AB1718 Levine et al. By Glazer",29,10,1,0,40
1215969,893639,2019-09-12,Assembly,"AB 1718 Levine Concurrence in Senate Amendments",57,18,4,0,79
1215969,894462,2019-08-12,Senate,Result,7,1,0,0,8
1215970,850076,2019-04-22,Assembly,"Do pass. To Consent Calendar",12,0,0,0,12
1215970,854650,2019-04-29,Assembly,"AB 1305 Obernolte Consent Calendar Second Day Regular Session",76,0,4,0,80
1215971,842103,2019-04-10,Assembly,"Do pass and be re-referred to the Committee on [Judiciary]",5,2,1,0,8
1215971,856010,2019-04-30,Assembly,"Do pass",11,0,1,0,12
1215971,874044,2019-05-28,Assembly,"AB 1399 Bloom Assembly Third Reading",48,18,14,0,80
1215971,883940,2019-06-18,Senate,"Do pass, but first be re-referred to the Committee on [Judiciary]",7,1,3,0,11
1215971,893218,2019-07-09,Senate,"Do pass as amended",7,1,1,0,9
1215971,893219,2019-09-03,Senate,"Assembly 3rd Reading AB1399 Bloom By Allen",29,9,2,0,40
1215971,893220,2019-09-05,Assembly,"AB 1399 Bloom Concurrence in Senate Amendments",58,14,7,0,79
1215972,851193,2019-04-23,Assembly,"Do pass and be re-referred to the Committee on [Appropriations]",7,1,0,0,8
1215972,866081,2019-05-16,Assembly,"Do pass as amended",13,5,0,0,18
1215972,874682,2019-05-29,Assembly,"AB 1331 Bonta Assembly Third Reading",49,24,7,0,80
1215972,892446,2019-07-09,Senate,"Do pass as amended, but first amend, and re-refer to the Committee on [Appropriations]",6,1,0,0,7
1215972,892447,2019-08-12,Senate,"Placed on suspense file",7,0,0,0,7
1215972,892448,2019-08-30,Senate,"Do pass as amended",5,1,1,0,7
1215972,892449,2019-09-10,Senate,"Assembly 3rd Reading AB1331 Bonta By Mitchell",27,9,4,0,40
1215972,892450,2019-09-11,Assembly,"AB 1331 Bonta Concurrence in Senate Amendments",59,11,9,0,79
1215973,836884,2019-04-03,Senate,"Do pass, but first be re-referred to the Committee on [Appropriations]",8,0,1,0,9
1215973,848910,2019-04-22,Senate,"Placed on suspense file",6,0,0,0,6
1215973,866419,2019-05-16,Senate,"Do pass",6,0,0,0,6
1215973,871291,2019-05-23,Senate,"Special Consent SB589",38,0,0,0,38
1215973,883955,2019-06-18,Assembly,"Do pass as amended and be re-referred to the Committee on [Appropriations]",14,0,1,0,15
1215973,891407,2019-08-30,Assembly,"Do pass as amended",18,0,0,0,18
1215973,891408,2019-09-10,Assembly,"SB 589 Bates Senate Third Reading By Brough",79,0,0,0,79
1215973,891409,2019-09-11,Senate,"Unfinished Business SB589 Bates et al. Concurrence",40,0,0,0,40
1215974,843029,2019-04-10,Assembly,"Do pass and be re-referred to the Committee on [Appropriations]",4,1,1,0,6
1215974,866055,2019-05-16,Assembly,"Do pass",12,5,1,0,18
1215974,870173,2019-05-22,Assembly,"AB 1505 O'Donnell Assembly Third Reading",44,19,17,0,80
1215974,891579,2019-07-10,Senate,"Do pass, but first be re-referred to the Committee on [Appropriations]",4,3,0,0,7
1215974,891580,2019-08-19,Senate,"Placed on suspense file",5,0,2,0,7
1215974,891581,2019-08-30,Senate,"Do pass as amended",5,2,0,0,7
1215974,891582,2019-09-09,Senate,"Assembly 3rd Reading AB1505 O'Donnell et al. By Leyva",27,11,2,0,40
1215974,891583,2019-09-10,Assembly,"AB 1505 O'Donnell Concurrence in Senate Amendments",60,16,3,0,79
1215974,896093,2019-09-09,Senate,"Assembly 3rd Reading AB1505 O'Donnell et al. BatusCellData"">",5,11,0,0,16
1215975,850625,2019-04-22,Assembly,"Do pass and be re-referred to the Committee on [Utilities and Energy]",12,2,1,0,15
1215976,852755,2019-04-24,Assembly,"Do pass and be re-referred to the Committee on [Appropriations]",7,0,0,0,7
1215976,865837,2019-05-16,Assembly,"Do pass",14,4,0,0,18
1215976,874626,2019-05-29,Assembly,"AB 1613 O'Donnell Assembly Third Reading",64,13,3,0,80
1215976,884761,2019-06-19,Senate,"Do pass, but first be re-referred to the Committee on [Appropriations]",4,1,0,0,5
1215976,893023,2019-08-12,Senate,"Placed on suspense file",7,0,0,0,7
1215976,893024,2019-08-30,Senate,"Do pass",5,2,0,0,7
1215976,893025,2019-09-09,Senate,"Assembly 3rd Reading AB1613 O'Donnell et al. By Beall",31,9,0,0,40
1215977,839902,2019-04-08,Assembly,"Do pass and be re-referred to the Committee on [Appropriations] with recommendation: To Consent Calendar",11,0,0,0,11
1215977,852261,2019-04-24,Assembly,"Do pass. To Consent Calendar",18,0,0,0,18
1215977,858306,2019-05-02,Assembly,"AB 1392 Mullin Consent Calendar Second Day Regular Session",76,0,4,0,80
1215977,880545,2019-06-11,Senate,"Do pass, but first be re-referred to the Committee on [Appropriations] with the recommendation: To Consent Calendar",8,0,1,0,9
1215977,889218,2019-07-01,Senate,"Consent Calendar AB1392",39,0,1,0,40
1215977,894038,2019-08-15,Assembly,"AB 1392 Mullin Concurrence in Senate Amendments",76,0,3,0,79
1215978,852991,2019-04-24,Senate,"Do pass, but first be re-referred to the Committee on [Appropriations]",9,0,0,0,9
1215978,868819,2019-05-21,Senate,"Senate 3rd Reading SB746 Bates et al",38,0,0,0,38
1215978,880431,2019-06-11,Assembly,"Do pass and be re-referred to the Committee on [Appropriations]",12,0,3,0,15
1215979,850459,2019-04-22,Assembly,"Do pass and be re-referred to the Committee on [Appropriations] with recommendation: To Consent Calendar",15,0,0,0,15
1215979,856827,2019-05-01,Assembly,"Do pass. To Consent Calendar",18,0,0,0,18
1215979,862272,2019-05-09,Assembly,"AB 1475 Bauer-Kahan Consent Calendar Second Day Regular Session",76,0,4,0,80
1215979,887423,2019-06-25,Senate,"Do pass, but first be re-referred to the Committee on [Appropriations]",12,0,1,0,13
1215979,891159,2019-08-26,Senate,"Assembly 3rd Reading AB1475 Bauer-Kahan et al. By Glazer",39,0,1,0,40
1215979,891160,2019-08-30,Assembly,"AB 1475 Bauer-Kahan Concurrence in Senate Amendments",75,0,4,0,79
1215980,841550,2019-04-09,Assembly,"Do pass and be re-referred to the Committee on [Business and Professions]",9,1,2,0,12
1215980,850444,2019-04-23,Assembly,"Do pass as amended and be re-referred to the Committee on [Appropriations]",15,2,3,0,20
1215980,865606,2019-05-16,Assembly,"Do pass as amended",13,4,1,0,18
1215980,869780,2019-05-22,Assembly,"AB 1340 Chiu Assembly Third Reading",60,12,8,0,80
1215980,889284,2019-07-01,Senate,"Do pass, but first be re-referred to the Committee on [Education]",8,0,1,0,9
1215980,890922,2019-07-10,Senate,"Do pass, but first be re-referred to the Committee on [Appropriations]",7,0,0,0,7
1215980,890923,2019-08-12,Senate,"Placed on suspense file",7,0,0,0,7
1215980,890924,2019-08-30,Senate,"Do pass as amended",7,0,0,0,7
1215980,890925,2019-09-10,Senate,"Assembly 3rd Reading AB1340 Chiu et al. By Hill",39,0,1,0,40
1215980,890926,2019-09-11,Assembly,"AB 1340 Chiu Concurrence in Senate Amendments",75,0,4,0,79
1215981,841651,2019-04-09,Assembly,"Do pass and be re-referred to the Committee on [Business and Professions]",11,0,1,0,12
1215981,850005,2019-04-23,Assembly,"Do pass and be re-referred to the Committee on [Appropriations]",18,0,2,0,20
1215981,865531,2019-05-16,Assembly,"Do pass",18,0,0,0,18
1215981,869851,2019-05-22,Assembly,"AB 1344 Bauer-Kahan Assembly Third Reading",74,0,6,0,80
1215981,876184,2019-04-09,Assembly,"Do pass and be re-referred to the Committe",0,0,1,0,1
1215981,889311,2019-07-01,Senate,"Do pass, but first be re-referred to the Committee on [Education]",7,0,2,0,9
1215981,892573,2019-07-10,Senate,"Do pass, but first be re-referred to the Committee on [Appropriations]",7,0,0,0,7
1215981,892574,2019-08-12,Senate,"Placed on suspense file",7,0,0,0,7
1215981,892575,2019-08-30,Senate,"Do pass",6,0,1,0,7
1215981,892576,2019-09-04,Senate,"Assembly 3rd Reading AB1344 Bauer-Kahan et al",40,0,0,0,40
1215981,892577,2019-09-10,Assembly,"AB 1344 Bauer-Kahan Concurrence in Senate Amendments",79,0,0,0,79
1215983,852726,2019-04-24,Assembly,"Do pass and be re-referred to the Committee on [Appropriations]",8,0,0,0,8
1215984,853109,2019-04-24,Assembly,"Do pass and be re-referred to the Committee on [Appropriations] with recommendation: To Consent Calendar",7,0,0,0,7
1215984,865818,2019-05-16,Assembly,"Do pass",18,0,0,0,18
1215984,871193,2019-05-23,Assembly,"AB 1767 Ramos Assembly Third Reading",78,0,2,0,80
1215984,888034,2019-06-26,Senate,"Do pass, but first be re-referred to the Committee on [Appropriations]",7,0,0,0,7
1215984,891756,2019-07-08,Senate,"Placed on suspense file",7,0,0,0,7
1215984,891757,2019-08-30,Senate,"Do pass as amended",6,1,0,0,7
1215984,891758,2019-09-04,Senate,"Assembly 3rd Reading AB1767 Ramos et al. By Rubio",35,3,2,0,40
1215984,891759,2019-09-09,Assembly,"AB 1767 Ramos Concurrence in Senate Amendments",78,0,1,0,79
1215985,841501,2019-04-10,Senate,"Do pass, but first be re-referred to the Committee on [Governmental Organization]",7,0,0,0,7
1215985,850449,2019-04-23,Senate,"Do pass, but first be re-referred to the Committee on [Appropriations]",15,0,1,0,16
1215985,863150,2019-05-13,Senate,"Placed on suspense file",6,0,0,0,6
1215987,849047,2019-04-10,Senate,"Do pass as amended, but first amend, and re-refer to the Committee on [Appropriations]",6,0,1,0,7
1215987,859532,2019-05-06,Senate,"Placed on suspense file",5,0,1,0,6
1215988,850216,2019-04-22,Assembly,"Do pass and be re-referred to the Committee on [Appropriations]",10,1,4,0,15
1215989,848984,2019-04-10,Senate,"Do pass as amended, but first amend, and re-refer to the Committee on [Appropriations]",7,0,0,0,7
1215989,859502,2019-05-06,Senate,"Placed on suspense file",5,0,1,0,6
1215989,865586,2019-05-16,Senate,"Do pass as amended",6,0,0,0,6
1215989,871353,2019-05-23,Senate,"Senate 3rd Reading SB594 Rubio",38,0,0,0,38
1215992,841179,2019-04-09,Assembly,"Do pass as amended and be re-referred to the Committee on [Appropriations]",12,0,3,0,15
1215992,865743,2019-05-16,Assembly,"Do pass as amended",13,1,4,0,18
1215992,874454,2019-05-29,Assembly,"AB 1642 Wood Assembly Third Reading",67,2,11,0,80
1215992,892794,2019-07-10,Senate,"Do pass as amended, but first amend, and re-refer to the Committee on [Appropriations]",7,1,1,0,9
1215992,892795,2019-08-12,Senate,"Placed on suspense file",7,0,0,0,7
1215992,892796,2019-08-30,Senate,"Do pass as amended",5,2,0,0,7
1215992,892797,2019-09-04,Senate,"Assembly 3rd Reading AB1642 Wood By Pan",39,1,0,0,40
1215992,892798,2019-09-06,Assembly,"With recommendation: That Senate amendments be concurred in",12,0,3,0,15
1215992,892799,2019-09-09,Assembly,"AB 1642 Wood Concurrence in Senate Amendments",76,0,3,0,79
1215993,841560,2019-04-10,Senate,"Do pass, but first be re-referred to the Committee on [Human Services]",6,0,1,0,7
1215993,850282,2019-04-22,Senate,"Do pass, but first be re-referred to the Committee on [Appropriations]",6,0,0,0,6
1215993,863092,2019-05-13,Senate,"Placed on suspense file",6,0,0,0,6
1215993,865680,2019-05-16,Senate,"Do pass as amended",6,0,0,0,6
1215993,871390,2019-05-23,Senate,"Senate 3rd Reading SB614 Rubio",38,0,0,0,38
1215993,974831,2020-08-03,Assembly,"Do pass as amended and be re-referred to the Committee on [Appropriations]",5,2,0,0,7
1215994,840024,2019-04-09,Assembly,"Do pass as amended and be re-referred to the Committee on [Natural Resources]",8,3,1,0,12
1215994,854966,2019-04-29,Assembly,"Do pass as amended",6,3,2,0,11
1215994,865690,2019-05-16,Assembly,"Do pass",11,5,2,0,18
1215994,871526,2019-05-23,Assembly,"AB 1731 Boerner Horvath Assembly Third Reading",42,23,15,0,80
1215994,884751,2019-06-18,Senate,"Do pass, but first be re-referred to the Committee on [Natural Resources and Water]",7,2,0,0,9
1215994,891466,2019-07-09,Senate,"Do pass, but first be re-referred to the Committee on [Governance and Finance]",6,1,2,0,9
1215994,974879,2020-08-05,Senate,"Do pass, but first be re-referred to the Committee on [Appropriations]",4,1,0,0,5
1215994,975820,2020-08-13,Senate,"Placed on suspense file",7,0,0,0,7
1215994,976371,2020-08-20,Senate,"Do pass as amended",5,1,1,0,7
1215994,977486,2020-08-31,Assembly,"With recommendation: That Senate amendments be concurred in",11,0,3,0,14
1215994,977805,2020-08-30,Senate,"Assembly 3rd Reading AB1731 Boerner Horvath By Hertzberg Urgency Clause",30,8,2,0,40
1215994,977806,2020-09-01,Assembly,"AB 1731 BOERNER HORVATH Concurrence - Urgency Added",74,0,5,0,79
1215995,840891,2019-04-09,Assembly,"Do pass. To Consent Calendar",8,0,0,0,8
1215995,852743,2019-04-25,Assembly,"AB 1336 Smith Consent Calendar Second Day Regular Session",76,0,4,0,80
1215995,880466,2019-06-10,Senate,"Do pass",5,0,1,0,6
1215995,885883,2019-06-20,Senate,"Special Consent AB1336",40,0,0,0,40
1215997,841733,2019-04-09,Assembly,"Do pass and be re-referred to the Committee on [Higher Education] with recommendation: To Consent Calendar",15,0,0,0,15
1215997,851408,2019-04-23,Assembly,"Do pass and be re-referred to the Committee on [Appropriations]",11,0,1,0,12
1215998,852722,2019-04-24,Senate,"Do pass, but first be re-referred to the Committee on [Appropriations]",13,0,0,0,13
1215998,874554,2019-05-29,Senate,"Senate 3rd Reading SB740 Mitchell",38,0,0,0,38
1215998,892517,2019-07-10,Assembly,"Do pass and be re-referred to the Committee on [Appropriations] with recommendation: To Consent Calendar",14,0,0,0,14
1215998,892518,2019-08-14,Assembly,"Do pass",18,0,0,0,18
1215998,892519,2019-08-22,Assembly,"SB 740 Mitchell Senate Third Reading By Mayes",75,0,4,0,79
1215998,892520,2019-08-30,Senate,"Special Consent SB740",37,0,3,0,40
1215999,902211,2020-01-13,Assembly,"Do pass as amended and be re-referred to the Committee on [Appropriations]",8,3,0,0,11
1215999,905416,2020-01-23,Assembly,"Do pass",13,5,0,0,18
1215999,906433,2020-01-27,Assembly,"AB 1441 Levine Assembly Third Reading",41,18,21,0,80
1216001,836768,2019-04-03,Assembly,"Do pass and be re-referred to the Committee on [Health]",20,0,1,0,21
1216001,840009,2019-04-09,Assembly,"Do pass and be re-referred to the Committee on [Appropriations] with recommendation: To Consent Calendar",15,0,0,0,15
1216002,853623,2019-04-24,Assembly,"Do pass and be re-referred to the Committee on [Appropriations] with recommendation: To Consent Calendar",7,0,0,0,7
1216002,861963,2019-05-08,Assembly,"Do pass. To Consent Calendar",18,0,0,0,18
1216002,865960,2019-05-16,Assembly,"AB 1299 Flora Consent Calendar Second Day Regular Session",74,0,6,0,80
1216002,885310,2019-06-19,Senate,"Do pass, but first be re-referred to the Committee on [Appropriations]",5,0,0,0,5
1216002,892385,2019-09-11,Senate,"Do pass, but first be re-referred to the Committee on [Appropriations]",5,2,0,0,7
1216002,974630,2020-07-31,Senate,"Do pass, but first be re-referred to the Committee on [Appropriations] with the recommendation: To Consent Calendar",7,0,0,0,7
1216002,975792,2020-08-13,Senate,"Placed on suspense file",7,0,0,0,7
1216002,976480,2020-08-20,Senate,"Do pass",7,0,0,0,7
1216002,977920,2020-08-31,Senate,"Assembly 3rd Reading AB1299 Salas et al. By Caballero",39,0,1,0,40
1216002,977921,2020-08-31,Assembly,"AB 1299 SALAS Concurrence in Senate Amendments",76,0,3,0,79
1216003,850656,2019-04-22,Senate,"Do pass as amended, but first amend, and re-refer to the Committee on [Judiciary]",9,0,0,0,9
1216003,863271,2019-05-13,Senate,"Placed on suspense file",6,0,0,0,6
1216003,866108,2019-05-16,Senate,"Do pass",6,0,0,0,6
1216003,871419,2019-05-23,Senate,"Special Consent SB650",38,0,0,0,38
1216003,883701,2019-06-18,Assembly,"Do pass as amended and be re-referred to the Committee on [Health]",18,0,1,0,19
1216003,892229,2019-07-02,Assembly,"Do pass as amended and be re-referred to the Committee on [Appropriations]",13,0,2,0,15
1216003,894268,2019-05-16,Senate,Result,6,0,0,0,6
1216003,895633,2019-05-13,Senate,Result,6,0,0,0,6
1216006,903159,2020-01-15,Senate,"Do pass, but first be re-referred to the Committee on [Appropriations]",7,0,0,0,7
1216006,906372,2020-01-27,Senate,"Senate 3rd Reading SB776 Skinner",30,6,3,0,39
1216006,974971,2020-08-05,Assembly,"Do pass as amended and be re-referred to the Committee on [Appropriations]",6,2,0,0,8
1216006,976331,2020-08-20,Assembly,"Do pass as amended",12,6,0,0,18
1216006,978144,2020-08-31,Assembly,"SB 776 Skinner Senate Third Reading By Kamlager",53,15,11,0,79
1216007,852819,2019-04-24,Senate,"Do pass as amended, but first amend, and re-refer to the Committee on [Appropriations]",9,0,0,0,9
1216007,868809,2019-05-21,Senate,"Senate 3rd Reading SB714 Umberg",38,0,0,0,38
1216007,891197,2019-09-09,Senate,"Unfinished Business SB714 Pan Concurrence",27,11,2,0,40
1216007,891198,2019-09-09,Assembly,"SB 714 Pan Senate Third Reading By WOOD",49,18,12,0,79
1216008,850709,2019-04-23,Assembly,"Do pass as amended and be re-referred to the Committee on [Revenue and Taxation]",7,0,0,0,7
1216008,860862,2019-05-06,Assembly,"Do pass and be re-referred to the Committee on [Appropriations]",11,0,0,0,11
1216009,852846,2019-04-25,Assembly,"Do pass and be re-referred to the Committee on [Appropriations]",6,1,0,0,7
1216009,865925,2019-05-16,Assembly,"Do pass",13,4,1,0,18
1216009,874677,2019-05-29,Assembly,"AB 1784 Santiago Assembly Third Reading",60,12,8,0,80
1216010,851478,2019-04-23,Assembly,"Do pass as amended. To Consent Calendar",8,0,0,0,8
1216010,858327,2019-05-02,Assembly,"AB 1537 Cunningham Consent Calendar Second Day Regular Session",76,0,4,0,80
1216010,880560,2019-06-11,Senate,"Do pass",7,0,0,0,7
1216010,885672,2019-06-20,Senate,"Special Consent AB1537",40,0,0,0,40
1216013,840063,2019-04-08,Senate,"Do pass as amended, but first amend, and re-refer to the Committee on [Judiciary]",9,0,0,0,9
1216013,851184,2019-04-23,Senate,"Do pass as amended, but first amend, and re-refer to the Committee on [Appropriations]",8,0,1,0,9
1216013,863264,2019-05-13,Senate,"Placed on suspense file",6,0,0,0,6
1216013,866358,2019-05-16,Senate,"Do pass",6,0,0,0,6
1216013,871303,2019-05-23,Senate,"Senate 3rd Reading SB581 Caballero",35,0,3,0,38
1216013,891562,2019-07-02,Assembly,"Do pass as amended and be re-referred to the Committee on [Appropriations]",15,0,4,0,19
1216013,891563,2019-08-30,Assembly,"Do pass as amended",17,0,1,0,18
1216014,851557,2019-04-24,Assembly,"Do pass",8,4,2,0,14
1216014,862287,2019-05-09,Assembly,"AB 1602 Low Assembly Third Reading",55,18,7,0,80
1216015,850603,2019-04-22,Assembly,"Do pass and be re-referred to the Committee on [Appropriations] with recommendation: To Consent Calendar",15,0,0,0,15
1216016,851378,2019-04-23,Assembly,"Do pass and be re-referred to the Committee on [Appropriations] with recommendation: To Consent Calendar",19,0,1,0,20
1216016,866351,2019-05-16,Assembly,"Do pass",18,0,0,0,18
1216016,871389,2019-05-23,Assembly,"AB 1519 B. & P. Assembly Third Reading By LOW",78,0,2,0,80
1216016,891850,2019-07-08,Senate,"Do pass, but first be re-referred to the Committee on [Appropriations]",9,0,0,0,9
1216016,891851,2019-08-12,Senate,"Placed on suspense file",7,0,0,0,7
1216016,891852,2019-08-30,Senate,"Do pass",7,0,0,0,7
1216016,891853,2019-09-11,Senate,"Assembly 3rd Reading AB1519 Low By Glazer",37,0,3,0,40
1216016,893861,2019-09-13,Assembly,"With recommendation: That Senate amendments be concurred in",18,0,1,0,19
1216016,893909,2019-09-13,Assembly,"AB 1519 Low Concurrence in Senate Amendments",78,0,1,0,79
1216017,850491,2019-04-22,Senate,"Do pass, but first be re-referred to the Committee on [Appropriations]",9,0,0,0,9
1216017,859878,2019-05-06,Senate,"Placed on suspense file",5,0,1,0,6
1216017,866461,2019-05-16,Senate,"Do pass",6,0,0,0,6
1216017,871601,2019-05-23,Senate,"Special Consent SB606",38,0,0,0,38
1216017,893268,2019-07-09,Assembly,"Do pass as amended and be re-referred to the Committee on [Appropriations]",19,0,0,0,19
1216017,893269,2019-08-30,Assembly,"Do pass",18,0,0,0,18
1216017,893270,2019-09-10,Assembly,"Do pass",15,0,4,0,19
1216017,893898,2019-09-13,Assembly,"SB 606 Glazer Senate Third Reading By Low",79,0,0,0,79
1216017,894207,2019-09-13,Senate,"Unfinished Business SB606 Glazer",39,1,0,0,40
1216017,894391,2019-09-14,Senate,"Unfinished Business SB606 Glazer",39,1,0,0,40
1216018,835011,2019-04-03,Assembly,"Do pass as amended and be re-referred to the Committee on [Local Government]",7,0,1,0,8
1216018,853114,2019-04-24,Assembly,"Do pass as amended and be re-referred to the Committee on [Appropriations]",6,1,1,0,8
1216018,866134,2019-05-16,Assembly,"Do pass as amended",14,3,1,0,18
1216018,872142,2019-05-24,Assembly,"AB 1783 Robert Rivas Assembly Third Reading",59,11,10,0,80
1216018,892125,2019-07-02,Senate,"Do pass, but first be re-referred to the Committee on [Governance and Finance]",7,3,1,0,11
1216018,892126,2019-07-10,Senate,"Do pass as amended, but first amend, and re-refer to the Committee on [Appropriations]",5,2,0,0,7
1216018,892127,2019-08-26,Senate,"Placed on suspense file",6,0,1,0,7
1216018,892128,2019-08-30,Senate,"Do pass as amended",5,2,0,0,7
1216018,892129,2019-09-10,Senate,"Assembly 3rd Reading AB1783 Robert Rivas et al. By Wiener",27,10,3,0,40
1216018,893655,2019-09-11,Assembly,"AB 1783 Robert Rivas Concurrence in Senate Amendments",57,16,6,0,79
1216019,848933,2019-04-09,Assembly,"Do pass as amended, and be re-referred to the Committee on [Appropriations] with recommendation: To Consent Calendar",8,0,0,0,8
1216019,866098,2019-05-16,Assembly,"Do pass as amended",13,0,5,0,18
1216019,874476,2019-05-29,Assembly,"AB 1435 Nazarian Assembly Third Reading",78,0,2,0,80
1216021,852734,2019-04-24,Assembly,"Do pass and be re-referred to the Committee on [Appropriations]",7,0,0,0,7
1216021,865679,2019-05-16,Assembly,"Do pass as amended",13,0,5,0,18
1216021,872145,2019-05-24,Assembly,"AB 1558 Ramos Assembly Third Reading",77,0,3,0,80
1216021,881040,2019-06-12,Senate,"Do pass, but first be re-referred to the Committee on [Labor, Public Employment and Retirement ] with the recommendation: To Consent Calendar",7,0,0,0,7
1216021,884765,2019-06-19,Senate,"Do pass, but first be re-referred to the Committee on [Appropriations] with the recommendation: To Consent Calendar",5,0,0,0,5
1216021,892331,2019-09-04,Senate,"Assembly 3rd Reading AB1558 Ramos et al. By Caballero",40,0,0,0,40
1216021,892332,2019-09-09,Assembly,"AB 1558 Ramos Concurrence in Senate Amendments",78,0,1,0,79
1216023,853044,2019-04-23,Senate,"Do pass as amended, but first amend, and re-refer to the Committee on [Appropriations]",6,0,1,0,7
1216023,867699,2019-05-20,Senate,"Senate 3rd Reading SB701 Jones",38,0,0,0,38
1216023,880273,2019-06-11,Assembly,"Do pass and be re-referred to the Committee on [Appropriations] with recommendation: To Consent Calendar",8,0,0,0,8
1216023,888307,2019-06-26,Assembly,"Do pass. To Consent Calendar",15,0,3,0,18
1216023,893312,2019-07-05,Assembly,"SB 701 Jones Consent Calendar Second Day Regular Session",70,0,9,0,79
1216023,894507,2019-07-05,Assembly,06/26/19,15,0,0,0,15
1216025,836727,2019-04-02,Assembly,"Do pass as amended, and be re-referred to the Committee on [Revenue and Taxation] with recommendation: To Consent Calendar",7,0,0,0,7
1216027,852979,2019-04-24,Senate,"Do pass as amended, but first amend, and re-refer to the Committee on [Appropriations]",7,0,0,0,7
1216027,863248,2019-05-13,Senate,"Placed on suspense file",6,0,0,0,6
1216027,866000,2019-05-16,Senate,"Do pass",6,0,0,0,6
1216027,871437,2019-05-23,Senate,"Special Consent SB667",38,0,0,0,38
1216027,886927,2019-06-24,Assembly,"Do pass as amended and be re-referred to the Committee on [Appropriations]",11,0,0,0,11
1216027,894771,2019-05-23,Senate,Date,6,0,0,0,6
1216027,976308,2020-08-20,Assembly,"Do pass as amended",18,0,0,0,18
1216028,841751,2019-04-09,Assembly,"Do pass and be re-referred to the Committee on [Judiciary]",6,1,1,0,8
1216028,850455,2019-04-23,Assembly,"Do pass as amended and be re-referred to the Committee on [Appropriations]",9,3,0,0,12
1216028,861540,2019-05-08,Assembly,"Do pass",13,4,1,0,18
1216028,863046,2019-05-13,Assembly,"AB 1324 Levine Assembly Third Reading",59,12,9,0,80
1216028,880559,2019-06-10,Senate,"Do pass, but first be re-referred to the Committee on [Judiciary]",5,0,1,0,6
1216029,850400,2019-04-22,Assembly,"Do pass and be re-referred to the Committee on [Appropriations]",15,0,0,0,15
1216030,853581,2019-04-24,Assembly,"Do pass as amended and be re-referred to the Committee on [Appropriations]",5,1,1,0,7
1216030,865942,2019-05-16,Assembly,"Do pass",14,2,2,0,18
1216030,871359,2019-05-23,Assembly,"AB 1684 Maienschein Assembly Third Reading",64,9,7,0,80
1216033,842943,2019-04-10,Assembly,"Do pass as amended",4,1,1,0,6
1216033,863030,2019-05-13,Assembly,"AB 1507 Smith Assembly Third Reading",54,18,8,0,80
1216033,890378,2019-07-10,Senate,"Do pass as amended, but first amend, and re-refer to the Committee on [Appropriations]",4,3,0,0,7
1216033,890379,2019-08-19,Senate,"Placed on suspense file",5,0,2,0,7
1216033,890380,2019-08-30,Senate,"Do pass as amended",5,2,0,0,7
1216033,890381,2019-09-11,Senate,"Assembly 3rd Reading AB1507 Smith et al. By Leyva",25,12,3,0,40
1216033,893623,2019-09-12,Assembly,"AB 1507 Smith Concurrence in Senate Amendments",57,17,5,0,79
1216033,894825,2019-09-11,Senate,Assemb,5,12,0,0,17
1216034,837222,2019-04-03,Senate,"Do pass, but first be re-referred to the Committee on [Appropriations]",8,0,1,0,9
1216034,849512,2019-04-22,Senate,"Placed on suspense file",6,0,0,0,6
1216035,851685,2019-04-23,Assembly,"Do pass and be re-referred to the Committee on [Appropriations]",15,0,0,0,15
1216035,865739,2019-05-16,Assembly,"Do pass as amended",13,0,5,0,18
1216035,874576,2019-05-29,Assembly,"AB 1779 Daly Assembly Third Reading",76,0,4,0,80
1216035,891796,2019-07-10,Senate,"Do pass as amended, but first amend, and re-refer to the Committee on [Appropriations]",8,0,1,0,9
1216035,891797,2019-08-12,Senate,"Placed on suspense file",7,0,0,0,7
1216039,853029,2019-04-24,Assembly,"Do pass and be re-referred to the Committee on [Appropriations]",19,0,2,0,21
1216039,861944,2019-05-08,Assembly,"Do pass. To Consent Calendar",18,0,0,0,18
1216039,865970,2019-05-16,Assembly,"AB 1311 Ting Consent Calendar Second Day Regular Session",74,0,6,0,80
1216039,880427,2019-06-11,Senate,"Do pass, but first be re-referred to the Committee on [Appropriations]",14,0,2,0,16
1216039,891598,2019-08-26,Senate,"Assembly 3rd Reading AB1311 Ting et al. By Wiener",39,0,1,0,40
1216039,891599,2019-09-03,Assembly,"AB 1311 Ting Concurrence in Senate Amendments",77,0,2,0,79
1216040,855933,2019-04-30,Assembly,"Do pass. To Consent Calendar",12,0,0,0,12
1216040,859573,2019-05-06,Assembly,"AB 1373 Patterson Consent Calendar Second Day Regular Session",77,0,3,0,80
1216040,880856,2019-06-11,Senate,"Do pass and be ordered to the Consent Calendar",9,0,0,0,9
1216040,883073,2019-06-17,Senate,"Consent Calendar AB1373",40,0,0,0,40
1216040,894042,2019-08-12,Assembly,"AB 1373 Patterson Concurrence in Senate Amendments",76,0,3,0,79
1216041,854835,2019-04-24,Assembly,"Do pass as amended, and be re-referred to the Committee on [Appropriations] with recommendation: To Consent Calendar",7,0,0,0,7
1216042,851573,2019-04-23,Assembly,"Do pass and be re-referred to the Committee on [Appropriations]",8,0,0,0,8
1216043,833904,2019-04-01,Assembly,"Do pass and be re-referred to the Committee on [Appropriations]",15,0,0,0,15
1216043,867041,2019-05-16,Assembly,"Do pass",18,0,0,0,18
1216043,870986,2019-05-23,Assembly,"AB 1671 Berman Assembly Third Reading",78,0,2,0,80
1216043,887824,2019-06-25,Senate,"Do pass as amended, but first amend, and re-refer to the Committee on [Appropriations] with the recommendation: To Consent Calendar",13,0,0,0,13
1216043,891594,2019-07-08,Senate,"Placed on suspense file",7,0,0,0,7
1216043,891595,2019-08-30,Senate,"Do pass",7,0,0,0,7
1216043,891596,2019-09-03,Senate,"Assembly 3rd Reading AB1671 Berman By Beall",40,0,0,0,40
1216043,891597,2019-09-05,Assembly,"AB 1671 Berman Concurrence in Senate Amendments",78,0,1,0,79
1216044,841943,2019-04-09,Assembly,"Do pass and be re-referred to the Committee on [Housing and Community Development]",7,0,1,0,8
1216044,851305,2019-04-24,Assembly,"Do pass as amended and be re-referred to the Committee on [Appropriations]",7,1,0,0,8
1216045,901476,2020-01-08,Senate,"Do pass, but first be re-referred to the Committee on [Judiciary]",2,2,4,0,8
1216045,901477,2020-01-08,Senate,"[First] hearing set for [01-08-2020]: Failed passage in Committee. Reconsideration granted",8,0,0,0,8
1216047,851912,2019-04-23,Assembly,"Do pass and be re-referred to the Committee on [Appropriations] with recommendation: To Consent Calendar",19,0,1,0,20
1216047,866223,2019-05-16,Assembly,"Do pass",18,0,0,0,18
1216047,871395,2019-05-23,Assembly,"AB 1521 B. & P. Assembly Third Reading By LOW",78,0,2,0,80
1216047,893595,2019-07-08,Senate,"Do pass as amended, but first amend, and re-refer to the Committee on [Appropriations]",9,0,0,0,9
1216047,893596,2019-08-12,Senate,"Placed on suspense file",7,0,0,0,7
1216047,893597,2019-08-30,Senate,"Do pass",7,0,0,0,7
1216047,893598,2019-09-09,Senate,"Assembly 3rd Reading AB1521 Low By Glazer",40,0,0,0,40
1216047,893599,2019-09-10,Assembly,"AB 1521 Low Concurrence in Senate Amendments",76,0,3,0,79
1216049,841471,2019-04-10,Assembly,"Do pass as amended and be re-referred to the Committee on [Local Government]",8,0,0,0,8
1216049,853139,2019-04-24,Assembly,"Do pass as amended and be re-referred to the Committee on [Appropriations]",8,0,0,0,8
1216049,866017,2019-05-16,Assembly,"Do pass",18,0,0,0,18
1216049,871137,2019-05-23,Assembly,"AB 1483 Grayson Assembly Third Reading",77,0,3,0,80
1216049,880005,2019-05-16,Assembly,Do,8,0,0,0,8
1216049,890626,2019-07-02,Senate,"Do pass, but first be re-referred to the Committee on [Governance and Finance]",10,0,1,0,11
1216049,890627,2019-07-10,Senate,"Do pass as amended, but first amend, and re-refer to the Committee on [Appropriations]",6,0,1,0,7
1216049,890628,2019-08-26,Senate,"Placed on suspense file",6,0,1,0,7
1216049,890629,2019-08-30,Senate,"Do pass as amended",7,0,0,0,7
1216049,890630,2019-09-10,Senate,"That the measure be returned to Senate Floor for consideration. Ordered to third reading",6,0,1,0,7
1216049,890631,2019-09-11,Senate,"Assembly 3rd Reading AB1483 Grayson et al. By Wiener",40,0,0,0,40
1216049,893769,2019-09-12,Assembly,"AB 1483 Grayson Concurrence in Senate Amendments",79,0,0,0,79
1216050,842880,2019-04-09,Assembly,"Do pass as amended and be re-referred to the Committee on [Judiciary]",15,2,3,0,20
1216050,850358,2019-04-23,Assembly,"Do pass as amended and be re-referred to the Committee on [Appropriations]",9,2,1,0,12
1216050,866334,2019-05-16,Assembly,"Do pass",14,3,1,0,18
1216050,871288,2019-05-23,Assembly,"AB 1417 Blanca Rubio Assembly Third Reading",66,6,8,0,80
1216050,889318,2019-07-01,Senate,"Do pass, but first be re-referred to the Committee on [Judiciary]",7,0,2,0,9
1216050,891592,2019-07-09,Senate,"Do pass as amended, but first amend, and re-refer to the Committee on [Appropriations]",7,1,1,0,9
1216050,891593,2019-08-12,Senate,"Placed on suspense file",7,0,0,0,7
1216052,851229,2019-04-23,Assembly,"Do pass and be re-referred to the Committee on [Appropriations]",8,1,6,0,15
1216054,860729,2019-05-01,Assembly,"Do pass as amended",7,0,1,0,8
1216054,863125,2019-05-13,Assembly,"AB 1659 Bloom Assembly Third Reading",67,0,13,0,80
1216054,883774,2019-06-18,Senate,"Do pass, but first be re-referred to the Committee on [Governance and Finance]",10,0,1,0,11
1216054,891141,2019-07-10,Senate,"Do pass as amended, but first amend, and re-refer to the Committee on [Appropriations]",7,0,0,0,7
1216054,977278,2020-08-28,Senate,"Do pass as amended, but first amend, and re-refer to the Committee on [Appropriations]",7,3,3,0,13
1216057,841702,2019-04-10,Senate,"Do pass, but first be re-referred to the Committee on [Natural Resources and Water]",12,0,1,0,13
1216057,850111,2019-04-23,Senate,"Do pass as amended, but first amend, and re-refer to the Committee on [Appropriations]",9,0,0,0,9
1216057,863218,2019-05-13,Senate,"Placed on suspense file",6,0,0,0,6
1216058,901473,2020-01-08,Assembly,"Do pass",20,0,1,0,21
1216058,904122,2020-01-21,Assembly,"AB 1635 Gray Assembly Third Reading",70,0,10,0,80
1216060,851321,2019-04-23,Assembly,"Do pass and be re-referred to the Committee on [Appropriations] with recommendation: To Consent Calendar",15,0,0,0,15
1216060,866457,2019-05-16,Assembly,"Do pass as amended",18,0,0,0,18
1216060,874551,2019-05-29,Assembly,"AB 1759 Salas Assembly Third Reading",78,0,2,0,80
1216063,841344,2019-04-09,Assembly,"Do pass and be re-referred to the Committee on [Appropriations]",5,0,3,0,8
1216063,865812,2019-05-16,Assembly,"Do pass",17,1,0,0,18
1216063,871430,2019-05-23,Assembly,"AB 1501 Low Assembly Third Reading",66,0,14,0,80
1216063,891999,2019-07-02,Senate,"Do pass, but first be re-referred to the Committee on [Appropriations]",6,0,1,0,7
1216063,892000,2019-08-12,Senate,"Placed on suspense file",7,0,0,0,7
1216063,895255,2019-05-23,Assembly,Result,66,0,0,0,66
1216064,841835,2019-04-09,Assembly,"Do pass and be re-referred to the Committee on [Appropriations]",14,0,0,0,14
1216064,866653,2019-05-16,Assembly,"Do pass as amended",13,0,5,0,18
1216064,874541,2019-05-29,Assembly,"AB 1387 Wood Assembly Third Reading",78,0,2,0,80
1216065,841171,2019-04-02,Senate,"Do pass as amended, but first amend, and re-refer to the Committee on [Human Services]",8,1,2,0,11
1216065,850717,2019-04-22,Senate,"Do pass, but first be re-referred to the Committee on [Appropriations]",6,0,0,0,6
1216065,860464,2019-05-06,Senate,"Placed on suspense file",5,0,1,0,6
1216065,866433,2019-05-16,Senate,"Do pass",6,0,0,0,6
1216065,874010,2019-05-28,Senate,"Senate 3rd Reading SB695 Portantino",34,2,2,0,38
1216065,882778,2019-06-17,Assembly,"Be re-referred to the Committee on [Education]",11,0,1,0,12
1216065,891125,2019-07-10,Assembly,"Do pass and be re-referred to the Committee on [Appropriations]",5,1,1,0,7
1216065,891126,2019-08-30,Assembly,"Do pass",14,3,1,0,18
1216065,891127,2019-09-09,Assembly,"SB 695 Portantino Senate Third Reading By Reyes",67,4,8,0,79
1216065,891128,2019-09-11,Senate,"That the Assembly amendments be concurred in",6,0,1,0,7
1216065,893780,2019-09-12,Senate,"Unfinished Business SB695 Portantino Concurrence",31,6,3,0,40
1216067,851207,2019-04-23,Assembly,"Do pass and be re-referred to the Committee on [Appropriations]",11,3,1,0,15
1216068,858648,2019-05-01,Assembly,"Do pass",6,2,0,0,8
1216068,871539,2019-05-22,Assembly,"AB 1413 Gloria Assembly Third Reading",47,26,7,0,80
1216068,887808,2019-06-25,Senate,"Do pass, but first be re-referred to the Committee on [Governance and Finance]",7,3,3,0,13
1216068,893038,2019-07-10,Senate,"Do pass as amended",4,1,2,0,7
1216068,893039,2019-09-11,Senate,"Assembly 3rd Reading AB1413 Gloria By Dodd",28,10,2,0,40
1216068,893816,2019-09-12,Assembly,"AB 1413 Gloria Concurrence in Senate Amendments",50,25,4,0,79
1216069,852512,2019-04-22,Assembly,"Do pass as amended and be re-referred to the Committee on [Appropriations]",11,0,0,0,11
1216069,866346,2019-05-16,Assembly,"Do pass",18,0,0,0,18
1216069,871431,2019-05-23,Assembly,"AB 1668 Carrillo Assembly Third Reading",78,0,2,0,80
1216069,887789,2019-06-25,Senate,"Do pass, but first be re-referred to the Committee on [Public Safety]",9,0,0,0,9
1216069,893151,2019-07-09,Senate,"Do pass as amended, but first amend, and re-refer to the Committee on [Appropriations]",7,0,0,0,7
1216069,893152,2019-08-12,Senate,"Placed on suspense file",7,0,0,0,7
1216069,893153,2019-08-30,Senate,"Do pass as amended",7,0,0,0,7
1216069,893154,2019-09-11,Senate,"Assembly 3rd Reading AB1668 Carrillo et al. By Dodd",40,0,0,0,40
1216069,893737,2019-09-12,Assembly,"AB 1668 Carrillo Concurrence in Senate Amendments",79,0,0,0,79
1216070,835789,2019-04-02,Senate,"Do pass, but first be re-referred to the Committee on [Appropriations] with the recommendation: To Consent Calendar",4,0,1,0,5
1216070,852987,2019-04-25,Senate,"Consent Calendar SB664",37,0,1,0,38
1216070,883139,2019-06-17,Assembly,"Be re-referred to the Committees on [Transportation] and [Privacy and Consumer Protection]",11,0,1,0,12
1216070,891325,2019-07-01,Assembly,"Do pass and be re-referred to the Committee on [Privacy and Consumer Protection]",14,0,1,0,15
1216070,891326,2019-07-09,Assembly,"Do pass as amended and be re-referred to the Committee on [Appropriations]",11,0,0,0,11
1216070,891327,2019-08-28,Assembly,"Do pass and be re-referred to the Committee on [Rules]",17,0,1,0,18
1216073,811729,2019-02-28,Assembly,"Be adopted. To Consent Calendar",11,0,1,0,12
1216073,816338,2019-03-07,Assembly,"ACR 40 Blanca Rubio Consent Calendar Second Day Regular Session",74,0,6,0,80
1216073,831705,2019-03-28,Senate,"Special Consent ACR40",35,0,3,0,38
1216074,851117,2019-04-23,Assembly,"Do pass and be re-referred to the Committee on [Appropriations]",7,0,0,0,7
1216075,856092,2019-04-24,Assembly,"Do pass as amended and be re-referred to the Committee on [Appropriations]",10,2,3,0,15
1216076,853019,2019-04-23,Senate,"Do pass as amended, but first amend, and re-refer to the Committee on [Appropriations]",7,2,0,0,9
1216076,863074,2019-05-13,Senate,"Placed on suspense file",6,0,0,0,6
1216076,865750,2019-05-16,Senate,"Do pass",4,2,0,0,6
1216076,875489,2019-05-30,Senate,"Senate 3rd Reading SB749 Durazo",21,12,5,0,38
1216076,883745,2019-06-18,Assembly,"Do pass as amended and be re-referred to the Committee on [Appropriations]",8,3,1,0,12
1216076,890969,2019-08-30,Assembly,"Do pass as amended",12,5,1,0,18
1216076,890970,2019-09-06,Assembly,"SB 749 Durazo Senate Third Reading By Gonzalez Amendment Set #1",43,16,20,0,79
1216077,853083,2019-04-24,Assembly,"Do pass and be re-referred to the Committee on [Appropriations] with recommendation: To Consent Calendar",7,0,0,0,7
1216077,856732,2019-05-01,Assembly,"Do pass. To Consent Calendar",18,0,0,0,18
1216077,862231,2019-05-09,Assembly,"AB 1554 Gonzalez Consent Calendar Second Day Regular Session",76,0,4,0,80
1216077,881147,2019-06-12,Senate,"Do pass, but first be re-referred to the Committee on [Appropriations]",5,0,0,0,5
1216077,894687,2019-08-12,Senate,"Assembly 3rd Reading AB1554 Gonzalez By Mitchell",33,5,2,0,40
1216077,894688,2019-08-15,Assembly,"AB 1554 Gonzalez Concurrence in Senate Amendments",75,0,4,0,79
1216078,835864,2019-04-02,Assembly,"Do pass as amended and be re-referred to the Committee on [Appropriations]",11,0,1,0,12
1216080,834300,2019-04-02,Assembly,"Do pass. To Consent Calendar",20,0,0,0,20
1216080,838351,2019-04-08,Assembly,"AB 1529 Low Consent Calendar Second Day",73,0,7,0,80
1216080,879884,2019-06-10,Senate,"Do pass and be ordered to the Consent Calendar",9,0,0,0,9
1216080,891914,2019-07-08,Senate,"Do pass",9,0,0,0,9
1216080,891915,2019-08-26,Senate,"Assembly 3rd Reading AB1529 Low By Hertzberg Urgency Clause",38,0,2,0,40
1216080,891916,2019-09-05,Assembly,"With recommendation: That Senate amendments be concurred in, but first be re-referred to Com. on [Business and Professions]",13,0,2,0,15
1216080,891917,2019-09-10,Assembly,"With recommendation: That Senate amendments be concurred in",15,0,4,0,19
1216080,891918,2019-09-11,Assembly,"AB 1529 Low Concurrence - Urgency Added",78,0,1,0,79
1216081,841950,2019-04-09,Assembly,"Do pass as amended and be re-referred to the Committee on [Appropriations]",6,0,2,0,8
1216081,851520,2019-04-24,Assembly,"Do pass",13,3,2,0,18
1216081,862218,2019-05-09,Assembly,"AB 1423 Wicks Assembly Third Reading",51,10,19,0,80
1216081,883819,2019-06-18,Senate,"Do pass as amended, but first amend, and re-refer to the Committee on [Appropriations]",7,0,0,0,7
1216081,891424,2019-08-26,Senate,"Assembly 3rd Reading AB1423 Wicks By Skinner",38,0,2,0,40
1216081,891425,2019-09-03,Assembly,"AB 1423 Wicks Concurrence in Senate Amendments",68,0,11,0,79
1216082,851182,2019-04-23,Assembly,"Do pass as amended and be re-referred to the Committee on [Appropriations]",9,3,0,0,12
1216082,866450,2019-05-16,Assembly,"Do pass",13,4,1,0,18
1216082,874512,2019-05-29,Assembly,"AB 1753 Carrillo Assembly Third Reading",57,17,6,0,80
1216082,892114,2019-07-09,Senate,"Do pass, but first be re-referred to the Committee on [Appropriations]",5,1,3,0,9
1216082,892115,2019-08-12,Senate,"Placed on suspense file",7,0,0,0,7
1216083,842882,2019-04-10,Assembly,"Do pass and be re-referred to the Committee on [Banking and Finance]",8,0,0,0,8
1216083,902229,2020-01-13,Assembly,"Do pass as amended and be re-referred to the Committee on [Appropriations]",12,0,0,0,12
1216083,905365,2020-01-23,Assembly,"Do pass",18,0,0,0,18
1216083,906442,2020-01-27,Assembly,"AB 1551 Arambula Assembly Third Reading",77,0,3,0,80
1216083,975846,2020-08-13,Senate,"Do pass, but first be re-referred to the Committee on [Appropriations]",7,0,0,0,7
1216083,977197,2020-08-27,Senate,"Assembly 3rd Reading AB1551 Arambula et al. By Caballero",30,0,10,0,40
1216083,978110,2020-08-30,Assembly,"AB 1551 Arambula Concurrence in Senate Amendments",75,0,4,0,79
1216084,841642,2019-04-10,Assembly,"Do pass and be re-referred to the Committee on [Appropriations]",5,2,0,0,7
1216084,865751,2019-05-16,Assembly,"Do pass",13,5,0,0,18
1216084,870997,2019-05-23,Assembly,"AB 1451 Low Assembly Third Reading",56,19,5,0,80
1216084,883859,2019-06-18,Senate,"Do pass, but first be re-referred to the Committee on [Public Safety]",4,1,0,0,5
1216084,893302,2019-07-09,Senate,"Do pass, but first be re-referred to the Committee on [Appropriations]",4,1,2,0,7
1216084,893303,2019-08-12,Senate,"Placed on suspense file",7,0,0,0,7
1216084,893304,2019-08-30,Senate,"Do pass as amended",5,2,0,0,7
1216084,893305,2019-09-10,Senate,"Assembly 3rd Reading AB1451 Low et al. By Hertzberg",24,12,4,0,40
1216084,893306,2019-09-11,Assembly,"AB 1451 Low Concurrence in Senate Amendments",58,18,3,0,79
1216085,842501,2019-04-09,Assembly,"Do pass and be re-referred to the Committee on [Business and Professions] with recommendation: To Consent Calendar",15,0,0,0,15
1216085,850666,2019-04-23,Assembly,"Do pass and be re-referred to the Committee on [Appropriations] with recommendation: To Consent Calendar",19,0,1,0,20
1216085,856722,2019-05-01,Assembly,"Do pass. To Consent Calendar",18,0,0,0,18
1216085,862234,2019-05-09,Assembly,"AB 1723 Wood Consent Calendar Second Day Regular Session",76,0,4,0,80
1216085,879876,2019-06-10,Senate,"Do pass, but first be re-referred to the Committee on [Appropriations] with the recommendation: To Consent Calendar",9,0,0,0,9
1216085,893032,2019-09-05,Senate,"Assembly 3rd Reading AB1723 Wood By Glazer",38,0,2,0,40
1216087,842531,2019-04-09,Assembly,"Do pass as amended and be re-referred to the Committee on [Appropriations]",14,0,1,0,15
1216089,851190,2019-04-23,Assembly,"Do pass as amended and be re-referred to the Committee on [Appropriations]",15,1,4,0,20
1216090,840048,2019-04-09,Assembly,"Do pass as amended and be re-referred to the Committee on [Public Safety]",9,0,3,0,12
1216090,862125,2019-05-09,Assembly,"AB 1510 Reyes Assembly Third Reading",65,0,15,0,80
1216090,884557,2019-06-18,Senate,"Do pass, but first be re-referred to the Committee on [Appropriations]",7,0,2,0,9
1216090,892172,2019-08-19,Senate,"Placed on suspense file",5,0,2,0,7
1216090,892173,2019-08-30,Senate,"Do pass as amended",6,1,0,0,7
1216090,892174,2019-09-04,Senate,"Assembly 3rd Reading AB1510 Reyes et al. By Jackson Urgency Clause",39,0,1,0,40
1216090,892175,2019-09-09,Assembly,"AB 1510 Reyes Concurrence - Urgency Added",73,0,6,0,79
1216091,851585,2019-04-23,Assembly,"Do pass and be re-referred to the Committee on [Appropriations]",15,0,0,0,15
1216092,837118,2019-04-03,Assembly,"Do pass and be re-referred to the Committee on [Arts, Entertainment, Sports, Tourism, and Internet Media]",20,0,1,0,21
1216092,850810,2019-04-23,Assembly,"Do pass and be re-referred to the Committee on [Appropriations]",7,0,0,0,7
1216092,866396,2019-05-16,Assembly,"Do pass",18,0,0,0,18
1216092,874409,2019-05-29,Assembly,"AB 1754 Jones-Sawyer Assembly Third Reading",78,0,2,0,80
1216092,890508,2019-07-09,Senate,"Do pass as amended, but first amend, and re-refer to the Committee on [Appropriations]",15,0,1,0,16
1216092,890509,2019-08-12,Senate,"Placed on suspense file",7,0,0,0,7
1216092,890510,2019-08-30,Senate,"Do pass",7,0,0,0,7
1216092,890511,2019-09-09,Senate,"Special Consent AB1754",40,0,0,0,40
1216092,890512,2019-09-10,Assembly,"AB 1754 Jones-Sawyer Concurrence in Senate Amendments",79,0,0,0,79
1216092,894014,2019-08-12,Senate,Result,15,0,0,0,15
1216096,851002,2019-04-22,Senate,"Do pass, but first be re-referred to the Committee on [Appropriations] with the recommendation: To Consent Calendar",6,0,0,0,6
1216096,862303,2019-05-09,Senate,"Consent Calendar SB735",38,0,0,0,38
1216096,884275,2019-06-18,Assembly,"Do pass and be re-referred to the Committee on [Appropriations]",8,0,0,0,8
1216096,888134,2019-06-26,Assembly,"Do pass. To Consent Calendar",15,0,3,0,18
1216096,894075,2019-07-05,Assembly,"SB 735 Leyva Consent Calendar Second Day Regular Session",70,0,9,0,79
1216098,842941,2019-04-10,Assembly,"Do pass and be re-referred to the Committee on [Natural Resources]",10,2,3,0,15
1216098,849231,2019-04-22,Assembly,"Do pass and be re-referred to the Committee on [Appropriations]",8,1,2,0,11
1216099,858261,2019-05-01,Assembly,"Do pass as amended",8,0,0,0,8
1216099,868101,2019-05-20,Assembly,"AB 1304 Waldron Assembly Third Reading",75,0,5,0,80
1216099,974628,2020-07-31,Senate,"Do pass, but first be re-referred to the Committee on [Appropriations]",6,0,1,0,7
1216099,975763,2020-08-13,Senate,"Placed on suspense file",7,0,0,0,7
1216099,976344,2020-08-20,Senate,"Do pass as amended",7,0,0,0,7
1216099,977420,2020-08-29,Senate,"Assembly 3rd Reading AB1304 Waldron et al. By Umberg",36,1,3,0,40
1216099,977909,2020-08-31,Assembly,"AB 1304 WALDRON Concurrence in Senate Amendments",76,0,3,0,79
1216100,834411,2019-04-02,Senate,"Do pass, but first be re-referred to the Committee on [Appropriations]",6,1,0,0,7
1216100,848952,2019-04-22,Senate,"Placed on suspense file",6,0,0,0,6
1216100,866373,2019-05-16,Senate,"Do pass as amended",4,2,0,0,6
1216100,871292,2019-05-23,Senate,"Senate 3rd Reading SB555 Mitchell",31,5,2,0,38
1216100,892374,2019-07-09,Assembly,"Do pass and be re-referred to the Committee on [Appropriations]",7,1,0,0,8
1216100,976410,2020-08-20,Assembly,"Do pass as amended",13,5,0,0,18
1216100,976902,2020-08-26,Assembly,"SB 555 Mitchell Senate Third Reading By KALRA",51,8,20,0,79
1216100,977912,2020-08-30,Senate,"Unfinished Business SB555 Mitchell et al. Concurrence",32,6,2,0,40
1216102,853159,2019-04-24,Senate,"Do pass as amended, but first amend, and re-refer to the Committee on [Appropriations] with the recommendation: To Consent Calendar",9,0,0,0,9
1216102,863089,2019-05-13,Senate,"Placed on suspense file",6,0,0,0,6
1216102,865919,2019-05-16,Senate,"Do pass",6,0,0,0,6
1216102,871078,2019-05-23,Senate,"Special Consent SB706",38,0,0,0,38
1216102,890761,2019-07-09,Assembly,"Do pass and be re-referred to the Committee on [Appropriations] with recommendation: To Consent Calendar",15,0,0,0,15
1216102,890762,2019-08-30,Assembly,"Do pass as amended",18,0,0,0,18
1216102,890763,2019-09-09,Assembly,"SB 706 Galgiani Senate Third Reading By Flora",78,0,1,0,79
1216102,890764,2019-09-10,Senate,"Unfinished Business SB706 Galgiani Concurrence",40,0,0,0,40
1216104,902205,2020-01-13,Assembly,"Do pass as amended and be re-referred to the Committee on [Appropriations]",15,0,0,0,15
1216105,901320,2020-01-06,Assembly,"Be re-referred to the Committee on [Business and Professions]",12,0,0,0,12
1216105,902805,2020-01-14,Assembly,"Do pass and be re-referred to the Committee on [Appropriations]",18,0,1,0,19
1216105,905334,2020-01-23,Assembly,"Do pass. To Consent Calendar",18,0,0,0,18
1216105,912000,2020-01-30,Assembly,"AB 1469 Low Consent Calendar Second Day Regular Session",76,0,4,0,80
1216105,975335,2020-08-08,Senate,"Do pass, but first be re-referred to the Committee on [Appropriations]",9,0,0,0,9
1216105,975847,2020-08-13,Senate,"Placed on suspense file",7,0,0,0,7
1216107,839879,2019-04-09,Assembly,"Do pass. To Consent Calendar",12,0,0,0,12
1216107,848812,2019-04-22,Assembly,"AB 1637 Smith Consent Calendar Second Day Regular Session",78,0,2,0,80
1216107,877688,2019-06-04,Senate,"Do pass, but first be re-referred to the Committee on [Appropriations] with the recommendation: To Consent Calendar",9,0,0,0,9
1216107,887087,2019-06-24,Senate,"Placed on suspense file",7,0,0,0,7
1216107,890593,2019-08-30,Senate,"Do pass",7,0,0,0,7
1216107,890594,2019-09-09,Senate,"Special Consent AB1637 Smith et al",40,0,0,0,40
1216109,903168,2020-01-15,Senate,"Do pass, but first be re-referred to the Committee on [Appropriations]",2,5,0,0,7
1216110,834375,2019-04-02,Assembly,"Do pass and be re-referred to the Committee on [Appropriations]",19,0,1,0,20
1216110,851710,2019-04-24,Assembly,"Do pass. To Consent Calendar",18,0,0,0,18
1216110,858005,2019-05-02,Assembly,"AB 1384 O'Donnell Consent Calendar Second Day Regular Session",76,0,4,0,80
1216110,878592,2019-06-05,Senate,"Do pass, but first be re-referred to the Committee on [Rules]",7,0,0,0,7
1216111,855938,2019-04-23,Assembly,"Do pass as amended, and be re-referred to the Committee on [Appropriations] with recommendation: To Consent Calendar",11,0,0,0,11
1216111,866199,2019-05-16,Assembly,"Do pass",18,0,0,0,18
1216111,871324,2019-05-23,Assembly,"AB 1576 Calderon Assembly Third Reading",78,0,2,0,80
1216111,879279,2019-05-16,Assembly,Do,11,0,0,0,11
1216111,887530,2019-06-25,Senate,"Do pass, but first be re-referred to the Committee on [Judiciary]",16,0,0,0,16
1216111,890697,2019-07-09,Senate,"Do pass, but first be re-referred to the Committee on [Appropriations] with the recommendation: To Consent Calendar",8,0,1,0,9
1216111,890698,2019-08-12,Senate,"Placed on suspense file",7,0,0,0,7
1216112,842828,2019-04-10,Senate,"Do pass, but first be re-referred to the Committee on [Governmental Organization]",7,0,0,0,7
1216112,850874,2019-04-23,Senate,"Do pass, but first be re-referred to the Committee on [Appropriations]",16,0,0,0,16
1216112,860130,2019-05-06,Senate,"Placed on suspense file",5,0,1,0,6
1216112,866406,2019-05-16,Senate,"Do pass as amended",6,0,0,0,6
1216112,871129,2019-05-23,Senate,"Senate 3rd Reading SB598 Moorlach",38,0,0,0,38
1216112,885515,2019-06-19,Assembly,"Do pass and be re-referred to the Committee on [Accountability and Administrative Review] with recommendation: To Consent Calendar",8,0,0,0,8
1216112,892454,2019-07-03,Assembly,"Do pass and be re-referred to the Committee on [Appropriations] with recommendation: To Consent Calendar",7,0,0,0,7
1216112,892455,2019-08-14,Assembly,"Do pass",18,0,0,0,18
1216112,892456,2019-09-10,Assembly,"SB 598 Moorlach Senate Third Reading By Obernolte",78,0,1,0,79
1216112,892457,2019-09-11,Senate,"Unfinished Business SB598 Moorlach et al. Concurrence",40,0,0,0,40
1216114,853049,2019-04-24,Assembly,"Do pass and be re-referred to the Committee on [Appropriations] with recommendation: To Consent Calendar",8,0,0,0,8
1216114,857081,2019-05-01,Assembly,"Do pass. To Consent Calendar",18,0,0,0,18
1216114,862166,2019-05-09,Assembly,"AB 1745 Kalra Consent Calendar Second Day Regular Session",76,0,4,0,80
1216114,878086,2019-06-04,Senate,"Do pass, but first be re-referred to the Committee on [Appropriations] with the recommendation: To Consent Calendar",10,0,1,0,11
1216114,887265,2019-06-24,Senate,"Do pass",7,0,0,0,7
1216114,892548,2019-09-03,Senate,"Assembly 3rd Reading AB1745 Kalra et al. By Beall",40,0,0,0,40
1216114,892549,2019-09-05,Assembly,"AB 1745 Kalra Concurrence in Senate Amendments",79,0,0,0,79
1216115,841311,2019-04-09,Assembly,"Do pass as amended and be re-referred to the Committee on [Privacy and Consumer Protection]",5,0,3,0,8
1216115,855979,2019-04-30,Assembly,"Do pass",9,0,2,0,11
1216115,862298,2019-05-09,Assembly,"AB 1638 Obernolte Assembly Third Reading",60,7,13,0,80
1216115,891745,2019-07-02,Senate,"Do pass as amended",4,0,3,0,7
1216115,891746,2019-08-15,Senate,"Assembly 3rd Reading AB1638 Obernolte By Wiener",32,4,4,0,40
1216115,891747,2019-08-19,Assembly,"AB 1638 Obernolte Concurrence in Senate Amendments",60,9,10,0,79
1216116,863659,2019-05-01,Assembly,"Do pass and be re-referred to the Committee on [Appropriations]",3,2,1,0,6
1216117,893257,2019-08-15,Assembly,"AB 1333 Dahle Third Reading Urgency By GRAY",76,0,3,0,79
1216117,893258,2019-08-26,Senate,"Assembly 3rd Reading AB1333 Dahle By Dahle Urgency Clause",39,0,1,0,40
1216119,860915,2019-05-06,Assembly,"Do pass and be re-referred to the Committee on [Appropriations]",9,0,2,0,11
1216119,866280,2019-05-16,Assembly,"Do pass",18,0,0,0,18
1216119,871728,2019-05-23,Assembly,"AB 1590 Blanca Rubio Assembly Third Reading",61,3,16,0,80
1216119,885005,2019-06-19,Senate,"Do pass as amended, but first amend, and re-refer to the Committee on [Appropriations]",5,0,2,0,7
1216119,891078,2019-07-08,Senate,"Placed on suspense file",7,0,0,0,7
1216119,891079,2019-08-30,Senate,"Do pass as amended",7,0,0,0,7
1216119,891080,2019-09-05,Senate,"Assembly 3rd Reading AB1590 Blanca Rubio By Galgiani",39,0,1,0,40
1216119,891081,2019-09-09,Assembly,"AB 1590 Blanca Rubio Concurrence in Senate Amendments",78,0,1,0,79
1216120,851606,2019-04-23,Assembly,"Do pass and be re-referred to the Committee on [Appropriations] with recommendation: To Consent Calendar",8,0,0,0,8
1216120,864887,2019-05-15,Assembly,"Do pass. To Consent Calendar",16,0,2,0,18
1216120,870016,2019-05-22,Assembly,"AB 1643 Eduardo Garcia Consent Calendar Second Day Regular Session",77,0,3,0,80
1216122,860864,2019-05-06,Assembly,"Do pass and be re-referred to the Committee on [Appropriations]",10,0,1,0,11
1216123,850898,2019-04-23,Assembly,"Do pass as amended and be re-referred to the Committee on [Appropriations]",5,2,1,0,8
1216123,905373,2020-01-23,Assembly,"Do pass as amended",11,5,2,0,18
1216123,912009,2020-01-30,Assembly,"AB 1608 Holden Assembly Third Reading",48,18,14,0,80
1216124,851751,2019-04-23,Assembly,"Do pass",18,0,2,0,20
1216124,854977,2019-04-29,Assembly,"AB 1565 Quirk Assembly Third Reading",75,0,5,0,80
1216124,876902,2019-06-03,Senate,"Do pass and be ordered to the Consent Calendar",9,0,0,0,9
1216124,879254,2019-06-06,Senate,"Consent Calendar AB1565",37,0,1,0,38
1216126,839695,2019-04-08,Assembly,"Do pass and be re-referred to the Committee on [Natural Resources]",13,0,2,0,15
1216128,851603,2019-04-23,Assembly,"Do pass and be re-referred to the Committee on [Appropriations] with recommendation: To Consent Calendar",15,0,0,0,15
1216128,861808,2019-05-08,Assembly,"Do pass. To Consent Calendar",18,0,0,0,18
1216128,865810,2019-05-16,Assembly,"AB 1352 Waldron Consent Calendar Second Day Regular Session",74,0,6,0,80
1216128,884561,2019-06-19,Senate,"Do pass, but first be re-referred to the Committee on [Appropriations]",9,0,0,0,9
1216128,892838,2019-09-04,Senate,"Assembly 3rd Reading AB1352 Waldron By Beall",40,0,0,0,40
1216128,892839,2019-09-09,Assembly,"AB 1352 Waldron Concurrence in Senate Amendments",79,0,0,0,79
1216129,839964,2019-04-08,Senate,"Do pass as amended, but first amend, and re-refer to the Committee on [Housing]",6,0,0,0,6
1216129,850098,2019-04-22,Senate,"Do pass, but first be re-referred to the Committee on [Appropriations]",10,1,0,0,11
1216129,859501,2019-05-06,Senate,"Placed on suspense file",5,0,1,0,6
1216129,865947,2019-05-16,Senate,"Do pass as amended",5,1,0,0,6
1216129,871178,2019-05-23,Senate,"Senate 3rd Reading SB687 Rubio",35,2,1,0,38
1216129,891173,2019-07-03,Assembly,"Do pass and be re-referred to the Committee on [Appropriations]",8,0,0,0,8
1216129,891174,2019-08-14,Assembly,"Do pass",15,0,3,0,18
1216129,891175,2019-09-04,Assembly,"Do pass",7,0,1,0,8
1216129,891176,2019-09-09,Assembly,"SB 687 Rubio Senate Third Reading By Luz Rivas",77,0,2,0,79
1216129,891177,2019-09-11,Senate,"That the Assembly amendments be concurred in",5,0,1,0,6
1216129,893797,2019-09-12,Senate,"Unfinished Business SB687 Rubio Concurrence",39,1,0,0,40
1216129,894134,2019-09-04,Assembly,Result,15,0,0,0,15
1216130,853041,2019-04-24,Assembly,"Do pass and be re-referred to the Committee on [Appropriations] with recommendation: To Consent Calendar",12,0,1,0,13
1216131,854869,2019-04-23,Assembly,"Do pass as amended and be re-referred to the Committee on [Appropriations]",12,7,1,0,20
1216131,865832,2019-05-16,Assembly,"Do pass as amended",10,7,1,0,18
1216133,841670,2019-04-09,Assembly,"Do pass and be re-referred to the Committee on [Appropriations]",12,0,0,0,12
1216133,865535,2019-05-16,Assembly,"Do pass",18,0,0,0,18
1216133,870134,2019-05-22,Assembly,"AB 1346 Medina Assembly Third Reading",77,0,3,0,80
1216133,889285,2019-07-01,Senate,"Do pass, but first be re-referred to the Committee on [Education]",8,0,1,0,9
1216133,893339,2019-07-10,Senate,"Do pass, but first be re-referred to the Committee on [Appropriations] with the recommendation: To Consent Calendar",7,0,0,0,7
1216133,893340,2019-08-12,Senate,"Placed on suspense file",7,0,0,0,7
1216133,893341,2019-08-30,Senate,"Do pass",7,0,0,0,7
1216133,893342,2019-09-11,Senate,"Assembly 3rd Reading AB1346 Medina et al. By Dodd",40,0,0,0,40
1216133,893759,2019-09-12,Assembly,"AB 1346 Medina Concurrence in Senate Amendments",79,0,0,0,79
1216136,851669,2019-04-24,Senate,"Do pass, but first be re-referred to the Committee on [Appropriations]",4,3,0,0,7
1216136,863044,2019-05-13,Senate,"Placed on suspense file",6,0,0,0,6
1216136,866158,2019-05-16,Senate,"Do pass as amended",4,2,0,0,6
1216137,851802,2019-04-23,Assembly,"Do pass and be re-referred to the Committee on [Appropriations]",14,0,1,0,15
1216138,856046,2019-04-30,Assembly,"Do pass as amended",11,0,1,0,12
1216138,862129,2019-05-09,Assembly,"AB 1380 Obernolte Assembly Third Reading",77,0,3,0,80
1216138,884849,2019-06-18,Senate,"Do pass",9,0,0,0,9
1216138,894026,2019-07-11,Senate,"Special Consent AB1380",39,0,1,0,40
1216138,894027,2019-08-12,Assembly,"AB 1380 Obernolte Concurrence in Senate Amendments",78,0,1,0,79
1216141,835357,2019-04-03,Assembly,"Do pass and be re-referred to the Committee on [Appropriations]",14,0,0,0,14
1216142,841520,2019-04-09,Assembly,"Do pass as amended, and be re-referred to the Committee on [Appropriations] with recommendation: To Consent Calendar",15,0,0,0,15
1216142,866752,2019-05-16,Assembly,"Do pass as amended",18,0,0,0,18
1216142,874707,2019-05-29,Assembly,"AB 1705 Bonta Assembly Third Reading",78,0,2,0,80
1216142,891813,2019-07-10,Senate,"Do pass, but first be re-referred to the Committee on [Appropriations]",8,0,1,0,9
1216142,891814,2019-08-12,Senate,"Placed on suspense file",7,0,0,0,7
1216142,891815,2019-08-30,Senate,"Do pass as amended",6,0,1,0,7
1216142,891816,2019-09-10,Senate,"Assembly 3rd Reading AB1705 Bonta By Pan",40,0,0,0,40
1216142,891817,2019-09-11,Assembly,"AB 1705 Bonta Concurrence in Senate Amendments",79,0,0,0,79
1216145,842752,2019-04-10,Senate,"Do pass, but first be re-referred to the Committee on [Appropriations]",7,0,2,0,9
1216145,854935,2019-04-29,Senate,"Placed on suspense file",6,0,0,0,6
1216147,857199,2019-05-01,Assembly,"Do pass",6,0,1,0,7
1216147,862257,2019-05-09,Assembly,"AB 1707 Berman Assembly Third Reading",66,2,12,0,80
1216147,883975,2019-06-18,Senate,"Do pass",4,1,0,0,5
1216147,892427,2019-09-11,Senate,"Assembly 3rd Reading AB1707 Berman By McGuire",36,3,1,0,40
1216149,841718,2019-04-09,Senate,"Do pass, but first be re-referred to the Committee on [Appropriations]",7,0,1,0,8
1216149,874438,2019-05-29,Senate,"Senate 3rd Reading SB616 Wieckowski et al",26,9,3,0,38
1216149,887691,2019-06-25,Assembly,"Do pass and be re-referred to the Committee on [Appropriations]",9,3,0,0,12
1216149,890445,2019-08-21,Assembly,"Do pass",11,5,2,0,18
1216149,890446,2019-09-06,Assembly,"SB 616 Wieckowski Senate Third Reading By Luz Rivas Amendment Set #1",53,16,10,0,79
1216149,890447,2019-09-10,Assembly,"SB 616 Wieckowski Senate Third Reading By Luz Rivas",48,23,8,0,79
1216149,890448,2019-09-11,Senate,"Unfinished Business SB616 Wieckowski et al. Concurrence",28,12,0,0,40
1216151,902811,2020-01-14,Assembly,"Do pass and be re-referred to the Committee on [Appropriations]",8,2,1,0,11
1216152,838888,2019-04-02,Senate,"Do pass as amended, but first amend, and re-refer to the Committee on [Veterans Affairs]",7,0,1,0,8
1216152,852032,2019-04-23,Senate,"Do pass",6,0,1,0,7
1216152,873760,2019-05-28,Senate,"Senate 3rd Reading SB644 Glazer et al",38,0,0,0,38
1216152,883935,2019-06-18,Assembly,"Do pass and be re-referred to the Committee on [Veterans Affairs]",12,0,0,0,12
1216152,891422,2019-07-09,Assembly,"Do pass",10,0,1,0,11
1216152,891423,2019-09-10,Assembly,"SB 644 Glazer Senate Third Reading By Bauer-Kahan",78,0,1,0,79
1216152,893555,2019-09-12,Senate,"Unfinished Business SB644 Glazer et al. Concurrence",40,0,0,0,40
1216154,855974,2019-04-30,Assembly,"Do pass as amended",7,3,2,0,12
1216161,849999,2019-04-23,Assembly,"Do pass and be re-referred to the Committee on [Appropriations] with recommendation: To Consent Calendar",7,0,0,0,7
1216161,866494,2019-05-16,Assembly,"Do pass",18,0,0,0,18
1216161,870972,2019-05-23,Assembly,"AB 1696 Chau Assembly Third Reading",78,0,2,0,80
1216161,891088,2019-07-08,Senate,"Do pass, but first be re-referred to the Committee on [Appropriations]",9,0,0,0,9
1216161,891089,2019-08-12,Senate,"Placed on suspense file",7,0,0,0,7
1216168,853165,2019-04-24,Assembly,"Do pass and be re-referred to the Committee on [Appropriations]",8,0,0,0,8
1216168,865847,2019-05-16,Assembly,"Do pass",18,0,0,0,18
1216168,871498,2019-05-23,Assembly,"AB 1702 Luz Rivas Assembly Third Reading",78,0,2,0,80
1216168,887524,2019-06-24,Senate,"Do pass, but first be re-referred to the Committee on [Housing]",6,0,0,0,6
1216168,891371,2019-07-02,Senate,"Do pass, but first be re-referred to the Committee on [Appropriations]",9,1,1,0,11
1216168,891372,2019-08-12,Senate,"Placed on suspense file",7,0,0,0,7
1216168,891373,2019-08-30,Senate,"Do pass as amended",7,0,0,0,7
1216168,891374,2019-09-10,Senate,"Assembly 3rd Reading AB1702 Luz Rivas et al. By Mitchell",40,0,0,0,40
1216168,891375,2019-09-11,Assembly,"AB 1702 Luz Rivas Concurrence in Senate Amendments",79,0,0,0,79
1216168,894508,2019-08-30,Senate,Date,7,0,0,0,7
1216170,851515,2019-04-23,Assembly,"Do pass as amended and be re-referred to the Committee on [Appropriations]",11,3,1,0,15
1216170,866037,2019-05-16,Assembly,"Do pass as amended",13,4,1,0,18
1216170,874435,2019-05-29,Assembly,"AB 1695 Carrillo Assembly Third Reading",57,17,6,0,80
1216170,893259,2019-07-10,Senate,"Do pass as amended, but first amend, and re-refer to the Committee on [Appropriations]",8,0,1,0,9
1216170,893260,2019-08-12,Senate,"Placed on suspense file",7,0,0,0,7
1216170,893261,2019-08-30,Senate,"Do pass",5,2,0,0,7
1216170,893262,2019-09-10,Senate,"Assembly 3rd Reading AB1695 Carrillo By Pan",32,8,0,0,40
1216170,893263,2019-09-11,Assembly,"AB 1695 Carrillo Concurrence in Senate Amendments",57,17,5,0,79
1216171,853373,2019-04-22,Assembly,"Do pass as amended and be re-referred to the Committee on [Appropriations]",9,0,2,0,11
1216171,866800,2019-05-16,Assembly,"Do pass",13,0,5,0,18
1216171,874408,2019-05-29,Assembly,"AB 1694 O'Donnell Assembly Third Reading",66,0,14,0,80
1216171,893456,2019-07-09,Senate,"Do pass as amended, but first amend, and re-refer to the Committee on [Appropriations]",7,1,1,0,9
1216171,893457,2019-08-12,Senate,"Placed on suspense file",7,0,0,0,7
1216173,851661,2019-04-23,Assembly,"Do pass and be re-referred to the Committee on [Appropriations]",11,0,1,0,12
1216173,865950,2019-05-16,Assembly,"Do pass",18,0,0,0,18
1216173,874591,2019-05-29,Assembly,"AB 1703 Bloom Assembly Third Reading",78,0,2,0,80
1216174,843192,2019-04-10,Assembly,"Do pass",8,0,0,0,8
1216174,858651,2019-05-02,Assembly,"AB 1743 Bloom Assembly Third Reading",77,0,3,0,80
1216174,893378,2019-07-03,Senate,"Do pass",7,0,0,0,7
1216174,893379,2019-09-04,Senate,"That the measure be returned to Senate Floor for consideration. Ordered to third reading",5,0,2,0,7
1216174,893380,2019-09-11,Senate,"Assembly 3rd Reading AB1743 Bloom By Beall",40,0,0,0,40
1216174,893751,2019-09-12,Assembly,"AB 1743 Bloom Concurrence in Senate Amendments",79,0,0,0,79
1216178,852865,2019-04-24,Assembly,"Do pass and be re-referred to the Committee on [Privacy and Consumer Protection]",12,0,1,0,13
1216178,855980,2019-04-30,Assembly,"Do pass",11,0,0,0,11
1216178,862142,2019-05-09,Assembly,"AB 1699 Levine Assembly Third Reading",75,0,5,0,80
1216178,891856,2019-07-10,Senate,"Do pass as amended",11,0,2,0,13
1216178,891857,2019-09-09,Senate,"Assembly 3rd Reading AB1699 Levine By Jackson",40,0,0,0,40
1216178,891858,2019-09-10,Assembly,"AB 1699 Levine Concurrence in Senate Amendments",79,0,0,0,79
1216180,853274,2019-04-24,Senate,"Do pass, but first be re-referred to the Committee on [Appropriations]",8,0,1,0,9
1216180,871231,2019-05-23,Senate,"Senate 3rd Reading SB758 Portantino",38,0,0,0,38
1216180,975014,2020-08-04,Assembly,"Do pass as amended and be re-referred to the Committee on [Appropriations]",12,0,3,0,15
1216180,976432,2020-08-20,Assembly,"Do pass as amended",17,1,0,0,18
1216181,854815,2019-04-29,Assembly,"Do pass",24,0,7,0,31
1216181,874311,2019-05-28,Assembly,"AB 1714 Blanca Rubio Assembly Third Reading",71,0,9,0,80
1216184,818973,2019-03-11,Assembly,"Be adopted. To Consent Calendar",9,0,3,0,12
1216184,822416,2019-03-14,Assembly,"ACR 42 Reyes Consent Calendar Second Day Regular Session",72,0,8,0,80
1216184,836780,2019-04-04,Senate,"Special Consent ACR42",37,0,1,0,38
1221874,854683,2019-04-29,Assembly,"Be adopted",27,0,4,0,31
1221874,859450,2019-05-06,Assembly,"ACA 11 Obernolte Assembly Third Reading",76,0,4,0,80
1221874,890354,2019-08-14,Senate,"Be adopted, but first be re-referred to the Committee on [Elections and Constitutional Amendments]",18,0,0,0,18
1221874,968312,2020-06-23,Senate,"Be adopted, but first be re-referred to the Committee on [Appropriations]",4,1,0,0,5
1221874,968698,2020-06-24,Senate,"Be adopted",5,2,0,0,7
1221874,969392,2020-06-26,Assembly,"ACA 11 Mullin Concurrence in Senate Amendments",56,5,18,0,79
1221874,969707,2020-06-25,Senate,"Assembly 3rd Reading ACA11 Mullin et al. By Galgiani",29,5,6,0,40
1221908,822482,2019-03-14,Senate,"Senate 3rd Reading SR23 Portantino et al",36,0,2,0,38
1221943,887508,2019-06-24,Assembly,"Be adopted. To third reading",7,1,3,0,11
1221943,892763,2019-07-08,Assembly,"AJR 10 Reyes Assembly Third Reading",64,1,14,0,79
1221943,892764,2019-08-21,Senate,"Be adopted. Ordered to third reading",5,0,2,0,7
1221943,892765,2019-09-04,Senate,"Assembly 3rd Reading AJR10 Reyes et al. By Allen",31,3,6,0,40
1221943,892766,2019-09-09,Assembly,"AJR 10 Reyes Concurrence in Senate Amendments",64,5,10,0,79
1221977,841843,2019-04-10,Senate,"Do pass, but first be re-referred to the Committee on [Appropriations] with the recommendation: To Consent Calendar",4,0,1,0,5
1221977,858238,2019-05-02,Senate,"Consent Calendar SB778 L., P.E. & R. (Hill) Urgency Clause",38,0,0,0,38
1221977,881016,2019-06-12,Assembly,"Do pass and be re-referred to the Committee on [Appropriations] with recommendation: To Consent Calendar",7,0,0,0,7
1221977,888121,2019-06-26,Assembly,"Do pass. To Consent Calendar",15,0,3,0,18
1221977,891100,2019-08-15,Assembly,"SB 778 L., P.E. & R. Third Reading Urgency By KALRA",76,0,3,0,79
1223526,853154,2019-04-23,Senate,"Do pass as amended, but first amend, and re-refer to the Committee on [Appropriations] with the recommendation: To Consent Calendar",9,0,0,0,9
1223526,865898,2019-05-16,Senate,"Consent Calendar SB779 N.R. & W",37,0,1,0,38
1223526,892748,2019-07-02,Assembly,"Do pass and be re-referred to the Committee on [Appropriations]",14,0,0,0,14
1223526,892749,2019-08-14,Assembly,"Do pass",18,0,0,0,18
1223526,892750,2019-08-22,Assembly,"SB 779 N.R. & W. Senate Third Reading By GARCIA, E",75,0,4,0,79
1223562,842363,2019-04-10,Assembly,"Do pass and be re-referred to the Committee on [Appropriations] with recommendation: To Consent Calendar",11,0,0,0,11
1223562,866085,2019-05-16,Assembly,"Do pass",16,1,1,0,18
1223562,871298,2019-05-23,Assembly,"AB 1801 AGRI. Assembly Third Reading By EGGMAN",76,2,2,0,80
1223562,893134,2019-07-02,Senate,"Do pass, but first be re-referred to the Committee on [Appropriations] with the recommendation: To Consent Calendar",5,0,0,0,5
1223562,893135,2019-08-12,Senate,"Do pass",7,0,0,0,7
1223562,893136,2019-09-03,Senate,"Assembly 3rd Reading AB1801 AGRI. (Eggman) By Dahle",40,0,0,0,40
1223562,893137,2019-09-05,Assembly,"AB 1801 AGRI. Concurrence in Senate Amendments By EGGMAN",77,0,2,0,79
1223599,816662,2019-03-07,Assembly,"Be adopted. To Consent Calendar",10,0,2,0,12
1223599,822453,2019-03-14,Assembly,"ACR 43 Bonta Consent Calendar Second Day Regular Session",72,0,8,0,80
1223599,836890,2019-04-04,Senate,"Special Consent ACR43",37,0,1,0,38
1223636,853082,2019-04-24,Senate,"Be adopted, but first be re-referred to the Committee on [Elections and Constitutional Amendments]",4,3,0,0,7
1223636,860814,2019-05-07,Senate,"Be adopted, but first be re-referred to the Committee on [Appropriations]",4,1,0,0,5
1223636,863199,2019-05-13,Senate,"Placed on suspense file",6,0,0,0,6
1223636,865962,2019-05-16,Senate,"Be adopted",4,2,0,0,6
1223672,841888,2019-04-10,Assembly,"Do pass and be re-referred to the Committee on [Appropriations] with recommendation: To Consent Calendar",11,0,0,0,11
1223672,852375,2019-04-24,Assembly,"Do pass. To Consent Calendar",18,0,0,0,18
1223672,858097,2019-05-02,Assembly,"AB 1800 AGRI. Consent Calendar Second Day Regular Session",76,0,4,0,80
1223672,894046,2019-07-02,Senate,"Do pass, but first be re-referred to the Committee on [Appropriations] with the recommendation: To Consent Calendar",5,0,0,0,5
1223672,894047,2019-08-15,Senate,"Consent Calendar AB1800 AGRI",37,0,3,0,40
1223709,851266,2019-04-23,Senate,"Be adopted, but first be re-referred to the Committee on [Appropriations] with recommendation: To Consent Calendar",12,0,0,0,12
1223709,862309,2019-05-09,Senate,"Consent Calendar SCR21",38,0,0,0,38
1223709,889216,2019-07-01,Assembly,"Be adopted, and re-refer to the Committee on [Appropriations] with recommendation: To Consent Calendar",15,0,0,0,15
1223709,894029,2019-08-14,Assembly,"Be adopted. To third reading",18,0,0,0,18
1223709,894030,2019-08-22,Assembly,"SCR 21 Bates Senate Third Reading By Brough",76,0,3,0,79
1223709,894031,2019-08-26,Senate,"Unfinished Business SCR21 Bates et al. Concurrence",39,0,1,0,40
1227211,853269,2019-04-23,Assembly,"Do pass as amended, and be re-referred to the Committee on [Appropriations] with recommendation: To Consent Calendar",7,0,0,0,7
1227222,833205,2019-03-26,Senate,"Be adopted as amended",7,0,1,0,8
1227222,836758,2019-04-04,Senate,"Senate 3rd Reading SJR2 Umberg et al",28,7,3,0,38
1227222,860905,2019-05-07,Assembly,"Be adopted. To third reading",9,3,0,0,12
1227222,863308,2019-05-13,Assembly,"SJR 2 Umberg Senate Third Reading By Eggman",56,13,11,0,80
1227237,851783,2019-04-23,Assembly,"Do pass and be re-referred to the Committee on [Appropriations] with recommendation: To Consent Calendar",15,0,0,0,15
1227237,856805,2019-05-01,Assembly,"Do pass. To Consent Calendar",18,0,0,0,18
1227237,862266,2019-05-09,Assembly,"AB 1803 HEALTH Consent Calendar Second Day Regular Session",76,0,4,0,80
1227237,881325,2019-06-12,Senate,"Do pass, but first be re-referred to the Committee on [Appropriations] with the recommendation: To Consent Calendar",9,0,0,0,9
1227237,889225,2019-07-01,Senate,"Consent Calendar AB1803 HEALTH (Wood) Urgency Clause",39,0,1,0,40
1227250,833803,2019-04-01,Assembly,"Be adopted. To Consent Calendar",15,0,0,0,15
1227250,836543,2019-04-04,Assembly,"ACR 44 Gallagher Consent Calendar Second Day Regular Session",75,0,5,0,80
1227250,880339,2019-06-11,Senate,"Be adopted, but first be re-referred to the Committee on [Appropriations] with recommendation: To Consent Calendar",10,0,2,0,12
1227250,889265,2019-07-01,Senate,"Consent Calendar ACR44",39,0,1,0,40
1227265,837001,2019-04-03,Assembly,"Do pass and be re-referred to the Committee on [Appropriations] with recommendation: To Consent Calendar",6,0,1,0,7
1227265,852083,2019-04-24,Assembly,"Do pass. To Consent Calendar",18,0,0,0,18
1227265,857899,2019-05-02,Assembly,"AB 1804 L. & E. Consent Calendar Second Day Regular Session",76,0,4,0,80
1227265,881015,2019-06-12,Senate,"Do pass as amended, but first amend, and re-refer to the Committee on [Appropriations]",5,0,0,0,5
1227265,889291,2019-07-01,Senate,"Assembly 3rd Reading AB1804 L. & E. (Kalra) By Hill",39,0,1,0,40
1227265,893012,2019-08-12,Assembly,"AB 1804 L. & E. Concurrence in Senate Amendments By KALRA",75,0,4,0,79
1227278,853403,2019-04-24,Assembly,"Do pass as amended and be re-referred to the Committee on [Appropriations]",7,0,0,0,7
1227278,861675,2019-05-08,Assembly,"Do pass",14,4,0,0,18
1227278,865905,2019-05-16,Assembly,"AB 1805 L. & E. Assembly Third Reading By KALRA",62,11,7,0,80
1227278,885462,2019-06-19,Senate,"Do pass, but first be re-referred to the Committee on [Appropriations]",4,1,0,0,5
1227278,892475,2019-08-12,Senate,"Assembly 3rd Reading AB1805 L. & E. (Kalra) By Hill",30,9,1,0,40
1227291,836628,2019-04-02,Assembly,"Do pass as amended and be re-referred to the Committee on [Accountability and Administrative Review]",7,0,0,0,7
1227291,851571,2019-04-24,Assembly,"Do pass and be re-referred to the Committee on [Appropriations] with recommendation: To Consent Calendar",7,0,0,0,7
1227291,865831,2019-05-16,Assembly,"Do pass as amended",18,0,0,0,18
1227291,872115,2019-05-24,Assembly,"AB 1808 J., E.D. & E. Assembly Third Reading By CERVANTES",77,0,3,0,80
1227304,850905,2019-04-23,Assembly,"Do pass and be re-referred to the Committee on [Appropriations] with recommendation: To Consent Calendar",7,0,0,0,7
1227319,853115,2019-04-24,Senate,"Do pass, but first be re-referred to the Committee on [Appropriations] with the recommendation: To Consent Calendar",7,0,0,0,7
1227319,865582,2019-05-16,Senate,"Consent Calendar SB780 GOV. & F",37,0,1,0,38
1227319,893366,2019-07-10,Assembly,"Do pass and be re-referred to the Committee on [Appropriations] with recommendation: To Consent Calendar",8,0,0,0,8
1227319,893367,2019-08-21,Assembly,"Do pass. To Consent Calendar",17,0,1,0,18
1227319,893368,2019-08-30,Assembly,"SB 780 GOV.& F. Consent Calendar Second Day Regular Session",67,0,12,0,79
1227319,893369,2019-09-04,Senate,"Unfinished Business SB780 GOV. & F. (McGuire) Concurrence",40,0,0,0,40
1227332,836873,2019-04-02,Assembly,"Do pass as amended and be re-referred to the Committee on [Accountability and Administrative Review]",7,0,0,0,7
1227332,851850,2019-04-24,Assembly,"Do pass and be re-referred to the Committee on [Appropriations]",7,0,0,0,7
1227332,866400,2019-05-16,Assembly,"Do pass",18,0,0,0,18
1227332,871352,2019-05-23,Assembly,"AB 1809 J., E.D. & E. Assembly Third Reading By CERVANTES",78,0,2,0,80
1227332,887756,2019-06-25,Senate,"Do pass, but first be re-referred to the Committee on [Veterans Affairs]",16,0,0,0,16
1227332,893757,2019-07-09,Senate,"Do pass, but first be re-referred to the Committee on [Appropriations]",6,0,1,0,7
1227332,893758,2019-08-19,Senate,"Placed on suspense file",5,0,2,0,7
1227347,851659,2019-04-23,Assembly,"Do pass and be re-referred to the Committee on [Appropriations] with recommendation: To Consent Calendar",15,0,0,0,15
1227347,861409,2019-05-08,Assembly,"Do pass. To Consent Calendar",18,0,0,0,18
1227347,866174,2019-05-16,Assembly,"AB 1802 HEALTH Consent Calendar Second Day Regular Session",74,0,6,0,80
1227347,881097,2019-06-12,Senate,"Do pass, but first be re-referred to the Committee on [Appropriations] with the recommendation: To Consent Calendar",9,0,0,0,9
1227347,889266,2019-07-01,Senate,"Consent Calendar AB1802 HEALTH",39,0,1,0,40
1229633,816392,2019-03-07,Assembly,"Be adopted. To Consent Calendar",10,0,2,0,12
1229633,822308,2019-03-14,Assembly,"HR 17 Reyes Consent Calendar Second Day Regular Session",72,0,8,0,80
1229649,851763,2019-04-24,Senate,"Be adopted. Ordered to third reading",4,0,1,0,5
1229649,860342,2019-05-06,Senate,"Senate 3rd Reading SJR3 Wilk et al",38,0,0,0,38
1229649,888107,2019-06-26,Assembly,"Be adopted. To third reading",7,0,0,0,7
1229649,893120,2019-08-12,Assembly,"SJR 3 Wilk Senate Third Reading By O'Donnell",73,0,6,0,79
1229662,825960,2019-03-20,Senate,"Be adopted. Ordered to third reading",7,1,1,0,9
1229662,831345,2019-03-28,Senate,"Senate 3rd Reading SJR4 Leyva et al",26,9,3,0,38
1229662,880778,2019-06-11,Assembly,"Be adopted. To third reading",11,2,2,0,15
1229662,889217,2019-07-01,Assembly,"SJR 4 Leyva Senate Third Reading By Petrie-Norris",59,14,6,0,79
1229675,840019,2019-04-08,Assembly,"Do pass and be re-referred to the Committee on [Accountability and Administrative Review] with recommendation: To Consent Calendar",15,0,0,0,15
1229675,851723,2019-04-24,Assembly,"Do pass and be re-referred to the Committee on [Appropriations] with recommendation: To Consent Calendar",7,0,0,0,7
1229675,861573,2019-05-08,Assembly,"Do pass. To Consent Calendar",18,0,0,0,18
1229675,866147,2019-05-16,Assembly,"AB 1810 TRANS. Consent Calendar Second Day Regular Session",74,0,6,0,80
1229675,887634,2019-06-25,Senate,"Do pass, but first be re-referred to the Committee on [Governmental Organization] with the recommendation: To Consent Calendar",13,0,0,0,13
1229675,890941,2019-07-09,Senate,"Do pass, but first be re-referred to the Committee on [Appropriations] with the recommendation: To Consent Calendar",15,0,1,0,16
1229675,890942,2019-08-19,Senate,"Placed on suspense file",5,0,2,0,7
1229675,890943,2019-08-30,Senate,"Do pass",7,0,0,0,7
1229675,890944,2019-09-10,Senate,"That the measure be returned to Senate Floor for consideration. Ordered to third reading",10,0,3,0,13
1229675,890945,2019-09-11,Senate,"Assembly 3rd Reading AB1810 TRANS. (Frazier) By Beall",40,0,0,0,40
1229675,893656,2019-09-12,Assembly,"AB 1810 TRANS. Concurrence in Senate Amendments By FRAZIER",79,0,0,0,79
1229688,819013,2019-03-11,Assembly,"Be adopted. To third reading",9,0,3,0,12
1229688,836765,2019-04-04,Senate,"Special Consent ACR45",37,0,1,0,38
1230838,852370,2019-04-24,Assembly,"Do pass. To Consent Calendar",14,0,0,0,14
1230838,858308,2019-05-02,Assembly,"AB 1814 INS. Consent Calendar Second Day Regular Session",76,0,4,0,80
1230838,881407,2019-06-12,Senate,"Do pass and be ordered to the Consent Calendar",13,0,0,0,13
1230849,826803,2019-03-21,Senate,"Senate 3rd Reading SCR22 Chang",36,0,2,0,38
1230849,838799,2019-04-08,Assembly,"Be adopted. To Consent Calendar",11,0,1,0,12
1230849,842826,2019-04-11,Assembly,"SCR 22 Chang Consent Calendar Second Day Regular Session",72,0,8,0,80
1230860,832046,2019-03-28,Assembly,"Be adopted. To third reading",10,0,2,0,12
1230869,852694,2019-04-24,Assembly,"Do pass and be re-referred to the Committee on [Appropriations] with recommendation: To Consent Calendar",14,0,0,0,14
1230869,862032,2019-05-08,Assembly,"Do pass. To Consent Calendar",18,0,0,0,18
1230869,865932,2019-05-16,Assembly,"AB 1815 INS. Consent Calendar Second Day Regular Session",74,0,6,0,80
1230891,851417,2019-04-23,Senate,"Do pass, but first be re-referred to the Committee on [Appropriations] with the recommendation: To Consent Calendar",7,0,0,0,7
1230891,862187,2019-05-09,Senate,"Consent Calendar SB781 PUB. S",38,0,0,0,38
1230891,887441,2019-06-25,Assembly,"Do pass as amended, and be re-referred to the Committee on [Appropriations] with recommendation: To Consent Calendar",8,0,0,0,8
1230891,893647,2019-07-10,Assembly,"Do pass. To Consent Calendar",16,0,2,0,18
1230891,893648,2019-08-15,Assembly,"SB 781 PUB. S. Consent Calendar Second Day Regular Session",76,0,3,0,79
1230891,893649,2019-08-22,Senate,"Special Consent SB781 PUB. S",39,0,1,0,40
1230900,851524,2019-04-24,Assembly,"Do pass and be re-referred to the Committee on [Appropriations] with recommendation: To Consent Calendar",14,0,0,0,14
1230900,861549,2019-05-08,Assembly,"Do pass. To Consent Calendar",18,0,0,0,18
1230900,866157,2019-05-16,Assembly,"AB 1813 INS. Consent Calendar Second Day Regular Session",74,0,6,0,80
1230900,880959,2019-06-12,Senate,"Do pass as amended, but first amend, and re-refer to the Committee on [Judiciary] with the recommendation: To Consent Calendar",13,0,0,0,13
1230900,891807,2019-07-02,Senate,"Do pass, but first be re-referred to the Committee on [Appropriations] with the recommendation: To Consent Calendar",9,0,0,0,9
1230900,891808,2019-08-15,Senate,"Consent Calendar AB1813 INS",37,0,3,0,40
1230900,891809,2019-08-19,Assembly,"AB 1813 INS. Concurrence in Senate Amendments By DALY",77,0,2,0,79
1230900,896051,2019-08-15,Senate,"Consent Calendar AB1813Label"">Noes",9,0,0,0,9
1230911,852412,2019-04-24,Assembly,"Do pass and be re-referred to the Committee on [Appropriations] with recommendation: To Consent Calendar",14,0,0,0,14
1230911,856957,2019-05-01,Assembly,"Do pass. To Consent Calendar",18,0,0,0,18
1230911,862139,2019-05-09,Assembly,"AB 1816 INS. Consent Calendar Second Day Regular Session",76,0,4,0,80
1230911,888254,2019-06-26,Senate,"Do pass as amended",13,0,0,0,13
1230911,891401,2019-08-21,Senate,"That the measure be returned to Senate Floor for consideration. Ordered to third reading",13,0,0,0,13
1230911,891402,2019-09-09,Senate,"Assembly 3rd Reading AB1816 Daly et al. By Rubio Urgency Clause",40,0,0,0,40
1230911,891403,2019-09-11,Assembly,"With recommendation: That Senate amendments be concurred in",11,0,3,0,14
1230911,893554,2019-09-12,Assembly,"AB 1816 Daly Concurrence - Urgency Added",79,0,0,0,79
1230921,852673,2019-04-24,Assembly,"Do pass and be re-referred to the Committee on [Appropriations] with recommendation: To Consent Calendar",14,0,0,0,14
1230921,857014,2019-05-01,Assembly,"Do pass. To Consent Calendar",18,0,0,0,18
1230921,862122,2019-05-09,Assembly,"AB 1812 INS. Consent Calendar Second Day Regular Session",76,0,4,0,80
1230930,818670,2019-03-11,Assembly,"Be adopted. To third reading",9,0,3,0,12
1230930,836861,2019-04-04,Senate,"Special Consent ACR46",37,0,1,0,38
1232532,850614,2019-04-22,Assembly,"Be adopted. To Consent Calendar",15,0,0,0,15
1232532,852680,2019-04-25,Assembly,"ACR 47 Bigelow Consent Calendar Second Day Regular Session",76,0,4,0,80
1232532,880850,2019-06-11,Senate,"Be adopted, but first be re-referred to the Committee on [Appropriations] with recommendation: To Consent Calendar",10,0,2,0,12
1232532,894222,2019-07-01,Senate,"Special Consent ACR47",38,0,2,0,40
1232537,839785,2019-04-09,Assembly,"Do pass. To Consent Calendar",12,0,0,0,12
1232537,849019,2019-04-22,Assembly,"AB 1817 JUD. Consent Calendar Second Day Regular Session",78,0,2,0,80
1232537,877638,2019-06-04,Senate,"Do pass and be ordered to the Consent Calendar",9,0,0,0,9
1232537,888426,2019-06-27,Senate,"Assembly 3rd Reading AB1817 JUD. (Stone) By Jackson",36,0,4,0,40
1232537,889302,2019-07-01,Assembly,"AB 1817 JUD. Concurrence in Senate Amendments By STONE",78,0,1,0,79
1232543,856612,2019-04-30,Assembly,"Do pass. To Consent Calendar",12,0,0,0,12
1232543,859469,2019-05-06,Assembly,"AB 1820 JUD. Consent Calendar Second Day Regular Session",77,0,3,0,80
1232543,880901,2019-06-11,Senate,"Do pass, but first be re-referred to the Committee on [Appropriations] with the recommendation: To Consent Calendar",9,0,0,0,9
1232543,889269,2019-07-01,Senate,"Consent Calendar AB1820 JUD",39,0,1,0,40
1232543,890642,2019-08-26,Senate,"Assembly 3rd Reading AB1820 JUD. (Stone) By Jackson",39,0,1,0,40
1232543,890643,2019-09-11,Assembly,"With recommendation: That Senate amendments be concurred in",11,0,1,0,12
1232543,893668,2019-09-12,Assembly,"AB 1820 JUD. Concurrence in Senate Amendments By STONE",79,0,0,0,79
1232550,841650,2019-04-09,Assembly,"Do pass as amended and be re-referred to the Committee on [Appropriations]",12,0,0,0,12
1232550,851435,2019-04-24,Assembly,"Do pass",18,0,0,0,18
1232550,860349,2019-05-06,Assembly,"AB 1819 JUD. Assembly Third Reading By STONE",77,0,3,0,80
1232550,891919,2019-07-02,Senate,"Do pass, but first be re-referred to the Committee on [Appropriations] with the recommendation: To Consent Calendar",9,0,0,0,9
1232550,891920,2019-08-12,Senate,"Placed on suspense file",7,0,0,0,7
1232550,891921,2019-08-30,Senate,"Do pass as amended",7,0,0,0,7
1232550,891922,2019-09-05,Senate,"Assembly 3rd Reading AB1819 JUD. (Stone) By Borgeas",40,0,0,0,40
1232550,891923,2019-09-10,Assembly,"AB 1819 JUD. Concurrence in Senate Amendments By STONE",79,0,0,0,79
1232550,894330,2019-08-12,Senate,Result,9,0,0,0,9
1232554,840501,2019-04-09,Assembly,"Do pass. To Consent Calendar",12,0,0,0,12
1232554,849413,2019-04-22,Assembly,"AB 1818 JUD. Consent Calendar Second Day Regular Session",78,0,2,0,80
1232554,893407,2019-07-02,Senate,"Do pass as amended, but first amend, and re-refer to the Committee on [Appropriations] with the recommendation: To Consent Calendar",9,0,0,0,9
1232554,893408,2019-08-26,Senate,"Assembly 3rd Reading AB1818 JUD. (Stone) By Jackson",39,0,1,0,40
1232554,893409,2019-08-30,Assembly,"AB 1818 JUD. Concurrence in Senate Amendments By STONE",74,0,5,0,79
1232561,840912,2019-04-09,Assembly,"Do pass",9,3,0,0,12
1232561,853423,2019-04-25,Assembly,"AB 1821 JUD. Assembly Third Reading By STONE",59,17,4,0,80
1232561,880436,2019-06-11,Senate,"Do pass",7,2,0,0,9
1232561,893893,2019-07-01,Senate,"Assembly 3rd Reading AB1821 JUD. (Stone) By Stern",29,10,1,0,40
1232566,826788,2019-03-21,Senate,"Senate 3rd Reading SR25 Caballero et al",36,0,2,0,38
1232570,831285,2019-03-28,Senate,"Senate 3rd Reading SR24 Durazo et al",36,0,2,0,38
1234390,852561,2019-04-24,Senate,"Do pass",5,0,0,0,5
1234390,858190,2019-05-02,Senate,"Senate 3rd Reading SB783 L., P.E. & R. (Hill)",38,0,0,0,38
1234422,822400,2019-03-14,Assembly,"Be adopted. To Consent Calendar",11,0,1,0,12
1234422,826835,2019-03-21,Assembly,"ACR 48 Reyes Consent Calendar Second Day Regular Session",72,0,8,0,80
1234422,849613,2019-04-22,Senate,"Special Consent ACR48",38,0,0,0,38
1234459,851344,2019-04-24,Senate,"Do pass, but first be re-referred to the Committee on [Appropriations] with the recommendation: To Consent Calendar",5,0,0,0,5
1234459,862206,2019-05-09,Senate,"Consent Calendar SB782 L., P.E. & R",38,0,0,0,38
1234459,888077,2019-06-26,Assembly,"Do pass and be re-referred to the Committee on [Appropriations] with recommendation: To Consent Calendar",7,0,0,0,7
1234459,890791,2019-08-14,Assembly,"Do pass",18,0,0,0,18
1234459,890792,2019-09-03,Assembly,"SB 782 L., P.E. & R. Senate Third Reading By RODRIGUEZ",77,0,2,0,79
1234459,890793,2019-09-04,Senate,"Unfinished Business SB782 L., P.E. & R. (Hill) Concurrence",40,0,0,0,40
1234493,841715,2019-04-09,Senate,"Be adopted. Ordered to third reading",9,3,0,0,12
1234493,849149,2019-04-22,Senate,"Senate 3rd Reading SJR5 Beall et al",28,10,0,0,38
1234493,894016,2019-07-01,Assembly,"Be adopted. To third reading",11,4,0,0,15
1234493,894017,2019-08-26,Assembly,"SJR 5 Beall Senate Third Reading By Frazier",49,24,6,0,79
1234493,894018,2019-09-03,Senate,"Unfinished Business SJR5 Beall et al. Concurrence",28,11,1,0,40
1234525,822256,2019-03-14,Assembly,"Be adopted. To third reading",11,0,1,0,12
1234554,856949,2019-05-01,Senate,"Do pass, but first be re-referred to the Committee on [Appropriations] with the recommendation: To Consent Calendar",9,0,0,0,9
1234554,865868,2019-05-16,Senate,"Consent Calendar SB784 HEALTH (Pan) Urgency Clause",37,0,1,0,38
1234554,880672,2019-06-11,Assembly,"Do pass and be re-referred to the Committee on [Appropriations] with recommendation: To Consent Calendar",14,0,1,0,15
1234554,887971,2019-06-26,Assembly,"Do pass. To Consent Calendar",15,0,3,0,18
1234554,892522,2019-07-05,Assembly,"SB 784 HEALTH Consent Calendar Second Day Regular Session",70,0,9,0,79
1234554,892523,2019-07-11,Senate,"Unfinished Business SB784 HEALTH (Pan) Urgency Clause Concurrence",39,0,1,0,40
1237219,850781,2019-04-22,Senate,"Do pass, but first be re-referred to the Committee on [Appropriations] with the recommendation: To Consent Calendar",9,0,0,0,9
1237219,862351,2019-05-09,Senate,"Consent Calendar SB786 B.P.&E.D",38,0,0,0,38
1237219,891732,2019-07-09,Assembly,"Do pass and be re-referred to the Committee on [Appropriations]",19,0,0,0,19
1237219,891733,2019-08-14,Assembly,"Do pass",18,0,0,0,18
1237219,891734,2019-09-10,Assembly,"SB 786 B., P. & E.D. Senate Third Reading By LOW",79,0,0,0,79
1237219,891735,2019-09-11,Senate,"Unfinished Business SB786 B.P.&E.D. (Glazer) Concurrence",40,0,0,0,40
1237225,822153,2019-03-14,Assembly,"Be adopted. To third reading",11,0,1,0,12
1237237,852617,2019-04-24,Senate,"Be adopted and be ordered to the Consent Calendar",5,0,0,0,5
1237237,858314,2019-05-02,Senate,"Consent Calendar SJR6",38,0,0,0,38
1237237,887708,2019-06-25,Assembly,"Be adopted. To Consent Calendar",11,0,0,0,11
1237237,889274,2019-07-01,Assembly,"SJR 6 Chang Consent Calendar Second Day Regular Session",77,0,2,0,79
1237245,850964,2019-04-23,Senate,"Do pass, but first be re-referred to the Committee on [Appropriations] with the recommendation: To Consent Calendar",9,0,0,0,9
1237245,859444,2019-05-06,Senate,"Placed on suspense file",5,0,1,0,6
1237245,866482,2019-05-16,Senate,"Do pass",6,0,0,0,6
1237245,871317,2019-05-23,Senate,"Special Consent SB785 N.R. & W",38,0,0,0,38
1237245,883957,2019-06-18,Assembly,"Do pass and be re-referred to the Committee on [Natural Resources]",13,0,0,0,13
1237245,890860,2019-07-08,Assembly,"Do pass and be re-referred to the Committee on [Appropriations] with recommendation: To Consent Calendar",11,0,0,0,11
1237245,890861,2019-08-30,Assembly,"Do pass as amended",18,0,0,0,18
1237245,890862,2019-09-10,Assembly,"SB 785 N.R. & W. Senate Third Reading By FRIEDMAN",79,0,0,0,79
1237245,890863,2019-09-11,Senate,"Unfinished Business SB785 N.R. & W. (Stern) Concurrence",40,0,0,0,40
1237251,838932,2019-04-08,Senate,"Senate 3rd Reading SCR23 McGuire et al",38,0,0,0,38
1237251,849361,2019-04-22,Assembly,"Be adopted. To Consent Calendar",11,0,1,0,12
1237251,853089,2019-04-25,Assembly,"SCR 23 McGuire Consent Calendar Second Day Regular Session",76,0,4,0,80
1237256,858649,2019-05-01,Assembly,"Do pass. To Consent Calendar",8,0,0,0,8
1237256,862325,2019-05-09,Assembly,"AB 1822 L. GOV. Consent Calendar Second Day Regular Session",76,0,4,0,80
1237256,878866,2019-06-05,Senate,"Do pass and be ordered to the Consent Calendar",7,0,0,0,7
1237256,883696,2019-06-17,Senate,"Consent Calendar AB1822 L. GOV",40,0,0,0,40
1237263,838396,2019-04-08,Senate,"Senate 3rd Reading SCR24 Leyva",38,0,0,0,38
1237263,848755,2019-04-22,Assembly,"Be adopted. To Consent Calendar",11,0,1,0,12
1237263,852713,2019-04-25,Assembly,"SCR 24 Leyva Consent Calendar Second Day Regular Session",76,0,4,0,80
1237268,862107,2019-05-07,Assembly,"Be adopted as amended",9,0,3,0,12
1237268,867808,2019-05-20,Assembly,"AJR 11 Carrillo Assembly Third Reading",60,0,20,0,80
1237268,880409,2019-06-11,Senate,"Be adopted as amended",7,2,0,0,9
1237268,891993,2019-08-15,Senate,"Assembly 3rd Reading AJR11 Carrillo et al. By Caballero",29,0,11,0,40
1237268,891994,2019-08-22,Assembly,"AJR 11 Carrillo Concurrence in Senate Amendments",61,0,18,0,79
1238045,850530,2019-04-22,Assembly,"Do pass and be re-referred to the Committee on [Accountability and Administrative Review] with recommendation: To Consent Calendar",11,0,0,0,11
1238045,851718,2019-04-24,Assembly,"Do pass and be re-referred to the Committee on [Appropriations] with recommendation: To Consent Calendar",7,0,0,0,7
1238045,864894,2019-05-15,Assembly,"Do pass. To Consent Calendar",16,0,2,0,18
1238045,870076,2019-05-22,Assembly,"AB 1824 NAT. RES. Consent Calendar Second Day Regular Session",77,0,3,0,80
1238045,878339,2019-06-05,Senate,"Do pass, but first be re-referred to the Committee on [Appropriations] with the recommendation: To Consent Calendar",7,0,0,0,7
1238045,891142,2019-09-09,Senate,"Assembly 3rd Reading AB1824 NAT. RES. (Friedman) By Allen",40,0,0,0,40
1238045,891143,2019-09-10,Assembly,"AB 1824 NAT. RES. Concurrence in Senate Amendments By FRIEDMAN",79,0,0,0,79
1238051,850438,2019-04-22,Assembly,"Do pass and be re-referred to the Committee on [Appropriations] with recommendation: To Consent Calendar",11,0,0,0,11
1238051,864901,2019-05-15,Assembly,"Do pass. To Consent Calendar",16,0,2,0,18
1238051,870068,2019-05-22,Assembly,"AB 1823 NAT. RES. Consent Calendar Second Day Regular Session",77,0,3,0,80
1238051,887846,2019-06-25,Senate,"Do pass, but first be re-referred to the Committee on [Appropriations] with the recommendation: To Consent Calendar",9,0,0,0,9
1238051,890453,2019-09-10,Senate,"Assembly 3rd Reading AB1823 NAT. RES. (Friedman) By Stern",40,0,0,0,40
1238051,890454,2019-09-11,Assembly,"AB 1823 NAT. RES. Concurrence in Senate Amendments By FRIEDMAN",79,0,0,0,79
1238058,858188,2019-05-02,Assembly,"Be adopted. To third reading",9,0,3,0,12
1238058,875442,2019-05-30,Senate,"Special Consent ACR51",38,0,0,0,38
1238064,823984,2019-03-18,Assembly,"Be adopted. To third reading",11,0,1,0,12
1238070,853148,2019-04-24,Assembly,"Be adopted and re-referred to the Committee on [Appropriations]",7,0,0,0,7
1238070,861526,2019-05-08,Assembly,"Be adopted. To Consent Calendar",18,0,0,0,18
1238070,863070,2019-05-13,Assembly,"ACR 50 Chiu Consent Calendar Second Day Regular Session",74,0,6,0,80
1238070,881001,2019-06-12,Senate,"Be adopted, but first be re-referred to the Committee on [Appropriations] with recommendation: To Consent Calendar",5,0,0,0,5
1238070,887062,2019-06-24,Senate,"Placed on suspense file",7,0,0,0,7
1238070,892016,2019-08-30,Senate,"Be adopted. Ordered to third reading",7,0,0,0,7
1238070,892017,2019-09-04,Senate,"Assembly 3rd Reading ACR50 Chiu et al. By Pan",40,0,0,0,40
1238794,827993,2019-03-25,Assembly,"Be adopted. To third reading",12,0,0,0,12
1238794,862339,2019-05-09,Senate,"Special Consent ACR52",38,0,0,0,38
1238821,857002,2019-04-29,Assembly,"Be adopted. To third reading",10,0,2,0,12
1239530,858342,2019-05-02,Senate,"Senate 3rd Reading SCR25 Galgiani et al",38,0,0,0,38
1239530,866540,2019-05-16,Assembly,"Be adopted. To Consent Calendar",9,0,3,0,12
1239530,869963,2019-05-22,Assembly,"SCR 25 Galgiani Consent Calendar Second Day Regular Session",77,0,3,0,80
1239538,828228,2019-03-25,Assembly,"Be adopted. To third reading",12,0,0,0,12
1239553,831831,2019-03-28,Senate,"Senate 3rd Reading SCR26 Jackson et al",34,0,4,0,38
1239553,838307,2019-04-08,Assembly,"Be adopted. To Consent Calendar",11,0,1,0,12
1239553,842926,2019-04-11,Assembly,"SCR 26 Jackson Consent Calendar Second Day Regular Session",72,0,8,0,80
1239562,833787,2019-04-01,Assembly,"Be adopted. To third reading",10,0,2,0,12
1239578,850411,2019-04-23,Senate,"Do pass, but first be re-referred to the Committee on [Judiciary]",16,0,0,0,16
1239578,856956,2019-04-30,Senate,"Do pass, but first be re-referred to the Committee on [Appropriations] with the recommendation: To Consent Calendar",9,0,0,0,9
1239578,867758,2019-05-20,Senate,"Senate 3rd Reading SB788 G.O. (Dodd) Urgency Clause",38,0,0,0,38
1239578,888096,2019-06-26,Assembly,"Do pass and be re-referred to the Committee on [Judiciary] with recommendation: To Consent Calendar",19,0,2,0,21
1239578,890890,2019-07-09,Assembly,"Do pass and be re-referred to the Committee on [Appropriations] with recommendation: To Consent Calendar",12,0,0,0,12
1239578,890891,2019-08-14,Assembly,"Do pass",18,0,0,0,18
1239578,890892,2019-08-22,Assembly,"SB 788 G.O. Third Reading Urgency By BIGELOW",75,0,4,0,79
1239990,855791,2019-04-30,Senate,"Do pass and be ordered to the Consent Calendar",4,0,0,0,4
1239990,859620,2019-05-06,Senate,"Consent Calendar SB787 AGRI. (Galgiani)",38,0,0,0,38
1239990,880493,2019-06-11,Assembly,"Do pass",17,0,2,0,19
1239990,893611,2019-07-08,Assembly,"SB 787 AGRI. Senate Third Reading By EGGMAN",77,0,2,0,79
1239990,893612,2019-09-03,Assembly,"SB 787 AGRI. Senate Third Reading By EGGMAN",77,0,2,0,79
1239990,893613,2019-09-04,Senate,"Unfinished Business SB787 AGRI. (Galgiani) Concurrence",40,0,0,0,40
1240863,831347,2019-03-28,Senate,"Senate 3rd Reading SR26 Borgeas et al",37,0,1,0,38
1240900,828116,2019-03-25,Assembly,"Be adopted. To Consent Calendar",12,0,0,0,12
1240900,831386,2019-03-28,Assembly,"HR 26 Flora Consent Calendar Second Day Regular Session",72,0,8,0,80
1240936,826702,2019-03-21,Assembly,"Be adopted. To third reading",11,0,1,0,12
1240936,849611,2019-04-22,Senate,"Special Consent ACR53",38,0,0,0,38
1241835,836883,2019-04-04,Senate,"Senate 3rd Reading SCR29 Leyva",30,0,8,0,38
1241835,893956,2019-07-09,Assembly,"Be adopted. To Consent Calendar",10,0,2,0,12
1241835,893957,2019-08-12,Assembly,"SCR 29 Leyva Consent Calendar Second Day Regular Session",77,0,2,0,79
1241835,893958,2019-08-22,Senate,"Special Consent SCR29",39,0,1,0,40
1241838,853384,2019-04-25,Assembly,"Be adopted. To third reading",10,0,2,0,12
1241838,866748,2019-05-16,Senate,"Special Consent ACR54",37,0,1,0,38
1241840,836908,2019-04-04,Senate,"Senate 3rd Reading SR27 Pan et al",37,0,1,0,38
1241843,836920,2019-04-04,Assembly,"Be adopted. To third reading",9,0,3,0,12
1241843,862518,2019-05-09,Senate,"Special Consent ACR56",38,0,0,0,38
1241845,836902,2019-04-04,Assembly,"Be adopted. To Consent Calendar",9,0,3,0,12
1241845,842848,2019-04-11,Assembly,"ACR 55 Fong Consent Calendar Second Day Regular Session",72,0,8,0,80
1241845,862320,2019-05-09,Senate,"Special Consent ACR55",38,0,0,0,38
1241847,831393,2019-03-28,Assembly,"Be adopted. To third reading",10,0,2,0,12
1241849,838742,2019-04-08,Senate,"Senate 3rd Reading SCR27 Leyva et al",38,0,0,0,38
1241849,849435,2019-04-22,Assembly,"Be adopted. To Consent Calendar",11,0,1,0,12
1241849,853153,2019-04-25,Assembly,"SCR 27 Leyva Consent Calendar Second Day Regular Session",76,0,4,0,80
1241852,881983,2019-06-13,Assembly,"Be adopted. To third reading",11,0,1,0,12
1241852,893550,2019-07-11,Senate,"Special Consent ACR57",39,0,1,0,40
1242475,850719,2019-04-23,Senate,"Be adopted, but first be re-referred to the Committee on [Appropriations]",16,0,0,0,16
1242475,863242,2019-05-13,Senate,"Senate 3rd Reading SCR31 Bradford et al",37,0,1,0,38
1242475,892783,2019-07-03,Assembly,"Be adopted and re-referred to the Committee on [Appropriations]",7,0,0,0,7
1242475,892784,2019-08-14,Assembly,"Be adopted. To third reading",18,0,0,0,18
1242475,902221,2020-01-13,Assembly,"SCR 31 Bradford Senate Third Reading By Kamlager",72,0,8,0,80
1242475,904101,2020-01-21,Senate,"Unfinished Business SCR31 Bradford et al. Concurrence",38,0,1,0,39
1242500,863156,2019-05-13,Senate,"Senate 3rd Reading SCR30 Pan",37,0,1,0,38
1242500,875410,2019-05-30,Assembly,"Be adopted. To Consent Calendar",10,0,2,0,12
1242500,879184,2019-06-06,Assembly,"SCR 30 Pan Consent Calendar Second Day Regular Session",77,0,3,0,80
1242500,885953,2019-06-20,Senate,"Special Consent SCR30",40,0,0,0,40
1242522,842039,2019-04-09,Senate,"Be adopted. Ordered to third reading",7,0,0,0,7
1242522,859470,2019-05-06,Senate,"Senate 3rd Reading SJR7 Glazer et al",38,0,0,0,38
1242522,883926,2019-06-18,Assembly,"Be adopted. To Consent Calendar",10,0,1,0,11
1242522,887072,2019-06-24,Assembly,"SJR 7 Glazer Consent Calendar Second Day Regular Session",77,0,2,0,79
1243128,853333,2019-04-24,Assembly,"Do pass and be re-referred to the Committee on [Appropriations] with recommendation: To Consent Calendar",19,0,2,0,21
1243128,861959,2019-05-08,Assembly,"Do pass. To Consent Calendar",18,0,0,0,18
1243128,866155,2019-05-16,Assembly,"AB 1825 G.O. Consent Calendar Second Day Regular Session",74,0,6,0,80
1243128,892326,2019-07-09,Senate,"Do pass, but first be re-referred to the Committee on [Appropriations] with the recommendation: To Consent Calendar",15,0,1,0,16
1243128,892329,2019-09-10,Senate,"Assembly 3rd Reading AB1825 G.O. (Gray) By Dodd",40,0,0,0,40
1243128,893886,2019-09-13,Assembly,"With recommendation: That Senate amendments be concurred in",18,0,3,0,21
1243128,893960,2019-09-13,Assembly,"AB 1825 Governmental Organizatio Concurrence in Senate Amendments By GRAY",79,0,0,0,79
1243128,894506,2019-05-16,Assembly,"Bill Votes",18,0,0,0,18
1243139,852480,2019-04-23,Senate,"Be adopted, but first be re-referred to the Committee on [Appropriations] with recommendation: To Consent Calendar",12,0,0,0,12
1243139,862184,2019-05-09,Senate,"Consent Calendar SCR32",38,0,0,0,38
1243139,893863,2019-07-01,Assembly,"Be adopted, and re-refer to the Committee on [Appropriations] with recommendation: To Consent Calendar",15,0,0,0,15
1243139,893864,2019-08-14,Assembly,"Be adopted. To third reading",18,0,0,0,18
1243139,893865,2019-08-19,Assembly,"SCR 32 Morrell Senate Third Reading By Obernolte",78,0,1,0,79
1243139,893866,2019-08-22,Senate,"Unfinished Business SCR32 Morrell Concurrence",38,0,2,0,40
1243150,838639,2019-04-08,Senate,"Senate 3rd Reading SCR33 Allen et al",38,0,0,0,38
1243150,848891,2019-04-22,Assembly,"Be adopted. To Consent Calendar",11,0,1,0,12
1243150,852775,2019-04-25,Assembly,"SCR 33 Allen Consent Calendar Second Day Regular Session",76,0,4,0,80
1243161,853416,2019-04-24,Assembly,"Do pass and be re-referred to the Committee on [Appropriations] with recommendation: To Consent Calendar",19,0,2,0,21
1243161,861965,2019-05-08,Assembly,"Do pass. To Consent Calendar",18,0,0,0,18
1243161,866480,2019-05-16,Assembly,"AB 1827 G.O. Consent Calendar Second Day Regular Session",74,0,6,0,80
1243161,893678,2019-07-09,Senate,"Do pass, but first be re-referred to the Committee on [Appropriations] with the recommendation: To Consent Calendar",15,0,1,0,16
1243172,853322,2019-04-24,Senate,"Do pass, but first be re-referred to the Committee on [Appropriations] with the recommendation: To Consent Calendar",7,0,0,0,7
1243172,862340,2019-05-09,Senate,"Consent Calendar SB790 GOV. & F",38,0,0,0,38
1243172,892685,2019-07-08,Assembly,"Do pass and be re-referred to the Committee on [Appropriations] with recommendation: To Consent Calendar",10,0,1,0,11
1243172,892686,2019-08-14,Assembly,"Do pass",18,0,0,0,18
1243172,892687,2019-08-22,Assembly,"SB 790 GOV.& F. Senate Third Reading By BURKE",75,0,4,0,79
1243172,892688,2019-08-30,Senate,"Special Consent SB790 GOV. & F",37,0,3,0,40
1243183,836529,2019-04-04,Assembly,"Be adopted. To third reading",9,0,3,0,12
1243194,853700,2019-04-24,Senate,"Do pass, but first be re-referred to the Committee on [Appropriations] with the recommendation: To Consent Calendar",7,0,0,0,7
1243194,859571,2019-05-06,Senate,"Placed on suspense file",5,0,1,0,6
1243194,865805,2019-05-16,Senate,"Do pass",6,0,0,0,6
1243194,871358,2019-05-23,Senate,"Special Consent SB791 GOV. & F",38,0,0,0,38
1243194,891050,2019-07-08,Assembly,"Do pass and be re-referred to the Committee on [Appropriations]",10,0,1,0,11
1243194,891051,2019-08-30,Assembly,"Do pass",18,0,0,0,18
1243194,891052,2019-09-09,Assembly,"SB 791 GOV.& F. Third Reading Urgency By BURKE",79,0,0,0,79
1243194,894178,2019-09-09,Assembly,Date,18,0,0,0,18
1243205,852739,2019-04-24,Senate,"Do pass and be ordered to the Consent Calendar",7,0,0,0,7
1243205,858255,2019-05-02,Senate,"Consent Calendar SB789 GOV. & F",38,0,0,0,38
1243205,894043,2019-07-03,Assembly,"Do pass. To Consent Calendar",8,0,0,0,8
1243205,894044,2019-07-11,Assembly,"SB 789 GOV.& F. Consent Calendar Second Day Regular Session",76,0,3,0,79
1243205,894045,2019-08-22,Senate,"Special Consent SB789 GOV. & F. (McGuire)",39,0,1,0,40
1243216,831478,2019-03-28,Senate,"Senate 3rd Reading SCR34 Allen et al",34,0,4,0,38
1243216,836927,2019-04-04,Assembly,"Be adopted. To Consent Calendar",9,0,3,0,12
1243216,842806,2019-04-11,Assembly,"SCR 34 Allen Consent Calendar Second Day Regular Session",72,0,8,0,80
1243216,896110,2019-04-11,Assembly,Date,9,0,0,0,9
1243227,853671,2019-04-24,Assembly,"Do pass and be re-referred to the Committee on [Appropriations] with recommendation: To Consent Calendar",19,0,2,0,21
1243227,861958,2019-05-08,Assembly,"Do pass. To Consent Calendar",18,0,0,0,18
1243227,865985,2019-05-16,Assembly,"AB 1828 G.O. Consent Calendar Second Day Regular Session",74,0,6,0,80
1243227,880946,2019-06-11,Senate,"Do pass, but first be re-referred to the Committee on [Appropriations] with the recommendation: To Consent Calendar",14,0,2,0,16
1243238,853386,2019-04-24,Assembly,"Do pass. To Consent Calendar",19,0,2,0,21
1243238,858259,2019-05-02,Assembly,"AB 1826 G.O. Consent Calendar Second Day Regular Session",76,0,4,0,80
1243238,893462,2019-07-09,Senate,"Do pass and be ordered to the Consent Calendar",15,0,1,0,16
1244191,849265,2019-04-22,Assembly,"Be adopted. To third reading",11,0,1,0,12
1244191,880663,2019-06-10,Senate,"Be adopted and be ordered to the Consent Calendar",5,0,1,0,6
1244191,882976,2019-06-17,Senate,"Consent Calendar ACR59",40,0,0,0,40
1244265,836896,2019-04-04,Assembly,"Be adopted. To third reading",9,0,3,0,12
1244343,836886,2019-04-04,Assembly,"Be adopted. To third reading",9,0,3,0,12
1244343,862162,2019-05-09,Senate,"Special Consent ACR58",38,0,0,0,38
1245038,860326,2019-05-06,Senate,"Senate 3rd Reading SCR35 Rubio et al",38,0,0,0,38
1245038,862281,2019-05-09,Assembly,"Be adopted. To Consent Calendar",11,0,1,0,12
1245038,866483,2019-05-16,Assembly,"SCR 35 Rubio Consent Calendar Second Day Regular Session",74,0,6,0,80
1245727,892307,2019-08-15,Assembly,"Be adopted. To Consent Calendar",10,0,2,0,12
1245727,892308,2019-08-26,Assembly,"ACR 61 Salas Consent Calendar Second Day",77,0,2,0,79
1245727,892309,2019-09-09,Senate,"Assembly 3rd Reading ACR61 Salas et al",40,0,0,0,40
1245739,863320,2019-05-13,Senate,"Senate 3rd Reading SR28 Wilk et al",37,0,1,0,38
1245751,878893,2019-06-05,Senate,"Be adopted and be ordered to the Consent Calendar",7,0,0,0,7
1245751,883212,2019-06-17,Senate,"Consent Calendar SJR8",40,0,0,0,40
1245751,894117,2019-07-10,Assembly,"Be adopted. To Consent Calendar",7,0,0,0,7
1245751,894118,2019-08-15,Assembly,"SJR 8 Wilk Consent Calendar Second Day Regular Session",76,0,3,0,79
1245764,857117,2019-05-01,Assembly,"Do pass as amended. To Consent Calendar",7,0,0,0,7
1245764,862327,2019-05-09,Assembly,"AB 1829 E. & R. Consent Calendar Second Day Regular Session",76,0,4,0,80
1245764,877945,2019-06-04,Senate,"Do pass and be ordered to the Consent Calendar",5,0,0,0,5
1245764,893493,2019-08-26,Senate,"Assembly 3rd Reading AB1829 E. & R. (Berman) By Umberg",39,0,1,0,40
1245764,893494,2019-08-30,Assembly,"AB 1829 E. & R. Concurrence in Senate Amendments By BERMAN",74,0,5,0,79
1246648,841497,2019-04-10,Assembly,"Be adopted. To third reading",8,0,4,0,12
1246669,868854,2019-05-20,Assembly,"Be adopted. To third reading",9,0,3,0,12
1246669,886135,2019-06-20,Senate,"Special Consent ACR62",40,0,0,0,40
1247524,884742,2019-06-19,Assembly,"Be adopted. To third reading",7,0,0,0,7
1247524,891536,2019-07-01,Assembly,"AJR 14 Lackey Assembly Third Reading",75,0,4,0,79
1247524,891537,2019-08-26,Senate,"Be adopted as amended, and be ordered to the Consent Calendar",6,0,0,0,6
1247524,891538,2019-08-30,Senate,"Consent Calendar AJR14",37,0,3,0,40
1247524,891539,2019-09-03,Assembly,"AJR 14 Lackey Concurrence in Senate Amendments",77,0,2,0,79
1247533,849663,2019-04-22,Assembly,"Be adopted. To third reading",11,0,1,0,12
1247533,866431,2019-05-16,Senate,"Special Consent ACR63",37,0,1,0,38
1248130,872339,2019-05-24,Assembly,"Be adopted. To Consent Calendar",11,0,1,0,12
1248130,874497,2019-05-29,Assembly,"ACR 65 Weber Consent Calendar Second Day Regular Session",76,0,4,0,80
1248130,886151,2019-06-20,Senate,"Special Consent ACR65",40,0,0,0,40
1248131,851695,2019-04-23,Assembly,"Be adopted and re-referred to the Committee on [Appropriations]",9,1,2,0,12
1248131,866051,2019-05-16,Assembly,"Be adopted. To third reading",13,3,2,0,18
1248131,892417,2019-07-10,Senate,"Be adopted, but first be re-referred to the Committee on [Appropriations]",7,0,0,0,7
1248131,892418,2019-08-12,Senate,"Placed on suspense file",7,0,0,0,7
1248131,892419,2019-08-30,Senate,"Be adopted. Ordered to third reading",4,1,2,0,7
1248131,892420,2019-09-05,Senate,"Assembly 3rd Reading ACR64 McCarty et al. By Glazer",33,3,4,0,40
1248951,881119,2019-06-11,Assembly,"Be adopted. To Consent Calendar",7,0,0,0,7
1248951,882796,2019-06-17,Assembly,"AJR 15 Bloom Consent Calendar Second Day",75,0,4,0,79
1248951,894004,2019-07-02,Senate,"Be adopted. Ordered to third reading",11,0,0,0,11
1248951,894005,2019-09-04,Senate,"Assembly 3rd Reading AJR15 Bloom By Beall",40,0,0,0,40
1249462,860389,2019-05-06,Senate,"Senate 3rd Reading SR30 Beall et al",38,0,0,0,38
1249463,850911,2019-04-22,Assembly,"Be adopted as amended. To Consent Calendar",15,0,0,0,15
1249463,854932,2019-04-29,Assembly,"ACR 66 Aguiar-Curry Consent Calendar Second Day",76,0,4,0,80
1249463,880676,2019-06-11,Senate,"Be adopted, but first be re-referred to the Committee on [Appropriations] with recommendation: To Consent Calendar",10,0,2,0,12
1249463,893903,2019-07-01,Senate,"Consent Calendar ACR66",39,0,1,0,40
1249463,893904,2019-07-05,Assembly,"ACR 66 Aguiar-Curry Concurrence in Senate Amendments",70,0,9,0,79
1249464,859913,2019-05-06,Senate,"Senate 3rd Reading SCR36 Pan",38,0,0,0,38
1249464,889276,2019-07-01,Assembly,"Be adopted. To Consent Calendar",11,0,1,0,12
1249464,894078,2019-07-05,Assembly,"SCR 36 Pan Consent Calendar Second Day Regular Session",70,0,9,0,79
1249466,853573,2019-04-25,Senate,"Senate 3rd Reading SR29 Caballero et al",37,0,1,0,38
1249467,880985,2019-06-12,Assembly,"Be adopted as amended, and re-refer to the Committee on [Appropriations]",7,0,0,0,7
1249467,884583,2019-06-19,Assembly,"Be adopted",13,4,1,0,18
1249467,887438,2019-06-24,Assembly,"ACA 14 Gonzalez Assembly Third Reading",57,12,10,0,79
1249467,893298,2019-07-10,Senate,"Be adopted, but first be re-referred to the Committee on [Elections and Constitutional Amendments]",6,0,1,0,7
1249467,893299,2019-08-20,Senate,"Be adopted, but first be re-referred to the Committee on [Appropriations]",4,1,0,0,5
1249467,893300,2019-08-26,Senate,"Placed on suspense file",6,0,1,0,7
1249467,893301,2019-08-30,Senate,"Be adopted as amended",5,2,0,0,7
1249467,894205,2019-09-13,Senate,"Assembly 3rd Reading ACA14 Gonzalez et al. By Wilk",23,12,0,0,35
1249467,894206,2019-09-13,Senate,"Assembly 3rd Reading ACA14 Gonzalez et al. By Wilk Reconsider",33,0,0,0,33
1249467,894399,2019-08-26,Senate,Result,6,0,0,0,6
1249467,894400,2019-09-14,Senate,"Assembly 3rd Reading ACA14 Gonzalez et al. By Wilk",23,12,5,0,40
1249467,894451,2019-09-14,Senate,"Assembly 3rd Reading ACA14 Gonzalez et al. By Wilk Reconsider",33,0,7,0,40
1249467,895177,2019-08-20,Senate,"Sen Elections and Constitutional Amendments",4,1,0,0,5
1250136,841523,2019-04-10,Assembly,"Be adopted. To third reading",8,0,4,0,12
1250136,862135,2019-05-09,Senate,"Special Consent ACR67",38,0,0,0,38
1250138,864899,2019-05-15,Assembly,"Do pass. To Consent Calendar",16,0,2,0,18
1250138,870243,2019-05-22,Assembly,"AB 1830 Gonzalez Consent Calendar Second Day Regular Session",77,0,3,0,80
1250138,887048,2019-06-24,Senate,"Do pass",7,0,0,0,7
1250138,889317,2019-07-01,Senate,"Assembly 3rd Reading AB1830 Gonzalez By Portantino Urgency Clause",38,0,2,0,40
1250143,849247,2019-04-22,Senate,"Senate 3rd Reading SR31 Borgeas et al",38,0,0,0,38
1250145,853152,2019-04-25,Senate,"Senate 3rd Reading SCR39 Rubio et al",37,0,1,0,38
1250148,858114,2019-05-02,Senate,"Senate 3rd Reading SCR37 Leyva",38,0,0,0,38
1250148,862363,2019-05-09,Assembly,"Be adopted. To Consent Calendar",11,0,1,0,12
1250148,865621,2019-05-16,Assembly,"SCR 37 Leyva Consent Calendar Second Day Regular Session",74,0,6,0,80
1250596,841746,2019-04-10,Assembly,"Be adopted. To third reading",8,0,4,0,12
1250596,849341,2019-04-22,Assembly,"AJR 16 Luz Rivas Assembly Third Reading",78,0,2,0,80
1250596,892340,2019-08-27,Senate,"Be adopted and be ordered to the Consent Calendar",9,0,0,0,9
1250596,892341,2019-08-30,Senate,"Consent Calendar AJR16",37,0,3,0,40
1250596,892342,2019-09-05,Assembly,"AJR 16 Luz Rivas Concurrence in Senate Amendments",79,0,0,0,79
1250617,853362,2019-04-25,Assembly,"Be adopted. To third reading",10,0,2,0,12
1250617,866343,2019-05-16,Senate,"Special Consent ACR68",37,0,1,0,38
1250640,862383,2019-05-09,Assembly,"Be adopted. To Consent Calendar",11,0,1,0,12
1250640,865954,2019-05-16,Assembly,"ACR 69 Eduardo Garcia Consent Calendar Second Day Regular Session",74,0,6,0,80
1250640,879232,2019-06-06,Senate,"Special Consent ACR69",37,0,1,0,38
1251640,854813,2019-04-29,Assembly,"Be adopted. To third reading",10,0,2,0,12
1251640,871893,2019-05-23,Senate,"Special Consent ACR70",38,0,0,0,38
1251641,880722,2019-06-11,Assembly,"Be adopted, and re-refer to the Committee on [Appropriations] with recommendation: To Consent Calendar",8,0,0,0,8
1251641,892072,2019-08-30,Assembly,"Be adopted. To third reading",18,0,0,0,18
1251641,892073,2019-09-10,Assembly,"AJR 17 Ramos Assembly Third Reading",79,0,0,0,79
1253615,857978,2019-05-02,Assembly,"Be adopted. To third reading",9,0,3,0,12
1253616,859576,2019-05-06,Senate,"Senate 3rd Reading SCR42 Nielsen",38,0,0,0,38
1253616,872072,2019-05-24,Assembly,"Be adopted. To Consent Calendar",11,0,1,0,12
1253616,874525,2019-05-29,Assembly,"SCR 42 Nielsen Consent Calendar Second Day Regular Session",76,0,4,0,80
1253617,866952,2019-05-16,Assembly,"Be adopted. To third reading",9,0,3,0,12
1253617,879127,2019-06-06,Senate,"Special Consent ACR73",37,0,1,0,38
1253618,854542,2019-04-29,Senate,"Senate 3rd Reading SCR41 Allen et al",37,0,1,0,38
1253618,867668,2019-05-20,Assembly,"Be adopted. To Consent Calendar",9,0,3,0,12
1253618,871606,2019-05-23,Assembly,"SCR 41 Allen Consent Calendar Second Day",78,0,2,0,80
1253619,860362,2019-05-06,Senate,"Senate 3rd Reading SR33 Stern",38,0,0,0,38
1253620,855449,2019-04-29,Assembly,"Be adopted. To third reading",10,0,2,0,12
1253620,871370,2019-05-23,Senate,"Special Consent ACR72",38,0,0,0,38
1253621,853293,2019-04-25,Senate,"Senate 3rd Reading SCR40 Hueso et al",37,0,1,0,38
1253621,862380,2019-05-09,Assembly,"Be adopted. To Consent Calendar",11,0,1,0,12
1253621,866088,2019-05-16,Assembly,"SCR 40 Hueso Consent Calendar Second Day Regular Session",74,0,6,0,80
1253987,859414,2019-05-06,Assembly,"Be adopted. To third reading",12,0,0,0,12
1253987,875613,2019-05-30,Senate,"Special Consent ACR74",38,0,0,0,38
1254321,852723,2019-04-25,Assembly,"Be adopted. To third reading",10,0,2,0,12
1254321,866112,2019-05-16,Senate,"Special Consent ACR77",37,0,1,0,38
1254322,858168,2019-05-01,Assembly,"Be adopted, and re-refer to the Committee on [Appropriations] with recommendation: To Consent Calendar",12,0,3,0,15
1254322,861699,2019-05-08,Assembly,"Be adopted. To Consent Calendar",18,0,0,0,18
1254322,863143,2019-05-13,Assembly,"ACR 78 Holden Consent Calendar Second Day Regular Session",74,0,6,0,80
1254322,894049,2019-07-10,Senate,"Be adopted, but first be re-referred to the Committee on [Appropriations]",12,0,1,0,13
1254322,894050,2019-09-03,Senate,"Assembly 3rd Reading ACR78 Holden et al. By Hill",38,1,1,0,40
1254324,859500,2019-05-06,Assembly,"Be adopted. To third reading",12,0,0,0,12
1254324,875492,2019-05-30,Senate,"Special Consent ACR75",38,0,0,0,38
1254326,859621,2019-05-06,Assembly,"Be adopted. To Consent Calendar",12,0,0,0,12
1254326,862108,2019-05-09,Assembly,"ACR 76 Smith Consent Calendar Second Day Regular Session",76,0,4,0,80
1254326,875590,2019-05-30,Senate,"Special Consent ACR76",38,0,0,0,38
1254646,859570,2019-05-06,Senate,"Senate 3rd Reading SR35 Archuleta",38,0,0,0,38
1254647,866632,2019-05-16,Assembly,"Be adopted. To third reading",9,0,3,0,12
1254647,879281,2019-06-06,Senate,"Special Consent ACR79",37,0,1,0,38
1254648,859596,2019-05-06,Senate,"Senate 3rd Reading SR34 Caballero",38,0,0,0,38
1255191,872337,2019-05-24,Assembly,"Be adopted. To third reading",11,0,1,0,12
1255191,879871,2019-06-10,Senate,"Assembly 3rd Reading ACR81 Gipson et al. By McGuire",35,0,3,0,38
1255221,859634,2019-05-06,Assembly,"Be adopted. To Consent Calendar",12,0,0,0,12
1255221,862365,2019-05-09,Assembly,"ACR 80 Levine Consent Calendar Second Day Regular Session",76,0,4,0,80
1255221,875628,2019-05-30,Senate,"Special Consent ACR80",38,0,0,0,38
1255590,858204,2019-05-02,Assembly,"Be adopted. To third reading",9,0,3,0,12
1255590,871593,2019-05-23,Senate,"Special Consent ACR83",38,0,0,0,38
1255600,891962,2019-08-21,Assembly,"Do pass. To Consent Calendar",17,0,1,0,18
1255600,891963,2019-08-30,Assembly,"AB 1831 Gonzalez Consent Calendar Second Day",67,0,12,0,79
1255600,891964,2019-09-09,Senate,"Assembly 3rd Reading AB1831 Gonzalez By Portantino Urgency Clause",40,0,0,0,40
1255612,863284,2019-05-13,Senate,"Senate 3rd Reading SCR43 Stern",37,0,1,0,38
1255612,879906,2019-06-10,Assembly,"Be adopted. To Consent Calendar",12,0,0,0,12
1255612,881552,2019-06-13,Assembly,"SCR 43 Stern Consent Calendar Second Day Regular Session",77,0,2,0,79
1255612,893929,2019-07-01,Senate,"Unfinished Business SCR43 Stern et al. Concurrence",39,0,1,0,40
1255623,870683,2019-05-22,Senate,"Senate 3rd Reading SR36 Wiener et al",36,0,2,0,38
1255634,866864,2019-05-16,Assembly,"Be adopted. To third reading",9,0,3,0,12
1255645,863298,2019-05-13,Senate,"Senate 3rd Reading SR37 Rubio et al",37,0,1,0,38
1255657,869452,2019-05-20,Assembly,"Be adopted. To third reading",9,0,3,0,12
1255657,886137,2019-06-20,Senate,"Special Consent ACR82",40,0,0,0,40
1256020,862093,2019-05-09,Assembly,"Be adopted. To third reading",11,0,1,0,12
1256020,877446,2019-06-03,Senate,"Assembly 3rd Reading ACR85 Reyes et al. By Allen",38,0,0,0,38
1256023,881573,2019-06-13,Assembly,"Be adopted. To third reading",11,0,1,0,12
1256023,891855,2019-07-11,Senate,"Special Consent ACR86",39,0,1,0,40
1256026,863144,2019-05-13,Senate,"Senate 3rd Reading SCR44 Dodd et al",37,0,1,0,38
1256026,890575,2019-07-09,Assembly,"Be adopted. To Consent Calendar",11,0,0,0,11
1256026,890576,2019-08-12,Assembly,"SCR 44 Dodd Consent Calendar Second Day Regular Session",77,0,2,0,79
1256027,859613,2019-05-06,Assembly,"Be adopted. To Consent Calendar",12,0,0,0,12
1256027,862078,2019-05-09,Assembly,"HR 32 Mullin Consent Calendar Second Day Regular Session",76,0,4,0,80
1256030,884369,2019-06-18,Assembly,"Be adopted. To third reading",11,1,1,0,13
1256030,888625,2019-06-27,Assembly,"AJR 18 Luz Rivas Assembly Third Reading",60,0,19,0,79
1256375,867844,2019-05-20,Senate,"Senate 3rd Reading SR39 Jackson",38,0,0,0,38
1256376,877681,2019-06-04,Assembly,"Be adopted. To Consent Calendar",11,0,1,0,12
1256376,879177,2019-06-06,Assembly,"HR 34 McCarty Consent Calendar Second Day",77,0,3,0,80
1256377,875494,2019-05-30,Senate,"Special Consent SR38",38,0,0,0,38
1256378,886031,2019-06-19,Assembly,"Amend, and be adopted as amended and re-refer to the Committee on [Appropriations] with the recommendation: To Consent Calendar",7,0,0,0,7
1256378,891886,2019-08-14,Assembly,"Be adopted. To third reading",18,0,0,0,18
1256379,883083,2019-06-17,Assembly,"Be adopted. To Consent Calendar",11,0,1,0,12
1256379,887503,2019-06-20,Assembly,"HR 33 McCarty Consent Calendar Second Day Regular Session",77,0,2,0,79
1256380,865884,2019-05-16,Assembly,"Be adopted. To Consent Calendar",9,0,3,0,12
1256380,870118,2019-05-22,Assembly,"ACR 88 Reyes Consent Calendar Second Day Regular Session",77,0,3,0,80
1256380,886259,2019-06-20,Senate,"Special Consent ACR88",40,0,0,0,40
1256951,879870,2019-06-10,Senate,"Senate 3rd Reading SCR45 McGuire",35,0,3,0,38
1256951,883087,2019-06-17,Assembly,"Be adopted. To Consent Calendar",11,0,1,0,12
1256951,886140,2019-06-20,Assembly,"SCR 45 McGuire Consent Calendar Second Day Regular Session",77,0,2,0,79
1256952,881734,2019-06-13,Assembly,"Be adopted. To Consent Calendar",11,0,1,0,12
1256952,885783,2019-06-20,Assembly,"ACR 89 Cooley Consent Calendar Second Day",77,0,2,0,79
1256952,894183,2019-08-15,Senate,"Assembly 3rd Reading ACR89 Cooley et al. By Nielsen",36,1,3,0,40
1257257,881548,2019-06-11,Assembly,"Be adopted. To third reading",7,0,1,0,8
1257257,892145,2019-09-09,Senate,"Assembly 3rd Reading ACR91 Jones-Sawyer et al. By Bradford",30,7,3,0,40
1257263,865973,2019-05-16,Senate,"Senate 3rd Reading SCR47 Rubio et al",37,0,1,0,38
1257263,887045,2019-06-24,Assembly,"Be adopted. To Consent Calendar",12,0,0,0,12
1257263,888554,2019-06-27,Assembly,"SCR 47 Rubio Consent Calendar Second Day Regular Session",71,0,8,0,79
1257272,867757,2019-05-20,Assembly,"Be adopted. To third reading",9,0,3,0,12
1257272,874503,2019-05-29,Assembly,"HR 36 Smith Consent Calendar Second Day",76,0,4,0,80
1257281,866002,2019-05-16,Assembly,"Be adopted. To third reading",9,0,3,0,12
1257281,893496,2019-07-11,Senate,"Special Consent ACR90",39,0,1,0,40
1257289,887819,2019-06-25,Senate,"Be adopted, but first be re-referred to the Committee on [Appropriations] with recommendation: To Consent Calendar",12,0,1,0,13
1257289,890720,2019-07-11,Senate,"Consent Calendar SCR46 Galgiani",38,0,2,0,40
1257289,890721,2019-09-11,Assembly,"Be adopted. To Consent Calendar",14,0,1,0,15
1257289,893975,2019-09-14,Assembly,"SCR 46 Galgiani Consent Calendar Second Day Regular Session",75,0,4,0,79
1257297,862113,2019-05-09,Assembly,"Be adopted. To third reading",11,0,1,0,12
1257297,875633,2019-05-30,Senate,"Special Consent ACR93",38,0,0,0,38
1257305,865959,2019-05-16,Assembly,"Be adopted. To Consent Calendar",9,0,3,0,12
1257305,869951,2019-05-22,Assembly,"ACR 92 Waldron Consent Calendar Second Day Regular Session",77,0,3,0,80
1257305,886084,2019-06-20,Senate,"Special Consent ACR92",40,0,0,0,40
1257663,865967,2019-05-16,Assembly,"Be adopted. To third reading",9,0,3,0,12
1258065,872270,2019-05-24,Senate,"Senate 3rd Reading SR40 Caballero",36,0,2,0,38
1260541,865684,2019-05-16,Senate,"Senate 3rd Reading SCR48 Archuleta et al",37,0,1,0,38
1260541,872257,2019-05-24,Assembly,"Be adopted. To Consent Calendar",11,0,1,0,12
1260541,874648,2019-05-29,Assembly,"SCR 48 Archuleta Consent Calendar Second Day Regular Session",76,0,4,0,80
1261058,881557,2019-06-13,Assembly,"Be adopted. To Consent Calendar",11,0,1,0,12
1261058,885987,2019-06-20,Assembly,"ACR 94 Reyes Consent Calendar Second Day Regular Session",77,0,2,0,79
1261058,894093,2019-08-12,Senate,"Assembly 3rd Reading ACR94 Reyes et al. By Leyva",39,0,1,0,40
1261060,872546,2019-05-20,Senate,"Senate 3rd Reading SR42 Rubio",38,0,0,0,38
1261062,873814,2019-05-28,Senate,"Senate 3rd Reading SCR49 Dodd et al",38,0,0,0,38
1261062,879206,2019-06-06,Assembly,"Be adopted. To Consent Calendar",11,0,1,0,12
1261062,881484,2019-06-13,Assembly,"SCR 49 Dodd Consent Calendar Second Day",77,0,2,0,79
1261066,872306,2019-05-24,Senate,"Senate 3rd Reading SCR52 Jones",37,0,1,0,38
1261066,875372,2019-05-30,Assembly,"Be adopted. To Consent Calendar",10,0,2,0,12
1261066,879153,2019-06-06,Assembly,"SCR 52 Jones Consent Calendar Second Day Regular Session",77,0,3,0,80
1261069,873875,2019-05-28,Senate,"Senate 3rd Reading SCR51 Morrell et al",38,0,0,0,38
1261069,891559,2019-08-30,Assembly,"Be adopted. To Consent Calendar",12,0,0,0,12
1261069,891560,2019-09-05,Assembly,"SCR 51 Morrell Consent Calendar Second Day Regular Session",79,0,0,0,79
1261069,891561,2019-09-06,Senate,"Unfinished Business SCR51 Morrell et al. Concurrence",39,0,1,0,40
1261071,867874,2019-05-20,Senate,"Senate 3rd Reading SCR50 Skinner et al",38,0,0,0,38
1261071,876998,2019-06-03,Assembly,"Be adopted. To Consent Calendar",11,0,1,0,12
1261071,879190,2019-06-06,Assembly,"SCR 50 Skinner Consent Calendar Second Day Regular Session",77,0,3,0,80
1261073,872319,2019-05-24,Assembly,"Be adopted. To third reading",11,0,1,0,12
1261559,872314,2019-05-24,Assembly,"Be adopted. To third reading",11,0,1,0,12
1261559,889309,2019-07-01,Senate,"Assembly 3rd Reading ACR95 Choi et al. By Bates",39,0,1,0,40
1261559,891793,2019-07-08,Assembly,"ACR 95 Choi Concurrence in Senate Amendments",76,0,3,0,79
1262107,872027,2019-05-24,Assembly,"Be adopted. To Consent Calendar",11,0,1,0,12
1262107,874451,2019-05-29,Assembly,"ACR 96 Kalra Consent Calendar Second Day Regular Session",76,0,4,0,80
1262107,886157,2019-06-20,Senate,"Special Consent ACR96",40,0,0,0,40
1262558,868564,2019-05-20,Assembly,"Be adopted. To third reading",9,0,3,0,12
1263069,876947,2019-06-03,Senate,"Senate 3rd Reading SR43 Leyva et al",38,0,0,0,38
1263600,883971,2019-06-18,Assembly,"Be adopted. To third reading",9,0,3,0,12
1263600,888428,2019-06-27,Assembly,"AJR 19 Gloria Assembly Third Reading",57,0,22,0,79
1263600,890735,2019-08-27,Senate,"Be adopted as amended",8,0,1,0,9
1263600,890736,2019-09-04,Senate,"Assembly 3rd Reading AJR19 Gloria et al. By Pan",30,0,10,0,40
1263600,890737,2019-09-09,Assembly,"AJR 19 Gloria Concurrence in Senate Amendments",63,0,16,0,79
1264433,879454,2019-06-06,Senate,"Senate 3rd Reading SCR53 Grove et al",37,0,1,0,38
1264433,883663,2019-06-17,Assembly,"Be adopted. To Consent Calendar",11,0,1,0,12
1264433,885925,2019-06-20,Assembly,"SCR 53 Grove Consent Calendar Second Day Regular Session",77,0,2,0,79
1264434,892269,2019-08-26,Senate,"Senate 3rd Reading SCR54 Grove et al",39,0,1,0,40
1264434,892270,2019-09-05,Assembly,"Be adopted. To Consent Calendar",11,0,1,0,12
1264434,892271,2019-09-09,Assembly,"SCR 54 Grove Consent Calendar Second Day Regular Session",79,0,0,0,79
1264834,886336,2019-06-20,Assembly,"Be adopted. To third reading",9,0,3,0,12
1264835,876963,2019-06-03,Senate,"Senate 3rd Reading SCR55 Jackson",38,0,0,0,38
1264835,879879,2019-06-10,Assembly,"Be adopted. To Consent Calendar",12,0,0,0,12
1264835,881592,2019-06-13,Assembly,"SCR 55 Jackson Consent Calendar Second Day Regular Session",77,0,2,0,79
1264837,887859,2019-06-25,Senate,"Be adopted, but first be re-referred to the Committee on [Appropriations] with recommendation: To Consent Calendar",13,0,0,0,13
1264837,890665,2019-07-11,Senate,"Consent Calendar SCR56",39,0,1,0,40
1264837,890666,2019-09-11,Assembly,"Be adopted. To Consent Calendar",14,0,1,0,15
1264837,893972,2019-09-14,Assembly,"SCR 56 McGuire Consent Calendar Second Day Regular Session",75,0,4,0,79
1264839,886938,2019-06-24,Senate,"Senate 3rd Reading SR44 Wiener et al",35,1,4,0,40
1265243,876973,2019-06-03,Senate,"Senate 3rd Reading SR45 Stern",38,0,0,0,38
1265446,892295,2019-08-26,Senate,"Senate 3rd Reading SCR57 Hueso et al",39,0,1,0,40
1265446,892296,2019-09-05,Assembly,"Be adopted. To Consent Calendar",11,0,1,0,12
1265446,892297,2019-09-09,Assembly,"SCR 57 Hueso Consent Calendar Second Day Regular Session",79,0,0,0,79
1265451,883853,2019-06-13,Senate,"Senate 3rd Reading SR46 Rubio",39,0,1,0,40
1265455,876910,2019-06-03,Assembly,"Be adopted. To third reading",11,0,1,0,12
1265705,883092,2019-06-17,Senate,"Senate 3rd Reading SCR58 Bradford et al",40,0,0,0,40
1265705,885747,2019-06-20,Assembly,"Be adopted. To Consent Calendar",9,0,3,0,12
1265705,888471,2019-06-27,Assembly,"SCR 58 Bradford Consent Calendar Second Day Regular Session",71,0,8,0,79
1265714,893673,2019-07-08,Assembly,"Be adopted. To Consent Calendar",15,0,0,0,15
1265714,893674,2019-07-11,Assembly,"ACR 97 Patterson Consent Calendar Second Day Regular Session",76,0,3,0,79
1265714,974822,2020-08-04,Senate,"Be adopted, but first be re-referred to the Committee on [Appropriations] with recommendation: To Consent Calendar",13,1,1,0,15
1265714,977360,2020-08-28,Senate,"Special Consent ACR97 Patterson By Borgeas",38,0,2,0,40
1266580,892348,2019-07-09,Assembly,"Be adopted, and re-refer to the Committee on [Appropriations] with recommendation: To Consent Calendar",15,0,0,0,15
1266580,892349,2019-08-21,Assembly,"Be adopted. To third reading",17,0,1,0,18
1266580,892350,2019-08-26,Assembly,"ACR 98 Wicks Assembly Third Reading",77,0,2,0,79
1266581,885805,2019-06-18,Assembly,"Be adopted as amended",9,2,1,0,12
1266581,890421,2019-08-27,Senate,"Be adopted as amended",7,2,0,0,9
1266581,890422,2019-09-04,Senate,"Assembly 3rd Reading ACR99 Low et al. By Umberg",29,7,4,0,40
1266581,890423,2019-09-09,Assembly,"ACR 99 Low Concurrence in Senate Amendments",61,11,7,0,79
1266887,894143,2019-07-08,Assembly,"Be adopted. To Consent Calendar",11,0,1,0,12
1266887,894144,2019-07-11,Assembly,"ACR 100 Choi Consent Calendar Second Day",76,0,3,0,79
1266887,894145,2019-08-22,Senate,"Special Consent ACR100",39,0,1,0,40
1266888,892895,2019-07-03,Senate,"Be adopted. Ordered to third reading",6,0,1,0,7
1266888,892896,2019-07-05,Senate,"Senate 3rd Reading SR47 Wieckowski",28,0,12,0,40
1266889,893762,2019-07-02,Assembly,"Be adopted. To Consent Calendar",15,0,0,0,15
1266889,893763,2019-07-08,Assembly,"ACR 101 Lackey Consent Calendar Second Day",76,0,3,0,79
1266889,901482,2020-01-08,Senate,"Be adopted and be ordered to the Consent Calendar",8,0,0,0,8
1266889,904123,2020-01-21,Senate,"Consent Calendar ACR101 Lackey et al",38,0,1,0,39
1267196,881508,2019-06-13,Assembly,"Be adopted. To third reading",11,0,1,0,12
1267196,892584,2019-07-11,Senate,"Special Consent ACR103",39,0,1,0,40
1267197,892845,2019-07-10,Assembly,"Be adopted and re-referred to the Committee on [Appropriations]",21,0,0,0,21
1267197,892846,2019-08-14,Assembly,"Be adopted. To third reading",18,0,0,0,18
1267197,892847,2019-08-19,Assembly,"ACR 102 Bigelow Assembly Third Reading",74,3,2,0,79
1267642,885879,2019-06-20,Assembly,"Be adopted. To Consent Calendar",9,0,3,0,12
1267642,888505,2019-06-27,Assembly,"ACR 104 Bonta Consent Calendar Second Day",71,0,8,0,79
1267642,894150,2019-08-22,Senate,"Special Consent ACR104",39,0,1,0,40
1267644,886376,2019-06-20,Assembly,"Be adopted. To Consent Calendar",9,0,3,0,12
1267644,888504,2019-06-27,Assembly,"HR 43 Choi Consent Calendar Second Day Regular Session",71,0,8,0,79
1267645,893410,2019-07-09,Assembly,"Be adopted. To third reading",10,0,1,0,11
1267645,893411,2019-08-12,Assembly,"AJR 20 Patterson Assembly Third Reading",77,0,2,0,79
1267646,893469,2019-07-08,Senate,"Be adopted. Ordered to third reading",9,0,0,0,9
1267646,893470,2019-09-06,Senate,"Senate 3rd Reading SR48 Hueso et al",35,0,5,0,40
1267647,888719,2019-06-27,Senate,"Senate 3rd Reading SR49 Glazer et al",37,0,3,0,40
1267911,893907,2019-08-26,Assembly,"Be adopted. To Consent Calendar",11,0,1,0,12
1267911,893908,2019-08-30,Assembly,"HR 44 Choi Consent Calendar Second Day Regular Session",67,0,12,0,79
1268424,888407,2019-06-27,Senate,"Senate 3rd Reading SR50 McGuire et al",37,0,3,0,40
1269078,888406,2019-06-27,Senate,"Senate 3rd Reading SCR60 Mitchell et al",37,0,3,0,40
1269078,892805,2019-07-08,Assembly,"Be adopted. To Consent Calendar",11,0,1,0,12
1269078,892806,2019-07-11,Assembly,"SCR 60 Mitchell Consent Calendar Second Day Regular Session",76,0,3,0,79
1269079,891439,2019-07-02,Assembly,"Be adopted and re-referred to the Committee on [Appropriations]",11,0,4,0,15
1269079,891440,2019-08-14,Assembly,"Be adopted. To third reading",15,0,3,0,18
1269079,891441,2019-08-19,Assembly,"ACR 105 Chiu Assembly Third Reading",68,0,11,0,79
1269347,894168,2019-07-08,Assembly,"Be adopted. To Consent Calendar",11,0,1,0,12
1269347,894169,2019-07-11,Assembly,"ACR 106 Cristina Garcia Consent Calendar Second Day Regular Session",76,0,3,0,79
1269347,894170,2019-08-22,Senate,"Special Consent ACR106",39,0,1,0,40
1269357,893883,2019-07-01,Assembly,"Be adopted. To Consent Calendar",11,0,1,0,12
1269357,893884,2019-07-05,Assembly,"HR 45 Maienschein Consent Calendar Second Day",70,0,9,0,79
1269507,890739,2019-08-26,Assembly,"Be adopted. To third reading",8,2,2,0,12
1269507,890740,2019-09-03,Assembly,"AJR 21 Gonzalez Assembly Third Reading",58,4,17,0,79
1269721,889236,2019-07-01,Senate,"Senate 3rd Reading SR51 Dodd",38,0,2,0,40
1270465,891932,2019-07-08,Assembly,"Be adopted. To Consent Calendar",11,0,1,0,12
1270465,891933,2019-08-12,Assembly,"HR 46 Choi Consent Calendar Second Day Regular Session",77,0,2,0,79
1270487,891557,2019-07-08,Assembly,"Be adopted. To Consent Calendar",11,0,1,0,12
1270487,891558,2019-08-12,Assembly,"HR 47 Choi Consent Calendar Second Day Regular Session",77,0,2,0,79
1270509,890952,2019-09-11,Assembly,"Be adopted. To Consent Calendar",14,0,1,0,15
1270509,893980,2019-09-14,Assembly,"ACR 107 Melendez Consent Calendar Second Day Regular Session",75,0,4,0,79
1270509,974836,2020-08-04,Senate,"Be adopted, but first be re-referred to the Committee on [Appropriations] with recommendation: To Consent Calendar",13,1,1,0,15
1270509,977401,2020-08-28,Senate,"Special Consent ACR107",38,0,2,0,40
1270509,978126,2020-08-30,Assembly,"ACR 107 Waldron Concurrence in Senate Amendments",75,0,4,0,79
1270615,891829,2019-08-26,Assembly,"Be adopted. To third reading",8,3,1,0,12
1270615,891830,2019-09-05,Assembly,"ACR 110 Wicks Assembly Third Reading",60,15,4,0,79
1270640,962359,2020-06-02,Senate,"Be adopted, but first be re-referred to the Committee on [Appropriations]",9,3,4,0,16
1270640,964323,2020-06-09,Senate,"Placed on suspense file",7,0,0,0,7
1270666,891025,2019-08-22,Assembly,"Be adopted. To Consent Calendar",12,0,0,0,12
1270666,891026,2019-08-30,Assembly,"ACR 109 Quirk-Silva Consent Calendar Second Day Regular Session",67,0,12,0,79
1270666,891027,2019-09-09,Senate,"Assembly 3rd Reading ACR109",40,0,0,0,40
1270691,893438,2019-07-09,Senate,"Be adopted, but first be re-referred to the Committee on [Appropriations] with recommendation: To Consent Calendar",13,0,0,0,13
1270691,893439,2019-08-15,Senate,"Consent Calendar SCR62",37,0,3,0,40
1270827,894172,2019-07-11,Assembly,"Be adopted. To third reading",11,0,1,0,12
1270849,890700,2019-09-11,Assembly,"Be adopted. To Consent Calendar",14,0,1,0,15
1270849,893973,2019-09-14,Assembly,"ACR 112 Bigelow Consent Calendar Second Day Regular Session",75,0,4,0,79
1270849,974821,2020-08-04,Senate,"Be adopted, but first be re-referred to the Committee on [Appropriations] with recommendation: To Consent Calendar",13,1,1,0,15
1270849,977284,2020-08-28,Senate,"Special Consent ACR112",38,0,2,0,40
1270849,978204,2020-08-30,Assembly,"ACR 112 Bigelow Concurrence in Senate Amendments",75,0,4,0,79
1270855,902822,2020-01-14,Senate,"Be adopted. Ordered to third reading",6,1,0,0,7
1270855,904106,2020-01-21,Senate,"Senate 3rd Reading SJR10 Bradford",29,6,4,0,39
1270860,894139,2019-07-08,Assembly,"Be adopted. To Consent Calendar",11,0,1,0,12
1270860,894140,2019-07-11,Assembly,"ACR 111 Kiley Consent Calendar Second Day Regular Session",76,0,3,0,79
1270860,894141,2019-08-22,Senate,"Special Consent ACR111",39,0,1,0,40
1270888,891687,2019-08-15,Assembly,"Be adopted. To Consent Calendar",10,0,2,0,12
1270888,891688,2019-08-22,Assembly,"ACR 114 Kalra Consent Calendar Second Day",74,0,5,0,79
1270888,891689,2019-09-09,Senate,"Assembly 3rd Reading ACR114",40,0,0,0,40
1270894,894083,2019-07-11,Assembly,"Be adopted. To third reading",11,0,1,0,12
1270894,894084,2019-08-30,Senate,"Special Consent ACR113",37,0,3,0,40
1270912,890350,2019-08-12,Assembly,"Be adopted. To third reading",9,2,1,0,12
1270912,890351,2019-08-26,Assembly,"ACR 115 Kamlager-Dove Assembly Third Reading",50,18,11,0,79
1270912,903163,2020-01-15,Senate,"Be adopted. Ordered to third reading",4,1,2,0,7
1271061,894073,2019-07-11,Assembly,"Be adopted. To Consent Calendar",11,0,1,0,12
1271061,894074,2019-08-15,Assembly,"HR 49 Kalra Consent Calendar Second Day",76,0,3,0,79
1271063,891525,2019-08-26,Assembly,"Be adopted. To third reading",8,2,2,0,12
1271063,891526,2019-09-03,Assembly,"AJR 22 Ting Assembly Third Reading",60,3,16,0,79
1271193,891603,2019-08-26,Senate,"Senate 3rd Reading SCR63 Skinner et al",39,0,1,0,40
1271193,891604,2019-09-05,Assembly,"Be adopted. To Consent Calendar",11,0,1,0,12
1271193,891605,2019-09-09,Assembly,"SCR 63 Skinner Consent Calendar Second Day Regular Session",79,0,0,0,79
1272853,894082,2019-09-04,Senate,"Senate 3rd Reading SR55 Leyva et al",40,0,0,0,40
1272856,894067,2019-08-19,Senate,"Senate 3rd Reading SCR64 Bates et al",40,0,0,0,40
1272856,894068,2019-08-26,Assembly,"Be adopted. To Consent Calendar",11,0,1,0,12
1272856,894069,2019-08-30,Assembly,"SCR 64 Bates Consent Calendar Second Day Regular Session",67,0,12,0,79
1272860,893575,2019-08-28,Senate,"Be adopted as amended",11,0,2,0,13
1272860,893576,2019-08-30,Senate,"Senate 3rd Reading SJR11",37,0,3,0,40
1272864,893185,2019-09-03,Senate,"Senate 3rd Reading SR54 Dodd et al",40,0,0,0,40
1272872,893636,2019-08-26,Senate,"Senate 3rd Reading SCR65 Dodd et al",39,0,1,0,40
1272872,893637,2019-09-05,Assembly,"Be adopted. To Consent Calendar",11,0,1,0,12
1272872,893638,2019-09-09,Assembly,"SCR 65 Dodd Consent Calendar Second Day Regular Session",79,0,0,0,79
1272876,893875,2019-08-19,Senate,"Senate 3rd Reading SR53 Hertzberg",40,0,0,0,40
1272879,894106,2019-08-19,Assembly,"Be adopted. To Consent Calendar",10,0,2,0,12
1272880,891482,2019-08-19,Assembly,"Be adopted. To Consent Calendar",10,0,2,0,12
1272880,891483,2019-08-22,Assembly,"ACR 118 Wicks Consent Calendar Second Day Regular Session",74,0,5,0,79
1272880,891484,2019-09-09,Senate,"Assembly 3rd Reading ACR118",40,0,0,0,40
1272881,894136,2019-08-22,Assembly,"Be adopted. To Consent Calendar",12,0,0,0,12
1272881,894137,2019-08-30,Assembly,"ACR 122 Gonzalez Consent Calendar Second Day Regular Session",67,0,12,0,79
1272881,894138,2019-09-05,Senate,"Assembly 3rd Reading ACR122 Gonzalez et al. By Mitchell",40,0,0,0,40
1272882,890749,2019-09-11,Assembly,"Be adopted. To Consent Calendar",14,0,1,0,15
1272882,893977,2019-09-14,Assembly,"ACR 120 Quirk Consent Calendar Second Day Regular Session",75,0,4,0,79
1272882,974820,2020-08-04,Senate,"Be adopted, but first be re-referred to the Committee on [Appropriations] with recommendation: To Consent Calendar",13,1,1,0,15
1272882,977286,2020-08-28,Senate,"Special Consent ACR120",38,0,2,0,40
1272883,892310,2019-08-22,Assembly,"Be adopted. To Consent Calendar",12,0,0,0,12
1272883,892311,2019-08-30,Assembly,"ACR 121 Chen Consent Calendar Second Day Regular Session",67,0,12,0,79
1272883,892312,2019-09-09,Senate,"Assembly 3rd Reading ACR121",40,0,0,0,40
1272884,894179,2019-08-19,Assembly,"Be adopted. To Consent Calendar",10,0,2,0,12
1272884,894180,2019-08-22,Assembly,"HR 52 Lackey Consent Calendar Second Day Regular Session",74,0,5,0,79
1272885,893989,2019-08-22,Assembly,"Be adopted. To Consent Calendar",12,0,0,0,12
1272885,893990,2019-09-03,Assembly,"HR 54 Kamlager-Dove Consent Calendar Second Day",76,0,3,0,79
1272886,890687,2019-09-11,Assembly,"Be adopted. To Consent Calendar",14,0,1,0,15
1272886,893967,2019-09-14,Assembly,"ACR 119 Flora Consent Calendar Second Day Regular Session",75,0,4,0,79
1272886,974802,2020-08-04,Senate,"Be adopted, but first be re-referred to the Committee on [Appropriations] with recommendation: To Consent Calendar",13,1,1,0,15
1272886,977311,2020-08-28,Senate,"Special Consent ACR119",38,0,2,0,40
1272886,978178,2020-08-30,Assembly,"ACR 119 Flora Concurrence in Senate Amendments",75,0,4,0,79
1272888,891122,2019-08-19,Assembly,"Be adopted. To Consent Calendar",10,0,2,0,12
1272888,891123,2019-08-22,Assembly,"ACR 117 Eduardo Garcia Consent Calendar Second Day Regular Session",74,0,5,0,79
1272888,891124,2019-09-09,Senate,"Assembly 3rd Reading ACR117",40,0,0,0,40
1272889,894100,2019-08-30,Assembly,"Be adopted. To Consent Calendar",12,0,0,0,12
1272889,894101,2019-09-05,Assembly,"HR 53 Limón Consent Calendar Second Day",79,0,0,0,79
1272905,902820,2020-01-14,Senate,"Be adopted, but first be re-referred to the Committee on [Appropriations] with recommendation: To Consent Calendar",9,0,3,0,12
1272905,906385,2020-01-27,Senate,"Special Consent SCR67",38,0,1,0,39
1272905,957329,2020-05-04,Assembly,"Be adopted. To Consent Calendar",15,0,0,0,15
1272905,960452,2020-05-26,Assembly,"SCR 67 Archuleta Consent Calendar Second Day Regular Session",75,0,4,0,79
1272906,891196,2019-08-26,Senate,"Senate 3rd Reading SR56 Lena Gonzalez et al",39,0,1,0,40
1272907,890738,2019-09-11,Assembly,"Be adopted. To Consent Calendar",14,0,1,0,15
1272907,893976,2019-09-14,Assembly,"ACR 124 Arambula Consent Calendar Second Day Regular Session",75,0,4,0,79
1272907,974806,2020-08-04,Senate,"Be adopted, but first be re-referred to the Committee on [Appropriations] with recommendation: To Consent Calendar",13,1,1,0,15
1272907,977369,2020-08-28,Senate,"Consent Calendar ACR124",39,0,1,0,40
1272908,893876,2019-08-15,Assembly,"Be adopted. To third reading",10,0,2,0,12
1272909,893086,2019-08-26,Assembly,"Be adopted. To Consent Calendar",11,0,1,0,12
1272909,893087,2019-08-30,Assembly,"ACR 123 Gabriel Consent Calendar Second Day Regular Session",67,0,12,0,79
1272909,893088,2019-09-09,Senate,"Assembly 3rd Reading ACR123",40,0,0,0,40
1272910,902823,2020-01-14,Senate,"Be adopted as amended, but first amend, and re-refer to the Committee on [Appropriations] with the recommendation: To Consent Calendar",9,0,3,0,12
1272910,906379,2020-01-27,Senate,"Special Consent SCR68",38,0,1,0,39
1272910,957324,2020-05-04,Assembly,"Be adopted. To Consent Calendar",15,0,0,0,15
1272910,960438,2020-05-26,Assembly,"SCR 68 Archuleta Consent Calendar Second Day Regular Session",75,0,4,0,79
1272942,902845,2020-01-14,Senate,"Be adopted, but first be re-referred to the Committee on [Appropriations]",5,0,2,0,7
1272942,904102,2020-01-21,Senate,"Placed on suspense file",7,0,0,0,7
1272942,905339,2020-01-23,Senate,"Be adopted as amended",6,0,1,0,7
1272942,912021,2020-01-30,Senate,"Senate 3rd Reading SCR69 Bradford",30,0,9,0,39
1272948,892963,2019-08-22,Senate,"Senate 3rd Reading SCR70 Dodd",38,0,2,0,40
1272948,892964,2019-08-30,Assembly,"Be adopted. To Consent Calendar",12,0,0,0,12
1272948,892965,2019-09-05,Assembly,"SCR 70 Dodd Consent Calendar Second Day Regular Session",79,0,0,0,79
1272951,893606,2019-09-09,Assembly,"Be adopted. To third reading",7,0,0,0,7
1272951,893961,2019-09-14,Assembly,"ACR 125 Jones-Sawyer Consent Calendar Second Day",75,0,4,0,79
1272954,891765,2019-08-29,Senate,"Be adopted. Ordered to third reading",6,0,3,0,9
1272954,891766,2019-08-30,Senate,"Senate 3rd Reading SJR12 Grove",26,2,12,0,40
1272957,894230,2019-08-29,Senate,"Be adopted. Ordered to third reading",5,0,2,0,7
1272957,894231,2019-09-06,Senate,"Senate 3rd Reading SR57 Hueso",39,0,1,0,40
1272973,894098,2019-08-22,Assembly,"Be adopted. To third reading",12,0,0,0,12
1272974,892320,2019-08-19,Assembly,"Be adopted. To Consent Calendar",10,0,2,0,12
1272974,892321,2019-08-22,Assembly,"ACR 126 Maienschein Consent Calendar Second Day Regular Session",74,0,5,0,79
1272974,892322,2019-09-09,Senate,"Assembly 3rd Reading ACR126",40,0,0,0,40
1272976,890732,2019-09-11,Assembly,"Be adopted. To Consent Calendar",14,0,1,0,15
1272976,893979,2019-09-14,Assembly,"ACR 128 Gray Consent Calendar Second Day Regular Session",75,0,4,0,79
1272976,974826,2020-08-04,Senate,"Be adopted, but first be re-referred to the Committee on [Appropriations] with recommendation: To Consent Calendar",13,1,1,0,15
1272976,977739,2020-08-30,Senate,"Assembly 3rd Reading ACR128 Gray et al. By Galgiani",39,0,1,0,40
1272976,977740,2020-08-31,Assembly,"ACR 128 Gray Concurrence in Senate Amendments",76,0,3,0,79
1272977,890703,2019-09-11,Assembly,"Be adopted. To Consent Calendar",14,0,1,0,15
1272977,893974,2019-09-14,Assembly,"ACR 127 Flora Consent Calendar Second Day Regular Session",75,0,4,0,79
1272977,974815,2020-08-04,Senate,"Be adopted, but first be re-referred to the Committee on [Appropriations] with recommendation: To Consent Calendar",13,1,1,0,15
1272977,977334,2020-08-28,Senate,"Special Consent ACR127",38,0,2,0,40
1272977,978051,2020-08-30,Assembly,"ACR 127 Flora Concurrence in Senate Amendments",75,0,4,0,79
1273021,892542,2019-08-26,Assembly,"Be adopted. To Consent Calendar",11,0,1,0,12
1273021,892543,2019-08-30,Assembly,"ACR 133 Kalra Consent Calendar Second Day Regular Session",67,0,12,0,79
1273021,892544,2019-09-09,Senate,"Assembly 3rd Reading ACR133",40,0,0,0,40
1273023,892362,2019-08-26,Assembly,"Be adopted. To Consent Calendar",11,0,1,0,12
1273023,892363,2019-08-30,Assembly,"HR 58 Reyes Consent Calendar Second Day Regular Session",67,0,12,0,79
1273024,893603,2019-08-26,Assembly,"Be adopted. To third reading",9,0,3,0,12
1273024,893604,2019-09-09,Senate,"Assembly 3rd Reading ACR130 Weber et al. By Bradford",31,0,9,0,40
1273025,894102,2019-08-30,Assembly,"Be adopted. To Consent Calendar",12,0,0,0,12
1273025,894103,2019-09-05,Assembly,"HR 59 Blanca Rubio Consent Calendar Second Day Regular Session",79,0,0,0,79
1273026,892673,2019-08-26,Assembly,"Be adopted. To third reading",11,0,1,0,12
1273026,892674,2019-09-09,Senate,"Assembly 3rd Reading ACR129",40,0,0,0,40
1273027,892567,2019-08-22,Assembly,"Be adopted. To Consent Calendar",12,0,0,0,12
1273027,892568,2019-08-30,Assembly,"ACR 131 Petrie-Norris Consent Calendar Second Day Regular Session",67,0,12,0,79
1273027,892569,2019-09-09,Senate,"Assembly 3rd Reading ACR131",40,0,0,0,40
1273028,892586,2019-08-26,Assembly,"Be adopted. To Consent Calendar",11,0,1,0,12
1273028,892587,2019-08-30,Assembly,"ACR 132 Kalra Consent Calendar Second Day Regular Session",67,0,12,0,79
1273028,892588,2019-09-09,Senate,"Assembly 3rd Reading ACR132",40,0,0,0,40
1273101,892886,2019-09-03,Senate,"Senate 3rd Reading SR60 Hill",40,0,0,0,40
1273103,892301,2019-08-30,Senate,"Senate 3rd Reading SCR72 Morrell et al",37,0,3,0,40
1273103,892302,2019-09-05,Assembly,"Be adopted. To Consent Calendar",11,0,1,0,12
1273103,892303,2019-09-09,Assembly,"SCR 72 Morrell Consent Calendar Second Day Regular Session",79,0,0,0,79
1273104,892557,2019-09-03,Senate,"Senate 3rd Reading SR59 Skinner",40,0,0,0,40
1273133,891889,2019-08-30,Senate,"Senate 3rd Reading SCR73",37,0,3,0,40
1273133,891890,2019-09-05,Assembly,"Be adopted. To Consent Calendar",11,0,1,0,12
1273133,891891,2019-09-09,Assembly,"SCR 73 Pan Consent Calendar Second Day Regular Session",79,0,0,0,79
1273134,891163,2019-08-26,Assembly,"Be adopted. To Consent Calendar",11,0,1,0,12
1273134,891164,2019-08-30,Assembly,"ACR 134 Chu Consent Calendar Second Day Regular Session",67,0,12,0,79
1273134,891165,2019-09-09,Senate,"Assembly 3rd Reading ACR134",40,0,0,0,40
1273135,891826,2019-08-30,Senate,"Senate 3rd Reading SCR74",37,0,3,0,40
1273135,891827,2019-09-05,Assembly,"Be adopted. To Consent Calendar",11,0,1,0,12
1273135,891828,2019-09-09,Assembly,"SCR 74 Pan Consent Calendar Second Day Regular Session",79,0,0,0,79
1273136,894010,2019-08-30,Senate,"Senate 3rd Reading SR62 Durazo",34,0,6,0,40
1273147,891109,2019-08-26,Assembly,"Be adopted. To Consent Calendar",11,0,1,0,12
1273147,891110,2019-08-30,Assembly,"ACR 135 Calderon Consent Calendar Second Day Regular Session",67,0,12,0,79
1273147,891111,2019-09-09,Senate,"Assembly 3rd Reading ACR135",40,0,0,0,40
1273147,891112,2019-09-10,Assembly,"ACR 135 Calderon Concurrence in Senate Amendments",79,0,0,0,79
1273328,894012,2019-09-05,Assembly,"Be adopted. To Consent Calendar",11,0,1,0,12
1273328,894013,2019-09-09,Assembly,"HR 60 Blanca Rubio Consent Calendar Second Day",79,0,0,0,79
1273330,893504,2019-08-30,Senate,"Senate 3rd Reading SCR75",37,0,3,0,40
1273330,893505,2019-09-05,Assembly,"Be adopted. To Consent Calendar",11,0,1,0,12
1273330,893506,2019-09-09,Assembly,"SCR 75 Hurtado Consent Calendar Second Day Regular Session",79,0,0,0,79
1273331,894151,2019-09-05,Assembly,"Be adopted. To third reading",11,0,1,0,12
1273373,893466,2019-08-30,Senate,"Senate 3rd Reading SCR76",37,0,3,0,40
1273373,893467,2019-09-05,Assembly,"Be adopted. To Consent Calendar",11,0,1,0,12
1273373,893468,2019-09-09,Assembly,"SCR 76 Rubio Consent Calendar Second Day Regular Session",79,0,0,0,79
1273376,894019,2019-09-05,Assembly,"Be adopted. To Consent Calendar",11,0,1,0,12
1273376,894020,2019-09-09,Assembly,"HR 62 Flora Consent Calendar Second Day Regular Session",79,0,0,0,79
1273466,894095,2019-09-05,Senate,"Senate 3rd Reading SR64 Hurtado et al",40,0,0,0,40
1273580,894096,2019-09-05,Senate,"Senate 3rd Reading SR65 Jackson",40,0,0,0,40
1273644,894036,2019-09-05,Assembly,"Be adopted. To Consent Calendar",11,0,1,0,12
1273644,894037,2019-09-09,Assembly,"HR 65 Gloria Consent Calendar Second Day Regular Session",79,0,0,0,79
1274184,961685,2020-05-29,Senate,"Be adopted, but first be re-referred to the Committee on [Appropriations] with recommendation: To Consent Calendar",13,0,2,0,15
1274184,965641,2020-06-11,Senate,"Consent Calendar SCR77",39,0,1,0,40
1274184,975369,2020-08-10,Assembly,"Be adopted. To Consent Calendar",15,0,0,0,15
1274184,977905,2020-08-30,Senate,"Unfinished Business SCR77 Glazer et al. Concurrence",39,0,1,0,40
1274184,977906,2020-08-30,Assembly,"SCR 77 Glazer Consent Calendar Second Day Regular Session",75,0,4,0,79
1274401,957317,2020-05-04,Assembly,"Be adopted. To Consent Calendar",15,0,0,0,15
1274401,960454,2020-05-26,Assembly,"ACR 139 Arambula Consent Calendar Second Day Regular Session",75,0,4,0,79
1274401,974837,2020-08-04,Senate,"Be adopted, but first be re-referred to the Committee on [Appropriations] with recommendation: To Consent Calendar",13,1,1,0,15
1274401,977299,2020-08-28,Senate,"Consent Calendar ACR139",39,0,1,0,40
1274570,938048,2020-02-27,Assembly,"Be adopted. To Consent Calendar",10,0,2,0,12
1274570,944393,2020-03-05,Assembly,"HR 66 Choi Consent Calendar Second Day Regular Session",72,0,8,0,80
1295821,959741,2020-05-20,Assembly,"Do pass and be re-referred to the Committee on [Appropriations]",7,0,0,0,7
1295821,962875,2020-06-03,Assembly,"Do pass",18,0,0,0,18
1295821,965696,2020-06-11,Assembly,"AB 1850 Gonzalez Assembly Third Reading",76,0,3,0,79
1295823,905376,2020-01-23,Assembly,"Be adopted. To Consent Calendar",11,0,1,0,12
1295823,912024,2020-01-30,Assembly,"ACR 144 Low Consent Calendar Second Day",76,0,4,0,80
1295823,925959,2020-02-18,Senate,"Assembly 3rd Reading ACR144 Low By Glazer",35,0,4,0,39
1295824,901762,2020-01-09,Assembly,"HR 68 Rendon Assembly Third Reading",75,0,5,0,80
1295826,958321,2020-05-12,Senate,"Do pass, but first be re-referred to the Committee on [Appropriations] with the recommendation: To Consent Calendar",13,0,3,0,16
1295826,965637,2020-06-11,Senate,"Consent Calendar SB794",39,0,1,0,40
1295826,974805,2020-08-03,Assembly,"Do pass and be re-referred to the Committee on [Appropriations]",3,0,16,0,19
1295828,958507,2020-05-13,Senate,"Do pass, but first be re-referred to the Committee on [Appropriations]",8,1,0,0,9
1295828,964344,2020-06-09,Senate,"Placed on suspense file",7,0,0,0,7
1295828,967472,2020-06-18,Senate,"Do pass as amended",5,1,1,0,7
1295828,969792,2020-06-25,Senate,"Senate 3rd Reading SB793 Hill et al",33,4,3,0,40
1295828,975009,2020-08-04,Assembly,"Do pass as amended and be re-referred to the Committee on [Appropriations]",10,2,3,0,15
1295828,976414,2020-08-20,Assembly,"Do pass",13,3,2,0,18
1295828,976623,2020-08-24,Assembly,"SB 793 Hill Senate Third Reading By WOOD",58,1,20,0,79
1295828,977348,2020-08-28,Senate,"Unfinished Business SB793 Hill et al. Concurrence",34,0,6,0,40
1295841,901662,2020-01-09,Assembly,"Be adopted. To third reading",12,0,0,0,12
1295841,917149,2020-02-06,Senate,"Special Consent ACR142 Choi et al",38,0,1,0,39
1295842,958330,2020-05-12,Assembly,"Do pass and be re-referred to the Committee on [Appropriations]",8,0,0,0,8
1295842,962361,2020-06-02,Assembly,"Do pass",15,1,2,0,18
1295842,965070,2020-06-10,Assembly,"AB 1851 Wicks Assembly Third Reading",70,4,5,0,79
1295842,974277,2020-07-29,Senate,"Do pass as amended, but first amend, and re-refer to the Committee on [Appropriations]",6,0,1,0,7
1295842,976619,2020-08-24,Senate,"Assembly 3rd Reading AB1851 Wicks et al. By Wiener",38,1,1,0,40
1295842,976903,2020-08-26,Assembly,"AB 1851 Wicks Concurrence in Senate Amendments By RIVAS, R",73,0,6,0,79
1295843,949772,2020-03-11,Assembly,"Do pass and be re-referred to the Committee on [Appropriations]",6,1,1,0,8
1295843,962841,2020-06-03,Assembly,"Do pass as amended",15,3,0,0,18
1295843,965028,2020-06-10,Assembly,"AB 1845 Luz Rivas Assembly Third Reading",69,0,10,0,79
1295843,975314,2020-08-10,Senate,"Do pass as amended, but first amend, and re-refer to the Committee on [Appropriations]",5,1,1,0,7
1295843,976042,2020-08-17,Senate,"Placed on suspense file",7,0,0,0,7
1295843,976324,2020-08-20,Senate,"Do pass as amended",5,2,0,0,7
1295843,977784,2020-08-30,Senate,"Assembly 3rd Reading AB1845 Luz Rivas et al. By Wiener",36,2,2,0,40
1295843,977785,2020-08-31,Assembly,"AB 1845 Luz Rivas Concurrence in Senate Amendments",69,5,5,0,79
1295846,957785,2020-05-06,Assembly,"Do pass as amended, and be re-referred to the Committee on [Appropriations] with recommendation: To Consent Calendar",7,0,0,0,7
1295846,962751,2020-06-03,Assembly,"Do pass as amended",18,0,0,0,18
1295846,964988,2020-06-10,Assembly,"AB 1837 Smith Assembly Third Reading",78,0,1,0,79
1295847,957768,2020-05-06,Assembly,"Do pass and be re-referred to the Committee on [Appropriations]",7,0,0,0,7
1295847,962845,2020-06-03,Assembly,"Do pass",16,1,1,0,18
1295847,963541,2020-06-08,Assembly,"AB 1835 Weber Assembly Third Reading",75,0,4,0,79
1295847,974286,2020-07-29,Senate,"Do pass, but first be re-referred to the Committee on [Appropriations]",7,0,0,0,7
1295847,975801,2020-08-13,Senate,"Placed on suspense file",7,0,0,0,7
1295847,976462,2020-08-20,Senate,"Do pass",7,0,0,0,7
1295847,977374,2020-08-28,Senate,"Special Consent AB1835",39,0,1,0,40
1295851,903560,2020-01-17,Assembly,"Be adopted. To Consent Calendar",12,0,0,0,12
1295851,905412,2020-01-23,Assembly,"ACR 141 Kalra Consent Calendar Second Day",74,0,6,0,80
1295851,923975,2020-02-14,Senate,"Special Consent ACR141 Kalra et al",34,0,5,0,39
1295854,901666,2020-01-09,Assembly,"Be adopted. To third reading",12,0,0,0,12
1295854,917103,2020-02-06,Senate,"Special Consent ACR140",38,0,1,0,39
1295854,919199,2020-02-10,Assembly,"ACR 140 Mark Stone Concurrence in Senate Amendments",65,0,15,0,80
1295855,960429,2020-05-26,Senate,"Do pass, but first be re-referred to the Committee on [Appropriations]",8,2,1,0,11
1295855,964383,2020-06-09,Senate,"Placed on suspense file",7,0,0,0,7
1295855,967392,2020-06-18,Senate,"Do pass as amended",5,1,1,0,7
1295855,969757,2020-06-25,Senate,"Senate 3rd Reading SB795 Beall et al",29,10,1,0,40
1295855,974297,2020-07-29,Assembly,"Do pass as amended and be re-referred to the Committee on [Appropriations]",7,1,0,0,8
1295856,902818,2020-01-14,Senate,"Be adopted. Ordered to third reading",6,1,2,0,9
1295856,904117,2020-01-21,Senate,"Senate 3rd Reading SR66 Leyva et al",29,9,1,0,39
1297310,966456,2020-06-15,Assembly,"AB 1893 BUDGET Assembly Third Reading By TING",60,14,5,0,79
1297311,966523,2020-06-15,Assembly,"AB 1897 BUDGET Assembly Third Reading By TING",60,14,5,0,79
1297312,966515,2020-06-15,Assembly,"AB 1868 BUDGET Assembly Third Reading By TING",60,14,5,0,79
1297312,977459,2020-08-29,Senate,"Do pass",10,5,3,0,18
1297315,966500,2020-06-15,Assembly,"AB 1873 BUDGET Assembly Third Reading By TING",60,14,5,0,79
1297316,966510,2020-06-15,Assembly,"AB 1880 BUDGET Assembly Third Reading By TING",60,14,5,0,79
1297317,966489,2020-06-15,Assembly,"AB 1872 BUDGET Assembly Third Reading By TING",60,14,5,0,79
1297317,977443,2020-08-29,Senate,"Do pass",13,5,0,0,18
1297317,977754,2020-08-31,Senate,"Assembly 3rd Reading AB1872 BUDGET (Ting) By Mitchell",30,9,1,0,40
1297317,977755,2020-08-31,Assembly,"AB 1872 BUDGET Concurrence in Senate Amendments By TING",72,0,7,0,79
1297318,966484,2020-06-15,Assembly,"AB 1869 BUDGET Assembly Third Reading By TING",60,14,5,0,79
1297318,977448,2020-08-29,Senate,"Do pass",14,4,0,0,18
1297318,977790,2020-08-31,Senate,"Assembly 3rd Reading AB1869 BUDGET (Ting) By Mitchell",30,7,3,0,40
1297318,977791,2020-08-31,Assembly,"AB 1869 BUDGET Concurrence in Senate Amendments By TING",59,17,3,0,79
1297321,966493,2020-06-15,Assembly,"AB 1864 BUDGET Assembly Third Reading By TING",60,14,5,0,79
1297321,977453,2020-08-29,Senate,"Do pass",13,5,0,0,18
1297321,977809,2020-08-31,Senate,"Assembly 3rd Reading AB1864 Limón By Mitchell",28,10,2,0,40
1297321,977810,2020-08-31,Assembly,"AB 1864 Limón Concurrence in Senate Amendments",58,16,5,0,79
1297322,966524,2020-06-15,Assembly,"AB 1902 BUDGET Assembly Third Reading By TING",60,14,5,0,79
1297323,966455,2020-06-15,Assembly,"AB 1877 BUDGET Assembly Third Reading By TING",60,14,5,0,79
1297324,966463,2020-06-15,Assembly,"AB 1894 BUDGET Assembly Third Reading By TING",60,14,5,0,79
1297325,966517,2020-06-15,Assembly,"AB 1865 BUDGET Assembly Third Reading By TING",60,14,5,0,79
1297325,966518,2020-06-15,Assembly,"AB 1865 BUDGET Assembly Third Reading By TING",60,14,5,0,79
1297325,966519,2020-06-15,Assembly,"AB 1865 BUDGET Assembly Third Reading By TING",60,14,5,0,79
1297325,966520,2020-06-15,Assembly,"AB 1865 BUDGET Assembly Third Reading By TING",60,14,5,0,79
1297325,977449,2020-08-29,Senate,"Do pass",13,5,0,0,18
1297325,981387,2020-08-29,Senate,"Amendments (Committee's)",5,12,1,0,18
1297329,958320,2020-05-12,Senate,"Do pass, but first be re-referred to the Committee on [Appropriations] with the recommendation: To Consent Calendar",13,0,3,0,16
1297329,965587,2020-06-11,Senate,"Consent Calendar SB800",39,0,1,0,40
1297329,974818,2020-08-03,Assembly,"Do pass and be re-referred to the Committee on [Appropriations] with recommendation: To Consent Calendar",17,0,2,0,19
1297329,975532,2020-08-11,Assembly,"Do pass. To Consent Calendar",17,0,0,0,17
1297329,978026,2020-08-30,Senate,"Unfinished Business SB800 Dodd et al. Concurrence",39,0,1,0,40
1297329,978027,2020-08-30,Assembly,"SB 800 Dodd Consent Calendar Second Day Regular Session",75,0,4,0,79
1297330,966454,2020-06-15,Assembly,"AB 1886 BUDGET Assembly Third Reading By TING",60,14,5,0,79
1297332,966441,2020-06-15,Assembly,"AB 1900 BUDGET Assembly Third Reading By TING",60,14,5,0,79
1297333,966459,2020-06-15,Assembly,"AB 1867 BUDGET Assembly Third Reading By TING",60,14,5,0,79
1297333,977457,2020-08-29,Senate,"Do pass",13,5,0,0,18
1297333,977812,2020-08-31,Senate,"Assembly 3rd Reading AB1867 BUDGET (Ting) By Mitchell",30,9,1,0,40
1297333,977813,2020-08-31,Assembly,"AB 1867 BUDGET Concurrence in Senate Amendments By TING",59,15,5,0,79
1297334,949782,2020-03-11,Assembly,"Do pass and be re-referred to the Committee on [Local Government]",7,0,1,0,8
1297335,903559,2020-01-17,Assembly,"Be adopted. To third reading",12,0,0,0,12
1297335,923981,2020-02-14,Senate,"Special Consent ACR145",34,0,5,0,39
1297336,958781,2020-05-14,Senate,"Do pass as amended, but first amend, and re-refer to the Committee on [Appropriations]",9,1,3,0,13
1297336,964346,2020-06-09,Senate,"Placed on suspense file",7,0,0,0,7
1297336,967487,2020-06-18,Senate,"Do pass",5,2,0,0,7
1297336,969755,2020-06-25,Senate,"Senate 3rd Reading SB801 Glazer et al",36,0,4,0,40
1297337,966490,2020-06-15,Assembly,"AB 1899 BUDGET Assembly Third Reading By TING",60,14,5,0,79
1297338,966516,2020-06-15,Assembly,"AB 1866 BUDGET Assembly Third Reading By TING",60,14,5,0,79
1297339,966443,2020-06-15,Assembly,"AB 1892 BUDGET Assembly Third Reading By TING",60,14,5,0,79
1297341,966514,2020-06-15,Assembly,"AB 1863 BUDGET Assembly Third Reading By TING",60,14,5,0,79
1297343,966462,2020-06-15,Assembly,"AB 1889 BUDGET Assembly Third Reading By TING",60,14,5,0,79
1297344,966476,2020-06-15,Assembly,"AB 1884 BUDGET Assembly Third Reading By TING",60,14,5,0,79
1297345,966485,2020-06-15,Assembly,"AB 1891 BUDGET Assembly Third Reading By TING",60,14,5,0,79
1297346,901663,2020-01-09,Assembly,"Be adopted. To third reading",12,0,0,0,12
1297346,917129,2020-02-06,Senate,"Special Consent ACR146",38,0,1,0,39
1297348,966464,2020-06-15,Assembly,"AB 1885 BUDGET Assembly Third Reading By TING",60,14,5,0,79
1297348,977447,2020-08-29,Senate,"Do pass",13,5,0,0,18
1297348,977795,2020-08-31,Senate,"Assembly 3rd Reading AB1885 BUDGET (Ting) By Mitchell",32,2,6,0,40
1297348,977796,2020-08-31,Assembly,"AB 1885 Budget Concurrence in Senate Amendments By TING",59,10,10,0,79
1297349,966467,2020-06-15,Assembly,"AB 1896 BUDGET Assembly Third Reading By TING",60,14,5,0,79
1297350,966444,2020-06-15,Assembly,"AB 1890 BUDGET Assembly Third Reading By TING",60,14,5,0,79
1297352,966449,2020-06-15,Assembly,"AB 1879 BUDGET Assembly Third Reading By TING",60,14,5,0,79
1297353,966498,2020-06-15,Assembly,"AB 1888 BUDGET Assembly Third Reading By TING",60,14,5,0,79
1297354,966526,2020-06-15,Assembly,"AB 1878 BUDGET Assembly Third Reading By TING",60,14,5,0,79
1297355,966501,2020-06-15,Assembly,"AB 1875 BUDGET Assembly Third Reading By TING",60,14,5,0,79
1297356,957761,2020-05-06,Assembly,"Do pass. To Consent Calendar",7,0,0,0,7
1297356,960444,2020-05-26,Assembly,"AB 1859 Santiago Consent Calendar Second Day Regular Session",75,0,4,0,79
1297356,974261,2020-07-29,Senate,"Do pass as amended, and be ordered to the Consent Calendar",7,0,0,0,7
1297356,977403,2020-08-28,Senate,"Consent Calendar AB1859",39,0,1,0,40
1297356,977724,2020-08-30,Assembly,"AB 1859 Santiago Concurrence in Senate Amendments",75,0,4,0,79
1297358,966471,2020-06-15,Assembly,"AB 1895 BUDGET Assembly Third Reading By TING",60,14,5,0,79
1297359,966473,2020-06-15,Assembly,"AB 1882 BUDGET Assembly Third Reading By TING",60,14,5,0,79
1297360,966503,2020-06-15,Assembly,"AB 1876 BUDGET Assembly Third Reading By TING",60,14,5,0,79
1297360,977440,2020-08-29,Senate,"Do pass",13,5,0,0,18
1297360,977830,2020-08-31,Senate,"Assembly 3rd Reading AB1876 BUDGET (Ting) By Mitchell",28,10,2,0,40
1297360,977831,2020-08-31,Assembly,"AB 1876 BUDGET Concurrence in Senate Amendments By TING",57,17,5,0,79
1297361,966447,2020-06-15,Assembly,"AB 1881 BUDGET Assembly Third Reading By TING",60,14,5,0,79
1297362,966511,2020-06-15,Assembly,"AB 1898 BUDGET Assembly Third Reading By TING",60,14,5,0,79
1297364,966448,2020-06-15,Assembly,"AB 1901 BUDGET Assembly Third Reading By TING",60,14,5,0,79
1297365,966488,2020-06-15,Assembly,"AB 1874 BUDGET Assembly Third Reading By TING",60,14,5,0,79
1297366,966509,2020-06-15,Assembly,"AB 1887 BUDGET Assembly Third Reading By TING",60,14,5,0,79
1297367,966487,2020-06-15,Assembly,"AB 1883 BUDGET Assembly Third Reading By TING",60,14,5,0,79
1297369,966468,2020-06-15,Assembly,"AB 1870 BUDGET Assembly Third Reading By TING",60,14,5,0,79
1297370,966527,2020-06-15,Assembly,"AB 1871 BUDGET Assembly Third Reading By TING",60,14,5,0,79
1299678,958562,2020-05-13,Senate,"Do pass, but first be re-referred to the Committee on [Appropriations] with the recommendation: To Consent Calendar",9,0,0,0,9
1299678,964422,2020-06-09,Senate,"Placed on suspense file",7,0,0,0,7
1299678,967455,2020-06-18,Senate,"Do pass as amended",7,0,0,0,7
1299678,968704,2020-06-24,Senate,"Special Consent SB803",39,0,1,0,40
1299678,975010,2020-08-04,Assembly,"Do pass and be re-referred to the Committee on [Appropriations]",15,0,0,0,15
1299678,976347,2020-08-20,Assembly,"Do pass as amended",18,0,0,0,18
1299678,978169,2020-08-31,Senate,"Unfinished Business SB803 Beall et al. Concurrence",36,1,3,0,40
1299678,978170,2020-08-31,Assembly,"SB 803 Beall Senate Third Reading By Arambula",76,0,3,0,79
1299684,957451,2020-05-05,Assembly,"Do pass and be re-referred to the Committee on [Appropriations] with recommendation: To Consent Calendar",7,0,0,0,7
1299684,962808,2020-06-03,Assembly,"Do pass",18,0,0,0,18
1299684,963564,2020-06-08,Assembly,"AB 1906 Salas Assembly Third Reading",77,0,2,0,79
1299684,974909,2020-08-05,Senate,"Do pass, but first be re-referred to the Committee on [Appropriations] with the recommendation: To Consent Calendar",5,0,0,0,5
1299684,975799,2020-08-13,Senate,"Placed on suspense file",7,0,0,0,7
1299684,976381,2020-08-20,Senate,"Do pass as amended",7,0,0,0,7
1299684,977749,2020-08-30,Senate,"Assembly 3rd Reading AB1906 Salas et al. By Galgiani",39,0,1,0,40
1299684,977750,2020-08-31,Assembly,"AB 1906 Salas Concurrence in Senate Amendments",76,0,3,0,79
1299710,903561,2020-01-17,Senate,"Senate 3rd Reading SR67 Bradford et al",34,0,5,0,39
1299718,958313,2020-05-12,Senate,"Do pass as amended",6,0,1,0,7
1299718,964345,2020-06-09,Senate,"Placed on suspense file",7,0,0,0,7
1299733,902804,2020-01-14,Assembly,"Be adopted. To third reading",8,3,0,0,11
1299733,904119,2020-01-21,Assembly,"HR 69 Limón Assembly Third Reading",55,14,11,0,80
1300951,958792,2020-05-14,Senate,"Do pass, but first be re-referred to the Committee on [Appropriations]",1,4,0,0,5
1300951,958793,2020-05-14,Senate,"[First] hearing set for [05-14-2020]: Failed passage in Committee. Reconsideration granted",5,0,0,0,5
1300971,957320,2020-05-04,Assembly,"Be adopted. To Consent Calendar",15,0,0,0,15
1300971,960473,2020-05-26,Assembly,"ACR 147 Lackey Consent Calendar Second Day Regular Session",75,0,4,0,79
1300971,974803,2020-08-04,Senate,"Be adopted, but first be re-referred to the Committee on [Appropriations] with recommendation: To Consent Calendar",13,1,1,0,15
1300971,977321,2020-08-28,Senate,"Special Consent ACR147",38,0,2,0,40
1300997,906386,2020-01-27,Senate,"Senate 3rd Reading SR68 Pan et al",39,0,0,0,39
1302056,967486,2020-06-18,Senate,"Senate 3rd Reading SB843 B. & F.R",29,11,0,0,40
1302057,967443,2020-06-18,Senate,"Senate 3rd Reading SB818 B. & F.R",29,11,0,0,40
1302059,967390,2020-06-18,Senate,"Senate 3rd Reading SB834 B. & F.R",29,11,0,0,40
1302061,967464,2020-06-18,Senate,"Senate 3rd Reading SB813 B. & F.R",29,11,0,0,40
1302062,967381,2020-06-18,Senate,"Senate 3rd Reading SB835 B. & F.R",29,11,0,0,40
1302064,967462,2020-06-18,Senate,"Senate 3rd Reading SB815 B. & F.R",29,11,0,0,40
1302066,967473,2020-06-18,Senate,"Senate 3rd Reading SB840 B. & F.R",29,11,0,0,40
1302067,967478,2020-06-18,Senate,"Senate 3rd Reading SB830 B. & F.R",29,11,0,0,40
1302069,967435,2020-06-18,Senate,"Senate 3rd Reading SB842 B. & F.R",29,11,0,0,40
1302070,967446,2020-06-18,Senate,"Senate 3rd Reading SB846 B. & F.R",29,11,0,0,40
1302072,967459,2020-06-18,Senate,"Senate 3rd Reading SB816 B. & F.R",29,11,0,0,40
1302074,967471,2020-06-18,Senate,"Senate 3rd Reading SB839 B. & F.R",29,11,0,0,40
1302075,967387,2020-06-18,Senate,"Senate 3rd Reading SB809 B. & F.R. (Mitchell)",29,11,0,0,40
1302078,967409,2020-06-18,Senate,"Senate 3rd Reading SB821 B. & F.R",29,11,0,0,40
1302080,967460,2020-06-18,Senate,"Senate 3rd Reading SB832 B. & F.R",29,11,0,0,40
1302082,967483,2020-06-18,Senate,"Senate 3rd Reading SB837 B. & F.R",29,11,0,0,40
1302083,967458,2020-06-18,Senate,"Senate 3rd Reading SB820 B. & F.R",29,11,0,0,40
1302083,978041,2020-08-31,Senate,"Unfinished Business SB820 B. & F.R. (Mitchell) Concurrence",29,10,1,0,40
1302083,978042,2020-08-31,Assembly,"SB 820 B. & F. R. Senate Third Reading By TING",58,16,5,0,79
1302085,967439,2020-06-18,Senate,"Senate 3rd Reading SB814 B. & F.R",29,11,0,0,40
1302087,967434,2020-06-18,Senate,"Senate 3rd Reading SB823 B. & F.R",29,11,0,0,40
1302087,977865,2020-08-31,Senate,"Unfinished Business SB823 B. & F.R. (Mitchell) Concurrence",21,13,6,0,40
1302087,977866,2020-08-31,Assembly,"SB 823 Budget and Fiscal Review Senate Third Reading By TING",54,16,9,0,79
1302088,967414,2020-06-18,Senate,"Senate 3rd Reading SB822 B. & F.R",29,11,0,0,40
1302090,967395,2020-06-18,Senate,"Senate 3rd Reading SB827 B. & F.R",29,11,0,0,40
1302091,967428,2020-06-18,Senate,"Senate 3rd Reading SB833 B. & F.R",29,11,0,0,40
1302093,967438,2020-06-18,Senate,"Senate 3rd Reading SB825 B. & F.R",29,11,0,0,40
1302095,967480,2020-06-18,Senate,"Senate 3rd Reading SB828 B. & F.R",29,11,0,0,40
1302096,967476,2020-06-18,Senate,"Senate 3rd Reading SB829 B. & F.R",29,11,0,0,40
1302098,967436,2020-06-18,Senate,"Senate 3rd Reading SB844 B. & F.R",29,11,0,0,40
1302100,967470,2020-06-18,Senate,"Senate 3rd Reading SB838 B. & F.R",29,11,0,0,40
1302101,967384,2020-06-18,Senate,"Senate 3rd Reading SB824 B. & F.R",29,11,0,0,40
1302103,967456,2020-06-18,Senate,"Senate 3rd Reading SB811 B. & F.R",29,11,0,0,40
1302104,967451,2020-06-18,Senate,"Senate 3rd Reading SB819 B. & F.R",29,11,0,0,40
1302106,967401,2020-06-18,Senate,"Senate 3rd Reading SB836 B. & F.R",29,11,0,0,40
1302108,967444,2020-06-18,Senate,"Senate 3rd Reading SB817 B. & F.R",29,11,0,0,40
1302109,967467,2020-06-18,Senate,"Senate 3rd Reading SB831 B. & F.R",29,11,0,0,40
1302111,967411,2020-06-18,Senate,"Senate 3rd Reading SB848 B. & F.R",29,11,0,0,40
1302114,967447,2020-06-18,Senate,"Senate 3rd Reading SB812 B. & F.R",29,11,0,0,40
1302117,967466,2020-06-18,Senate,"Senate 3rd Reading SB847 B. & F.R",29,11,0,0,40
1302119,967377,2020-06-18,Senate,"Senate 3rd Reading SB826 B. & F.R",29,11,0,0,40
1302121,967426,2020-06-18,Senate,"Senate 3rd Reading SB810 B. & F.R. (Mitchell)",29,11,0,0,40
1302122,967499,2020-06-18,Senate,"Senate 3rd Reading SB841 B. & F.R",29,11,0,0,40
1302124,967514,2020-06-18,Senate,"Senate 3rd Reading SB845 B. & F.R",29,11,0,0,40
1303143,905380,2020-01-23,Assembly,"Be adopted. To Consent Calendar",11,0,1,0,12
1303143,912018,2020-01-30,Assembly,"HR 71 Kiley Consent Calendar Second Day Regular Session",76,0,4,0,80
1303144,960905,2020-05-27,Senate,"Do pass, but first be re-referred to the Committee on [Appropriations]",1,1,5,0,7
1303144,960906,2020-05-27,Senate,"[First] hearing set for [05-27-2020]: Failed passage in Committee. Reconsideration granted",7,0,0,0,7
1303147,958532,2020-05-13,Senate,"Do pass as amended, but first amend, and re-refer to the Committee on [Appropriations]",7,2,0,0,9
1303147,964334,2020-06-09,Senate,"Placed on suspense file",7,0,0,0,7
1303147,967452,2020-06-18,Senate,"Do pass as amended",5,1,1,0,7
1303147,969773,2020-06-25,Senate,"Senate 3rd Reading SB852 Pan",31,9,0,0,40
1303147,975650,2020-08-12,Assembly,"Do pass as amended and be re-referred to the Committee on [Appropriations]",11,1,3,0,15
1303147,976420,2020-08-20,Assembly,"Do pass as amended",13,5,0,0,18
1303147,978124,2020-08-31,Senate,"Unfinished Business SB852 Pan et al. Concurrence",31,8,1,0,40
1303147,978125,2020-08-31,Assembly,"SB 852 Pan Senate Third Reading By Wood",66,7,6,0,79
1303148,948564,2020-03-10,Assembly,"Do pass and be re-referred to the Committee on [Judiciary]",5,3,1,0,9
1303150,905387,2020-01-23,Senate,"Senate 3rd Reading SCR78 Pan et al",37,0,2,0,39
1303150,912013,2020-01-30,Assembly,"Be adopted. To Consent Calendar",10,0,2,0,12
1303150,917098,2020-02-06,Assembly,"SCR 78 Pan Consent Calendar Second Day Regular Session",75,0,5,0,80
1303155,912037,2020-01-30,Assembly,"Be adopted. To Consent Calendar",10,0,2,0,12
1303155,917121,2020-02-06,Assembly,"HR 70 Quirk Consent Calendar Second Day",75,0,5,0,80
1307964,958569,2020-05-13,Senate,"Do pass as amended, but first amend, and re-refer to the Committee on [Appropriations]",7,2,0,0,9
1307964,964355,2020-06-09,Senate,"Placed on suspense file",7,0,0,0,7
1307964,967493,2020-06-18,Senate,"Do pass as amended",5,2,0,0,7
1307964,969775,2020-06-25,Senate,"Senate 3rd Reading SB855 Wiener et al",30,5,5,0,40
1307964,975007,2020-08-04,Assembly,"Do pass as amended and be re-referred to the Committee on [Appropriations]",13,0,2,0,15
1307964,976407,2020-08-20,Assembly,"Do pass as amended",14,1,3,0,18
1307964,976906,2020-08-26,Assembly,"SB 855 Wiener Senate Third Reading By Arambula",63,1,15,0,79
1307964,978057,2020-08-30,Senate,"Unfinished Business SB855 Wiener et al. Concurrence",30,8,2,0,40
1307964,978058,2020-08-30,Senate,"Unfinished Business SB855 Wiener et al. Concurrence Reconsider",39,0,1,0,40
1307964,978059,2020-08-30,Senate,"Unfinished Business SB855 Wiener et al. Concurrence",31,7,2,0,40
1307968,905379,2020-01-23,Assembly,"Be adopted. To third reading",11,0,1,0,12
1307977,949766,2020-03-11,Assembly,"Do pass as amended and be re-referred to the Committee on [Appropriations]",6,0,2,0,8
1307977,962747,2020-06-03,Assembly,"Do pass",17,0,1,0,18
1307977,963486,2020-06-08,Assembly,"AB 1923 Salas Assembly Third Reading",77,0,2,0,79
1307977,974962,2020-08-06,Senate,"Do pass, but first be re-referred to the Committee on [Appropriations] with the recommendation: To Consent Calendar",11,0,0,0,11
1307977,975837,2020-08-13,Senate,"Placed on suspense file",7,0,0,0,7
1309958,958524,2020-05-13,Assembly,"Do pass as amended and be re-referred to the Committee on [Appropriations]",9,1,2,0,12
1309958,962833,2020-06-03,Assembly,"Do pass",14,0,4,0,18
1309958,965573,2020-06-11,Assembly,"AB 1930 Medina Third Reading Urgency",72,1,6,0,79
1309958,974264,2020-07-29,Senate,"Do pass as amended, but first amend, and re-refer to the Committee on [Appropriations]",5,1,1,0,7
1309958,975845,2020-08-13,Senate,"Placed on suspense file",7,0,0,0,7
1309965,948576,2020-03-10,Assembly,"Do pass as amended, and be re-referred to the Committee on [Appropriations] with recommendation: To Consent Calendar",8,0,0,0,8
1309965,962428,2020-06-02,Assembly,"Do pass. To Consent Calendar",18,0,0,0,18
1309965,963508,2020-06-08,Assembly,"AB 1929 Blanca Rubio Consent Calendar Second Day Regular Session",76,0,3,0,79
1309965,975377,2020-08-10,Senate,"Do pass as amended, but first amend, and re-refer to the Committee on [Appropriations] with the recommendation: To Consent Calendar",7,0,0,0,7
1309965,977396,2020-08-28,Senate,"Consent Calendar AB1929",39,0,1,0,40
1309965,977829,2020-08-30,Assembly,"AB 1929 Blanca Rubio Concurrence in Senate Amendments",75,0,4,0,79
1309985,948570,2020-03-10,Assembly,"Do pass",5,0,3,0,8
1309985,965083,2020-06-10,Assembly,"AB 1927 Boerner Horvath Assembly Third Reading",77,0,2,0,79
1309985,974610,2020-07-31,Senate,"Do pass and be ordered to the Consent Calendar",7,0,0,0,7
1309985,977380,2020-08-28,Senate,"Consent Calendar AB1927",39,0,1,0,40
1309985,978114,2020-08-30,Assembly,"AB 1927 Boerner Horvath Concurrence in Senate Amendments",75,0,4,0,79
1312493,958805,2020-05-14,Senate,"Do pass as amended, but first amend, and re-refer to the Committee on [Appropriations]",12,0,1,0,13
1312493,964332,2020-06-09,Senate,"Placed on suspense file",7,0,0,0,7
1312493,967488,2020-06-18,Senate,"Do pass",7,0,0,0,7
1312493,969769,2020-06-25,Senate,"Senate 3rd Reading SB862 Dodd",40,0,0,0,40
1312703,958312,2020-05-12,Senate,"Do pass as amended, but first amend, and re-refer to the Committee on [Appropriations]",6,0,1,0,7
1312703,965585,2020-06-11,Senate,"Senate 3rd Reading SB860 Beall et al",39,0,1,0,40
1312703,974819,2020-08-03,Assembly,"Do pass and be re-referred to the Committee on [Appropriations] with recommendation: To Consent Calendar",7,0,0,0,7
1312703,976086,2020-08-18,Assembly,"Do pass. To Consent Calendar",18,0,0,0,18
1312703,978066,2020-08-30,Assembly,"SB 860 Beall Consent Calendar Second Day Regular Session",75,0,4,0,79
1312756,957594,2020-05-06,Assembly,"Do pass and be re-referred to the Committee on [Appropriations]",11,0,0,0,11
1312756,962854,2020-06-03,Assembly,"Do pass",18,0,0,0,18
1312756,966470,2020-06-15,Assembly,"AB 1935 Voepel Assembly Third Reading",79,0,0,0,79
1312913,959346,2020-05-18,Assembly,"Do pass and be re-referred to the Committee on [Appropriations]",11,0,4,0,15
1313228,948561,2020-03-10,Assembly,"Do pass as amended and be re-referred to the Committee on [Appropriations]",6,0,2,0,8
1314281,959750,2020-05-19,Assembly,"Do pass as amended and be re-referred to the Committee on [Appropriations]",5,3,0,0,8
1314281,962401,2020-06-02,Assembly,"Do pass",10,7,1,0,18
1314281,966512,2020-06-15,Assembly,"AB 1950 Kamlager Assembly Third Reading",48,22,9,0,79
1314281,974614,2020-07-31,Senate,"Do pass, but first be re-referred to the Committee on [Appropriations]",5,2,0,0,7
1314281,976642,2020-08-24,Senate,"Assembly 3rd Reading AB1950 Kamlager et al. By Mitchell",26,12,2,0,40
1314285,958803,2020-05-14,Assembly,"Do pass and be re-referred to the Committee on [Appropriations]",13,0,1,0,14
1314285,962411,2020-06-02,Assembly,"Do pass as amended",18,0,0,0,18
1314285,963511,2020-06-08,Assembly,"AB 1958 Cooper Third Reading Urgency",74,0,5,0,79
1314287,958299,2020-05-12,Senate,"Do pass, but first be re-referred to the Committee on [Appropriations]",13,0,3,0,16
1314287,964401,2020-06-09,Senate,"Do pass",5,0,2,0,7
1314287,969770,2020-06-25,Senate,"Senate 3rd Reading SB865 Hill",39,0,1,0,40
1314287,974908,2020-08-05,Assembly,"Do pass and be re-referred to the Committee on [Appropriations]",14,0,1,0,15
1314287,976345,2020-08-20,Assembly,"Do pass as amended",18,0,0,0,18
1314287,978077,2020-08-31,Senate,"Unfinished Business SB865 Hill Concurrence",39,0,1,0,40
1314287,978078,2020-08-31,Assembly,"SB 865 Hill Senate Third Reading By Holden",76,0,3,0,79
1314290,958536,2020-05-13,Senate,"Do pass, but first be re-referred to the Committee on [Appropriations] with the recommendation: To Consent Calendar",4,0,1,0,5
1314290,965665,2020-06-11,Senate,"Consent Calendar SB864",39,0,1,0,40
1314291,958780,2020-05-14,Assembly,"Do pass and be re-referred to the Committee on [Appropriations] with recommendation: To Consent Calendar",14,0,0,0,14
1314291,962391,2020-06-02,Assembly,"Do pass as amended. To Consent Calendar",18,0,0,0,18
1314291,965054,2020-06-10,Assembly,"AB 1949 Boerner Horvath Consent Calendar Second Day",77,0,2,0,79
1314291,974880,2020-08-05,Senate,"Do pass as amended, but first amend, and re-refer to the Committee on [Appropriations] with the recommendation: To Consent Calendar",9,0,0,0,9
1314291,976172,2020-08-19,Senate,"Placed on suspense file",7,0,0,0,7
1314291,976348,2020-08-20,Senate,"Do pass as amended",7,0,0,0,7
1314291,977352,2020-08-28,Senate,"Special Consent AB1949",39,0,1,0,40
1314291,978147,2020-08-30,Assembly,"AB 1949 Boerner Horvath Concurrence in Senate Amendments",75,0,4,0,79
1314292,958508,2020-05-12,Assembly,"Do pass and be re-referred to the Committee on [Appropriations]",20,0,1,0,21
1314292,962405,2020-06-02,Assembly,"Do pass",18,0,0,0,18
1314292,963636,2020-06-08,Assembly,"AB 1945 Salas Assembly Third Reading",76,0,3,0,79
1314292,974900,2020-08-05,Senate,"Do pass, but first be re-referred to the Committee on [Appropriations] with the recommendation: To Consent Calendar",5,0,0,0,5
1314292,975807,2020-08-13,Senate,"Placed on suspense file",7,0,0,0,7
1314292,976343,2020-08-20,Senate,"Do pass",7,0,0,0,7
1314292,977387,2020-08-28,Senate,"Special Consent AB1945",39,0,1,0,40
1314292,978208,2020-08-30,Assembly,"AB 1945 Salas Concurrence in Senate Amendments",74,0,5,0,79
1314295,959744,2020-05-20,Assembly,"Do pass and be re-referred to the Committee on [Appropriations]",5,2,0,0,7
1314295,962806,2020-06-03,Assembly,"Do pass",12,5,1,0,18
1314295,964980,2020-06-10,Assembly,"AB 1947 Kalra Assembly Third Reading",46,23,10,0,79
1314295,974473,2020-07-30,Senate,"Do pass, but first be re-referred to the Committee on [Appropriations]",7,2,0,0,9
1314295,975818,2020-08-13,Senate,"Placed on suspense file",7,0,0,0,7
1314295,976441,2020-08-20,Senate,"Do pass",5,2,0,0,7
1314295,976616,2020-08-24,Senate,"Assembly 3rd Reading AB1947 Kalra et al. By Leyva",28,12,0,0,40
1314297,958311,2020-05-12,Senate,"Do pass, but first be re-referred to the Committee on [Appropriations] with the recommendation: To Consent Calendar",13,0,3,0,16
1314297,965669,2020-06-11,Senate,"Consent Calendar SB869 G.O",39,0,1,0,40
1314297,974800,2020-08-03,Assembly,"Do pass and be re-referred to the Committee on [Appropriations] with recommendation: To Consent Calendar",17,0,2,0,19
1314297,975544,2020-08-11,Assembly,"Do pass. To Consent Calendar",17,0,0,0,17
1314297,977880,2020-08-30,Assembly,"SB 869 Dodd Third Reading Urgency By Gray",75,0,4,0,79
1314297,977881,2020-08-31,Senate,"Unfinished Business SB869 Dodd et al. Urgency Clause Concurrence",39,0,1,0,40
1316521,958810,2020-05-14,Senate,"Do pass",9,2,2,0,13
1316521,968060,2020-06-22,Senate,"Senate 3rd Reading SB872 Dodd et al",29,3,8,0,40
1316521,975549,2020-08-11,Assembly,"Do pass as amended",13,0,1,0,14
1316521,976627,2020-08-24,Assembly,"SB 872 Dodd Senate Third Reading By Wood",76,0,3,0,79
1316521,977366,2020-08-28,Senate,"Unfinished Business SB872 Dodd et al. Concurrence",33,0,7,0,40
1316582,948551,2020-03-10,Assembly,"Do pass as amended, and be re-referred to the Committee on [Appropriations] with recommendation: To Consent Calendar",6,0,2,0,8
1316582,962480,2020-06-02,Assembly,"Do pass. To Consent Calendar",18,0,0,0,18
1316582,963549,2020-06-08,Assembly,"AB 1963 Chu Consent Calendar Second Day Regular Session",76,0,3,0,79
1316582,974615,2020-07-31,Senate,"Do pass, but first be re-referred to the Committee on [Appropriations]",7,0,0,0,7
1316582,975833,2020-08-13,Senate,"Placed on suspense file",7,0,0,0,7
1316582,976433,2020-08-20,Senate,"Do pass",7,0,0,0,7
1316582,977288,2020-08-28,Senate,"Special Consent AB1963",39,0,1,0,40
1316582,978062,2020-08-30,Assembly,"AB 1963 Chu Concurrence in Senate Amendments",75,0,4,0,79
1316630,958771,2020-05-14,Assembly,"Do pass and be re-referred to the Committee on [Appropriations]",7,0,0,0,7
1316630,962416,2020-06-02,Assembly,"Do pass. To Consent Calendar",18,0,0,0,18
1316630,963593,2020-06-08,Assembly,"AB 1968 Ramos Consent Calendar Second Day Regular Session",76,0,3,0,79
1316630,974906,2020-08-05,Senate,"Do pass as amended, but first amend, and re-refer to the Committee on [Appropriations] with the recommendation: To Consent Calendar",9,0,0,0,9
1316630,976040,2020-08-17,Senate,"Placed on suspense file",7,0,0,0,7
1316723,959940,2020-05-21,Assembly,"Do pass and be re-referred to the Committee on [Appropriations]",16,1,2,0,19
1316723,962835,2020-06-03,Assembly,"Do pass",12,2,4,0,18
1316723,966482,2020-06-15,Assembly,"AB 1969 Blanca Rubio Assembly Third Reading",54,14,11,0,79
1316723,975373,2020-08-08,Senate,"Do pass, but first be re-referred to the Committee on [Appropriations]",9,0,0,0,9
1316723,975798,2020-08-13,Senate,"Placed on suspense file",7,0,0,0,7
1316723,976369,2020-08-20,Senate,"Do pass",5,2,0,0,7
1316723,978199,2020-08-30,Senate,"Assembly 3rd Reading AB1969 Blanca Rubio et al. By Rubio",32,7,1,0,40
1316723,978200,2020-08-30,Assembly,"AB 1969 Blanca Rubio Concurrence in Senate Amendments",56,7,16,0,79
1318049,959348,2020-05-18,Senate,"Do pass, but first be re-referred to the Committee on [Appropriations]",9,0,0,0,9
1318049,964415,2020-06-09,Senate,"Placed on suspense file",7,0,0,0,7
1318049,967442,2020-06-18,Senate,"Do pass as amended",7,0,0,0,7
1318049,968677,2020-06-24,Senate,"Special Consent SB878",39,0,1,0,40
1318049,975363,2020-08-10,Assembly,"Do pass and be re-referred to the Committee on [Appropriations]",19,0,0,0,19
1318049,976092,2020-08-10,Assembly,"Do pass as amended and be re-referred to the Committee on [Appropriations]",19,0,0,0,19
1318049,976093,2020-08-18,Assembly,"Do pass. To Consent Calendar",18,0,0,0,18
1318049,977889,2020-08-30,Assembly,"SB 878 Jones Consent Calendar Second Day Regular Session",75,0,4,0,79
1318071,958537,2020-05-12,Assembly,"Do pass and be re-referred to the Committee on [Appropriations]",19,0,2,0,21
1318071,962805,2020-06-03,Assembly,"Do pass as amended",18,0,0,0,18
1318071,965030,2020-06-10,Assembly,"AB 1974 Gray Assembly Third Reading",78,0,1,0,79
1318071,975936,2020-08-14,Senate,"Do pass, but first be re-referred to the Committee on [Appropriations]",16,0,0,0,16
1318071,976176,2020-08-19,Senate,"Placed on suspense file",7,0,0,0,7
1318071,976362,2020-08-20,Senate,"Do pass",7,0,0,0,7
1318071,978152,2020-08-30,Senate,"Assembly 3rd Reading AB1974 Gray et al. By Dodd",39,0,1,0,40
1318071,978153,2020-08-30,Assembly,"AB 1974 Gray Concurrence in Senate Amendments",74,0,5,0,79
1318093,913593,2020-02-03,Senate,"Senate 3rd Reading SCR79 Galgiani",38,0,1,0,39
1318093,917107,2020-02-06,Assembly,"Be adopted. To Consent Calendar",10,0,2,0,12
1318093,923980,2020-02-14,Assembly,"SCR 79 Galgiani Consent Calendar Second Day Regular Session",62,0,18,0,80
1318102,959326,2020-05-18,Assembly,"Do pass and be re-referred to the Committee on [Appropriations]",15,0,0,0,15
1318102,962461,2020-06-02,Assembly,"Do pass. To Consent Calendar",18,0,0,0,18
1318102,964982,2020-06-10,Assembly,"AB 1976 Eggman Assembly Third Reading",77,0,2,0,79
1318102,974661,2020-08-01,Senate,"Do pass as amended, but first amend, and re-refer to the Committee on [Appropriations]",8,0,1,0,9
1318102,975806,2020-08-13,Senate,"Placed on suspense file",7,0,0,0,7
1318102,976352,2020-08-20,Senate,"Do pass as amended",7,0,0,0,7
1318102,977179,2020-08-27,Senate,"Assembly 3rd Reading AB1976 Eggman et al. By Stern",30,0,10,0,40
1318102,977848,2020-08-30,Assembly,"AB 1976 Eggman Concurrence in Senate Amendments By WOOD",74,0,5,0,79
1319220,948552,2020-03-10,Assembly,"Do pass and be re-referred to the Committee on [Appropriations] with recommendation: To Consent Calendar",8,0,0,0,8
1319220,962759,2020-06-03,Assembly,"Do pass as amended",18,0,0,0,18
1319220,963509,2020-06-08,Assembly,"AB 1979 Friedman Assembly Third Reading",77,0,2,0,79
1319220,975370,2020-08-10,Senate,"Do pass, but first be re-referred to the Committee on [Appropriations] with the recommendation: To Consent Calendar",7,0,0,0,7
1319220,976037,2020-08-17,Senate,"Placed on suspense file",7,0,0,0,7
1319220,976449,2020-08-20,Senate,"Do pass as amended",7,0,0,0,7
1319220,977307,2020-08-28,Senate,"Special Consent AB1979",39,0,1,0,40
1319220,978119,2020-08-30,Assembly,"AB 1979 Friedman Concurrence in Senate Amendments",75,0,4,0,79
1319222,957784,2020-05-06,Assembly,"Do pass as amended",5,0,2,0,7
1319222,965077,2020-06-10,Assembly,"AB 1981 Nazarian Assembly Third Reading",66,4,9,0,79
1319222,974292,2020-07-29,Senate,"Do pass",7,0,0,0,7
1319222,976641,2020-08-24,Senate,"Assembly 3rd Reading AB1981 Nazarian By Leyva",31,5,4,0,40
1319223,957780,2020-05-06,Assembly,"Do pass as amended and be re-referred to the Committee on [Appropriations]",4,0,3,0,7
1319223,962780,2020-06-03,Assembly,"Do pass",16,0,2,0,18
1319223,965011,2020-06-10,Assembly,"AB 1982 Cunningham Assembly Third Reading",75,0,4,0,79
1319225,948569,2020-03-10,Assembly,"Do pass and be re-referred to the Committee on [Appropriations] with recommendation: To Consent Calendar",11,0,0,0,11
1319225,962369,2020-06-02,Assembly,"Do pass. To Consent Calendar",18,0,0,0,18
1319225,963603,2020-06-08,Assembly,"AB 1984 Maienschein Consent Calendar Second Day Regular Session",76,0,3,0,79
1319225,974488,2020-07-30,Senate,"Do pass, but first be re-referred to the Committee on [Appropriations] with the recommendation: To Consent Calendar",9,0,0,0,9
1319225,977290,2020-08-28,Senate,"Consent Calendar AB1984",39,0,1,0,40
1319225,977986,2020-08-30,Assembly,"AB 1984 Maienschein Concurrence in Senate Amendments",75,0,4,0,79
1319228,948547,2020-03-10,Assembly,"Do pass and be re-referred to the Committee on [Privacy and Consumer Protection] with recommendation: To Consent Calendar",11,0,0,0,11
1319231,912011,2020-01-30,Assembly,"Be adopted. To Consent Calendar",10,0,2,0,12
1319231,917108,2020-02-06,Assembly,"HR 75 Bauer-Kahan Consent Calendar Second Day Regular Session",75,0,5,0,80
1319233,959825,2020-05-19,Senate,"Do pass, but first be re-referred to the Committee on [Appropriations] with the recommendation: To Consent Calendar",7,0,0,0,7
1319233,964368,2020-06-09,Senate,"Placed on suspense file",7,0,0,0,7
1319235,958315,2020-05-12,Senate,"Do pass, but first be re-referred to the Committee on [Appropriations] with the recommendation: To Consent Calendar",6,0,1,0,7
1319235,964382,2020-06-09,Senate,"Placed on suspense file",7,0,0,0,7
1319235,967429,2020-06-18,Senate,"Do pass as amended",7,0,0,0,7
1319235,968684,2020-06-24,Senate,"Special Consent SB884",39,0,1,0,40
1319235,974840,2020-08-03,Assembly,"Do pass and be re-referred to the Committee on [Appropriations] with recommendation: To Consent Calendar",7,0,0,0,7
1319944,912019,2020-01-30,Senate,"Senate 3rd Reading SR69 Pan",38,0,1,0,39
1319945,912023,2020-01-30,Senate,"Senate 3rd Reading SR70 Atkins et al",38,0,1,0,39
1321438,958782,2020-05-14,Assembly,"Do pass as amended and be re-referred to the Committee on [Appropriations]",6,1,2,0,9
1321438,962438,2020-06-02,Assembly,"Do pass",16,0,2,0,18
1321438,966534,2020-06-15,Assembly,"AB 1989 Cristina Garcia Assembly Third Reading",67,0,12,0,79
1321438,974664,2020-08-01,Senate,"Do pass as amended, but first amend, and re-refer to the Committee on [Appropriations]",7,0,2,0,9
1321438,977775,2020-08-30,Senate,"Assembly 3rd Reading AB1989 Cristina Garcia By Skinner",38,0,2,0,40
1321438,977776,2020-08-31,Assembly,"AB 1989 Cristina Garcia Concurrence in Senate Amendments",73,0,6,0,79
1321442,957776,2020-05-07,Assembly,"Do pass and be re-referred to the Committee on [Appropriations]",14,0,0,0,14
1321442,962868,2020-06-03,Assembly,"Do pass",18,0,0,0,18
1321442,963570,2020-06-08,Assembly,"AB 1993 Kamlager Assembly Third Reading",77,0,2,0,79
1321442,974907,2020-08-05,Senate,"Do pass, but first be re-referred to the Committee on [Appropriations]",5,0,0,0,5
1321442,975787,2020-08-13,Senate,"Placed on suspense file",7,0,0,0,7
1321442,976297,2020-08-20,Senate,"Do pass as amended",6,1,0,0,7
1321442,977185,2020-08-27,Senate,"Assembly 3rd Reading AB1993 Kamlager et al. By Pan Urgency Clause",30,0,10,0,40
1321442,978196,2020-08-30,Assembly,"AB 1993 Kamlager Concurrence - Urgency Added",75,0,4,0,79
1321443,959352,2020-05-18,Assembly,"Do pass and be re-referred to the Committee on [Appropriations] with recommendation: To Consent Calendar",15,0,0,0,15
1321443,962777,2020-06-03,Assembly,"Do pass",18,0,0,0,18
1321443,963600,2020-06-08,Assembly,"AB 1994 Holden Assembly Third Reading",77,0,2,0,79
1321446,949777,2020-03-11,Assembly,"Do pass and be re-referred to the Committee on [Appropriations]",7,0,1,0,8
1321447,959970,2020-05-21,Assembly,"Do pass and be re-referred to the Committee on [Appropriations]",14,1,4,0,19
1321447,962376,2020-06-02,Assembly,"Do pass as amended",15,0,3,0,18
1321447,965588,2020-06-11,Assembly,"AB 1998 Low Assembly Third Reading",69,1,9,0,79
1321447,975342,2020-08-08,Senate,"Do pass, but first be re-referred to the Committee on [Appropriations]",4,1,4,0,9
1321447,975343,2020-08-08,Senate,"[First] hearing set for [08-10-2020]: Failed passage in Committee. Reconsideration granted",9,0,0,0,9
1321449,917116,2020-02-06,Assembly,"Be adopted. To Consent Calendar",10,0,2,0,12
1321449,923982,2020-02-14,Assembly,"ACR 153 Luz Rivas Consent Calendar Second Day",62,0,18,0,80
1321449,965695,2020-06-11,Senate,"Special Consent ACR153",39,0,1,0,40
1321450,923972,2020-02-14,Assembly,"Be adopted. To third reading",8,0,4,0,12
1321450,965650,2020-06-11,Senate,"Special Consent ACR154",39,0,1,0,40
1321452,919190,2020-02-10,Senate,"Senate 3rd Reading SR71 Chang",39,0,0,0,39
1322842,957595,2020-05-05,Assembly,"Do pass as amended",11,0,0,0,11
1322842,962426,2020-06-02,Assembly,"Do pass",15,0,3,0,18
1322842,963545,2020-06-08,Assembly,"AB 2004 Calderon Assembly Third Reading",68,1,10,0,79
1322842,975350,2020-08-08,Senate,"Do pass, but first be re-referred to the Committee on [Appropriations]",9,0,0,0,9
1322842,975849,2020-08-13,Senate,"Placed on suspense file",7,0,0,0,7
1322842,976446,2020-08-20,Senate,"Do pass as amended",6,0,1,0,7
1322842,977764,2020-08-31,Senate,"Assembly 3rd Reading AB2004 Calderon et al. By Hertzberg",39,0,1,0,40
1322842,977765,2020-08-31,Assembly,"AB 2004 CALDERON Concurrence in Senate Amendments",67,0,12,0,79
1322844,957327,2020-05-04,Assembly,"Do pass and be re-referred to the Committee on [Appropriations] with recommendation: To Consent Calendar",15,0,0,0,15
1322844,962442,2020-06-02,Assembly,"Do pass. To Consent Calendar",18,0,0,0,18
1322844,963546,2020-06-08,Assembly,"AB 2006 Fong Consent Calendar Second Day Regular Session",76,0,3,0,79
1322844,974796,2020-08-04,Senate,"Do pass, but first be re-referred to the Committee on [Appropriations] with the recommendation: To Consent Calendar",14,0,1,0,15
1322844,975832,2020-08-13,Senate,"Placed on suspense file",7,0,0,0,7
1322844,976502,2020-08-20,Senate,"Do pass",7,0,0,0,7
1322844,977325,2020-08-28,Senate,"Special Consent AB2006",39,0,1,0,40
1322846,948550,2020-03-10,Assembly,"Do pass as amended. To Consent Calendar",11,0,0,0,11
1322846,960468,2020-05-26,Assembly,"AB 2008 Cunningham Consent Calendar Second Day",75,0,4,0,79
1322851,923979,2020-02-14,Assembly,"Be adopted. To third reading",8,0,4,0,12
1322851,965574,2020-06-11,Senate,"Special Consent ACR155",39,0,1,0,40
1322852,912026,2020-01-30,Assembly,"Be adopted as amended",10,0,2,0,12
1322852,938022,2020-02-27,Senate,"Assembly 3rd Reading ACR156 Cooper et al. By Bradford",35,0,4,0,39
1322853,912014,2020-01-30,Assembly,"Be adopted. To Consent Calendar",10,0,2,0,12
1322853,917114,2020-02-06,Assembly,"HR 76 Chiu Consent Calendar Second Day Regular Session",75,0,5,0,80
1322854,917115,2020-02-06,Assembly,"Be adopted as amended",10,0,1,0,11
1322857,958807,2020-05-14,Senate,"Do pass, but first be re-referred to the Committee on [Appropriations]",0,2,3,0,5
1322857,958808,2020-05-14,Senate,"[First] hearing set for [05-14-2020]: Failed passage in Committee. Reconsideration granted",5,0,0,0,5
1322859,958796,2020-05-14,Senate,"Do pass, but first be re-referred to the Committee on [Appropriations]",12,0,1,0,13
1322859,964417,2020-06-09,Senate,"Placed on suspense file",7,0,0,0,7
1322859,967372,2020-06-18,Senate,"Do pass",7,0,0,0,7
1322859,968706,2020-06-24,Senate,"Special Consent SB895 Archuleta",39,0,1,0,40
1322859,974945,2020-08-06,Assembly,"Do pass and be re-referred to the Committee on [Appropriations] with recommendation: To Consent Calendar",9,0,2,0,11
1322859,976496,2020-08-20,Assembly,"Do pass",18,0,0,0,18
1322859,978002,2020-08-30,Assembly,"SB 895 Archuleta Senate Third Reading By Ramos",75,0,4,0,79
1322861,965644,2020-06-11,Senate,"Special Consent SCR80",39,0,1,0,40
1322863,965634,2020-06-11,Senate,"Special Consent SR73",39,0,1,0,40
1324242,959350,2020-05-18,Assembly,"Do pass and be re-referred to the Committee on [Appropriations]",11,0,0,0,11
1324242,962812,2020-06-03,Assembly,"Do pass",18,0,0,0,18
1324242,963575,2020-06-08,Assembly,"AB 2013 Irwin Assembly Third Reading",77,0,2,0,79
1324242,974285,2020-07-29,Senate,"Do pass, but first be re-referred to the Committee on [Appropriations] with the recommendation: To Consent Calendar",7,0,0,0,7
1324242,975775,2020-08-13,Senate,"Placed on suspense file",7,0,0,0,7
1324242,976499,2020-08-20,Senate,"Do pass",7,0,0,0,7
1324242,977399,2020-08-28,Senate,"Special Consent AB2013",39,0,1,0,40
1324242,977859,2020-08-30,Assembly,"AB 2013 Irwin Concurrence in Senate Amendments",75,0,4,0,79
1324243,948566,2020-03-10,Assembly,"Do pass and be re-referred to the Committee on [Judiciary]",6,0,2,0,8
1324243,963628,2020-06-08,Assembly,"AB 2014 Maienschein Assembly Third Reading",75,0,4,0,79
1324243,974617,2020-07-31,Senate,"Do pass, but first be re-referred to the Committee on [Rules] with the recommendation: To Consent Calendar",7,0,0,0,7
1324243,975830,2020-08-13,Senate,"Placed on suspense file",7,0,0,0,7
1324243,976453,2020-08-20,Senate,"Do pass",7,0,0,0,7
1324243,977313,2020-08-28,Senate,"Special Consent AB2014",39,0,1,0,40
1324243,978102,2020-08-30,Assembly,"AB 2014 Maienschein Concurrence in Senate Amendments",75,0,4,0,79
1324244,959332,2020-05-18,Assembly,"Do pass as amended and be re-referred to the Committee on [Appropriations]",15,0,0,0,15
1324244,962465,2020-06-02,Assembly,"Do pass",18,0,0,0,18
1324244,963523,2020-06-08,Assembly,"AB 2015 Eggman Assembly Third Reading",76,0,3,0,79
1324246,959777,2020-05-20,Assembly,"Do pass and be re-referred to the Committee on [Appropriations] with recommendation: To Consent Calendar",7,0,0,0,7
1324246,962432,2020-06-02,Assembly,"Do pass. To Consent Calendar",18,0,0,0,18
1324246,963492,2020-06-08,Assembly,"AB 2017 Mullin Consent Calendar Second Day Regular Session",76,0,3,0,79
1324246,974904,2020-08-05,Senate,"Do pass, but first be re-referred to the Committee on [Appropriations] with the recommendation: To Consent Calendar",5,0,0,0,5
1324246,977340,2020-08-28,Senate,"Consent Calendar AB2017",39,0,1,0,40
1324248,958579,2020-05-13,Assembly,"Do pass as amended and be re-referred to the Committee on [Appropriations]",10,0,2,0,12
1324248,962825,2020-06-03,Assembly,"Do pass",18,0,0,0,18
1324248,963520,2020-06-08,Assembly,"AB 2019 Holden Assembly Third Reading",77,0,2,0,79
1324250,958821,2020-05-14,Assembly,"Do pass and be re-referred to the Committee on [Appropriations] with recommendation: To Consent Calendar",14,0,0,0,14
1324251,957760,2020-05-06,Assembly,"Do pass as amended, and be re-referred to the Committee on [Appropriations] with recommendation: To Consent Calendar",7,0,0,0,7
1324253,948553,2020-03-10,Assembly,"Do pass and be re-referred to the Committee on [Appropriations]",8,0,0,0,8
1324254,938029,2020-02-27,Assembly,"Be adopted. To third reading",10,0,2,0,12
1324255,944407,2020-03-05,Assembly,"Be adopted. To third reading",10,0,2,0,12
1324256,917123,2020-02-06,Assembly,"Be adopted. To third reading",10,0,2,0,12
1325270,959324,2020-05-18,Assembly,"Do pass and be re-referred to the Committee on [Appropriations] with recommendation: To Consent Calendar",15,0,0,0,15
1325270,962819,2020-06-03,Assembly,"Do pass as amended",18,0,0,0,18
1325270,965033,2020-06-10,Assembly,"AB 2025 Gipson Third Reading Urgency",78,0,1,0,79
1325273,958558,2020-05-12,Assembly,"Do pass and be re-referred to the Committee on [Appropriations]",19,0,2,0,21
1325273,962737,2020-06-03,Assembly,"Do pass as amended",18,0,0,0,18
1325273,963616,2020-06-08,Assembly,"AB 2028 Aguiar-Curry Assembly Third Reading",77,0,2,0,79
1325273,975949,2020-08-14,Senate,"Do pass, but first be re-referred to the Committee on [Appropriations]",13,0,3,0,16
1325273,976154,2020-08-19,Senate,"Placed on suspense file",7,0,0,0,7
1325273,976311,2020-08-20,Senate,"Do pass as amended",5,0,2,0,7
1325275,958582,2020-05-13,Assembly,"Do pass and be re-referred to the Committee on [Appropriations]",12,0,0,0,12
1325275,962830,2020-06-03,Assembly,"Do pass as amended",18,0,0,0,18
1325275,966469,2020-06-15,Assembly,"AB 2030 Blanca Rubio Assembly Third Reading",79,0,0,0,79
1325282,960169,2020-05-22,Senate,"Do pass, but first be re-referred to the Committee on [Appropriations]",7,0,2,0,9
1325282,965612,2020-06-11,Senate,"Senate 3rd Reading SB898 Wieckowski",35,2,3,0,40
1325282,975663,2020-08-12,Assembly,"Do pass",11,0,0,0,11
1325282,976733,2020-08-25,Assembly,"SB 898 Wieckowski Senate Third Reading By Bonta",74,0,5,0,79
1325282,977175,2020-08-27,Senate,"Unfinished Business SB898 Wieckowski Concurrence",29,0,11,0,40
1325283,960435,2020-05-26,Senate,"Do pass as amended, but first amend, and re-refer to the Committee on [Appropriations]",10,0,1,0,11
1325283,964347,2020-06-09,Senate,"Placed on suspense file",7,0,0,0,7
1325283,967465,2020-06-18,Senate,"Do pass as amended",7,0,0,0,7
1325283,969735,2020-06-25,Senate,"Senate 3rd Reading SB899 Wiener et al",39,0,1,0,40
1325283,974301,2020-07-29,Assembly,"Do pass as amended and be re-referred to the Committee on [Appropriations]",5,0,3,0,8
1325286,960431,2020-05-26,Senate,"Do pass, but first be re-referred to the Committee on [Appropriations]",9,0,2,0,11
1325286,964338,2020-06-09,Senate,"Placed on suspense file",7,0,0,0,7
1325286,967445,2020-06-18,Senate,"Do pass",6,1,0,0,7
1325286,968065,2020-06-22,Senate,"Senate 3rd Reading SB902 Wiener et al",33,3,4,0,40
1325286,975495,2020-08-11,Assembly,"Do pass and be re-referred to the Committee on [Appropriations]",5,1,2,0,8
1325287,959742,2020-05-20,Senate,"Do pass, but first be re-referred to the Committee on [Appropriations] with the recommendation: To Consent Calendar",7,0,0,0,7
1325287,965629,2020-06-11,Senate,"Consent Calendar SB903 Grove Urgency Clause",39,0,1,0,40
1325287,974956,2020-08-05,Assembly,"Do pass and be re-referred to the Committee on [Appropriations] with recommendation: To Consent Calendar",8,0,0,0,8
1325287,975539,2020-08-11,Assembly,"Do pass. To Consent Calendar",17,0,0,0,17
1325287,978021,2020-08-30,Assembly,"SB 903 Grove Consent Calendar Second Day Regular Session",75,0,4,0,79
1325288,923977,2020-02-14,Senate,"Senate 3rd Reading SCR81 Jackson",34,0,5,0,39
1325288,928952,2020-02-20,Assembly,"Be adopted. To Consent Calendar",9,0,3,0,12
1325288,938012,2020-02-27,Assembly,"SCR 81 Jackson Consent Calendar Second Day Regular Session",71,0,9,0,80
1325289,925955,2020-02-18,Senate,"Senate 3rd Reading SR74 Bradford et al",35,0,4,0,39
1325290,923976,2020-02-14,Senate,"Senate 3rd Reading SR75 Rubio et al",34,0,5,0,39
1327489,959330,2020-05-18,Assembly,"Do pass as amended and be re-referred to the Committee on [Appropriations]",10,3,2,0,15
1327489,962468,2020-06-02,Assembly,"Do pass",12,5,1,0,18
1327489,963578,2020-06-08,Assembly,"AB 2037 Wicks Assembly Third Reading",50,15,14,0,79
1327489,974667,2020-08-01,Senate,"Do pass, but first be re-referred to the Committee on [Appropriations]",6,1,2,0,9
1327489,977433,2020-08-29,Senate,"Assembly 3rd Reading AB2037 Wicks et al. By Leyva",25,12,3,0,40
1327489,978011,2020-08-30,Assembly,"AB 2037 Wicks Concurrence in Senate Amendments By BONTA",51,12,16,0,79
1327490,957330,2020-05-04,Assembly,"Do pass and be re-referred to the Committee on [Appropriations] with recommendation: To Consent Calendar",15,0,0,0,15
1327490,962429,2020-06-02,Assembly,"Do pass. To Consent Calendar",18,0,0,0,18
1327490,963515,2020-06-08,Assembly,"AB 2038 TRANS. Consent Calendar Second Day Regular Session",76,0,3,0,79
1327490,974804,2020-08-04,Senate,"Do pass, but first be re-referred to the Committee on [Appropriations] with the recommendation: To Consent Calendar",14,0,1,0,15
1327490,977359,2020-08-28,Senate,"Consent Calendar AB2038 TRANS",39,0,1,0,40
1327492,958308,2020-05-12,Assembly,"Do pass and be re-referred to the Committee on [Appropriations] with recommendation: To Consent Calendar",8,0,0,0,8
1327492,962733,2020-06-03,Assembly,"Do pass as amended",18,0,0,0,18
1327492,965084,2020-06-10,Assembly,"AB 2040 Bigelow Assembly Third Reading",77,0,2,0,79
1327492,974265,2020-07-29,Senate,"Do pass, but first be re-referred to the Committee on [Appropriations] with the recommendation: To Consent Calendar",7,0,0,0,7
1327492,976031,2020-08-17,Senate,"Placed on suspense file",7,0,0,0,7
1327492,976340,2020-08-20,Senate,"Do pass as amended",7,0,0,0,7
1327492,977393,2020-08-28,Senate,"Special Consent AB2040",39,0,1,0,40
1327492,977799,2020-08-30,Assembly,"AB 2040 Bigelow Concurrence in Senate Amendments",75,0,4,0,79
1327495,959753,2020-05-20,Assembly,"Do pass and be re-referred to the Committee on [Appropriations]",6,1,0,0,7
1327495,962789,2020-06-03,Assembly,"Do pass as amended",14,4,0,0,18
1327495,965589,2020-06-11,Assembly,"AB 2043 Robert Rivas Assembly Third Reading",55,15,9,0,79
1327495,974899,2020-08-05,Senate,"Do pass, but first be re-referred to the Committee on [Appropriations]",4,0,1,0,5
1327495,975827,2020-08-13,Senate,"Placed on suspense file",7,0,0,0,7
1327495,976320,2020-08-20,Senate,"Do pass as amended",5,0,2,0,7
1327495,977428,2020-08-29,Senate,"Assembly 3rd Reading AB2043 Robert Rivas et al. By Caballero Urgency Clause",33,0,7,0,40
1327495,978052,2020-08-30,Assembly,"AB 2043 Robert Rivas Concurrence - Urgency Added",67,0,12,0,79
1327496,949771,2020-03-11,Assembly,"Do pass as amended and be re-referred to the Committee on [Natural Resources]",7,0,1,0,8
1327498,948565,2020-03-10,Assembly,"Do pass and be re-referred to the Committee on [Appropriations] with recommendation: To Consent Calendar",11,0,0,0,11
1327498,962395,2020-06-02,Assembly,"Do pass. To Consent Calendar",18,0,0,0,18
1327498,963488,2020-06-08,Assembly,"AB 2046 Voepel Consent Calendar Second Day Regular Session",76,0,3,0,79
1327498,974484,2020-07-30,Senate,"Do pass, but first be re-referred to the Committee on [Appropriations] with the recommendation: To Consent Calendar",9,0,0,0,9
1327498,977289,2020-08-28,Senate,"Consent Calendar AB2046",39,0,1,0,40
1327499,958512,2020-05-12,Assembly,"Do pass and be re-referred to the Committee on [Appropriations] with recommendation: To Consent Calendar",20,0,1,0,21
1327499,962821,2020-06-03,Assembly,"Do pass",18,0,0,0,18
1327499,963517,2020-06-08,Assembly,"AB 2047 Aguiar-Curry Assembly Third Reading",77,0,2,0,79
1327501,957767,2020-05-07,Assembly,"Do pass and be re-referred to the Committee on [Appropriations] with recommendation: To Consent Calendar",14,0,0,0,14
1327501,962375,2020-06-02,Assembly,"Do pass. To Consent Calendar",18,0,0,0,18
1327501,963538,2020-06-08,Assembly,"AB 2049 Cooley Consent Calendar Second Day Regular Session",76,0,3,0,79
1327501,974808,2020-08-04,Senate,"Do pass, but first be re-referred to the Committee on [Appropriations] with the recommendation: To Consent Calendar",13,0,0,0,13
1327501,977308,2020-08-28,Senate,"Consent Calendar AB2049",39,0,1,0,40
1327503,948549,2020-03-10,Assembly,"Do pass and be re-referred to the Committee on [Judiciary] with recommendation: To Consent Calendar",8,0,0,0,8
1327503,958162,2020-05-11,Assembly,"Do pass and be re-referred to the Committee on [Appropriations] with recommendation: To Consent Calendar",10,0,1,0,11
1327504,957795,2020-05-06,Assembly,"Do pass and be re-referred to the Committee on [Appropriations] with recommendation: To Consent Calendar",7,0,0,0,7
1327504,962735,2020-06-03,Assembly,"Do pass as amended",13,0,5,0,18
1327504,963622,2020-06-08,Assembly,"AB 2052 O'Donnell Assembly Third Reading",77,0,2,0,79
1327505,948555,2020-03-10,Assembly,"Do pass and be re-referred to the Committee on [Appropriations]",8,3,0,0,11
1327506,958544,2020-05-12,Assembly,"Do pass and be re-referred to the Committee on [Appropriations]",20,0,1,0,21
1327506,962752,2020-06-03,Assembly,"Do pass as amended",18,0,0,0,18
1327506,967505,2020-06-18,Assembly,"AB 2054 Kamlager Assembly Third Reading",78,0,1,0,79
1327506,975935,2020-08-14,Senate,"Do pass, but first be re-referred to the Committee on [Appropriations]",15,1,0,0,16
1327506,976153,2020-08-19,Senate,"Placed on suspense file",7,0,0,0,7
1327506,976448,2020-08-20,Senate,"Do pass",7,0,0,0,7
1327506,977381,2020-08-28,Senate,"Assembly 3rd Reading AB2054 Kamlager et al. By Wiener",35,2,3,0,40
1327506,978034,2020-08-30,Assembly,"AB 2054 Kamlager Concurrence in Senate Amendments",74,0,5,0,79
1327510,923974,2020-02-14,Assembly,"Be adopted. To third reading",8,0,4,0,12
1327510,965578,2020-06-11,Senate,"Special Consent ACR159",39,0,1,0,40
1327513,959783,2020-05-20,Senate,"Do pass as amended, but first amend, and re-refer to the Committee on [Appropriations]",5,2,0,0,7
1327513,965624,2020-06-11,Senate,"Senate 3rd Reading SB905 Archuleta",30,4,6,0,40
1327513,974950,2020-08-05,Assembly,"Do pass and be re-referred to the Committee on [Appropriations]",8,0,0,0,8
1327513,975492,2020-08-11,Assembly,"Do pass",12,4,1,0,17
1327513,977907,2020-08-30,Assembly,"SB 905 Archuleta Senate Third Reading By Gonzalez",57,1,21,0,79
1327513,977908,2020-08-31,Senate,"Unfinished Business SB905 Archuleta Concurrence",31,3,6,0,40
1327515,959826,2020-05-19,Senate,"Do pass, but first be re-referred to the Committee on [Appropriations]",7,0,0,0,7
1327515,964398,2020-06-09,Senate,"Placed on suspense file",7,0,0,0,7
1327515,967422,2020-06-18,Senate,"Do pass",7,0,0,0,7
1327515,968700,2020-06-24,Senate,"Special Consent SB907",39,0,1,0,40
1327515,974740,2020-08-03,Assembly,"Do pass and be re-referred to the Committee on [Appropriations] with recommendation: To Consent Calendar",6,0,2,0,8
1327515,976089,2020-08-18,Assembly,"Do pass as amended. To Consent Calendar",18,0,0,0,18
1327515,978035,2020-08-30,Senate,"Unfinished Business SB907 Archuleta et al. Concurrence",39,0,1,0,40
1327515,978036,2020-08-30,Assembly,"SB 907 Archuleta Consent Calendar Second Day Regular Session",75,0,4,0,79
1327516,959477,2020-05-19,Senate,"Do pass as amended, but first amend, and re-refer to the Committee on [Appropriations]",5,0,2,0,7
1327516,964427,2020-06-09,Senate,"Placed on suspense file",7,0,0,0,7
1327516,967378,2020-06-18,Senate,"Do pass as amended",6,1,0,0,7
1327516,967379,2020-06-18,Senate,"[06-18-2020] set for [First] hearing: Reconsideration of favorable vote granted",7,0,0,0,7
1327516,967380,2020-06-18,Senate,"Do pass as amended",5,1,1,0,7
1327516,969780,2020-06-25,Senate,"Senate 3rd Reading SB908 Wieckowski",29,4,7,0,40
1327516,975659,2020-08-12,Assembly,"Do pass as amended and be re-referred to the Committee on [Appropriations]",9,3,0,0,12
1327516,976382,2020-08-20,Assembly,"Do pass as amended",13,5,0,0,18
1327516,977957,2020-08-31,Senate,"Unfinished Business SB908 Wieckowski Concurrence",31,4,5,0,40
1327516,977958,2020-08-31,Assembly,"SB 908 Wieckowski Senate Third Reading By Limón",53,19,7,0,79
1327517,961682,2020-05-29,Senate,"Do pass and be ordered to the Consent Calendar",13,0,2,0,15
1327517,965599,2020-06-11,Senate,"Consent Calendar SB909 Dodd et al. Urgency Clause",39,0,1,0,40
1327517,975368,2020-08-10,Assembly,"Do pass. To Consent Calendar",15,0,0,0,15
1327517,978098,2020-08-30,Senate,"Unfinished Business SB909 Dodd et al. Urgency Clause Concurrence",39,0,1,0,40
1327517,978099,2020-08-30,Assembly,"SB 909 Dodd Consent Calendar Second Day Regular Session",75,0,4,0,79
1327520,959827,2020-05-19,Senate,"Do pass, but first be re-referred to the Committee on [Appropriations]",7,0,0,0,7
1327520,964416,2020-06-09,Senate,"Placed on suspense file",7,0,0,0,7
1327520,967406,2020-06-18,Senate,"Do pass as amended",7,0,0,0,7
1327520,969782,2020-06-25,Senate,"Senate 3rd Reading SB912 Beall Urgency Clause",40,0,0,0,40
1327520,974743,2020-08-03,Assembly,"Do pass and be re-referred to the Committee on [Appropriations]",6,0,2,0,8
1327520,976388,2020-08-20,Assembly,"Do pass as amended",18,0,0,0,18
1327520,976908,2020-08-26,Assembly,"SB 912 Beall Third Reading Urgency By Gipson",73,0,6,0,79
1327520,977426,2020-08-29,Senate,"Unfinished Business SB912 Beall et al. Urgency Clause Concurrence",38,0,2,0,40
1327522,959773,2020-05-20,Senate,"Do pass, but first be re-referred to the Committee on [Appropriations]",5,1,1,0,7
1327522,964379,2020-06-09,Senate,"Placed on suspense file",7,0,0,0,7
1327522,967457,2020-06-18,Senate,"Do pass",5,2,0,0,7
1327522,968061,2020-06-22,Senate,"Senate 3rd Reading SB914 Portantino et al",29,11,0,0,40
1327522,974961,2020-08-05,Assembly,"Do pass and be re-referred to the Committee on [Appropriations]",6,2,0,0,8
1327522,976444,2020-08-20,Assembly,"Do pass",13,5,0,0,18
1327522,977930,2020-08-30,Assembly,"SB 914 Portantino Senate Third Reading By Gabriel",53,19,7,0,79
1327522,977931,2020-08-31,Senate,"Unfinished Business SB914 Portantino et al. Concurrence",29,10,1,0,40
1327523,960175,2020-05-22,Senate,"Do pass as amended, but first amend, and re-refer to the Committee on [Appropriations]",7,1,1,0,9
1327523,964418,2020-06-09,Senate,"Placed on suspense file",7,0,0,0,7
1327523,967371,2020-06-18,Senate,"Do pass as amended",5,2,0,0,7
1327523,969763,2020-06-25,Senate,"Senate 3rd Reading SB915 Leyva et al",29,11,0,0,40
1327523,974309,2020-07-29,Assembly,"Do pass",6,1,1,0,8
1327523,976620,2020-08-24,Assembly,"SB 915 Leyva Senate Third Reading By Limón Amend By KILEY Set #2 Motion to Lay on the Table By CALDERON",54,17,8,0,79
1327523,977992,2020-08-31,Assembly,"SB 915 Leyva Senate Third Reading By Limón",44,15,20,0,79
1329652,959344,2020-05-18,Assembly,"Do pass and be re-referred to the Committee on [Appropriations]",11,0,0,0,11
1329653,948574,2020-03-10,Assembly,"Do pass as amended and be re-referred to the Committee on [Appropriations]",10,1,0,0,11
1329654,948568,2020-03-10,Assembly,"Do pass and be re-referred to the Committee on [Appropriations]",9,0,0,0,9
1329654,962823,2020-06-03,Assembly,"Do pass as amended",18,0,0,0,18
1329654,963540,2020-06-08,Assembly,"AB 2060 Holden Assembly Third Reading",75,0,4,0,79
1329654,975508,2020-08-11,Senate,"Do pass, but first be re-referred to the Committee on [Appropriations] with the recommendation: To Consent Calendar",5,0,2,0,7
1329654,976001,2020-08-17,Senate,"Placed on suspense file",7,0,0,0,7
1329655,948544,2020-03-10,Assembly,"Do pass as amended and be re-referred to the Committee on [Appropriations]",6,0,2,0,8
1329655,962836,2020-06-03,Assembly,"Do pass",14,1,3,0,18
1329655,963586,2020-06-08,Assembly,"AB 2061 Limón Assembly Third Reading",60,3,16,0,79
1329655,974997,2020-08-07,Senate,"Do pass, but first be re-referred to the Committee on [Appropriations]",5,1,1,0,7
1329655,976043,2020-08-17,Senate,"Placed on suspense file",7,0,0,0,7
1329655,976365,2020-08-20,Senate,"Do pass",5,1,1,0,7
1329655,977341,2020-08-28,Senate,"Assembly 3rd Reading AB2061 Limón et al. By Jackson",28,7,5,0,40
1329658,958559,2020-05-12,Assembly,"Do pass and be re-referred to the Committee on [Appropriations] with recommendation: To Consent Calendar",20,0,1,0,21
1329662,948575,2020-03-09,Assembly,"Do pass as amended and be re-referred to the Committee on [Appropriations]",10,0,1,0,11
1329662,962422,2020-06-02,Assembly,"Do pass. To Consent Calendar",18,0,0,0,18
1329662,963557,2020-06-08,Assembly,"AB 2068 Petrie-Norris Consent Calendar Second Day Regular Session",76,0,3,0,79
1329662,974299,2020-07-29,Senate,"Do pass, but first be re-referred to the Committee on [Appropriations] with the recommendation: To Consent Calendar",7,0,0,0,7
1329662,977333,2020-08-28,Senate,"Consent Calendar AB2068",39,0,1,0,40
1329662,977967,2020-08-30,Assembly,"AB 2068 Petrie-Norris Concurrence in Senate Amendments",75,0,4,0,79
1329671,958325,2020-05-12,Senate,"Do pass, but first be re-referred to the Committee on [Appropriations] with the recommendation: To Consent Calendar",13,0,3,0,16
1329671,965616,2020-06-11,Senate,"Consent Calendar SB918 G.O",39,0,1,0,40
1329671,974813,2020-08-03,Assembly,"Do pass and be re-referred to the Committee on [Appropriations] with recommendation: To Consent Calendar",17,0,2,0,19
1329671,975522,2020-08-11,Assembly,"Do pass. To Consent Calendar",17,0,0,0,17
1329671,977888,2020-08-30,Assembly,"SB 918 G.O. Consent Calendar Second Day Regular Session",75,0,4,0,79
1329674,961698,2020-05-29,Senate,"Do pass, but first be re-referred to the Committee on [Appropriations] with the recommendation: To Consent Calendar",13,0,2,0,15
1329674,964362,2020-06-09,Senate,"Placed on suspense file",7,0,0,0,7
1329674,967391,2020-06-18,Senate,"Do pass",7,0,0,0,7
1329674,968694,2020-06-24,Senate,"Special Consent SB921",39,0,1,0,40
1329674,975384,2020-08-10,Assembly,"Do pass and be re-referred to the Committee on [Appropriations] with recommendation: To Consent Calendar",15,0,0,0,15
1329674,976316,2020-08-20,Assembly,"Do pass",18,0,0,0,18
1329674,976732,2020-08-25,Assembly,"SB 921 Dahle Senate Third Reading By Megan Dahle",74,0,5,0,79
1329675,959787,2020-05-20,Senate,"Do pass as amended, but first amend, and re-refer to the Committee on [Appropriations] with the recommendation: To Consent Calendar",7,0,0,0,7
1329675,964340,2020-06-09,Senate,"Placed on suspense file",7,0,0,0,7
1329675,967440,2020-06-18,Senate,"Do pass as amended",7,0,0,0,7
1329675,968702,2020-06-24,Senate,"Special Consent SB922",39,0,1,0,40
1329675,974964,2020-08-05,Assembly,"Do pass and be re-referred to the Committee on [Appropriations] with recommendation: To Consent Calendar",8,0,0,0,8
1331780,958777,2020-05-14,Assembly,"Do pass as amended, and be re-referred to the Committee on [Appropriations] with recommendation: To Consent Calendar",14,0,0,0,14
1331780,962729,2020-06-03,Assembly,"Do pass as amended",18,0,0,0,18
1331780,963536,2020-06-08,Assembly,"AB 2076 Bigelow Assembly Third Reading",77,0,2,0,79
1331781,959300,2020-05-18,Assembly,"Do pass as amended and be re-referred to the Committee on [Appropriations]",11,2,2,0,15
1331781,962467,2020-06-02,Assembly,"Do pass",12,5,1,0,18
1331781,963493,2020-06-08,Assembly,"AB 2077 Ting Assembly Third Reading",50,18,11,0,79
1331781,974656,2020-08-01,Senate,"Do pass, but first be re-referred to the Committee on [Appropriations]",6,2,1,0,9
1331781,977418,2020-08-29,Senate,"Assembly 3rd Reading AB2077 Ting By Pan",27,10,3,0,40
1331790,948556,2020-03-10,Assembly,"Do pass and be re-referred to the Committee on [Appropriations]",8,0,0,0,8
1331796,959747,2020-05-20,Assembly,"Do pass and be re-referred to the Committee on [Appropriations]",5,1,1,0,7
1331796,962436,2020-06-02,Assembly,"Do pass",13,5,0,0,18
1331796,963634,2020-06-08,Assembly,"AB 2092 Rodriguez Assembly Third Reading",57,15,7,0,79
1331796,974889,2020-08-05,Senate,"Do pass, but first be re-referred to the Committee on [Appropriations]",4,1,0,0,5
1331796,975850,2020-08-13,Senate,"Placed on suspense file",7,0,0,0,7
1331796,976378,2020-08-20,Senate,"Do pass",5,2,0,0,7
1331796,977430,2020-08-29,Senate,"Assembly 3rd Reading AB2092 Rodriguez By Umberg",30,8,2,0,40
1331796,978167,2020-08-30,Assembly,"AB 2092 Rodriguez Concurrence in Senate Amendments",58,12,9,0,79
1331797,948554,2020-03-10,Assembly,"Do pass and be re-referred to the Committee on [Appropriations]",10,1,0,0,11
1331800,958540,2020-05-12,Assembly,"Do pass. To Consent Calendar",20,0,1,0,21
1331800,960448,2020-05-26,Assembly,"AB 2096 Gallagher Consent Calendar Second Day Regular Session",75,0,4,0,79
1331801,958561,2020-05-12,Assembly,"Do pass and be re-referred to the Committee on [Appropriations] with recommendation: To Consent Calendar",20,0,1,0,21
1331801,962382,2020-06-02,Assembly,"Do pass. To Consent Calendar",18,0,0,0,18
1331801,963604,2020-06-08,Assembly,"AB 2097 Gallagher Consent Calendar Second Day Regular Session",76,0,3,0,79
1331804,959342,2020-05-18,Assembly,"Do pass and be re-referred to the Committee on [Appropriations] with recommendation: To Consent Calendar",15,0,0,0,15
1331804,962784,2020-06-03,Assembly,"Do pass as amended",18,0,0,0,18
1331804,965007,2020-06-10,Assembly,"AB 2100 Wood Assembly Third Reading",78,0,1,0,79
1331804,974662,2020-08-01,Senate,"Do pass, but first be re-referred to the Committee on [Appropriations]",8,0,1,0,9
1331804,975771,2020-08-13,Senate,"Placed on suspense file",7,0,0,0,7
1331804,976491,2020-08-20,Senate,"Do pass as amended",7,0,0,0,7
1331804,977322,2020-08-28,Senate,"Special Consent AB2100",39,0,1,0,40
1331804,978087,2020-08-30,Assembly,"AB 2100 Wood Concurrence in Senate Amendments",75,0,4,0,79
1331805,940177,2020-03-02,Assembly,"Be adopted. To Consent Calendar",10,0,2,0,12
1331805,944394,2020-03-05,Assembly,"ACR 160 Gloria Consent Calendar Second Day Regular Session",72,0,8,0,80
1331805,967449,2020-06-18,Senate,"Special Consent ACR160",40,0,0,0,40
1331807,959296,2020-05-18,Senate,"Do pass, but first be re-referred to the Committee on [Appropriations]",9,0,0,0,9
1331807,964349,2020-06-09,Senate,"Placed on suspense file",7,0,0,0,7
1331809,958144,2020-05-11,Senate,"Do pass and be ordered to the Consent Calendar",7,0,0,0,7
1331809,965575,2020-06-11,Senate,"Consent Calendar SB928 GOV. & F. (McGuire) Urgency Clause",39,0,1,0,40
1331809,975533,2020-08-11,Assembly,"Do pass. To Consent Calendar",8,0,0,0,8
1331809,977998,2020-08-30,Assembly,"SB 928 GOV.& F. Consent Calendar Second Day Regular Session",75,0,4,0,79
1331810,958120,2020-05-11,Senate,"Do pass and be ordered to the Consent Calendar",7,0,0,0,7
1331810,965620,2020-06-11,Senate,"Consent Calendar SB929 GOV. & F. (McGuire) Urgency Clause",39,0,1,0,40
1331810,975531,2020-08-11,Assembly,"Do pass. To Consent Calendar",8,0,0,0,8
1331810,977970,2020-08-30,Assembly,"SB 929 GOV.& F. Consent Calendar Second Day Regular Session",75,0,4,0,79
1331811,958118,2020-05-11,Senate,"Do pass and be ordered to the Consent Calendar",7,0,0,0,7
1331811,965678,2020-06-11,Senate,"Consent Calendar SB930 GOV. & F. (McGuire)",39,0,1,0,40
1331811,975500,2020-08-11,Assembly,"Do pass. To Consent Calendar",8,0,0,0,8
1331811,977882,2020-08-30,Assembly,"SB 930 GOV.& F. Consent Calendar Second Day Regular Session",75,0,4,0,79
1331813,958539,2020-05-13,Senate,"Do pass as amended, but first amend, and re-refer to the Committee on [Appropriations]",9,0,0,0,9
1331813,964337,2020-06-09,Senate,"Placed on suspense file",7,0,0,0,7
1331813,967386,2020-06-18,Senate,"Do pass as amended",7,0,0,0,7
1331813,969800,2020-06-25,Senate,"Senate 3rd Reading SB932 Wiener et al. Urgency Clause",40,0,0,0,40
1331813,975008,2020-08-04,Assembly,"Do pass as amended and be re-referred to the Committee on [Appropriations]",15,0,0,0,15
1331813,976095,2020-08-18,Assembly,"Do pass as amended. To Consent Calendar",18,0,0,0,18
1331813,977959,2020-08-30,Senate,"Unfinished Business SB932 Wiener et al. Urgency Clause Concurrence",39,0,1,0,40
1331813,977960,2020-08-30,Assembly,"SB 932 Wiener Consent Calendar Second Day Regular Session",75,0,4,0,79
1331814,965582,2020-06-11,Senate,"Special Consent SR76",39,0,1,0,40
1333358,957450,2020-05-05,Assembly,"Do pass and be re-referred to the Committee on [Appropriations] with recommendation: To Consent Calendar",7,0,0,0,7
1333358,962414,2020-06-02,Assembly,"Do pass. To Consent Calendar",18,0,0,0,18
1333358,963522,2020-06-08,Assembly,"AB 2101 P.E. & R. Consent Calendar Second Day Regular Session",76,0,3,0,79
1333358,974885,2020-08-05,Senate,"Do pass, but first be re-referred to the Committee on [Appropriations] with the recommendation: To Consent Calendar",5,0,0,0,5
1333358,976002,2020-08-17,Senate,"Placed on suspense file",7,0,0,0,7
1333358,976406,2020-08-20,Senate,"Do pass",7,0,0,0,7
1333358,977397,2020-08-28,Senate,"Special Consent AB2101 P.E. & R",39,0,1,0,40
1333358,977444,2020-08-30,Assembly,"With recommendation: That Senate amendments be concurred in",6,0,1,0,7
1333358,977966,2020-08-30,Assembly,"AB 2101 Public Employment and Re Concurrence in Senate Amendments",75,0,4,0,79
1333361,948563,2020-03-10,Assembly,"Do pass and be re-referred to the Committee on [Appropriations] with recommendation: To Consent Calendar",9,0,0,0,9
1333361,962454,2020-06-02,Assembly,"Do pass. To Consent Calendar",18,0,0,0,18
1333361,963527,2020-06-08,Assembly,"AB 2104 Cristina Garcia Consent Calendar Second Day Regular Session",76,0,3,0,79
1333361,975494,2020-08-11,Senate,"Do pass, but first be re-referred to the Committee on [Appropriations] with the recommendation: To Consent Calendar",5,0,2,0,7
1333361,978095,2020-08-30,Senate,"Assembly 3rd Reading AB2104 Cristina Garcia By Durazo",39,0,1,0,40
1333361,978096,2020-08-30,Assembly,"AB 2104 Cristina Garcia Concurrence in Senate Amendments",73,1,5,0,79
1333362,948559,2020-03-10,Assembly,"Do pass and be re-referred to the Committee on [Appropriations] with recommendation: To Consent Calendar",6,0,2,0,8
1333363,958812,2020-05-14,Assembly,"Do pass and be re-referred to the Committee on [Appropriations]",14,0,0,0,14
1333363,962792,2020-06-03,Assembly,"Do pass",17,0,1,0,18
1333363,963574,2020-06-08,Assembly,"AB 2106 Aguiar-Curry Assembly Third Reading",73,0,6,0,79
1333363,974892,2020-08-05,Senate,"Do pass as amended, but first amend, and re-refer to the Committee on [Appropriations]",9,0,0,0,9
1333363,975993,2020-08-17,Senate,"Placed on suspense file",7,0,0,0,7
1333364,958317,2020-05-12,Assembly,"Do pass. To Consent Calendar",8,0,0,0,8
1333364,960458,2020-05-26,Assembly,"AB 2107 Rodriguez Consent Calendar Second Day Regular Session",75,0,4,0,79
1333364,974284,2020-07-29,Senate,"Do pass and be ordered to the Consent Calendar",7,0,0,0,7
1333364,977384,2020-08-28,Senate,"Consent Calendar AB2107 Rodriguez et al. By Hurtado",39,0,1,0,40
1333365,948571,2020-03-10,Assembly,"Do pass and be re-referred to the Committee on [Appropriations] with recommendation: To Consent Calendar",11,0,0,0,11
1333369,959327,2020-05-18,Assembly,"Do pass as amended and be re-referred to the Committee on [Appropriations]",15,0,0,0,15
1333369,962769,2020-06-03,Assembly,"Do pass as amended",18,0,0,0,18
1333369,965023,2020-06-10,Assembly,"AB 2112 Ramos Assembly Third Reading",78,0,1,0,79
1333369,975336,2020-08-10,Senate,"Do pass as amended, but first amend, and re-refer to the Committee on [Appropriations]",8,0,1,0,9
1333369,975988,2020-08-17,Senate,"Placed on suspense file",7,0,0,0,7
1333369,976430,2020-08-20,Senate,"Do pass as amended",7,0,0,0,7
1333369,977801,2020-08-30,Senate,"Assembly 3rd Reading AB2112 Ramos et al. By Hurtado",39,0,1,0,40
1333369,977802,2020-08-31,Assembly,"AB 2112 Ramos Concurrence in Senate Amendments",76,0,3,0,79
1333370,959949,2020-05-21,Assembly,"Do pass and be re-referred to the Committee on [Appropriations]",15,2,2,0,19
1333370,962855,2020-06-03,Assembly,"Do pass",14,4,0,0,18
1333370,965039,2020-06-10,Assembly,"AB 2113 Low Assembly Third Reading",66,4,9,0,79
1333370,975327,2020-08-08,Senate,"Do pass, but first be re-referred to the Committee on [Appropriations]",9,0,0,0,9
1333370,975808,2020-08-13,Senate,"Placed on suspense file",7,0,0,0,7
1333370,976465,2020-08-20,Senate,"Do pass",7,0,0,0,7
1333370,977184,2020-08-27,Senate,"Assembly 3rd Reading AB2113 Low et al. By Pan",30,0,10,0,40
1333370,978205,2020-08-30,Assembly,"AB 2113 Low Concurrence in Senate Amendments",65,0,14,0,79
1333371,957435,2020-05-05,Assembly,"Do pass and be re-referred to the Committee on [Appropriations]",5,1,1,0,7
1333371,962813,2020-06-03,Assembly,"Do pass as amended",13,5,0,0,18
1333371,965019,2020-06-10,Assembly,"AB 2114 Rodriguez Assembly Third Reading",58,17,4,0,79
1333371,975514,2020-08-11,Senate,"Do pass, but first be re-referred to the Committee on [Appropriations]",3,1,1,0,5
1333371,976033,2020-08-17,Senate,"Placed on suspense file",7,0,0,0,7
1333371,976370,2020-08-20,Senate,"Do pass as amended",5,2,0,0,7
1333371,977436,2020-08-29,Senate,"Assembly 3rd Reading AB2114 Rodriguez By Pan",22,12,6,0,40
1333371,978130,2020-08-30,Assembly,"AB 2114 Rodriguez Concurrence in Senate Amendments",55,15,9,0,79
1333375,959308,2020-05-18,Assembly,"Do pass as amended and be re-referred to the Committee on [Appropriations]",11,4,0,0,15
1333375,962778,2020-06-03,Assembly,"Do pass",13,5,0,0,18
1333375,963598,2020-06-08,Assembly,"AB 2118 Kalra Assembly Third Reading",56,19,4,0,79
1333375,975356,2020-08-10,Senate,"Do pass as amended, but first amend, and re-refer to the Committee on [Appropriations]",7,1,1,0,9
1333375,976041,2020-08-17,Senate,"Placed on suspense file",7,0,0,0,7
1333375,976360,2020-08-20,Senate,"Do pass",5,2,0,0,7
1333375,977735,2020-08-30,Senate,"Assembly 3rd Reading AB2118 Kalra et al. By Pan",29,10,1,0,40
1333375,977736,2020-08-31,Assembly,"AB 2118 Kalra Concurrence in Senate Amendments",60,16,3,0,79
1333379,959976,2020-05-21,Assembly,"Do pass and be re-referred to the Committee on [Appropriations]",18,0,1,0,19
1333379,962757,2020-06-03,Assembly,"Do pass",18,0,0,0,18
1333379,965635,2020-06-11,Assembly,"AB 2122 Blanca Rubio Assembly Third Reading",78,0,1,0,79
1333385,959964,2020-05-21,Senate,"Do pass, but first be re-referred to the Committee on [Appropriations]",7,0,0,0,7
1333385,964414,2020-06-09,Senate,"Placed on suspense file",7,0,0,0,7
1333385,967510,2020-06-18,Senate,"Do pass as amended",7,0,0,0,7
1333385,968692,2020-06-24,Senate,"Special Consent SB934",39,0,1,0,40
1333385,974196,2020-07-27,Assembly,"Do pass and be re-referred to the Committee on [Appropriations] with recommendation: To Consent Calendar",9,0,1,0,10
1333385,976437,2020-08-20,Assembly,"Do pass",18,0,0,0,18
1333385,976734,2020-08-25,Assembly,"SB 934 Bates Senate Third Reading By Choi",75,0,4,0,79
1333390,960162,2020-05-22,Senate,"Do pass as amended, but first amend, and re-refer to the Committee on [Appropriations]",5,1,3,0,9
1333390,964372,2020-06-09,Senate,"Placed on suspense file",7,0,0,0,7
1335299,957770,2020-05-06,Assembly,"Do pass as amended, and be re-referred to the Committee on [Appropriations] with recommendation: To Consent Calendar",7,0,0,0,7
1335299,962776,2020-06-03,Assembly,"Do pass as amended",18,0,0,0,18
1335299,963584,2020-06-08,Assembly,"AB 2126 O'Donnell Assembly Second Reading",76,0,3,0,79
1335299,974281,2020-07-29,Senate,"Do pass, but first be re-referred to the Committee on [Appropriations] with the recommendation: To Consent Calendar",7,0,0,0,7
1335299,975831,2020-08-13,Senate,"Placed on suspense file",7,0,0,0,7
1335307,959972,2020-05-21,Assembly,"Do pass. To Consent Calendar",19,0,0,0,19
1335307,963589,2020-06-08,Assembly,"AB 2134 Chen Consent Calendar Second Day",76,0,3,0,79
1335307,975324,2020-08-08,Senate,"Do pass and be ordered to the Consent Calendar",9,0,0,0,9
1335307,977388,2020-08-28,Senate,"Consent Calendar AB2134",39,0,1,0,40
1335314,957322,2020-05-04,Assembly,"Do pass and be re-referred to the Committee on [Appropriations] with recommendation: To Consent Calendar",15,0,0,0,15
1335314,962383,2020-06-02,Assembly,"Do pass. To Consent Calendar",18,0,0,0,18
1335314,963537,2020-06-08,Assembly,"AB 2141 Mathis Consent Calendar Second Day Regular Session",76,0,3,0,79
1335314,974825,2020-08-04,Senate,"Do pass, but first be re-referred to the Committee on [Appropriations] with the recommendation: To Consent Calendar",14,0,1,0,15
1335314,977373,2020-08-28,Senate,"Consent Calendar AB2141",39,0,1,0,40
1335316,958138,2020-05-11,Assembly,"Do pass. To Consent Calendar",10,0,1,0,11
1335316,960430,2020-05-26,Assembly,"AB 2143 Mark Stone Consent Calendar Second Day Regular Session",75,0,4,0,79
1335316,975773,2020-08-13,Senate,"Do pass and be ordered to the Consent Calendar",9,0,0,0,9
1335316,977306,2020-08-28,Senate,"Consent Calendar AB2143",39,0,1,0,40
1335320,959735,2020-05-19,Assembly,"Do pass and be re-referred to the Committee on [Appropriations]",5,2,1,0,8
1335320,962860,2020-06-03,Assembly,"Do pass",11,5,2,0,18
1335320,966475,2020-06-15,Assembly,"AB 2147 Reyes Assembly Third Reading",54,0,25,0,79
1335320,974621,2020-07-31,Senate,"Do pass as amended, but first amend, and re-refer to the Committee on [Appropriations]",5,1,1,0,7
1335320,975821,2020-08-13,Senate,"Placed on suspense file",7,0,0,0,7
1335320,976401,2020-08-20,Senate,"Do pass",5,2,0,0,7
1335320,977990,2020-08-30,Senate,"Assembly 3rd Reading AB2147 Reyes et al. By Bradford",30,0,10,0,40
1335320,977991,2020-08-30,Assembly,"AB 2147 Reyes Concurrence in Senate Amendments",51,12,16,0,79
1335322,957590,2020-05-05,Assembly,"Do pass as amended",9,2,0,0,11
1335322,964985,2020-06-10,Assembly,"AB 2149 Gonzalez Assembly Third Reading",68,5,6,0,79
1335322,976079,2020-08-18,Senate,"Do pass",8,1,0,0,9
1335322,977335,2020-08-28,Senate,"Assembly 3rd Reading AB2149 Gonzalez By Stern",34,2,4,0,40
1335322,978139,2020-08-30,Assembly,"AB 2149 Gonzalez Concurrence in Senate Amendments",65,6,8,0,79
1335323,959479,2020-05-19,Assembly,"Do pass as amended and be re-referred to the Committee on [Appropriations]",9,0,3,0,12
1335323,962770,2020-06-03,Assembly,"Do pass",14,0,4,0,18
1335323,963496,2020-06-08,Assembly,"AB 2150 Calderon Assembly Third Reading",66,1,12,0,79
1335323,975776,2020-08-13,Senate,"Do pass, but first be re-referred to the Committee on [Appropriations] with the recommendation: To Consent Calendar",7,0,0,0,7
1335323,976024,2020-08-17,Senate,"Placed on suspense file",7,0,0,0,7
1335324,958516,2020-05-13,Assembly,"Do pass and be re-referred to the Committee on [Appropriations] with recommendation: To Consent Calendar",7,0,0,0,7
1335324,962378,2020-06-02,Assembly,"Do pass. To Consent Calendar",18,0,0,0,18
1335324,963621,2020-06-08,Assembly,"AB 2151 Gallagher Consent Calendar Second Day Regular Session",76,0,3,0,79
1335324,974839,2020-08-04,Senate,"Do pass, but first be re-referred to the Committee on [Appropriations] with the recommendation: To Consent Calendar",5,0,0,0,5
1335324,977301,2020-08-28,Senate,"Consent Calendar AB2151",39,0,1,0,40
1335325,959953,2020-05-21,Assembly,"Do pass and be re-referred to the Committee on [Appropriations]",18,0,1,0,19
1335325,962810,2020-06-03,Assembly,"Do pass as amended",17,0,1,0,18
1335325,965092,2020-06-10,Assembly,"AB 2152 Gloria Assembly Third Reading",75,0,4,0,79
1335325,975359,2020-08-08,Senate,"Do pass",9,0,0,0,9
1335325,977196,2020-08-27,Senate,"Assembly 3rd Reading AB2152 Gloria et al. By Hill",30,0,10,0,40
1335325,977932,2020-08-30,Assembly,"AB 2152 Gloria Concurrence in Senate Amendments",72,1,6,0,79
1335330,959331,2020-05-18,Assembly,"Do pass and be re-referred to the Committee on [Appropriations] with recommendation: To Consent Calendar",15,0,0,0,15
1335330,962384,2020-06-02,Assembly,"Do pass. To Consent Calendar",18,0,0,0,18
1335330,963533,2020-06-08,Assembly,"AB 2157 Wood Consent Calendar Second Day Regular Session",76,0,3,0,79
1335330,974666,2020-08-01,Senate,"Do pass, but first be re-referred to the Committee on [Appropriations] with the recommendation: To Consent Calendar",8,0,1,0,9
1335330,975815,2020-08-13,Senate,"Do pass",7,0,0,0,7
1335330,976608,2020-08-24,Senate,"Assembly 3rd Reading AB2157 Wood By Hill",40,0,0,0,40
1335334,923973,2020-02-14,Assembly,"Be adopted. To Consent Calendar",8,0,4,0,12
1335334,928940,2020-02-20,Assembly,"ACR 164 Blanca Rubio Consent Calendar Second Day",69,0,11,0,80
1335334,965609,2020-06-11,Senate,"Special Consent ACR164",39,0,1,0,40
1335335,958117,2020-05-11,Senate,"Do pass",6,0,1,0,7
1335335,968057,2020-06-22,Senate,"Senate 3rd Reading SB940 Beall et al",38,0,2,0,40
1335335,974307,2020-07-29,Assembly,"Do pass",8,0,0,0,8
1335335,977743,2020-08-30,Assembly,"SB 940 Beall Senate Third Reading By Kalra",73,0,6,0,79
1335335,977744,2020-08-31,Senate,"Unfinished Business SB940 Beall et al. Concurrence",39,0,1,0,40
1335338,958795,2020-05-14,Senate,"Do pass as amended, but first amend, and re-refer to the Committee on [Appropriations]",5,0,0,0,5
1335338,964399,2020-06-09,Senate,"Placed on suspense file",7,0,0,0,7
1335345,961690,2020-05-29,Senate,"[First] hearing set for [05-29-2020]: Failed passage in Committee. Reconsideration granted",3,2,2,0,7
1335345,964998,2020-05-29,Senate,"Do pass as amended, but first amend, and re-refer to the Committee on [Appropriations]",3,2,2,0,7
1335347,961347,2020-05-28,Senate,"Do pass as amended, but first amend, and re-refer to the Committee on [Appropriations]",6,0,1,0,7
1335347,964419,2020-06-09,Senate,"Placed on suspense file",7,0,0,0,7
1335347,967423,2020-06-18,Senate,"Do pass",7,0,0,0,7
1335347,969723,2020-06-25,Senate,"Senate 3rd Reading SB952 Nielsen",28,11,1,0,40
1335351,959938,2020-05-21,Senate,"Do pass, but first be re-referred to the Committee on [Appropriations]",4,1,2,0,7
1335351,964397,2020-06-09,Senate,"Placed on suspense file",7,0,0,0,7
1335351,967425,2020-06-18,Senate,"Do pass",5,2,0,0,7
1335351,968056,2020-06-22,Senate,"Senate 3rd Reading SB956 Jackson",25,13,2,0,40
1336655,959318,2020-05-18,Assembly,"Do pass and be re-referred to the Committee on [Appropriations] with recommendation: To Consent Calendar",15,0,0,0,15
1336655,962756,2020-06-03,Assembly,"Do pass as amended",18,0,0,0,18
1336655,965087,2020-06-10,Assembly,"AB 2164 Robert Rivas Assembly Third Reading",78,0,1,0,79
1336655,974658,2020-08-01,Senate,"Do pass, but first be re-referred to the Committee on [Appropriations] with the recommendation: To Consent Calendar",8,0,1,0,9
1336655,975767,2020-08-13,Senate,"Placed on suspense file",7,0,0,0,7
1336655,976372,2020-08-20,Senate,"Do pass as amended",7,0,0,0,7
1336655,977345,2020-08-28,Senate,"Special Consent AB2164",39,0,1,0,40
1336655,977832,2020-08-30,Assembly,"AB 2164 Robert Rivas Concurrence in Senate Amendments",75,0,4,0,79
1336656,958154,2020-05-11,Assembly,"Do pass and be re-referred to the Committee on [Appropriations] with recommendation: To Consent Calendar",10,0,1,0,11
1336656,962386,2020-06-02,Assembly,"Do pass. To Consent Calendar",18,0,0,0,18
1336656,963580,2020-06-08,Assembly,"AB 2165 Robert Rivas Consent Calendar Second Day Regular Session",76,0,3,0,79
1336656,974490,2020-07-30,Senate,"Do pass, but first be re-referred to the Committee on [Appropriations] with the recommendation: To Consent Calendar",9,0,0,0,9
1336656,977793,2020-08-30,Senate,"Assembly 3rd Reading AB2165 Robert Rivas et al. By Umberg",39,0,1,0,40
1336656,977794,2020-08-31,Assembly,"AB 2165 Robert Rivas Concurrence in Senate Amendments",76,0,3,0,79
1336658,957789,2020-05-07,Assembly,"Do pass and be re-referred to the Committee on [Appropriations]",14,0,0,0,14
1336658,962873,2020-06-03,Assembly,"Do pass",17,0,1,0,18
1336658,963614,2020-06-08,Assembly,"AB 2167 Daly Assembly Third Reading",61,3,15,0,79
1336658,974799,2020-08-04,Senate,"Do pass as amended, but first amend, and re-refer to the Committee on [Appropriations]",12,0,1,0,13
1336658,976151,2020-08-19,Senate,"Placed on suspense file",7,0,0,0,7
1336658,976336,2020-08-20,Senate,"Do pass as amended",7,0,0,0,7
1336663,957325,2020-05-04,Assembly,"Do pass and be re-referred to the Committee on [Appropriations] with recommendation: To Consent Calendar",15,0,0,0,15
1336663,962379,2020-06-02,Assembly,"Do pass. To Consent Calendar",18,0,0,0,18
1336663,963547,2020-06-08,Assembly,"AB 2172 Petrie-Norris Consent Calendar Second Day Regular Session",76,0,3,0,79
1336663,974811,2020-08-04,Senate,"Do pass, but first be re-referred to the Committee on [Appropriations] with the recommendation: To Consent Calendar",14,0,1,0,15
1336663,975805,2020-08-13,Senate,"Placed on suspense file",7,0,0,0,7
1336663,976408,2020-08-20,Senate,"Do pass",7,0,0,0,7
1336663,977395,2020-08-28,Senate,"Special Consent AB2172",39,0,1,0,40
1336665,957779,2020-05-07,Assembly,"Do pass",8,0,0,0,8
1336665,963530,2020-06-08,Assembly,"AB 2174 Gallagher Assembly Third Reading",77,0,2,0,79
1336665,975381,2020-08-10,Senate,"Do pass",7,0,0,0,7
1336665,977167,2020-08-27,Senate,"Assembly 3rd Reading AB2174 Gallagher et al. By Nielsen",29,0,11,0,40
1336665,977997,2020-08-30,Assembly,"AB 2174 Gallagher Concurrence in Senate Amendments",75,0,4,0,79
1336669,958556,2020-05-12,Assembly,"Do pass and be re-referred to the Committee on [Appropriations]",20,0,1,0,21
1336669,962864,2020-06-03,Assembly,"Do pass",18,0,0,0,18
1336669,963577,2020-06-08,Assembly,"AB 2178 Levine Assembly Third Reading",76,0,3,0,79
1336680,957437,2020-05-05,Assembly,"Do pass and be re-referred to the Committee on [Appropriations] with recommendation: To Consent Calendar",13,0,0,0,13
1336680,962767,2020-06-03,Assembly,"Do pass as amended",17,0,1,0,18
1336680,965086,2020-06-10,Assembly,"AB 2189 Arambula Assembly Third Reading",77,0,2,0,79
1336681,958531,2020-05-13,Assembly,"Do pass",10,0,2,0,12
1336681,963499,2020-06-08,Assembly,"AB 2190 Medina Assembly Third Reading",77,0,2,0,79
1336683,957601,2020-05-06,Assembly,"Do pass and be re-referred to the Committee on [Appropriations]",11,0,0,0,11
1336683,962447,2020-06-02,Assembly,"Do pass. To Consent Calendar",18,0,0,0,18
1336683,963592,2020-06-08,Assembly,"AB 2192 V. A. Consent Calendar Second Day Regular Session",76,0,3,0,79
1336683,975352,2020-08-10,Senate,"Do pass, but first be re-referred to the Committee on [Appropriations] with the recommendation: To Consent Calendar",5,0,2,0,7
1336683,976022,2020-08-17,Senate,"Placed on suspense file",7,0,0,0,7
1336683,976393,2020-08-20,Senate,"Do pass",7,0,0,0,7
1336683,977342,2020-08-28,Senate,"Special Consent AB2192 V.A",39,0,1,0,40
1336684,957598,2020-05-06,Assembly,"Do pass",11,0,0,0,11
1336684,963513,2020-06-08,Assembly,"AB 2193 V. A. Assembly Third Reading",77,0,2,0,79
1336684,975332,2020-08-10,Senate,"Do pass and be ordered to the Consent Calendar",5,0,2,0,7
1336684,977296,2020-08-28,Senate,"Consent Calendar AB2193 V.A",39,0,1,0,40
1336686,957319,2020-05-04,Assembly,"Be adopted. To Consent Calendar",15,0,0,0,15
1336686,960479,2020-05-26,Assembly,"ACR 165 Ting Consent Calendar Second Day Regular Session",75,0,4,0,79
1336686,974838,2020-08-04,Senate,"Be adopted, but first be re-referred to the Committee on [Appropriations] with recommendation: To Consent Calendar",13,1,1,0,15
1336686,977336,2020-08-28,Senate,"Consent Calendar ACR165",39,0,1,0,40
1336695,959485,2020-05-19,Senate,"Do pass, but first be re-referred to the Committee on [Appropriations] with the recommendation: To Consent Calendar",5,0,0,0,5
1336695,965661,2020-06-11,Senate,"Consent Calendar SB970",39,0,1,0,40
1336695,973995,2020-07-27,Assembly,"Do pass and be re-referred to the Committee on [Appropriations]",6,1,0,0,7
1336695,975506,2020-08-11,Assembly,"Do pass",16,1,0,0,17
1336695,976643,2020-08-24,Assembly,"SB 970 Umberg Senate Third Reading By Berman",66,5,8,0,79
1336697,961341,2020-05-28,Senate,"Do pass as amended, but first amend, and re-refer to the Committee on [Appropriations]",4,2,1,0,7
1336697,968053,2020-06-22,Senate,"Senate 3rd Reading SB972 Skinner",25,12,3,0,40
1336697,974190,2020-07-27,Assembly,"Do pass as amended and be re-referred to the Committee on [Appropriations]",6,4,0,0,10
1336697,976385,2020-08-20,Assembly,"Do pass",11,7,0,0,18
1336697,976921,2020-08-26,Assembly,"SB 972 Skinner Senate Third Reading By Gabriel",42,20,17,0,79
1336697,978163,2020-08-30,Senate,"Unfinished Business SB972 Skinner Concurrence",28,11,1,0,40
1336698,958767,2020-05-14,Senate,"Do pass, but first be re-referred to the Committee on [Appropriations]",4,1,0,0,5
1336698,964409,2020-06-09,Senate,"Placed on suspense file",7,0,0,0,7
1336698,967419,2020-06-18,Senate,"Do pass as amended",5,2,0,0,7
1336698,969771,2020-06-25,Senate,"Senate 3rd Reading SB973 Jackson et al",29,9,2,0,40
1336698,974304,2020-07-29,Assembly,"Do pass and be re-referred to the Committee on [Appropriations]",5,2,0,0,7
1336698,976501,2020-08-20,Assembly,"Do pass as amended",13,5,0,0,18
1336698,976904,2020-08-26,Assembly,"SB 973 Jackson Senate Third Reading By Cristina Garcia",50,11,18,0,79
1336698,977940,2020-08-30,Senate,"Unfinished Business SB973 Jackson et al. Concurrence",29,8,3,0,40
1336699,961699,2020-05-29,Senate,"Do pass as amended, but first amend, and re-refer to the Committee on [Appropriations]",6,0,1,0,7
1336699,969410,2020-06-26,Senate,"Senate 3rd Reading SB974 Hurtado",33,6,1,0,40
1336699,974951,2020-08-06,Assembly,"Do pass as amended and be re-referred to the Committee on [Appropriations]",9,1,1,0,11
1336699,976078,2020-08-18,Assembly,"Do pass as amended",17,0,1,0,18
1336699,978039,2020-08-30,Assembly,"SB 974 Hurtado Senate Third Reading By Aguiar-Curry",71,3,5,0,79
1336699,978040,2020-08-31,Senate,"Unfinished Business SB974 Hurtado et al. Concurrence",34,3,3,0,40
1336702,958526,2020-05-13,Senate,"Do pass as amended, but first amend, and re-refer to the Committee on [Appropriations]",7,2,0,0,9
1336702,964413,2020-06-09,Senate,"Placed on suspense file",7,0,0,0,7
1336702,967450,2020-06-18,Senate,"Do pass as amended",5,2,0,0,7
1336702,969418,2020-06-26,Senate,"Senate 3rd Reading SB977 Monning",21,11,8,0,40
1336702,975004,2020-08-04,Assembly,"Do pass as amended and be re-referred to the Committee on [Appropriations]",8,4,3,0,15
1336702,976484,2020-08-20,Assembly,"Do pass",10,4,4,0,18
1336704,959780,2020-05-20,Senate,"Do pass, but first be re-referred to the Committee on [Appropriations]",2,5,0,0,7
1336704,959781,2020-05-20,Senate,"[First] hearing set for [05-20-2020]: Failed passage in Committee. Reconsideration granted",7,0,0,0,7
1336705,960161,2020-05-22,Senate,"Do pass as amended, but first amend, and re-refer to the Committee on [Appropriations]",7,1,1,0,9
1336705,964390,2020-06-09,Senate,"Placed on suspense file",7,0,0,0,7
1336705,967393,2020-06-18,Senate,"Do pass as amended",5,1,1,0,7
1336705,969729,2020-06-25,Senate,"Senate 3rd Reading SB980 Umberg et al",36,1,3,0,40
1336705,974829,2020-08-04,Assembly,"Do pass as amended and be re-referred to the Committee on [Appropriations]",10,0,1,0,11
1336705,976439,2020-08-20,Assembly,"Do pass",15,1,2,0,18
1336705,978142,2020-08-30,Assembly,"SB 980 Umberg Senate Third Reading By Gabriel",69,0,10,0,79
1336705,978143,2020-08-31,Senate,"Unfinished Business SB980 Umberg et al. Concurrence",39,0,1,0,40
1336708,965593,2020-06-11,Senate,"Special Consent SCR82",39,0,1,0,40
1337510,959490,2020-05-19,Assembly,"Do pass as amended and be re-referred to the Committee on [Appropriations]",12,0,0,0,12
1337510,962431,2020-06-02,Assembly,"Do pass",18,0,0,0,18
1337510,963521,2020-06-08,Assembly,"AB 2196 Gonzalez Assembly Third Reading",77,0,2,0,79
1337510,975772,2020-08-13,Senate,"Do pass, but first be re-referred to the Committee on [Appropriations]",7,0,0,0,7
1337510,976034,2020-08-17,Senate,"Placed on suspense file",7,0,0,0,7
1337510,976364,2020-08-20,Senate,"Do pass",7,0,0,0,7
1337510,977344,2020-08-28,Senate,"Special Consent AB2196",39,0,1,0,40
1337512,958148,2020-05-11,Assembly,"Do pass and be re-referred to the Committee on [Appropriations] with recommendation: To Consent Calendar",10,0,1,0,11
1337512,962822,2020-06-03,Assembly,"Do pass as amended",18,0,0,0,18
1337512,963562,2020-06-08,Assembly,"AB 2198 Ting Assembly Second Reading",76,0,3,0,79
1337512,974479,2020-07-30,Senate,"Do pass, but first be re-referred to the Committee on [Appropriations] with the recommendation: To Consent Calendar",9,0,0,0,9
1337512,975769,2020-08-13,Senate,"Placed on suspense file",7,0,0,0,7
1337513,959963,2020-05-21,Assembly,"Do pass and be re-referred to the Committee on [Appropriations]",18,0,1,0,19
1337513,962475,2020-06-02,Assembly,"Do pass",18,0,0,0,18
1337513,963498,2020-06-08,Assembly,"AB 2199 Nazarian Assembly Third Reading",72,0,7,0,79
1337513,975338,2020-08-08,Senate,"Do pass, but first be re-referred to the Committee on [Appropriations]",9,0,0,0,9
1337513,977762,2020-08-30,Senate,"Assembly 3rd Reading AB2199 Nazarian By Glazer",39,0,1,0,40
1337513,977763,2020-08-31,Assembly,"AB 2199 Nazarian Concurrence in Senate Amendments",73,0,6,0,79
1337517,959336,2020-05-18,Assembly,"Do pass as amended and be re-referred to the Committee on [Appropriations]",12,0,3,0,15
1337517,962739,2020-06-03,Assembly,"Do pass",13,0,5,0,18
1337517,963565,2020-06-08,Assembly,"AB 2203 Nazarian Assembly Third Reading",64,4,11,0,79
1337522,958142,2020-05-11,Assembly,"Do pass and be re-referred to the Committee on [Appropriations]",8,2,1,0,11
1337522,962791,2020-06-03,Assembly,"Do pass",14,4,0,0,18
1337522,965040,2020-06-10,Assembly,"AB 2208 Irwin Assembly Third Reading",62,13,4,0,79
1337522,974478,2020-07-30,Senate,"Do pass, but first be re-referred to the Committee on [Appropriations]",7,1,1,0,9
1337522,975779,2020-08-13,Senate,"Placed on suspense file",7,0,0,0,7
1337524,959968,2020-05-21,Assembly,"Do pass and be re-referred to the Committee on [Appropriations] with recommendation: To Consent Calendar",19,0,0,0,19
1337524,962463,2020-06-02,Assembly,"Do pass. To Consent Calendar",18,0,0,0,18
1337524,963633,2020-06-08,Assembly,"AB 2210 Aguiar-Curry Consent Calendar Second Day Regular Session",76,0,3,0,79
1337524,975375,2020-08-08,Senate,"Do pass, but first be re-referred to the Committee on [Appropriations] with the recommendation: To Consent Calendar",9,0,0,0,9
1337524,977302,2020-08-28,Senate,"Consent Calendar AB2210",39,0,1,0,40
1337527,958515,2020-05-12,Assembly,"Do pass as amended and be re-referred to the Committee on [Appropriations]",20,0,1,0,21
1337527,962865,2020-06-03,Assembly,"Do pass",18,0,0,0,18
1337527,965003,2020-06-10,Assembly,"AB 2213 Limón Assembly Third Reading",78,0,1,0,79
1337527,975938,2020-08-14,Senate,"Do pass, but first be re-referred to the Committee on [Appropriations] with the recommendation: To Consent Calendar",16,0,0,0,16
1337527,976161,2020-08-19,Senate,"Placed on suspense file",7,0,0,0,7
1337527,976438,2020-08-20,Senate,"Do pass as amended",7,0,0,0,7
1337527,978182,2020-08-30,Senate,"Assembly 3rd Reading AB2213 Limón et al. By Jackson",39,0,1,0,40
1337527,978183,2020-08-30,Assembly,"AB 2213 Limón Concurrence in Senate Amendments",75,0,4,0,79
1337532,959317,2020-05-18,Assembly,"Do pass and be re-referred to the Committee on [Appropriations]",12,1,2,0,15
1337532,962883,2020-06-03,Assembly,"Do pass as amended",12,4,2,0,18
1337532,965006,2020-06-10,Assembly,"AB 2218 Santiago Assembly Third Reading",59,13,7,0,79
1337532,975358,2020-08-10,Senate,"Do pass, but first be re-referred to the Committee on [Appropriations]",7,1,1,0,9
1337532,976039,2020-08-17,Senate,"Placed on suspense file",7,0,0,0,7
1337532,976411,2020-08-20,Senate,"Do pass as amended",5,2,0,0,7
1337532,977416,2020-08-29,Senate,"Assembly 3rd Reading AB2218 Santiago et al. By Wiener",28,9,3,0,40
1337532,978168,2020-08-30,Assembly,"AB 2218 Santiago Concurrence in Senate Amendments",54,10,15,0,79
1337533,957446,2020-05-05,Assembly,"Do pass and be re-referred to the Committee on [Appropriations]",5,2,0,0,7
1337550,960472,2020-05-26,Senate,"Do pass, but first be re-referred to the Committee on [Appropriations] with the recommendation: To Consent Calendar",7,0,2,0,9
1337550,964406,2020-06-09,Senate,"Placed on suspense file",7,0,0,0,7
1337550,967404,2020-06-18,Senate,"Do pass",7,0,0,0,7
1337550,968708,2020-06-24,Senate,"Special Consent SB989",39,0,1,0,40
1337550,974938,2020-08-06,Assembly,"Do pass as amended and be re-referred to the Committee on [Appropriations]",10,0,1,0,11
1337551,958769,2020-05-14,Senate,"Do pass, but first be re-referred to the Committee on [Appropriations]",1,4,0,0,5
1337551,958770,2020-05-14,Senate,"[First] hearing set for [05-14-2020]: Failed passage in Committee. Reconsideration granted",5,0,0,0,5
1337556,961687,2020-05-29,Senate,"Do pass as amended, but first amend, and re-refer to the Committee on [Appropriations]",5,0,2,0,7
1337556,964354,2020-06-09,Senate,"Placed on suspense file",7,0,0,0,7
1337556,967496,2020-06-18,Senate,"Do pass",7,0,0,0,7
1337556,967497,2020-06-18,Senate,"[06-18-2020] set for [First] hearing: Reconsideration of favorable vote granted",7,0,0,0,7
1337556,967498,2020-06-18,Senate,"Do pass as amended",5,1,1,0,7
1337556,969765,2020-06-25,Senate,"Senate 3rd Reading SB995 Atkins et al",32,4,4,0,40
1337556,974932,2020-08-06,Assembly,"Do pass as amended and be re-referred to the Committee on [Appropriations]",8,1,2,0,11
1337556,976483,2020-08-20,Assembly,"Do pass as amended",16,0,2,0,18
1337556,978091,2020-08-31,Assembly,"SB 995 Atkins Senate Third Reading By Gonzalez Move Previous Question By CALDERON",54,12,13,0,79
1337556,978092,2020-08-31,Assembly,"SB 995 Atkins Senate Third Reading By Gonzalez",62,4,13,0,79
1337557,928951,2020-02-20,Senate,"Senate 3rd Reading SCR83 Dodd et al",38,0,1,0,39
1337557,938020,2020-02-27,Assembly,"Be adopted. To Consent Calendar",10,0,2,0,12
1337557,944386,2020-03-05,Assembly,"SCR 83 Dodd Consent Calendar Second Day Regular Session",72,0,8,0,80
1338819,959775,2020-05-20,Assembly,"Do pass and be re-referred to the Committee on [Appropriations]",6,0,1,0,7
1338819,962389,2020-06-02,Assembly,"Do pass",14,4,0,0,18
1338819,963495,2020-06-08,Assembly,"AB 2231 Kalra Assembly Third Reading",57,15,7,0,79
1338819,974914,2020-08-05,Senate,"Do pass, but first be re-referred to the Committee on [Appropriations]",4,1,0,0,5
1338819,976618,2020-08-24,Senate,"Assembly 3rd Reading AB2231 Kalra By Monning",28,11,1,0,40
1338819,976923,2020-08-26,Assembly,"AB 2231 Kalra Concurrence in Senate Amendments",55,14,10,0,79
1338820,959939,2020-05-21,Assembly,"Do pass and be re-referred to the Committee on [Appropriations] with recommendation: To Consent Calendar",19,0,0,0,19
1338820,962466,2020-06-02,Assembly,"Do pass. To Consent Calendar",18,0,0,0,18
1338820,963587,2020-06-08,Assembly,"AB 2232 Grayson Consent Calendar Second Day Regular Session",76,0,3,0,79
1338822,957442,2020-05-05,Assembly,"Do pass",7,0,0,0,7
1338822,963567,2020-06-08,Assembly,"AB 2234 Chau Assembly Third Reading",77,0,2,0,79
1338822,974916,2020-08-05,Senate,"Do pass and be ordered to the Consent Calendar",5,0,0,0,5
1338822,977362,2020-08-28,Senate,"Consent Calendar AB2234",39,0,1,0,40
1338824,959749,2020-05-19,Assembly,"Do pass and be re-referred to the Committee on [Appropriations] with recommendation: To Consent Calendar",8,0,0,0,8
1338835,959313,2020-05-18,Assembly,"Do pass and be re-referred to the Committee on [Appropriations]",10,1,0,0,11
1338835,962456,2020-06-02,Assembly,"Do pass",13,4,1,0,18
1338835,963591,2020-06-08,Assembly,"AB 2247 Burke Assembly Third Reading",62,10,7,0,79
1338835,974266,2020-07-29,Senate,"Do pass, but first be re-referred to the Committee on [Appropriations]",5,0,2,0,7
1338835,978006,2020-08-30,Senate,"Assembly 3rd Reading AB2247 Burke By McGuire",30,2,8,0,40
1338841,959941,2020-05-21,Assembly,"Do pass. To Consent Calendar",19,0,0,0,19
1338841,963487,2020-06-08,Assembly,"AB 2253 Low Consent Calendar Second Day Regular Session",76,0,3,0,79
1338841,974653,2020-08-01,Senate,"Do pass and be ordered to the Consent Calendar",8,0,1,0,9
1338841,977285,2020-08-28,Senate,"Consent Calendar AB2253",39,0,1,0,40
1338845,959758,2020-05-20,Assembly,"Do pass and be re-referred to the Committee on [Appropriations]",7,0,0,0,7
1338845,962852,2020-06-03,Assembly,"Do pass as amended",18,0,0,0,18
1338845,965647,2020-06-11,Assembly,"AB 2257 Gonzalez Third Reading Urgency",77,0,2,0,79
1338845,974890,2020-08-05,Senate,"Do pass as amended, but first amend, and re-refer to the Committee on [Appropriations]",5,0,0,0,5
1338845,976053,2020-08-17,Senate,"Placed on suspense file",7,0,0,0,7
1338845,976490,2020-08-20,Senate,"Do pass as amended",7,0,0,0,7
1338845,977999,2020-08-31,Senate,"Assembly 3rd Reading AB2257 Gonzalez et al. By Jackson Urgency Clause",39,0,1,0,40
1338845,978000,2020-08-31,Assembly,"AB 2257 Gonzalez Concurrence - Urgency Added",74,0,5,0,79
1338852,960171,2020-05-22,Senate,"Do pass and be ordered to the Consent Calendar",8,0,1,0,9
1338852,965606,2020-06-11,Senate,"Consent Calendar SB1003 Jones et al. Urgency Clause",39,0,1,0,40
1338852,975660,2020-08-12,Assembly,"Do pass. To Consent Calendar",11,0,0,0,11
1338852,978201,2020-08-30,Senate,"Unfinished Business SB1003 Jones et al. Urgency Clause Concurrence",39,0,1,0,40
1338852,978202,2020-08-30,Assembly,"SB 1003 Jones Consent Calendar Second Day Regular Session",75,0,4,0,79
1338857,959978,2020-05-21,Senate,"Do pass as amended",7,0,0,0,7
1338857,965577,2020-06-11,Senate,"Senate 3rd Reading SB998 Moorlach",39,0,1,0,40
1338857,975493,2020-08-11,Assembly,"Do pass. To Consent Calendar",8,0,0,0,8
1338857,977954,2020-08-30,Assembly,"SB 998 Moorlach Consent Calendar Second Day Regular Session",75,0,4,0,79
1338858,960178,2020-05-22,Senate,"Do pass as amended",7,1,1,0,9
1338858,968055,2020-06-22,Senate,"Senate 3rd Reading SB999 Umberg et al",25,11,4,0,40
1338858,974295,2020-07-29,Assembly,"Do pass as amended",3,1,4,0,8
1338858,974296,2020-07-29,Assembly,Reconsideration,8,0,0,0,8
1341569,957609,2020-05-05,Assembly,"Do pass as amended and be re-referred to the Committee on [Appropriations]",8,3,0,0,11
1341573,959306,2020-05-18,Assembly,"Do pass as amended, and be re-referred to the Committee on [Appropriations] with recommendation: To Consent Calendar",15,0,0,0,15
1341573,962398,2020-06-02,Assembly,"Do pass. To Consent Calendar",18,0,0,0,18
1341573,963637,2020-06-08,Assembly,"AB 2265 Quirk-Silva Consent Calendar Second Day Regular Session",76,0,3,0,79
1341573,975362,2020-08-10,Senate,"Do pass as amended, but first amend, and re-refer to the Committee on [Appropriations] with the recommendation: To Consent Calendar",8,0,1,0,9
1341573,977402,2020-08-28,Senate,"Consent Calendar AB2265",39,0,1,0,40
1341573,978049,2020-08-30,Assembly,"AB 2265 Quirk-Silva Concurrence in Senate Amendments",75,0,4,0,79
1341579,958131,2020-05-11,Assembly,"Do pass and be re-referred to the Committee on [Appropriations]",8,2,1,0,11
1341579,962766,2020-06-03,Assembly,"Do pass as amended",14,3,1,0,18
1341579,963602,2020-06-08,Assembly,"AB 2271 Gabriel Assembly Second Reading",65,6,8,0,79
1341581,959979,2020-05-21,Assembly,"Do pass and be re-referred to the Committee on [Appropriations]",19,0,0,0,19
1341581,962365,2020-06-02,Assembly,"Do pass as amended",18,0,0,0,18
1341581,966458,2020-06-15,Assembly,"AB 2273 Bloom Assembly Third Reading",79,0,0,0,79
1341581,975337,2020-08-08,Senate,"Do pass as amended, but first amend, and re-refer to the Committee on [Appropriations]",9,0,0,0,9
1341581,977741,2020-08-30,Senate,"Assembly 3rd Reading AB2273 Bloom et al. By Allen",39,0,1,0,40
1341581,977742,2020-08-31,Assembly,"AB 2273 Bloom Concurrence in Senate Amendments",76,0,3,0,79
1341583,958327,2020-05-12,Assembly,"Do pass. To Consent Calendar",8,0,0,0,8
1341583,960478,2020-05-26,Assembly,"AB 2275 Nazarian Consent Calendar Second Day Regular Session",75,0,4,0,79
1341583,974272,2020-07-29,Senate,"Do pass and be ordered to the Consent Calendar",7,0,0,0,7
1341583,977332,2020-08-28,Senate,"Consent Calendar AB2275 Nazarian et al. Urgency Clause",39,0,1,0,40
1341583,977890,2020-08-30,Assembly,"AB 2275 Nazarian Concurrence - Urgency Added",75,0,4,0,79
1341584,959355,2020-05-18,Assembly,"Do pass and be re-referred to the Committee on [Appropriations] with recommendation: To Consent Calendar",15,0,0,0,15
1341584,962877,2020-06-03,Assembly,"Do pass",18,0,0,0,18
1341584,965067,2020-06-10,Assembly,"AB 2276 Reyes Assembly Third Reading",78,0,1,0,79
1341584,974660,2020-08-01,Senate,"Do pass as amended, but first amend, and re-refer to the Committee on [Appropriations]",8,0,1,0,9
1341584,975823,2020-08-13,Senate,"Placed on suspense file",7,0,0,0,7
1341584,976421,2020-08-20,Senate,"Do pass as amended",7,0,0,0,7
1341584,977425,2020-08-29,Senate,"Assembly 3rd Reading AB2276 Reyes et al. By Leyva",38,0,2,0,40
1341584,978023,2020-08-30,Assembly,"AB 2276 Reyes Concurrence in Senate Amendments",75,0,4,0,79
1341585,959323,2020-05-18,Assembly,"Do pass as amended, and be re-referred to the Committee on [Appropriations] with recommendation: To Consent Calendar",15,0,0,0,15
1341585,962731,2020-06-03,Assembly,"Do pass",18,0,0,0,18
1341585,965027,2020-06-10,Assembly,"AB 2277 Salas Assembly Third Reading",77,0,2,0,79
1341587,959351,2020-05-18,Assembly,"Do pass and be re-referred to the Committee on [Appropriations] with recommendation: To Consent Calendar",15,0,0,0,15
1341587,962387,2020-06-02,Assembly,"Do pass. To Consent Calendar",18,0,0,0,18
1341587,963606,2020-06-08,Assembly,"AB 2279 Cristina Garcia Consent Calendar Second Day Regular Session",76,0,3,0,79
1341588,959302,2020-05-18,Assembly,"Do pass and be re-referred to the Committee on [Appropriations]",10,0,5,0,15
1341588,962740,2020-06-03,Assembly,"Do pass",12,1,5,0,18
1341588,965049,2020-06-10,Assembly,"AB 2280 Chau Assembly Third Reading",53,10,16,0,79
1341590,957790,2020-05-07,Assembly,"Do pass and be re-referred to the Committee on [Appropriations] with recommendation: To Consent Calendar",8,0,0,0,8
1341590,962799,2020-06-03,Assembly,"Do pass as amended",18,0,0,0,18
1341590,963615,2020-06-08,Assembly,"AB 2282 McCarty Assembly Second Reading",77,0,2,0,79
1341593,957321,2020-05-04,Assembly,"Do pass and be re-referred to the Committee on [Appropriations] with recommendation: To Consent Calendar",15,0,0,0,15
1341593,962779,2020-06-03,Assembly,"Do pass",18,0,0,0,18
1341593,965671,2020-06-11,Assembly,"AB 2285 TRANS. Assembly Third Reading By FRAZIER",78,0,1,0,79
1341593,974816,2020-08-04,Senate,"Do pass, but first be re-referred to the Committee on [Appropriations] with the recommendation: To Consent Calendar",14,0,1,0,15
1341593,975803,2020-08-13,Senate,"Placed on suspense file",7,0,0,0,7
1341593,976300,2020-08-20,Senate,"Do pass as amended",7,0,0,0,7
1341593,977370,2020-08-28,Senate,"Special Consent AB2285 TRANS",39,0,1,0,40
1341593,977953,2020-08-30,Assembly,"AB 2285 TRANS. Concurrence in Senate Amendments By FRAZIER",75,0,4,0,79
1341595,958542,2020-05-13,Assembly,"Do pass and be re-referred to the Committee on [Appropriations] with recommendation: To Consent Calendar",11,0,0,0,11
1341595,962470,2020-06-02,Assembly,"Do pass. To Consent Calendar",18,0,0,0,18
1341595,963607,2020-06-08,Assembly,"AB 2287 Eggman Consent Calendar Second Day Regular Session",76,0,3,0,79
1341595,975501,2020-08-11,Senate,"Do pass, but first be re-referred to the Committee on [Appropriations] with the recommendation: To Consent Calendar",5,0,2,0,7
1341595,976048,2020-08-17,Senate,"Placed on suspense file",7,0,0,0,7
1341595,976358,2020-08-20,Senate,"Do pass as amended",6,0,1,0,7
1341595,977423,2020-08-29,Senate,"Assembly 3rd Reading AB2287 Eggman et al. By Galgiani",38,0,2,0,40
1341595,978053,2020-08-30,Assembly,"AB 2287 Eggman Concurrence in Senate Amendments By FRIEDMAN",75,0,4,0,79
1341596,959969,2020-05-21,Assembly,"Do pass and be re-referred to the Committee on [Appropriations]",19,0,0,0,19
1341596,962377,2020-06-02,Assembly,"Do pass. To Consent Calendar",18,0,0,0,18
1341596,963524,2020-06-08,Assembly,"AB 2288 Low Consent Calendar Second Day Regular Session",76,0,3,0,79
1341596,975331,2020-08-08,Senate,"Do pass, but first be re-referred to the Committee on [Appropriations]",9,0,0,0,9
1341596,975766,2020-08-13,Senate,"Placed on suspense file",7,0,0,0,7
1341596,976396,2020-08-20,Senate,"Do pass as amended",7,0,0,0,7
1341596,977163,2020-08-27,Senate,"Assembly 3rd Reading AB2288 Low et al. By Caballero Urgency Clause",30,0,10,0,40
1341596,978031,2020-08-30,Assembly,"AB 2288 Low Concurrence - Urgency Added",74,0,5,0,79
1341601,959340,2020-05-18,Assembly,"Do pass and be re-referred to the Committee on [Appropriations] with recommendation: To Consent Calendar",15,0,0,0,15
1341601,962734,2020-06-03,Assembly,"Do pass as amended",18,0,0,0,18
1341601,965017,2020-06-10,Assembly,"AB 2293 Mayes Assembly Third Reading",78,0,1,0,79
1341601,975313,2020-08-10,Senate,"Do pass as amended, but first amend, and re-refer to the Committee on [Appropriations] with the recommendation: To Consent Calendar",8,0,1,0,9
1341601,976027,2020-08-17,Senate,"Placed on suspense file",7,0,0,0,7
1341604,958786,2020-05-14,Assembly,"Do pass and be re-referred to the Committee on [Appropriations]",6,1,2,0,9
1341604,962771,2020-06-03,Assembly,"Do pass",14,1,3,0,18
1341604,965031,2020-06-10,Assembly,"AB 2296 Quirk Assembly Third Reading By BAUER-KAHAN",63,6,10,0,79
1341604,975499,2020-08-11,Senate,"Do pass, but first be re-referred to the Committee on [Appropriations]",4,0,3,0,7
1341604,976016,2020-08-17,Senate,"Placed on suspense file",7,0,0,0,7
1341604,976366,2020-08-20,Senate,"Do pass",5,2,0,0,7
1341604,977356,2020-08-28,Senate,"Assembly 3rd Reading AB2296 Quirk By Wieckowski",29,9,2,0,40
1341608,958791,2020-05-14,Assembly,"Do pass as amended",7,0,0,0,7
1341608,963601,2020-06-08,Assembly,"AB 2300 Cooper Assembly Third Reading",77,0,2,0,79
1341608,974663,2020-08-01,Senate,"Do pass and be ordered to the Consent Calendar",8,0,1,0,9
1341608,977394,2020-08-28,Senate,"Consent Calendar AB2300",39,0,1,0,40
1341619,959774,2020-05-20,Assembly,"Do pass and be re-referred to the Committee on [Appropriations] with recommendation: To Consent Calendar",7,0,0,0,7
1341619,962481,2020-06-02,Assembly,"Do pass. To Consent Calendar",18,0,0,0,18
1341619,963553,2020-06-08,Assembly,"AB 2311 Low Consent Calendar Second Day Regular Session",76,0,3,0,79
1341619,974901,2020-08-05,Senate,"Do pass, but first be re-referred to the Committee on [Appropriations] with the recommendation: To Consent Calendar",5,0,0,0,5
1341619,977372,2020-08-28,Senate,"Consent Calendar AB2311",39,0,1,0,40
1341619,978136,2020-08-30,Assembly,"AB 2311 Low Concurrence in Senate Amendments",75,0,4,0,79
1341622,958520,2020-05-13,Assembly,"Do pass and be re-referred to the Committee on [Appropriations]",7,0,0,0,7
1341622,962471,2020-06-02,Assembly,"Do pass",18,0,0,0,18
1341622,964987,2020-06-10,Assembly,"AB 2314 Ramos Assembly Third Reading",75,0,4,0,79
1341622,974835,2020-08-04,Senate,"Do pass, but first be re-referred to the Committee on [Appropriations] with the recommendation: To Consent Calendar",5,0,0,0,5
1341622,977346,2020-08-28,Senate,"Consent Calendar AB2314",39,0,1,0,40
1341622,977965,2020-08-30,Assembly,"AB 2314 Ramos Concurrence in Senate Amendments",75,0,4,0,79
1341627,958156,2020-05-11,Assembly,"Do pass. To Consent Calendar",10,0,1,0,11
1341627,960460,2020-05-26,Assembly,"AB 2319 Berman Consent Calendar Second Day Regular Session",75,0,4,0,79
1341627,976105,2020-08-18,Senate,"Do pass and be ordered to the Consent Calendar",9,0,0,0,9
1341627,977383,2020-08-28,Senate,"Consent Calendar AB2319",39,0,1,0,40
1341628,957597,2020-05-05,Assembly,"Do pass and be re-referred to the Committee on [Appropriations]",5,3,3,0,11
1341629,959769,2020-05-19,Assembly,"Do pass as amended, and be re-referred to the Committee on [Appropriations] with recommendation: To Consent Calendar",8,0,0,0,8
1341629,962400,2020-06-02,Assembly,"Do pass. To Consent Calendar",18,0,0,0,18
1341629,963563,2020-06-08,Assembly,"AB 2321 Jones-Sawyer Consent Calendar Second Day Regular Session",76,0,3,0,79
1341629,974612,2020-07-31,Senate,"Do pass, but first be re-referred to the Committee on [Appropriations] with the recommendation: To Consent Calendar",7,0,0,0,7
1341629,977189,2020-08-27,Senate,"Assembly 3rd Reading AB2321 Jones-Sawyer By Durazo",30,0,10,0,40
1341629,978151,2020-08-30,Assembly,"AB 2321 Jones-Sawyer Concurrence in Senate Amendments",75,0,4,0,79
1341631,958547,2020-05-13,Assembly,"Do pass and be re-referred to the Committee on [Appropriations]",7,2,2,0,11
1341631,962415,2020-06-02,Assembly,"Do pass as amended",16,0,2,0,18
1341631,963514,2020-06-08,Assembly,"AB 2323 Friedman Assembly Third Reading",72,0,7,0,79
1341631,975542,2020-08-11,Senate,"Do pass as amended, but first amend, and re-refer to the Committee on [Appropriations]",4,0,3,0,7
1341631,976169,2020-08-19,Senate,"Placed on suspense file",7,0,0,0,7
1341633,958145,2020-05-11,Assembly,"Do pass and be re-referred to the Committee on [Appropriations]",8,1,2,0,11
1341633,962417,2020-06-02,Assembly,"Do pass",11,3,4,0,18
1341633,965595,2020-06-11,Assembly,"AB 2325 Carrillo Assembly Third Reading",51,9,19,0,79
1341633,974475,2020-07-30,Senate,"Do pass as amended, but first amend, and re-refer to the Committee on [Appropriations]",8,0,1,0,9
1341633,975824,2020-08-13,Senate,"Placed on suspense file",7,0,0,0,7
1341633,976506,2020-08-20,Senate,"Do pass as amended",7,0,0,0,7
1341633,978191,2020-08-30,Senate,"Assembly 3rd Reading AB2325 Carrillo et al. By Rubio",37,1,2,0,40
1341633,978192,2020-08-30,Assembly,"AB 2325 Carrillo Concurrence in Senate Amendments",48,5,26,0,79
1341637,960239,2020-05-20,Assembly,"Do pass and be re-referred to the Committee on [Appropriations] with recommendation: To Consent Calendar",8,0,0,0,8
1341640,958119,2020-05-11,Assembly,"Do pass and be re-referred to the Committee on [Appropriations]",11,0,0,0,11
1341640,962872,2020-06-03,Assembly,"Do pass",18,0,0,0,18
1341640,965013,2020-06-10,Assembly,"AB 2332 Kalra Assembly Third Reading",78,0,1,0,79
1341640,975383,2020-08-08,Senate,"Do pass, but first be re-referred to the Committee on [Appropriations] with the recommendation: To Consent Calendar",9,0,0,0,9
1341640,975795,2020-08-13,Senate,"Placed on suspense file",7,0,0,0,7
1341641,958785,2020-05-14,Assembly,"Do pass and be re-referred to the Committee on [Appropriations]",7,2,0,0,9
1341641,962374,2020-06-02,Assembly,"Do pass",15,2,1,0,18
1341641,963531,2020-06-08,Assembly,"AB 2333 QUIRK Assembly Third Reading By BAUER-KAHAN",65,8,6,0,79
1341646,960910,2020-05-27,Assembly,"Do pass",10,0,1,0,11
1341646,965639,2020-06-11,Assembly,"AB 2338 Weber Assembly Third Reading",78,0,1,0,79
1341646,974983,2020-08-07,Senate,"Do pass, but first be re-referred to the Committee on [Appropriations]",7,0,0,0,7
1341646,977188,2020-08-27,Senate,"Assembly 3rd Reading AB2338 Weber By Gonzalez",30,0,10,0,40
1341650,928958,2020-02-20,Assembly,"Be adopted. To Consent Calendar",9,0,3,0,12
1341650,938043,2020-02-27,Assembly,"HR 82 Patterson Consent Calendar Second Day",71,0,9,0,80
1341657,959475,2020-05-19,Senate,"Do pass, but first be re-referred to the Committee on [Appropriations]",7,0,2,0,9
1341657,964402,2020-06-09,Senate,"Placed on suspense file",7,0,0,0,7
1341657,967485,2020-06-18,Senate,"Do pass as amended",7,0,0,0,7
1341657,968682,2020-06-24,Senate,"Special Consent SB1012",39,0,1,0,40
1341657,974955,2020-08-06,Assembly,"Do pass as amended and be re-referred to the Committee on [Appropriations]",8,2,1,0,11
1341657,976455,2020-08-20,Assembly,"Do pass",13,4,1,0,18
1341669,961683,2020-05-29,Senate,"Do pass, but first be re-referred to the Committee on [Appropriations] with the recommendation: To Consent Calendar",13,0,2,0,15
1341669,964369,2020-06-09,Senate,"Placed on suspense file",7,0,0,0,7
1341669,967421,2020-06-18,Senate,"Do pass",7,0,0,0,7
1341669,968705,2020-06-24,Senate,"Special Consent SB1024",39,0,1,0,40
1341669,975311,2020-08-10,Assembly,"Do pass and be re-referred to the Committee on [Appropriations]",10,2,3,0,15
1341669,976424,2020-08-20,Assembly,"Do pass as amended",13,2,3,0,18
1341669,978140,2020-09-01,Assembly,"SB 1024 Jones Senate Third Reading By O'Donnell",44,17,18,0,79
1341674,958509,2020-05-13,Senate,"Do pass as amended, and be ordered to the Consent Calendar",9,0,0,0,9
1341674,965627,2020-06-11,Senate,"Consent Calendar SB1029",39,0,1,0,40
1341674,975005,2020-08-04,Assembly,"Do pass as amended and be re-referred to the Committee on [Appropriations]",14,0,1,0,15
1341674,976099,2020-08-18,Assembly,"Do pass as amended",18,0,0,0,18
1341675,960457,2020-05-26,Senate,"Do pass, but first be re-referred to the Committee on [Appropriations] with the recommendation: To Consent Calendar",10,0,1,0,11
1341675,964377,2020-06-09,Senate,"Do pass",7,0,0,0,7
1341675,965672,2020-06-11,Senate,"Senate 3rd Reading SB1030 HOUSING (Wiener)",39,0,1,0,40
1341675,974280,2020-07-29,Assembly,"Do pass as amended and be re-referred to the Committee on [Appropriations]",8,0,0,0,8
1341675,975546,2020-08-11,Assembly,"Do pass. To Consent Calendar",17,0,0,0,17
1341675,977948,2020-08-31,Senate,"Unfinished Business SB1030 HOUSING (Wiener) Urgency Clause Concurrence",39,0,1,0,40
1341675,977949,2020-08-31,Assembly,"SB 1030 HOUSING Third Reading Urgency By CHIU",76,0,3,0,79
1341686,965586,2020-06-11,Senate,"Special Consent SCR84",39,0,1,0,40
1341687,950963,2020-03-12,Senate,"Senate 3rd Reading SCR85 Chang",33,0,6,0,39
1341688,938026,2020-02-27,Senate,"Senate 3rd Reading SR77 Allen",35,0,4,0,39
1343090,959725,2020-05-19,Assembly,"Do pass. To Consent Calendar",8,0,0,0,8
1343090,960471,2020-05-26,Assembly,"AB 2340 Bigelow Consent Calendar Second Day Regular Session",75,0,4,0,79
1343090,974626,2020-07-31,Senate,"Do pass, but first be re-referred to the Committee on [Rules] with the recommendation: To Consent Calendar",7,0,0,0,7
1343090,975825,2020-08-13,Senate,"Placed on suspense file",7,0,0,0,7
1343091,958518,2020-05-13,Assembly,"Do pass and be re-referred to the Committee on [Appropriations]",12,0,0,0,12
1343091,962820,2020-06-03,Assembly,"Do pass as amended",18,0,0,0,18
1343091,966495,2020-06-15,Assembly,"AB 2341 McCarty Assembly Third Reading",79,0,0,0,79
1343092,959760,2020-05-19,Assembly,"Do pass and be re-referred to the Committee on [Appropriations]",5,3,0,0,8
1343092,962748,2020-06-03,Assembly,"Do pass as amended",11,7,0,0,18
1343092,966496,2020-06-15,Assembly,"AB 2342 McCarty Assembly Third Reading",65,0,14,0,79
1343092,974982,2020-08-07,Senate,"Do pass, but first be re-referred to the Committee on [Appropriations]",6,1,0,0,7
1343092,976038,2020-08-17,Senate,"Placed on suspense file",7,0,0,0,7
1343092,976303,2020-08-20,Senate,"Do pass as amended",5,2,0,0,7
1343092,977747,2020-08-30,Senate,"Assembly 3rd Reading AB2342 McCarty et al. By Bradford",34,5,1,0,40
1343092,977748,2020-08-31,Assembly,"AB 2342 McCarty Concurrence in Senate Amendments",63,0,16,0,79
1343097,960243,2020-05-20,Assembly,"Do pass as amended and be re-referred to the Committee on [Appropriations]",7,0,1,0,8
1343097,962824,2020-06-03,Assembly,"Do pass",17,0,1,0,18
1343097,965093,2020-06-10,Assembly,"AB 2345 Gonzalez Assembly Third Reading",74,1,4,0,79
1343097,974926,2020-08-06,Senate,"Do pass, but first be re-referred to the Committee on [Appropriations]",8,0,3,0,11
1343097,976013,2020-08-17,Senate,"Placed on suspense file",7,0,0,0,7
1343097,976477,2020-08-20,Senate,"Do pass as amended",5,1,1,0,7
1343097,977788,2020-08-30,Senate,"Assembly 3rd Reading AB2345 Gonzalez et al. By Skinner",26,5,9,0,40
1343097,977789,2020-08-31,Assembly,"AB 2345 Gonzalez Concurrence in Senate Amendments",70,2,7,0,79
1343100,959298,2020-05-18,Assembly,"Do pass and be re-referred to the Committee on [Appropriations]",14,0,1,0,15
1343114,959329,2020-05-18,Assembly,"Do pass and be re-referred to the Committee on [Appropriations]",11,2,2,0,15
1343114,962849,2020-06-03,Assembly,"Do pass",13,5,0,0,18
1343114,965038,2020-06-10,Assembly,"AB 2360 Maienschein Assembly Third Reading",64,12,3,0,79
1343114,974665,2020-08-01,Senate,"Do pass as amended, but first amend, and re-refer to the Committee on [Appropriations]",7,1,1,0,9
1343114,975794,2020-08-13,Senate,"Placed on suspense file",7,0,0,0,7
1343114,976423,2020-08-20,Senate,"Do pass",5,2,0,0,7
1343114,977280,2020-08-28,Senate,"Assembly 3rd Reading AB2360 Maienschein By Mitchell",31,6,3,0,40
1343114,978037,2020-08-30,Assembly,"AB 2360 Maienschein Concurrence in Senate Amendments",62,0,17,0,79
1343116,959762,2020-05-19,Assembly,"Do pass and be re-referred to the Committee on [Appropriations]",6,2,0,0,8
1343116,962787,2020-06-03,Assembly,"Do pass",13,5,0,0,18
1343116,965001,2020-06-10,Assembly,"AB 2362 Muratsuchi Assembly Third Reading",55,20,4,0,79
1343116,974980,2020-08-07,Senate,"Do pass, but first be re-referred to the Committee on [Appropriations]",5,2,0,0,7
1343116,975995,2020-08-17,Senate,"Do pass, but first be re-referred to the Committee on [Appropriations]",5,2,0,0,7
1343116,976171,2020-08-19,Senate,"Placed on suspense file",7,0,0,0,7
1343116,976355,2020-08-20,Senate,"Do pass as amended",5,2,0,0,7
1343116,977417,2020-08-29,Senate,"Assembly 3rd Reading AB2362 Muratsuchi By Wiener",26,11,3,0,40
1343116,978025,2020-08-30,Assembly,"AB 2362 Muratsuchi Concurrence in Senate Amendments",53,18,8,0,79
1343119,957441,2020-05-05,Assembly,"Do pass and be re-referred to the Committee on [Appropriations]",7,0,0,0,7
1343119,962476,2020-06-02,Assembly,"Do pass. To Consent Calendar",18,0,0,0,18
1343119,963516,2020-06-08,Assembly,"AB 2365 Rodriguez Consent Calendar Second Day Regular Session",76,0,3,0,79
1343125,958519,2020-05-13,Assembly,"Do pass and be re-referred to the Committee on [Appropriations]",8,3,0,0,11
1343125,962753,2020-06-03,Assembly,"Do pass as amended",13,5,0,0,18
1343125,963534,2020-06-08,Assembly,"AB 2371 Friedman Assembly Third Reading",62,13,4,0,79
1343130,959319,2020-05-18,Assembly,"Do pass and be re-referred to the Committee on [Appropriations]",15,0,0,0,15
1343130,962406,2020-06-02,Assembly,"Do pass. To Consent Calendar",18,0,0,0,18
1343130,966450,2020-06-15,Assembly,"AB 2376 Flora Assembly Third Reading",78,0,1,0,79
1343131,957786,2020-05-07,Assembly,"Do pass and be re-referred to the Committee on [Appropriations]",6,0,2,0,8
1343131,962803,2020-06-03,Assembly,"Do pass",14,0,4,0,18
1343131,964992,2020-06-10,Assembly,"AB 2377 Chiu Assembly Third Reading",64,6,9,0,79
1343131,975376,2020-08-10,Senate,"Do pass, but first be re-referred to the Committee on [Appropriations]",5,2,0,0,7
1343131,975987,2020-08-17,Senate,"Placed on suspense file",7,0,0,0,7
1343131,976306,2020-08-20,Senate,"Do pass as amended",5,2,0,0,7
1343131,978137,2020-08-30,Senate,"Assembly 3rd Reading AB2377 Chiu et al. By Skinner",39,0,1,0,40
1343131,978138,2020-08-30,Assembly,"AB 2377 Chiu Concurrence in Senate Amendments",72,0,7,0,79
1343140,958511,2020-05-12,Assembly,"Do pass and be re-referred to the Committee on [Appropriations] with recommendation: To Consent Calendar",20,0,1,0,21
1343140,962459,2020-06-02,Assembly,"Do pass. To Consent Calendar",18,0,0,0,18
1343140,963572,2020-06-08,Assembly,"AB 2386 Bigelow Consent Calendar Second Day Regular Session",76,0,3,0,79
1343140,975944,2020-08-14,Senate,"Do pass, but first be re-referred to the Committee on [Appropriations] with the recommendation: To Consent Calendar",16,0,0,0,16
1343140,977883,2020-08-30,Senate,"Assembly 3rd Reading AB2386 Bigelow et al. By McGuire",39,0,1,0,40
1343140,977884,2020-08-31,Assembly,"AB 2386 Bigelow Concurrence in Senate Amendments",76,0,3,0,79
1343141,957774,2020-05-07,Assembly,"Do pass",8,0,0,0,8
1343141,965628,2020-06-11,Assembly,"AB 2387 Grayson Assembly Third Reading",75,0,4,0,79
1343141,975341,2020-08-10,Senate,"Do pass as amended",7,0,0,0,7
1343141,977173,2020-08-27,Senate,"Assembly 3rd Reading AB2387 Grayson By Beall",29,0,11,0,40
1343141,977937,2020-08-30,Assembly,"AB 2387 Grayson Concurrence in Senate Amendments",75,0,4,0,79
1343142,958529,2020-05-13,Assembly,"Do pass and be re-referred to the Committee on [Appropriations]",12,0,0,0,12
1343142,962738,2020-06-03,Assembly,"Do pass as amended",18,0,0,0,18
1343142,963552,2020-06-08,Assembly,"AB 2388 Berman Assembly Third Reading",77,0,2,0,79
1343151,957766,2020-05-07,Assembly,"Do pass. To Consent Calendar",14,0,0,0,14
1343151,960446,2020-05-26,Assembly,"AB 2397 INS. Consent Calendar Second Day Regular Session",75,0,4,0,79
1343152,957791,2020-05-07,Assembly,"Do pass. To Consent Calendar",14,0,0,0,14
1343152,960466,2020-05-26,Assembly,"AB 2398 INS. Consent Calendar Second Day Regular Session",75,0,4,0,79
1343153,957799,2020-05-07,Assembly,"Do pass. To Consent Calendar",14,0,0,0,14
1343153,960437,2020-05-26,Assembly,"AB 2399 INS. Consent Calendar Second Day Regular Session",75,0,4,0,79
1343153,974882,2020-08-05,Senate,"Do pass and be ordered to the Consent Calendar",5,0,0,0,5
1343153,977294,2020-08-28,Senate,"Consent Calendar AB2399 INS",39,0,1,0,40
1343154,958546,2020-05-13,Assembly,"Do pass and be re-referred to the Committee on [Appropriations]",7,0,0,0,7
1343154,962403,2020-06-02,Assembly,"Do pass as amended. To Consent Calendar",18,0,0,0,18
1343154,965085,2020-06-10,Assembly,"AB 2400 Quirk Consent Calendar Second Day Regular Session",77,0,2,0,79
1343154,974801,2020-08-04,Senate,"Do pass, but first be re-referred to the Committee on [Appropriations]",4,1,0,0,5
1343154,976628,2020-08-24,Senate,"Assembly 3rd Reading AB2400 Quirk By Hertzberg Urgency Clause",40,0,0,0,40
1343156,957773,2020-05-07,Assembly,"Do pass. To Consent Calendar",14,0,0,0,14
1343156,960456,2020-05-26,Assembly,"AB 2402 INS. Consent Calendar Second Day Regular Session",75,0,4,0,79
1343159,960237,2020-05-20,Assembly,"Do pass and be re-referred to the Committee on [Appropriations]",7,0,1,0,8
1343159,962807,2020-06-03,Assembly,"Do pass as amended",14,3,1,0,18
1343159,965008,2020-06-10,Assembly,"AB 2405 Burke Assembly Third Reading",64,5,10,0,79
1343159,974927,2020-08-06,Senate,"Do pass, but first be re-referred to the Committee on [Appropriations]",8,3,0,0,11
1343159,976009,2020-08-17,Senate,"Placed on suspense file",7,0,0,0,7
1343159,976422,2020-08-20,Senate,"Do pass as amended",5,2,0,0,7
1343159,977431,2020-08-29,Senate,"Assembly 3rd Reading AB2405 Burke et al. By Wiener",30,8,2,0,40
1343159,978082,2020-08-30,Assembly,"AB 2405 Burke Concurrence in Senate Amendments",64,8,7,0,79
1343160,960233,2020-05-20,Assembly,"Do pass and be re-referred to the Committee on [Appropriations]",6,2,0,0,8
1343164,958765,2020-05-14,Assembly,"Do pass",7,0,0,0,7
1343164,965000,2020-06-10,Assembly,"AB 2410 Cunningham Third Reading Urgency",78,0,1,0,79
1343167,957792,2020-05-07,Assembly,"Do pass and be re-referred to the Committee on [Appropriations] with recommendation: To Consent Calendar",8,0,0,0,8
1343167,962832,2020-06-03,Assembly,"Do pass",18,0,0,0,18
1343167,964986,2020-06-10,Assembly,"AB 2413 Ting Assembly Third Reading",78,0,1,0,79
1343170,958570,2020-05-13,Assembly,"Do pass as amended and be re-referred to the Committee on [Appropriations]",12,0,0,0,12
1343170,962801,2020-06-03,Assembly,"Do pass",18,0,0,0,18
1343170,965057,2020-06-10,Assembly,"AB 2416 Gabriel Assembly Third Reading",78,0,1,0,79
1343170,974267,2020-07-29,Senate,"Do pass, but first be re-referred to the Committee on [Appropriations]",7,0,0,0,7
1343170,976632,2020-08-24,Senate,"Assembly 3rd Reading AB2416 Gabriel By Durazo",39,0,1,0,40
1343174,932721,2020-02-24,Assembly,"Be adopted. To Consent Calendar",11,0,1,0,12
1343174,938007,2020-02-27,Assembly,"ACR 168 Medina Consent Calendar Second Day Regular Session",71,0,9,0,80
1343174,950975,2020-03-12,Senate,"Assembly 3rd Reading ACR168 Medina By Nielsen",33,0,6,0,39
1343175,938000,2020-02-27,Assembly,"Be adopted. To Consent Calendar",10,0,2,0,12
1343175,944388,2020-03-05,Assembly,"ACR 169 Aguiar-Curry Consent Calendar Second Day",72,0,8,0,80
1343175,967394,2020-06-18,Senate,"Special Consent ACR169",40,0,0,0,40
1343176,938035,2020-02-27,Assembly,"Be adopted. To Consent Calendar",10,0,2,0,12
1343176,944389,2020-03-05,Assembly,"ACR 170 Kamlager Consent Calendar Second Day Regular Session",72,0,8,0,80
1343176,967424,2020-06-18,Senate,"Special Consent ACR170",40,0,0,0,40
1343184,961702,2020-05-29,Senate,"Do pass, but first be re-referred to the Committee on [Appropriations]",5,0,2,0,7
1343184,964423,2020-06-09,Senate,"Placed on suspense file",7,0,0,0,7
1343184,967509,2020-06-18,Senate,"Do pass as amended",5,0,2,0,7
1343184,969402,2020-06-26,Senate,"Senate 3rd Reading SB1044 Allen",38,0,2,0,40
1343184,974493,2020-07-30,Assembly,"Do pass and be re-referred to the Committee on [Appropriations]",8,0,1,0,9
1343184,976425,2020-08-20,Assembly,"Do pass as amended",18,0,0,0,18
1343184,976916,2020-08-26,Assembly,"SB 1044 Allen Senate Third Reading By Bauer-Kahan",72,0,7,0,79
1343184,978173,2020-08-30,Senate,"Unfinished Business SB1044 Allen et al. Concurrence",39,0,1,0,40
1343189,961345,2020-05-28,Senate,"Do pass as amended",6,1,0,0,7
1343189,968063,2020-06-22,Senate,"Senate 3rd Reading SB1049 Glazer et al",32,8,0,0,40
1343189,975540,2020-08-11,Assembly,"Do pass",7,0,1,0,8
1343189,978079,2020-08-31,Assembly,"SB 1049 Glazer Senate Third Reading By Bauer-Kahan",63,9,7,0,79
1343193,959337,2020-05-18,Senate,"Do pass, but first be re-referred to the Committee on [Appropriations]",4,5,0,0,9
1343193,959338,2020-05-18,Senate,"[First] hearing set for [05-18-2020]: Failed passage in Committee. Reconsideration granted",9,0,0,0,9
1343194,959315,2020-05-18,Senate,"Do pass, but first be re-referred to the Committee on [Appropriations]",4,5,0,0,9
1343194,959316,2020-05-18,Senate,"[First] hearing set for [05-18-2020]: Failed passage in Committee. Reconsideration granted",9,0,0,0,9
1343198,960443,2020-05-26,Senate,"Do pass as amended, but first amend, and re-refer to the Committee on [Appropriations]",10,3,0,0,13
1343198,964371,2020-06-09,Senate,"Placed on suspense file",7,0,0,0,7
1343204,959752,2020-05-20,Senate,"Do pass, but first be re-referred to the Committee on [Appropriations]",6,1,0,0,7
1343204,964364,2020-06-09,Senate,"Placed on suspense file",7,0,0,0,7
1343204,967408,2020-06-18,Senate,"Do pass as amended",5,2,0,0,7
1343204,969409,2020-06-26,Senate,"Senate 3rd Reading SB1064 Skinner",29,9,2,0,40
1343204,974949,2020-08-05,Assembly,"Do pass and be re-referred to the Committee on [Appropriations]",7,0,1,0,8
1343204,976397,2020-08-20,Assembly,"Do pass as amended",14,4,0,0,18
1343204,977950,2020-08-31,Senate,"Unfinished Business SB1064 Skinner Concurrence",26,9,5,0,40
1343204,977951,2020-08-31,Assembly,"SB 1064 Skinner Senate Third Reading By Kalra",53,10,16,0,79
1343205,959819,2020-05-19,Senate,"Do pass as amended, but first amend, and re-refer to the Committee on [Appropriations]",7,0,0,0,7
1343205,964374,2020-06-09,Senate,"Placed on suspense file",7,0,0,0,7
1343205,967407,2020-06-18,Senate,"Do pass as amended",7,0,0,0,7
1343205,969776,2020-06-25,Senate,"Senate 3rd Reading SB1065 Hertzberg et al",40,0,0,0,40
1343205,974751,2020-08-03,Assembly,"Do pass and be re-referred to the Committee on [Appropriations] with recommendation: To Consent Calendar",6,0,2,0,8
1343205,976302,2020-08-20,Assembly,"Do pass as amended",18,0,0,0,18
1343205,976927,2020-08-26,Assembly,"SB 1065 Hertzberg Senate Third Reading By Maienschein",74,0,5,0,79
1343205,977435,2020-08-29,Senate,"Unfinished Business SB1065 Hertzberg et al. Concurrence",38,0,2,0,40
1343209,960455,2020-05-26,Senate,"Do pass as amended, but first amend, and re-refer to the Committee on [Appropriations]",10,2,1,0,13
1343209,964391,2020-06-09,Senate,"Placed on suspense file",7,0,0,0,7
1343216,961696,2020-05-29,Senate,"Be adopted, but first be re-referred to the Committee on [Appropriations] with recommendation: To Consent Calendar",13,0,2,0,15
1343216,965632,2020-06-11,Senate,"Special Consent SCR86 Hurtado",38,0,2,0,40
1343216,975320,2020-08-10,Assembly,"Be adopted. To Consent Calendar",15,0,0,0,15
1343216,978299,2020-08-30,Assembly,"SCR 86 Hurtado Consent Calendar Second Day Regular Session",75,0,4,0,79
1343217,940163,2020-03-02,Senate,"Senate 3rd Reading SR78 Dodd et al",29,0,10,0,39
1344346,958302,2020-05-12,Assembly,"Do pass and be re-referred to the Committee on [Appropriations]",8,0,0,0,8
1344346,962783,2020-06-03,Assembly,"Do pass as amended",18,0,0,0,18
1344346,965005,2020-06-10,Assembly,"AB 2421 Quirk Assembly Third Reading By RIVAS, L",76,0,3,0,79
1344346,974268,2020-07-29,Senate,"Do pass, but first be re-referred to the Committee on [Appropriations]",7,0,0,0,7
1344346,977439,2020-08-29,Senate,"Assembly 3rd Reading AB2421 Quirk et al. By Hertzberg",34,1,5,0,40
1344346,978134,2020-08-30,Assembly,"AB 2421 Quirk Concurrence in Senate Amendments",72,0,7,0,79
1344350,959733,2020-05-19,Assembly,"Do pass and be re-referred to the Committee on [Appropriations]",6,2,0,0,8
1344350,962853,2020-06-03,Assembly,"Do pass",13,4,1,0,18
1344350,966439,2020-06-15,Assembly,"AB 2425 Mark Stone Assembly Third Reading",56,15,8,0,79
1344350,974994,2020-08-07,Senate,"Do pass, but first be re-referred to the Committee on [Appropriations]",5,1,1,0,7
1344350,976000,2020-08-17,Senate,"Placed on suspense file",7,0,0,0,7
1344350,976460,2020-08-20,Senate,"Do pass as amended",5,2,0,0,7
1344350,977419,2020-08-29,Senate,"Assembly 3rd Reading AB2425 Mark Stone By Wiener",26,10,4,0,40
1344350,978131,2020-08-30,Assembly,"AB 2425 Mark Stone Concurrence in Senate Amendments",53,16,10,0,79
1344351,959767,2020-05-19,Assembly,"Do pass",8,0,0,0,8
1344351,963631,2020-06-08,Assembly,"AB 2426 Reyes Assembly Third Reading",70,0,9,0,79
1344351,974632,2020-07-31,Senate,"Do pass",5,1,1,0,7
1344351,977893,2020-08-30,Senate,"Assembly 3rd Reading AB2426 Reyes By Caballero",32,2,6,0,40
1344351,977894,2020-08-31,Assembly,"AB 2426 Reyes Concurrence in Senate Amendments",67,0,12,0,79
1344358,957448,2020-05-05,Assembly,"Do pass and be re-referred to the Committee on [Appropriations]",6,0,1,0,7
1344361,957769,2020-05-07,Assembly,"Do pass as amended",13,1,0,0,14
1344361,963543,2020-06-08,Assembly,"AB 2436 Bloom Assembly Third Reading",74,2,3,0,79
1344367,960891,2020-05-27,Assembly,"Do pass as amended",7,2,2,0,11
1344367,965591,2020-06-11,Assembly,"AB 2442 Chau Assembly Third Reading",56,17,6,0,79
1344368,957596,2020-05-05,Assembly,"Do pass as amended",8,3,0,0,11
1344368,965670,2020-06-11,Assembly,"AB 2443 Weber Assembly Third Reading",59,14,6,0,79
1344370,960903,2020-05-27,Assembly,"Do pass",10,0,1,0,11
1344370,963561,2020-06-08,Assembly,"AB 2445 Reyes Assembly Third Reading",77,0,2,0,79
1344370,974486,2020-07-30,Senate,"Do pass",8,0,1,0,9
1344370,977190,2020-08-27,Senate,"Assembly 3rd Reading AB2445 Reyes By Hertzberg Urgency Clause",30,0,10,0,40
1344370,978015,2020-08-30,Assembly,"AB 2445 Reyes Concurrence - Urgency Added",75,0,4,0,79
1344375,959307,2020-05-18,Assembly,"Do pass and be re-referred to the Committee on [Appropriations] with recommendation: To Consent Calendar",15,0,0,0,15
1344375,962848,2020-06-03,Assembly,"Do pass as amended",18,0,0,0,18
1344375,966457,2020-06-15,Assembly,"AB 2450 Grayson Third Reading Urgency",77,0,2,0,79
1344375,974655,2020-08-01,Senate,"Do pass, but first be re-referred to the Committee on [Appropriations] with the recommendation: To Consent Calendar",8,0,1,0,9
1344375,975781,2020-08-13,Senate,"Placed on suspense file",7,0,0,0,7
1344375,976454,2020-08-20,Senate,"Do pass",7,0,0,0,7
1344375,977186,2020-08-27,Senate,"Assembly 3rd Reading AB2450 Grayson By Dodd Urgency Clause",30,0,10,0,40
1344384,958523,2020-05-12,Assembly,"Do pass as amended and be re-referred to the Committee on [Appropriations]",20,0,1,0,21
1344384,962404,2020-06-02,Assembly,"Do pass. To Consent Calendar",18,0,0,0,18
1344384,963556,2020-06-08,Assembly,"AB 2459 Bigelow Consent Calendar Second Day Regular Session",76,0,3,0,79
1344384,975946,2020-08-14,Senate,"Do pass, but first be re-referred to the Committee on [Appropriations]",16,0,0,0,16
1344384,976633,2020-08-24,Senate,"Assembly 3rd Reading AB2459 Bigelow et al. By Dodd",40,0,0,0,40
1344384,976928,2020-08-26,Assembly,"AB 2459 Bigelow Concurrence in Senate Amendments",73,0,6,0,79
1344385,959948,2020-05-21,Assembly,"Do pass and be re-referred to the Committee on [Appropriations]",18,0,1,0,19
1344385,962774,2020-06-03,Assembly,"Do pass",18,0,0,0,18
1344385,964996,2020-06-10,Assembly,"AB 2460 Daly Assembly Third Reading",77,0,2,0,79
1344388,960897,2020-05-27,Assembly,"Do pass",8,0,3,0,11
1344388,965656,2020-06-11,Assembly,"AB 2463 Wicks Assembly Third Reading",68,0,11,0,79
1344388,975759,2020-08-13,Senate,"Do pass, but first be re-referred to the Committee on [Appropriations]",7,0,2,0,9
1344388,977318,2020-08-28,Senate,"Assembly 3rd Reading AB2463 Wicks By Monning",35,0,5,0,40
1344388,978097,2020-08-30,Assembly,"AB 2463 Wicks Concurrence in Senate Amendments By STONE",68,0,11,0,79
1344389,959309,2020-05-18,Assembly,"Do pass and be re-referred to the Committee on [Appropriations]",15,0,0,0,15
1344396,960895,2020-05-27,Assembly,"Do pass",10,0,1,0,11
1344396,965052,2020-06-10,Assembly,"AB 2471 Maienschein Assembly Third Reading",78,0,1,0,79
1344396,974474,2020-07-30,Senate,"Do pass and be ordered to the Consent Calendar",9,0,0,0,9
1344396,977821,2020-08-30,Senate,"Assembly 3rd Reading AB2471 Maienschein By Hertzberg",39,0,1,0,40
1344396,977822,2020-08-31,Assembly,"AB 2471 Maienschein Concurrence in Senate Amendments",76,0,3,0,79
1344398,957445,2020-05-05,Assembly,"Do pass and be re-referred to the Committee on [Appropriations]",7,0,0,0,7
1344398,962462,2020-06-02,Assembly,"Do pass as amended",18,0,0,0,18
1344398,963507,2020-06-08,Assembly,"AB 2473 Cooper Assembly Third Reading",76,1,2,0,79
1344403,959947,2020-05-21,Assembly,"Do pass and be re-referred to the Committee on [Appropriations]",18,1,0,0,19
1344403,962850,2020-06-03,Assembly,"Do pass",16,0,2,0,18
1344403,965581,2020-06-11,Assembly,"AB 2478 Carrillo Assembly Third Reading",75,0,4,0,79
1344403,975353,2020-08-08,Senate,"Do pass, but first be re-referred to the Committee on [Appropriations]",9,0,0,0,9
1344403,975791,2020-08-13,Senate,"Placed on suspense file",7,0,0,0,7
1344404,959757,2020-05-20,Assembly,"Do pass and be re-referred to the Committee on [Appropriations] with recommendation: To Consent Calendar",7,0,0,0,7
1344404,962402,2020-06-02,Assembly,"Do pass. To Consent Calendar",18,0,0,0,18
1344404,963502,2020-06-08,Assembly,"AB 2479 Gipson Consent Calendar Second Day Regular Session",76,0,3,0,79
1344404,974905,2020-08-05,Senate,"Do pass, but first be re-referred to the Committee on [Appropriations] with the recommendation: To Consent Calendar",5,0,0,0,5
1344404,977386,2020-08-28,Senate,"Consent Calendar AB2479",39,0,1,0,40
1344406,959728,2020-05-19,Assembly,"Do pass and be re-referred to the Committee on [Appropriations]",7,0,1,0,8
1344408,959761,2020-05-19,Assembly,"Do pass and be re-referred to the Committee on [Appropriations]",8,0,0,0,8
1344408,962827,2020-06-03,Assembly,"Do pass as amended",14,1,3,0,18
1344408,965037,2020-06-10,Assembly,"AB 2483 Bauer-Kahan Assembly Third Reading",70,0,9,0,79
1344408,974995,2020-08-07,Senate,"Do pass, but first be re-referred to the Committee on [Appropriations]",6,0,1,0,7
1344408,976003,2020-08-17,Senate,"Placed on suspense file",7,0,0,0,7
1344408,976334,2020-08-20,Senate,"Do pass",6,1,0,0,7
1344408,977377,2020-08-28,Senate,"Assembly 3rd Reading AB2483 Bauer-Kahan By Portantino",32,6,2,0,40
1344409,958541,2020-05-13,Assembly,"Do pass and be re-referred to the Committee on [Appropriations]",10,0,2,0,12
1344410,957782,2020-05-06,Assembly,"Do pass as amended, and be re-referred to the Committee on [Appropriations] with recommendation: To Consent Calendar",7,0,0,0,7
1344410,962727,2020-06-03,Assembly,"Do pass",18,0,0,0,18
1344410,965047,2020-06-10,Assembly,"AB 2485 Kalra Assembly Third Reading",78,0,1,0,79
1344419,958576,2020-05-13,Assembly,"Do pass and be re-referred to the Committee on [Appropriations]",10,0,2,0,12
1344419,962427,2020-06-02,Assembly,"Do pass. To Consent Calendar",18,0,0,0,18
1344419,963501,2020-06-08,Assembly,"AB 2494 Choi Consent Calendar Second Day Regular Session",76,0,3,0,79
1344426,959484,2020-05-19,Assembly,"Do pass and be re-referred to the Committee on [Appropriations]",7,3,2,0,12
1344426,962826,2020-06-03,Assembly,"Do pass as amended",12,5,1,0,18
1344426,966477,2020-06-15,Assembly,"AB 2501 Limón Assembly Third Reading",28,25,26,0,79
1344437,959755,2020-05-19,Assembly,"Do pass",6,1,1,0,8
1344437,966505,2020-06-15,Assembly,"AB 2512 Mark Stone Assembly Third Reading",57,0,22,0,79
1344437,974625,2020-07-31,Senate,"Do pass",5,0,2,0,7
1344437,977363,2020-08-28,Senate,"Assembly 3rd Reading AB2512 Mark Stone et al. By Bradford",30,1,9,0,40
1344442,958155,2020-05-11,Assembly,"Do pass as amended and be re-referred to the Committee on [Appropriations]",11,0,0,0,11
1344442,962424,2020-06-02,Assembly,"Do pass",18,0,0,0,18
1344442,966460,2020-06-15,Assembly,"AB 2517 Gloria Assembly Third Reading",79,0,0,0,79
1344442,974482,2020-07-30,Senate,"Do pass, but first be re-referred to the Committee on [Appropriations] with the recommendation: To Consent Calendar",9,0,0,0,9
1344442,977291,2020-08-28,Senate,"Consent Calendar AB2517",39,0,1,0,40
1344444,958772,2020-05-14,Assembly,"Do pass and be re-referred to the Committee on [Appropriations]",14,0,0,0,14
1344444,962775,2020-06-03,Assembly,"Do pass as amended",18,0,0,0,18
1344444,965059,2020-06-10,Assembly,"AB 2519 Wood Assembly Third Reading",77,0,2,0,79
1344445,959312,2020-05-18,Assembly,"Do pass as amended, and be re-referred to the Committee on [Appropriations] with recommendation: To Consent Calendar",15,0,0,0,15
1344445,962385,2020-06-02,Assembly,"Do pass. To Consent Calendar",18,0,0,0,18
1344445,963554,2020-06-08,Assembly,"AB 2520 Chiu Consent Calendar Second Day Regular Session",76,0,3,0,79
1344445,974657,2020-08-01,Senate,"Do pass, but first be re-referred to the Committee on [Appropriations] with the recommendation: To Consent Calendar",8,0,1,0,9
1344445,977315,2020-08-28,Senate,"Consent Calendar AB2520",39,0,1,0,40
1344445,978209,2020-08-30,Assembly,"AB 2520 Chiu Concurrence in Senate Amendments",75,0,4,0,79
1344448,958788,2020-05-14,Assembly,"Do pass and be re-referred to the Committee on [Appropriations] with recommendation: To Consent Calendar",14,0,0,0,14
1344449,959478,2020-05-19,Assembly,"Do pass and be re-referred to the Committee on [Appropriations]",8,3,1,0,12
1344449,962781,2020-06-03,Assembly,"Do pass as amended",13,5,0,0,18
1344449,965608,2020-06-11,Assembly,"AB 2524 Wicks Assembly Third Reading",58,16,5,0,79
1344449,975761,2020-08-13,Senate,"Do pass, but first be re-referred to the Committee on [Appropriations] with the recommendation: To Consent Calendar",7,0,0,0,7
1344449,977398,2020-08-28,Senate,"Consent Calendar AB2524",39,0,1,0,40
1344449,977895,2020-08-30,Assembly,"AB 2524 Wicks Concurrence in Senate Amendments By REYES",63,0,16,0,79
1344453,959339,2020-05-18,Assembly,"Do pass and be re-referred to the Committee on [Appropriations]",11,0,0,0,11
1344453,962371,2020-06-02,Assembly,"Do pass as amended",18,0,0,0,18
1344453,963518,2020-06-08,Assembly,"AB 2528 Diep Assembly Third Reading",77,0,2,0,79
1344457,959745,2020-05-19,Assembly,"Do pass and be re-referred to the Committee on [Appropriations]",7,1,0,0,8
1344457,962844,2020-06-03,Assembly,"Do pass",15,0,3,0,18
1344457,965073,2020-06-10,Assembly,"AB 2532 Irwin Assembly Third Reading",62,3,14,0,79
1344462,959771,2020-05-20,Assembly,"Do pass and be re-referred to the Committee on [Appropriations]",5,1,1,0,7
1344462,962879,2020-06-03,Assembly,"Do pass as amended",13,3,2,0,18
1344462,963512,2020-06-08,Assembly,"AB 2537 Rodriguez Assembly Third Reading",57,14,8,0,79
1344462,975516,2020-08-11,Senate,"Do pass, but first be re-referred to the Committee on [Appropriations]",4,1,0,0,5
1344462,976051,2020-08-17,Senate,"Placed on suspense file",7,0,0,0,7
1344462,976349,2020-08-20,Senate,"Do pass as amended",5,2,0,0,7
1344462,977983,2020-08-30,Senate,"Assembly 3rd Reading AB2537 Rodriguez et al. By Hertzberg",31,7,2,0,40
1344462,977984,2020-08-30,Assembly,"AB 2537 Rodriguez Concurrence in Senate Amendments",57,1,21,0,79
1344463,958763,2020-05-14,Assembly,"Do pass and be re-referred to the Committee on [Appropriations]",6,0,1,0,7
1344463,962441,2020-06-02,Assembly,"Do pass. To Consent Calendar",18,0,0,0,18
1344463,963559,2020-06-08,Assembly,"AB 2538 Chu Consent Calendar Second Day Regular Session",76,0,3,0,79
1344463,975328,2020-08-08,Senate,"Do pass, but first be re-referred to the Committee on [Appropriations] with the recommendation: To Consent Calendar",9,0,0,0,9
1344463,975810,2020-08-13,Senate,"Placed on suspense file",7,0,0,0,7
1344466,957794,2020-05-06,Assembly,"Do pass and be re-referred to the Committee on [Appropriations] with recommendation: To Consent Calendar",7,0,0,0,7
1344466,962390,2020-06-02,Assembly,"Do pass. To Consent Calendar",18,0,0,0,18
1344466,963583,2020-06-08,Assembly,"AB 2541 Medina Consent Calendar Second Day Regular Session",76,0,3,0,79
1344467,957323,2020-05-04,Assembly,"Do pass and be re-referred to the Committee on [Appropriations] with recommendation: To Consent Calendar",15,0,0,0,15
1344467,962407,2020-06-02,Assembly,"Do pass. To Consent Calendar",18,0,0,0,18
1344467,963566,2020-06-08,Assembly,"AB 2542 Kalra Consent Calendar Second Day Regular Session",76,0,3,0,79
1344467,974996,2020-08-07,Senate,"Do pass, but first be re-referred to the Committee on [Appropriations]",4,2,1,0,7
1344467,976006,2020-08-17,Senate,"Placed on suspense file",7,0,0,0,7
1344467,976339,2020-08-20,Senate,"Do pass as amended",5,2,0,0,7
1344467,977803,2020-08-31,Senate,"Assembly 3rd Reading AB2542 Kalra et al. By Mitchell",26,10,4,0,40
1344467,977804,2020-08-31,Assembly,"AB 2542 KALRA Concurrence in Senate Amendments",49,16,14,0,79
1344474,959977,2020-05-21,Assembly,"Do pass and be re-referred to the Committee on [Appropriations] with recommendation: To Consent Calendar",19,0,0,0,19
1344474,962765,2020-06-03,Assembly,"Do pass",18,0,0,0,18
1344474,965036,2020-06-10,Assembly,"AB 2549 Salas Assembly Third Reading",77,0,2,0,79
1344478,960241,2020-05-20,Assembly,"Do pass as amended, and be re-referred to the Committee on [Appropriations] with recommendation: To Consent Calendar",8,0,0,0,8
1344478,962876,2020-06-03,Assembly,"Do pass",18,0,0,0,18
1344478,965076,2020-06-10,Assembly,"AB 2553 Ting Assembly Third Reading",78,0,1,0,79
1344478,974954,2020-08-06,Senate,"Do pass, but first be re-referred to the Committee on [Appropriations] with the recommendation: To Consent Calendar",11,0,0,0,11
1344478,975793,2020-08-13,Senate,"Placed on suspense file",7,0,0,0,7
1344478,976392,2020-08-20,Senate,"Do pass as amended",7,0,0,0,7
1344478,977187,2020-08-27,Senate,"Assembly 3rd Reading AB2553 Ting et al. By Wiener Urgency Clause",30,0,10,0,40
1344478,978135,2020-08-30,Assembly,"AB 2553 Ting Concurrence - Urgency Added",75,0,4,0,79
1344479,959732,2020-05-19,Assembly,"Do pass and be re-referred to the Committee on [Appropriations] with recommendation: To Consent Calendar",8,0,0,0,8
1344484,959487,2020-05-19,Assembly,"Do pass and be re-referred to the Committee on [Appropriations]",10,0,2,0,12
1344484,962452,2020-06-02,Assembly,"Do pass. To Consent Calendar",18,0,0,0,18
1344484,963535,2020-06-08,Assembly,"AB 2559 Bauer-Kahan Consent Calendar Second Day Regular Session",76,0,3,0,79
1344484,975774,2020-08-13,Senate,"Do pass, but first be re-referred to the Committee on [Appropriations] with the recommendation: To Consent Calendar",7,0,0,0,7
1344484,977300,2020-08-28,Senate,"Consent Calendar AB2559",39,0,1,0,40
1344484,977996,2020-08-30,Assembly,"AB 2559 Bauer-Kahan Concurrence in Senate Amendments",75,0,4,0,79
1344485,958814,2020-05-14,Assembly,"Do pass and be re-referred to the Committee on [Appropriations] with recommendation: To Consent Calendar",9,0,0,0,9
1344485,962469,2020-06-02,Assembly,"Do pass. To Consent Calendar",18,0,0,0,18
1344485,963550,2020-06-08,Assembly,"AB 2560 Quirk Consent Calendar Second Day Regular Session",76,0,3,0,79
1344485,975945,2020-08-14,Senate,"Do pass, but first be re-referred to the Committee on [Appropriations]",7,0,0,0,7
1344485,978210,2020-08-30,Senate,"Assembly 3rd Reading AB2560 Quirk et al. By Allen",39,0,1,0,40
1344485,978211,2020-08-30,Assembly,"AB 2560 Quirk Concurrence in Senate Amendments",74,0,5,0,79
1344491,958121,2020-05-11,Assembly,"Be adopted, and re-refer to the Committee on [Appropriations] with recommendation: To Consent Calendar",10,0,1,0,11
1344491,962425,2020-06-02,Assembly,"Be adopted. To Consent Calendar",18,0,0,0,18
1344491,963555,2020-06-08,Assembly,"ACR 173 Gallagher Consent Calendar Second Day Regular Session",76,0,3,0,79
1344491,975760,2020-08-13,Senate,"Be adopted, but first be re-referred to the Committee on [Appropriations] with recommendation: To Consent Calendar",9,0,0,0,9
1344491,977343,2020-08-28,Senate,"Consent Calendar ACR173",39,0,1,0,40
1344495,938046,2020-02-27,Assembly,"Be adopted. To third reading",10,0,2,0,12
1344499,960164,2020-05-22,Senate,"Do pass as amended, but first amend, and re-refer to the Committee on [Appropriations]",7,1,1,0,9
1344499,964386,2020-06-09,Senate,"Placed on suspense file",7,0,0,0,7
1344499,967482,2020-06-18,Senate,"Do pass as amended",5,2,0,0,7
1344499,969401,2020-06-26,Senate,"Senate 3rd Reading SB1079 Skinner",30,10,0,0,40
1344499,975643,2020-08-12,Assembly,"Do pass",8,1,2,0,11
1344499,977825,2020-08-30,Assembly,"SB 1079 Skinner Senate Third Reading By Grayson",49,17,13,0,79
1344499,977826,2020-08-31,Senate,"Unfinished Business SB1079 Skinner et al. Concurrence",30,9,1,0,40
1344505,960476,2020-05-26,Senate,"Do pass as amended, but first amend, and re-refer to the Committee on [Appropriations]",9,0,2,0,11
1344505,964331,2020-06-09,Senate,"Placed on suspense file",7,0,0,0,7
1344505,967437,2020-06-18,Senate,"Do pass as amended",5,1,1,0,7
1344505,969415,2020-06-26,Senate,"Senate 3rd Reading SB1085 Skinner et al",31,1,8,0,40
1344505,974293,2020-07-29,Assembly,"Do pass as amended and be re-referred to the Committee on [Appropriations]",8,0,0,0,8
1344505,976373,2020-08-20,Assembly,"Do pass as amended",10,1,7,0,18
1344505,978001,2020-08-31,Assembly,"SB 1085 Skinner Senate Third Reading By Gonzalez",67,3,9,0,79
1344519,961691,2020-05-29,Senate,"Do pass as amended, but first amend, and re-refer to the Committee on [Appropriations]",4,1,2,0,7
1344519,969761,2020-06-25,Senate,"Senate 3rd Reading SB1099 Dodd et al",37,0,3,0,40
1344522,958817,2020-05-14,Senate,"Do pass, but first be re-referred to the Committee on [Appropriations]",4,1,0,0,5
1344522,968064,2020-06-22,Senate,"Senate 3rd Reading SB1102 Monning",25,11,4,0,40
1344522,974270,2020-07-29,Assembly,"Do pass and be re-referred to the Committee on [Appropriations]",5,2,0,0,7
1344522,975509,2020-08-11,Assembly,"Do pass",13,4,0,0,17
1344522,978070,2020-08-30,Assembly,"SB 1102 Monning Senate Third Reading By Kalra",52,18,9,0,79
1344522,978071,2020-08-31,Senate,"Unfinished Business SB1102 Monning et al. Concurrence",28,10,2,0,40
1344523,958797,2020-05-14,Senate,"Do pass as amended, but first amend, and re-refer to the Committee on [Appropriations]",4,1,0,0,5
1344523,964424,2020-06-09,Senate,"Placed on suspense file",7,0,0,0,7
1344523,967503,2020-06-18,Senate,"Do pass as amended",5,1,1,0,7
1344523,969424,2020-06-26,Senate,"Senate 3rd Reading SB1103 Hurtado",32,4,4,0,40
1344523,974311,2020-07-29,Assembly,"Do pass and be re-referred to the Committee on [Appropriations]",7,0,0,0,7
1344525,960173,2020-05-22,Senate,"Do pass and be ordered to the Consent Calendar",8,0,1,0,9
1344525,965571,2020-06-11,Senate,"Consent Calendar SB1105",39,0,1,0,40
1344530,958572,2020-05-13,Senate,"Do pass as amended, but first amend, and re-refer to the Committee on [Appropriations]",8,1,0,0,9
1344530,964363,2020-06-09,Senate,"Placed on suspense file",7,0,0,0,7
1344531,959759,2020-05-20,Senate,"Do pass, but first be re-referred to the Committee on [Appropriations]",6,1,0,0,7
1344531,964366,2020-06-09,Senate,"Placed on suspense file",7,0,0,0,7
1344531,967398,2020-06-18,Senate,"Do pass as amended",5,2,0,0,7
1344531,969416,2020-06-26,Senate,"Senate 3rd Reading SB1111 Durazo",30,8,2,0,40
1344531,974934,2020-08-05,Assembly,"Do pass and be re-referred to the Committee on [Appropriations]",8,0,0,0,8
1344531,976458,2020-08-20,Assembly,"Do pass as amended",14,2,2,0,18
1344531,977818,2020-08-31,Assembly,"SB 1111 Durazo Senate Third Reading By Kamlager",63,6,10,0,79
1344535,958571,2020-05-13,Senate,"Do pass as amended, but first amend, and re-refer to the Committee on [Appropriations]",4,0,1,0,5
1344535,964339,2020-06-09,Senate,"Placed on suspense file",7,0,0,0,7
1344535,967508,2020-06-18,Senate,"Do pass as amended",7,0,0,0,7
1344535,968695,2020-06-24,Senate,"Special Consent SB1115 Wilk et al. Urgency Clause",39,0,1,0,40
1344537,958789,2020-05-14,Senate,"Do pass as amended",12,0,1,0,13
1344537,965705,2020-06-11,Senate,"Special Consent SB1117",39,0,1,0,40
1344537,974911,2020-08-05,Assembly,"Do pass. To Consent Calendar",14,0,1,0,15
1344537,978088,2020-08-30,Senate,"Unfinished Business SB1117 Monning et al. Concurrence",39,0,1,0,40
1344537,978089,2020-08-30,Assembly,"SB 1117 Monning Consent Calendar Second Day Regular Session",75,0,4,0,79
1344540,961337,2020-05-28,Senate,"Do pass, but first be re-referred to the Committee on [Appropriations]",7,0,0,0,7
1344540,964408,2020-06-09,Senate,"Placed on suspense file",7,0,0,0,7
1344540,967385,2020-06-18,Senate,"Do pass as amended",7,0,0,0,7
1344540,968679,2020-06-24,Senate,"Special Consent SB1120",39,0,1,0,40
1344540,975543,2020-08-11,Assembly,"Do pass as amended and be re-referred to the Committee on [Appropriations]",5,1,2,0,8
1344540,976319,2020-08-20,Assembly,"Do pass",11,3,4,0,18
1344540,978157,2020-08-31,Assembly,"SB 1120 Atkins Senate Third Reading By Robert Rivas",44,18,17,0,79
1344543,959724,2020-05-20,Senate,"Do pass and be ordered to the Consent Calendar",7,0,0,0,7
1344543,965688,2020-06-11,Senate,"Consent Calendar SB1123",39,0,1,0,40
1344543,974943,2020-08-05,Assembly,"Do pass. To Consent Calendar",8,0,0,0,8
1344543,978028,2020-08-30,Senate,"Unfinished Business SB1123 Chang Concurrence",39,0,1,0,40
1344543,978029,2020-08-30,Assembly,"SB 1123 Chang Consent Calendar Second Day Regular Session",75,0,4,0,79
1344546,959734,2020-05-20,Senate,"Do pass and be ordered to the Consent Calendar",7,0,0,0,7
1344546,965638,2020-06-11,Senate,"Consent Calendar SB1126",39,0,1,0,40
1344546,974937,2020-08-05,Assembly,"Do pass. To Consent Calendar",8,0,0,0,8
1344546,977977,2020-08-30,Assembly,"SB 1126 Jones Senate Third Reading By Jones-Sawyer",75,0,4,0,79
1344546,977978,2020-08-31,Senate,"Unfinished Business SB1126 Jones Concurrence",39,0,1,0,40
1344550,960462,2020-05-26,Senate,"Do pass as amended, but first amend, and re-refer to the Committee on [Appropriations]",11,2,0,0,13
1344550,964384,2020-06-09,Senate,"Placed on suspense file",7,0,0,0,7
1344550,967382,2020-06-18,Senate,"Do pass as amended",5,2,0,0,7
1344550,969400,2020-06-26,Senate,"Senate 3rd Reading SB1130 Lena Gonzalez et al",30,9,1,0,40
1344550,974761,2020-08-03,Assembly,"Do pass and be re-referred to the Committee on [Appropriations]",9,3,1,0,13
1344550,976481,2020-08-20,Assembly,"Do pass as amended",13,5,0,0,18
1344553,959726,2020-05-20,Senate,"Do pass as amended",4,0,3,0,7
1344553,968050,2020-06-22,Senate,"Senate 3rd Reading SB1133 Jackson",29,0,11,0,40
1344558,960463,2020-05-26,Senate,"Do pass, but first be re-referred to the Committee on [Appropriations]",9,1,1,0,11
1344558,964325,2020-06-09,Senate,"Placed on suspense file",7,0,0,0,7
1344558,967453,2020-06-18,Senate,"Do pass",5,2,0,0,7
1344558,968049,2020-06-22,Senate,"Senate 3rd Reading SB1138 Wiener et al",30,8,2,0,40
1344558,974274,2020-07-29,Assembly,"Do pass and be re-referred to the Committee on [Appropriations]",7,1,0,0,8
1344558,976493,2020-08-20,Assembly,"Do pass as amended",13,4,1,0,18
1344558,978128,2020-08-31,Assembly,"SB 1138 Wiener Senate Third Reading By Burke",56,14,9,0,79
1344561,960176,2020-05-22,Senate,"Do pass as amended, but first amend, and re-refer to the Committee on [Appropriations]",8,0,1,0,9
1344561,964388,2020-06-09,Senate,"Placed on suspense file",7,0,0,0,7
1344561,967481,2020-06-18,Senate,"Do pass",7,0,0,0,7
1344561,969766,2020-06-25,Senate,"Senate 3rd Reading SB1141 Rubio et al",40,0,0,0,40
1344561,975664,2020-08-12,Assembly,"Do pass and be re-referred to the Committee on [Appropriations] with recommendation: To Consent Calendar",11,0,0,0,11
1344561,976075,2020-08-18,Assembly,"Do pass. To Consent Calendar",18,0,0,0,18
1344561,977968,2020-08-30,Senate,"Unfinished Business SB1141 Rubio et al. Concurrence",39,0,1,0,40
1344561,977969,2020-08-30,Assembly,"SB 1141 Rubio Consent Calendar Second Day Regular Session",75,0,4,0,79
1344566,965703,2020-06-11,Senate,"Special Consent SCR87",39,0,1,0,40
1345524,957762,2020-05-07,Assembly,"Do pass and be re-referred to the Committee on [Appropriations]",8,0,0,0,8
1345527,958139,2020-05-11,Assembly,"Do pass and be re-referred to the Committee on [Appropriations]",7,3,1,0,11
1345527,962843,2020-06-03,Assembly,"Do pass",13,5,0,0,18
1345527,965016,2020-06-10,Assembly,"AB 2570 Mark Stone Assembly Third Reading",44,20,15,0,79
1345530,958123,2020-05-11,Assembly,"Do pass. To Consent Calendar",10,0,1,0,11
1345530,960451,2020-05-26,Assembly,"AB 2573 Obernolte Consent Calendar Second Day Regular Session",75,0,4,0,79
1345531,958804,2020-05-14,Assembly,"Do pass and be re-referred to the Committee on [Appropriations] with recommendation: To Consent Calendar",14,0,0,0,14
1345533,959349,2020-05-18,Assembly,"Do pass and be re-referred to the Committee on [Appropriations]",13,0,2,0,15
1345533,962363,2020-06-02,Assembly,"Do pass",13,1,4,0,18
1345533,966531,2020-06-15,Assembly,"AB 2576 Gloria Assembly Third Reading",71,0,8,0,79
1345535,958505,2020-05-13,Assembly,"Do pass and be re-referred to the Committee on [Appropriations]",10,0,2,0,12
1345535,962420,2020-06-02,Assembly,"Do pass. To Consent Calendar",18,0,0,0,18
1345535,963624,2020-06-08,Assembly,"AB 2578 Irwin Consent Calendar Second Day Regular Session",76,0,3,0,79
1345537,960249,2020-05-20,Assembly,"Do pass as amended and be re-referred to the Committee on [Appropriations]",7,1,0,0,8
1345538,957771,2020-05-07,Assembly,"Do pass and be re-referred to the Committee on [Appropriations]",6,0,2,0,8
1345538,962809,2020-06-03,Assembly,"Do pass as amended",12,2,4,0,18
1345538,965062,2020-06-10,Assembly,"AB 2581 Reyes Assembly Third Reading",63,7,9,0,79
1345545,959731,2020-05-20,Assembly,"Do pass and be re-referred to the Committee on [Appropriations]",7,0,0,0,7
1345545,962366,2020-06-02,Assembly,"Do pass. To Consent Calendar",18,0,0,0,18
1345545,963605,2020-06-08,Assembly,"AB 2588 Kalra Consent Calendar Second Day Regular Session",76,0,3,0,79
1345545,975523,2020-08-11,Senate,"Do pass, but first be re-referred to the Committee on [Appropriations]",4,1,0,0,5
1345545,976014,2020-08-17,Senate,"Do pass",5,2,0,0,7
1345545,978105,2020-08-30,Senate,"Assembly 3rd Reading AB2588 Kalra By Gonzalez",28,11,1,0,40
1345545,978106,2020-08-30,Assembly,"AB 2588 Kalra Concurrence in Senate Amendments",54,14,11,0,79
1345549,959942,2020-05-21,Assembly,"Do pass and be re-referred to the Committee on [Appropriations]",17,1,1,0,19
1345549,962831,2020-06-03,Assembly,"Do pass as amended",15,1,2,0,18
1345549,963595,2020-06-08,Assembly,"AB 2592 Cristina Garcia Assembly Third Reading",69,1,9,0,79
1345549,975374,2020-08-08,Senate,"Do pass, but first be re-referred to the Committee on [Appropriations]",9,0,0,0,9
1345549,975822,2020-08-13,Senate,"Placed on suspense file",7,0,0,0,7
1345563,959770,2020-05-19,Assembly,"Do pass and be re-referred to the Committee on [Appropriations] with recommendation: To Consent Calendar",8,0,0,0,8
1345563,962814,2020-06-03,Assembly,"Do pass",18,0,0,0,18
1345563,964991,2020-06-10,Assembly,"AB 2606 Cervantes Assembly Third Reading",78,0,1,0,79
1345563,974627,2020-07-31,Senate,"Do pass, but first be re-referred to the Committee on [Appropriations] with the recommendation: To Consent Calendar",7,0,0,0,7
1345563,975813,2020-08-13,Senate,"Placed on suspense file",7,0,0,0,7
1345563,976452,2020-08-20,Senate,"Do pass",7,0,0,0,7
1345563,977392,2020-08-28,Senate,"Special Consent AB2606",39,0,1,0,40
1345565,958533,2020-05-12,Assembly,"Do pass and be re-referred to the Committee on [Appropriations] with recommendation: To Consent Calendar",20,0,1,0,21
1345574,959746,2020-05-19,Assembly,"Do pass and be re-referred to the Committee on [Appropriations]",8,0,0,0,8
1345574,962762,2020-06-03,Assembly,"Do pass",17,0,1,0,18
1345574,965088,2020-06-10,Assembly,"AB 2617 Gabriel Assembly Third Reading",76,0,3,0,79
1345574,974620,2020-07-31,Senate,"Do pass, but first be re-referred to the Committee on [Appropriations] with the recommendation: To Consent Calendar",7,0,0,0,7
1345574,975786,2020-08-13,Senate,"Placed on suspense file",7,0,0,0,7
1345574,976361,2020-08-20,Senate,"Do pass",7,0,0,0,7
1345574,977355,2020-08-28,Senate,"Special Consent AB2617",39,0,1,0,40
1345574,978148,2020-08-30,Assembly,"AB 2617 Gabriel Concurrence in Senate Amendments",73,0,6,0,79
1345576,958553,2020-05-13,Assembly,"Do pass and be re-referred to the Committee on [Appropriations]",7,3,1,0,11
1345578,958554,2020-05-13,Assembly,"Do pass and be re-referred to the Committee on [Appropriations]",8,3,0,0,11
1345578,962842,2020-06-03,Assembly,"Do pass as amended",13,5,0,0,18
1345578,965615,2020-06-11,Assembly,"AB 2621 Mullin Assembly Third Reading",63,12,4,0,79
1345578,975939,2020-08-14,Senate,"Do pass as amended, but first amend, and re-refer to the Committee on [Appropriations]",5,1,1,0,7
1345578,976179,2020-08-19,Senate,"Placed on suspense file",7,0,0,0,7
1345583,959343,2020-05-18,Assembly,"Do pass and be re-referred to the Committee on [Appropriations]",10,0,1,0,11
1345583,962839,2020-06-03,Assembly,"Do pass as amended",12,0,6,0,18
1345583,965061,2020-06-10,Assembly,"AB 2626 Bauer-Kahan Assembly Third Reading",78,0,1,0,79
1345594,959488,2020-05-19,Assembly,"Do pass and be re-referred to the Committee on [Appropriations] with recommendation: To Consent Calendar",11,0,1,0,12
1345599,958798,2020-05-14,Assembly,"Do pass and be re-referred to the Committee on [Appropriations]",14,0,0,0,14
1345601,959321,2020-05-18,Assembly,"Do pass as amended and be re-referred to the Committee on [Appropriations]",15,0,0,0,15
1345601,962743,2020-06-03,Assembly,"Do pass as amended",18,0,0,0,18
1345601,965051,2020-06-10,Assembly,"AB 2644 Wood Assembly Third Reading",78,0,1,0,79
1345601,974668,2020-08-01,Senate,"Do pass as amended, but first amend, and re-refer to the Committee on [Appropriations]",8,0,1,0,9
1345601,976644,2020-08-24,Senate,"Assembly 3rd Reading AB2644 Wood et al. By Pan",40,0,0,0,40
1345601,976901,2020-08-26,Assembly,"AB 2644 Wood Concurrence in Senate Amendments",74,0,5,0,79
1345608,957793,2020-05-06,Assembly,"Do pass as amended, and be re-referred to the Committee on [Appropriations] with recommendation: To Consent Calendar",7,0,0,0,7
1345612,959738,2020-05-19,Assembly,"Do pass and be re-referred to the Committee on [Appropriations]",7,0,1,0,8
1345612,962838,2020-06-03,Assembly,"Do pass",15,0,3,0,18
1345612,967441,2020-06-18,Assembly,"AB 2655 Gipson Assembly Third Reading",69,0,10,0,79
1345612,974993,2020-08-07,Senate,"Do pass, but first be re-referred to the Committee on [Appropriations]",7,0,0,0,7
1345612,976026,2020-08-17,Senate,"Placed on suspense file",7,0,0,0,7
1345612,976301,2020-08-20,Senate,"Do pass",7,0,0,0,7
1345612,977371,2020-08-28,Senate,"Special Consent AB2655",39,0,1,0,40
1345612,977961,2020-08-30,Assembly,"AB 2655 Gipson Concurrence Vote: Final Form",75,0,4,0,79
1345615,959763,2020-05-20,Assembly,"Do pass and be re-referred to the Committee on [Appropriations]",7,0,0,0,7
1345615,962798,2020-06-03,Assembly,"Do pass",17,0,1,0,18
1345615,964981,2020-06-10,Assembly,"AB 2658 Burke Assembly Third Reading",72,2,5,0,79
1345615,975538,2020-08-11,Senate,"Do pass, but first be re-referred to the Committee on [Appropriations]",4,1,0,0,5
1345615,975986,2020-08-17,Senate,"Placed on suspense file",7,0,0,0,7
1345615,976342,2020-08-20,Senate,"Do pass as amended",5,2,0,0,7
1345615,977807,2020-08-30,Senate,"Assembly 3rd Reading AB2658 Burke By Mitchell",31,8,1,0,40
1345615,977808,2020-08-31,Assembly,"AB 2658 Burke Concurrence in Senate Amendments",67,0,12,0,79
1345617,959335,2020-05-18,Assembly,"Do pass and be re-referred to the Committee on [Appropriations]",11,0,0,0,11
1345617,962815,2020-06-03,Assembly,"Do pass as amended",18,0,0,0,18
1345617,965010,2020-06-10,Assembly,"AB 2660 Burke Assembly Third Reading",78,0,1,0,79
1345617,974287,2020-07-29,Senate,"Do pass, but first be re-referred to the Committee on [Appropriations] with the recommendation: To Consent Calendar",7,0,0,0,7
1345617,977378,2020-08-28,Senate,"Consent Calendar AB2660",39,0,1,0,40
1345620,959962,2020-05-21,Assembly,"Do pass and be re-referred to the Committee on [Appropriations] with recommendation: To Consent Calendar",19,0,0,0,19
1345620,962837,2020-06-03,Assembly,"Do pass as amended",18,0,0,0,18
1345620,965597,2020-06-11,Assembly,"AB 2663 Eduardo Garcia Assembly Third Reading",78,0,1,0,79
1345620,974798,2020-08-04,Senate,"Do pass, but first be re-referred to the Committee on [Appropriations] with the recommendation: To Consent Calendar",14,0,1,0,15
1345620,975757,2020-08-13,Senate,"Placed on suspense file",7,0,0,0,7
1345620,976485,2020-08-20,Senate,"Do pass",7,0,0,0,7
1345620,977376,2020-08-28,Senate,"Special Consent AB2663",39,0,1,0,40
1345620,978024,2020-08-30,Assembly,"AB 2663 Eduardo Garcia Concurrence in Senate Amendments",75,0,4,0,79
1345647,960242,2020-05-20,Assembly,"Do pass",5,2,1,0,8
1345647,965069,2020-06-10,Assembly,"AB 2690 Low Assembly Third Reading",44,17,18,0,79
1345650,958779,2020-05-14,Assembly,"Do pass and be re-referred to the Committee on [Appropriations]",9,3,2,0,14
1345656,959736,2020-05-19,Assembly,"Do pass and be re-referred to the Committee on [Appropriations] with recommendation: To Consent Calendar",8,0,0,0,8
1345656,962433,2020-06-02,Assembly,"Do pass",18,0,0,0,18
1345656,963629,2020-06-08,Assembly,"AB 2699 Santiago Assembly Third Reading",74,0,5,0,79
1345656,975652,2020-08-12,Senate,"Do pass, but first be re-referred to the Committee on [Appropriations]",4,1,2,0,7
1345656,976015,2020-08-17,Senate,"Placed on suspense file",7,0,0,0,7
1345656,976471,2020-08-20,Senate,"Do pass as amended",6,1,0,0,7
1345656,977758,2020-08-30,Senate,"Assembly 3rd Reading AB2699 Santiago By Portantino",35,2,3,0,40
1345656,977759,2020-08-31,Assembly,"AB 2699 Santiago Concurrence in Senate Amendments",73,0,6,0,79
1345674,958153,2020-05-11,Assembly,"Do pass and be re-referred to the Committee on [Appropriations] with recommendation: To Consent Calendar",10,0,1,0,11
1345674,962453,2020-06-02,Assembly,"Do pass. To Consent Calendar",18,0,0,0,18
1345674,963617,2020-06-08,Assembly,"AB 2717 Chau Consent Calendar Second Day Regular Session",76,0,3,0,79
1345674,974497,2020-07-30,Senate,"Do pass, but first be re-referred to the Committee on [Appropriations] with the recommendation: To Consent Calendar",9,0,0,0,9
1345674,977193,2020-08-27,Senate,"Assembly 3rd Reading AB2717 Chau By Wieckowski",30,0,10,0,40
1345674,978127,2020-08-30,Assembly,"AB 2717 Chau Concurrence in Senate Amendments",75,0,4,0,79
1345680,958140,2020-05-11,Assembly,"Do pass. To Consent Calendar",10,0,1,0,11
1345680,960432,2020-05-26,Assembly,"AB 2723 Chiu Consent Calendar Second Day Regular Session",75,0,4,0,79
1345680,976103,2020-08-18,Senate,"Do pass as amended, and be ordered to the Consent Calendar",9,0,0,0,9
1345680,977282,2020-08-28,Senate,"Consent Calendar AB2723",39,0,1,0,40
1345680,978018,2020-08-30,Assembly,"AB 2723 Chiu Concurrence in Senate Amendments",75,0,4,0,79
1345687,958528,2020-05-12,Assembly,"Do pass and be re-referred to the Committee on [Appropriations] with recommendation: To Consent Calendar",20,0,1,0,21
1345687,962764,2020-06-03,Assembly,"Do pass",18,0,0,0,18
1345687,965078,2020-06-10,Assembly,"AB 2730 Cervantes Assembly Third Reading",78,0,1,0,79
1345687,975937,2020-08-14,Senate,"Do pass, but first be re-referred to the Committee on [Appropriations] with the recommendation: To Consent Calendar",16,0,0,0,16
1345687,976159,2020-08-19,Senate,"Placed on suspense file",7,0,0,0,7
1345687,976418,2020-08-20,Senate,"Do pass as amended",7,0,0,0,7
1345687,978188,2020-08-30,Senate,"Assembly 3rd Reading AB2730 Cervantes By Rubio",39,0,1,0,40
1345687,978189,2020-08-30,Assembly,"AB 2730 Cervantes Concurrence in Senate Amendments",74,0,5,0,79
1345688,958538,2020-05-13,Assembly,"Do pass and be re-referred to the Committee on [Appropriations]",9,0,2,0,11
1345688,962439,2020-06-02,Assembly,"Do pass as amended. To Consent Calendar",18,0,0,0,18
1345688,965025,2020-06-10,Assembly,"AB 2731 Gloria Consent Calendar Second Day Regular Session",77,0,2,0,79
1345688,975943,2020-08-14,Senate,"Do pass as amended, but first amend, and re-refer to the Committee on [Appropriations]",5,0,2,0,7
1345688,977745,2020-08-30,Senate,"Assembly 3rd Reading AB2731 Gloria et al. By Atkins",38,0,2,0,40
1345688,977746,2020-08-31,Assembly,"AB 2731 Gloria Concurrence in Senate Amendments",74,0,5,0,79
1345693,958783,2020-05-14,Assembly,"Do pass as amended and be re-referred to the Committee on [Appropriations]",14,0,0,0,14
1345698,959779,2020-05-19,Assembly,"Do pass. To Consent Calendar",8,0,0,0,8
1345698,960447,2020-05-26,Assembly,"AB 2741 Blanca Rubio Consent Calendar Second Day Regular Session",75,0,4,0,79
1345698,974616,2020-07-31,Senate,"Do pass and be ordered to the Consent Calendar",7,0,0,0,7
1345698,977320,2020-08-28,Senate,"Consent Calendar AB2741",39,0,1,0,40
1345702,958137,2020-05-11,Assembly,"Do pass and be re-referred to the Committee on [Appropriations]",11,0,0,0,11
1345702,962388,2020-06-02,Assembly,"Do pass",18,0,0,0,18
1345702,964984,2020-06-10,Assembly,"AB 2745 Megan Dahle Assembly Third Reading",78,0,1,0,79
1345703,960244,2020-05-20,Assembly,"Do pass as amended, and be re-referred to the Committee on [Appropriations] with recommendation: To Consent Calendar",8,0,0,0,8
1345703,962834,2020-06-03,Assembly,"Do pass as amended",18,0,0,0,18
1345703,965014,2020-06-10,Assembly,"AB 2746 Gabriel Assembly Third Reading",78,0,1,0,79
1345703,975334,2020-08-10,Senate,"Do pass, but first be re-referred to the Committee on [Appropriations] with the recommendation: To Consent Calendar",7,0,0,0,7
1345703,975991,2020-08-17,Senate,"Placed on suspense file",7,0,0,0,7
1345703,976389,2020-08-20,Senate,"Do pass as amended",7,0,0,0,7
1345703,977766,2020-08-30,Senate,"Assembly 3rd Reading AB2746 Gabriel et al. By Hurtado",39,0,1,0,40
1345703,977767,2020-08-31,Assembly,"AB 2746 Gabriel Concurrence in Senate Amendments",76,0,3,0,79
1345706,959965,2020-05-21,Assembly,"Do pass and be re-referred to the Committee on [Appropriations] with recommendation: To Consent Calendar",19,0,0,0,19
1345706,962758,2020-06-03,Assembly,"Do pass",18,0,0,0,18
1345706,965050,2020-06-10,Assembly,"AB 2749 Mark Stone Assembly Third Reading",78,0,1,0,79
1345706,975371,2020-08-08,Senate,"Do pass, but first be re-referred to the Committee on [Appropriations]",9,0,0,0,9
1345706,975819,2020-08-13,Senate,"Placed on suspense file",7,0,0,0,7
1345713,957781,2020-05-07,Assembly,"Do pass as amended",14,0,0,0,14
1345713,963610,2020-06-08,Assembly,"AB 2756 Limón Assembly Third Reading",77,0,2,0,79
1345713,974833,2020-08-04,Senate,"Do pass as amended",13,0,0,0,13
1345713,978194,2020-08-30,Senate,"Assembly 3rd Reading AB2756 Limón et al. By McGuire",39,0,1,0,40
1345713,978195,2020-08-30,Assembly,"AB 2756 Limón Concurrence in Senate Amendments",75,0,4,0,79
1345716,959971,2020-05-21,Assembly,"Do pass and be re-referred to the Committee on [Appropriations] with recommendation: To Consent Calendar",19,0,0,0,19
1345716,962397,2020-06-02,Assembly,"Do pass. To Consent Calendar",18,0,0,0,18
1345716,963635,2020-06-08,Assembly,"AB 2759 Obernolte Consent Calendar Second Day Regular Session",76,0,3,0,79
1345716,975330,2020-08-08,Senate,"Do pass, but first be re-referred to the Committee on [Appropriations] with the recommendation: To Consent Calendar",9,0,0,0,9
1345716,977169,2020-08-27,Senate,"Assembly 3rd Reading AB2759 Obernolte By Jones",30,0,10,0,40
1345716,978213,2020-08-30,Assembly,"AB 2759 Obernolte Concurrence in Senate Amendments",75,0,4,0,79
1345719,958775,2020-05-14,Assembly,"Do pass as amended and be re-referred to the Committee on [Appropriations]",7,0,2,0,9
1345719,962847,2020-06-03,Assembly,"Do pass",17,0,1,0,18
1345719,965596,2020-06-11,Assembly,"AB 2762 Muratsuchi Assembly Third Reading",73,1,5,0,79
1345719,975518,2020-08-11,Senate,"Do pass, but first be re-referred to the Committee on [Appropriations] with the recommendation: To Consent Calendar",5,0,2,0,7
1345719,976010,2020-08-17,Senate,"Placed on suspense file",7,0,0,0,7
1345719,976400,2020-08-20,Senate,"Do pass as amended",7,0,0,0,7
1345719,977293,2020-08-28,Senate,"Special Consent AB2762",39,0,1,0,40
1345719,977847,2020-08-30,Assembly,"AB 2762 Muratsuchi Concurrence in Senate Amendments",74,0,5,0,79
1345722,959782,2020-05-20,Assembly,"Do pass and be re-referred to the Committee on [Appropriations]",6,0,1,0,7
1345722,962797,2020-06-03,Assembly,"Do pass",14,4,0,0,18
1345722,965035,2020-06-10,Assembly,"AB 2765 O'Donnell Assembly Third Reading",61,15,3,0,79
1345722,975527,2020-08-11,Senate,"Do pass, but first be re-referred to the Committee on [Appropriations]",4,1,0,0,5
1345722,976049,2020-08-17,Senate,"Placed on suspense file",7,0,0,0,7
1345722,976327,2020-08-20,Senate,"Do pass as amended",5,2,0,0,7
1345722,977415,2020-08-29,Senate,"Assembly 3rd Reading AB2765 O'Donnell et al. By Beall",28,9,3,0,40
1345722,978214,2020-08-30,Assembly,"AB 2765 O'Donnell Concurrence in Senate Amendments",58,14,7,0,79
1345739,960235,2020-05-20,Assembly,"Do pass and be re-referred to the Committee on [Appropriations]",6,2,0,0,8
1345739,962474,2020-06-02,Assembly,"Do pass",13,5,0,0,18
1345739,965072,2020-06-10,Assembly,"AB 2782 Mark Stone Assembly Third Reading",51,20,8,0,79
1345739,975843,2020-08-13,Senate,"Do pass as amended, but first amend, and re-refer to the Committee on [Appropriations]",7,2,0,0,9
1345739,978122,2020-08-30,Senate,"Assembly 3rd Reading AB2782 Mark Stone et al. By Umberg",28,11,1,0,40
1345739,978123,2020-08-31,Assembly,"AB 2782 Mark Stone Concurrence in Senate Amendments",47,16,16,0,79
1345740,959954,2020-05-21,Assembly,"Do pass and be re-referred to the Committee on [Appropriations] with recommendation: To Consent Calendar",19,0,0,0,19
1345740,962449,2020-06-02,Assembly,"Do pass. To Consent Calendar",18,0,0,0,18
1345740,963596,2020-06-08,Assembly,"AB 2783 Medina Consent Calendar Second Day Regular Session",76,0,3,0,79
1345745,961332,2020-05-28,Assembly,"Do pass",13,0,2,0,15
1345745,963608,2020-06-08,Assembly,"AB 2788 Gloria Assembly Third Reading",62,0,17,0,79
1345745,974748,2020-08-03,Senate,"Do pass",10,0,3,0,13
1345745,978019,2020-08-30,Senate,"Assembly 3rd Reading AB2788 Gloria et al. By Rubio",31,0,9,0,40
1345745,978020,2020-08-30,Assembly,"AB 2788 Gloria Concurrence in Senate Amendments",62,0,17,0,79
1345757,958565,2020-05-13,Assembly,"Do pass and be re-referred to the Committee on [Appropriations]",8,3,0,0,11
1345757,962763,2020-06-03,Assembly,"Do pass as amended",13,5,0,0,18
1345757,965042,2020-06-10,Assembly,"AB 2800 Quirk Assembly Third Reading By CHAU",62,15,2,0,79
1345757,974913,2020-08-05,Senate,"Do pass as amended, but first amend, and re-refer to the Committee on [Appropriations]",7,2,0,0,9
1345757,975814,2020-08-13,Senate,"Placed on suspense file",7,0,0,0,7
1345757,976332,2020-08-20,Senate,"Do pass",6,1,0,0,7
1345757,977731,2020-08-30,Senate,"Assembly 3rd Reading AB2800 Quirk et al. By Caballero",32,7,1,0,40
1345757,977732,2020-08-31,Assembly,"AB 2800 Quirk Concurrence in Senate Amendments",63,10,6,0,79
1345762,958157,2020-05-11,Assembly,"Do pass. To Consent Calendar",10,0,1,0,11
1345762,960440,2020-05-26,Assembly,"AB 2805 Eggman Consent Calendar Second Day Regular Session",75,0,4,0,79
1345762,974481,2020-07-30,Senate,"Do pass and be ordered to the Consent Calendar",9,0,0,0,9
1345762,977314,2020-08-28,Senate,"Consent Calendar AB2805",39,0,1,0,40
1345765,959743,2020-05-19,Assembly,"Do pass",7,0,1,0,8
1345765,965032,2020-06-10,Assembly,"AB 2808 Cervantes Assembly Third Reading",75,0,4,0,79
1345766,958522,2020-05-13,Assembly,"Do pass as amended and be re-referred to the Committee on [Appropriations]",11,0,0,0,11
1345766,962736,2020-06-03,Assembly,"Do pass",18,0,0,0,18
1345766,965692,2020-06-11,Assembly,"AB 2809 Mullin Assembly Third Reading",78,0,1,0,79
1345766,974884,2020-08-05,Senate,"Do pass, but first be re-referred to the Committee on [Appropriations] with the recommendation: To Consent Calendar",9,0,0,0,9
1345766,975809,2020-08-13,Senate,"Placed on suspense file",7,0,0,0,7
1345766,976304,2020-08-20,Senate,"Do pass",7,0,0,0,7
1345766,977303,2020-08-28,Senate,"Special Consent AB2809",39,0,1,0,40
1345768,957591,2020-05-05,Assembly,"Do pass as amended",11,0,0,0,11
1345768,965663,2020-06-11,Assembly,"AB 2811 Berman Assembly Third Reading",72,1,6,0,79
1345778,959311,2020-05-18,Assembly,"Do pass and be re-referred to the Committee on [Appropriations]",15,0,0,0,15
1345778,962800,2020-06-03,Assembly,"Do pass",18,0,0,0,18
1345778,965029,2020-06-10,Assembly,"AB 2821 Nazarian Assembly Third Reading",78,0,1,0,79
1345778,974652,2020-08-01,Senate,"Do pass, but first be re-referred to the Committee on [Appropriations]",8,0,1,0,9
1345778,975784,2020-08-13,Senate,"Placed on suspense file",7,0,0,0,7
1345778,976309,2020-08-20,Senate,"Do pass as amended",7,0,0,0,7
1345778,977382,2020-08-28,Senate,"Special Consent AB2821",39,0,1,0,40
1345778,978207,2020-08-30,Assembly,"AB 2821 Nazarian Concurrence in Senate Amendments",75,0,4,0,79
1345787,959356,2020-05-18,Assembly,"Do pass as amended and be re-referred to the Committee on [Appropriations]",13,0,2,0,15
1345787,962878,2020-06-03,Assembly,"Do pass as amended",14,0,4,0,18
1345787,965600,2020-06-11,Assembly,"AB 2830 Wood Assembly Third Reading",64,0,15,0,79
1345790,959739,2020-05-19,Assembly,"Do pass and be re-referred to the Committee on [Appropriations] with recommendation: To Consent Calendar",8,0,0,0,8
1345801,958158,2020-05-11,Assembly,"Do pass and be re-referred to the Committee on [Appropriations] with recommendation: To Consent Calendar",10,0,1,0,11
1345801,962479,2020-06-02,Assembly,"Do pass. To Consent Calendar",18,0,0,0,18
1345801,963623,2020-06-08,Assembly,"AB 2844 Obernolte Consent Calendar Second Day Regular Session",76,0,3,0,79
1345801,974491,2020-07-30,Senate,"Do pass as amended, but first amend, and re-refer to the Committee on [Appropriations] with the recommendation: To Consent Calendar",9,0,0,0,9
1345801,977353,2020-08-28,Senate,"Consent Calendar AB2844",39,0,1,0,40
1345801,978113,2020-08-30,Assembly,"AB 2844 Obernolte Concurrence in Senate Amendments",75,0,4,0,79
1345804,959737,2020-05-19,Assembly,"Do pass and be re-referred to the Committee on [Appropriations]",6,1,1,0,8
1345804,962863,2020-06-03,Assembly,"Do pass",13,4,1,0,18
1345804,965611,2020-06-11,Assembly,"AB 2847 Chiu Assembly Third Reading",52,20,7,0,79
1345804,974619,2020-07-31,Senate,"Do pass, but first be re-referred to the Committee on [Appropriations]",5,2,0,0,7
1345804,975780,2020-08-13,Senate,"Placed on suspense file",7,0,0,0,7
1345804,976416,2020-08-20,Senate,"Do pass",5,2,0,0,7
1345804,977389,2020-08-28,Senate,"Assembly 3rd Reading AB2847 Chiu et al. By Wiener",25,12,3,0,40
1345804,978129,2020-08-30,Assembly,"AB 2847 Chiu Concurrence in Senate Amendments",52,19,8,0,79
1345808,960163,2020-05-22,Senate,"Do pass as amended, and be ordered to the Consent Calendar",8,0,1,0,9
1345808,966492,2020-06-15,Senate,"Senate 3rd Reading SB1146 Umberg",40,0,0,0,40
1345808,975655,2020-08-12,Assembly,"Do pass as amended",11,0,0,0,11
1345808,977993,2020-08-31,Senate,"Unfinished Business SB1146 Umberg Urgency Clause Concurrence",35,0,5,0,40
1345808,977994,2020-08-31,Assembly,"SB 1146 Umberg Third Reading Urgency By Reyes",75,0,4,0,79
1345810,960165,2020-05-22,Senate,"Do pass as amended, and be ordered to the Consent Calendar",8,0,1,0,9
1345810,965633,2020-06-11,Senate,"Consent Calendar SB1148",39,0,1,0,40
1345810,975651,2020-08-12,Assembly,"Do pass",11,0,0,0,11
1345810,977836,2020-08-30,Assembly,"SB 1148 Jones Senate Third Reading By Ramos",75,0,4,0,79
1345810,977837,2020-08-31,Senate,"Unfinished Business SB1148 Jones Concurrence",39,0,1,0,40
1345818,961684,2020-05-29,Senate,"Do pass, but first be re-referred to the Committee on [Appropriations] with the recommendation: To Consent Calendar",6,0,1,0,7
1345818,964341,2020-06-09,Senate,"Placed on suspense file",7,0,0,0,7
1345818,967454,2020-06-18,Senate,"Do pass as amended",7,0,0,0,7
1345818,968687,2020-06-24,Senate,"Special Consent SB1156",39,0,1,0,40
1345818,974470,2020-07-30,Assembly,"Do pass and be re-referred to the Committee on [Appropriations] with recommendation: To Consent Calendar",9,0,0,0,9
1345818,976325,2020-08-20,Assembly,"Do pass as amended",18,0,0,0,18
1345818,978030,2020-08-31,Assembly,"SB 1156 Archuleta Senate Third Reading By Bauer-Kahan",76,0,3,0,79
1345819,960166,2020-05-22,Senate,"Do pass as amended",7,0,2,0,9
1345819,965580,2020-06-11,Senate,"Senate 3rd Reading SB1157 Bradford",29,4,7,0,40
1345819,975658,2020-08-12,Assembly,"Do pass",9,1,1,0,11
1345819,976638,2020-08-24,Assembly,"SB 1157 Bradford Senate Third Reading By Reyes",57,6,16,0,79
1345819,977305,2020-08-28,Senate,"Unfinished Business SB1157 Bradford et al. Concurrence",30,8,2,0,40
1345821,958822,2020-05-14,Senate,"Do pass, but first be re-referred to the Committee on [Appropriations]",3,1,1,0,5
1345821,964327,2020-06-09,Senate,"Placed on suspense file",7,0,0,0,7
1345821,967405,2020-06-18,Senate,"Do pass as amended",5,2,0,0,7
1345821,969417,2020-06-26,Senate,"Senate 3rd Reading SB1159 Hill et al",28,11,1,0,40
1345821,975515,2020-08-11,Assembly,"Do pass as amended and be re-referred to the Committee on [Appropriations]",10,1,3,0,14
1345821,976296,2020-08-20,Assembly,"Do pass",14,4,0,0,18
1345821,978080,2020-08-31,Senate,"Unfinished Business SB1159 Hill et al. Urgency Clause Concurrence",30,8,2,0,40
1345821,978081,2020-08-31,Assembly,"SB 1159 Hill Third Reading Urgency By Daly",69,4,6,0,79
1345825,959473,2020-05-19,Senate,"Do pass, but first be re-referred to the Committee on [Appropriations]",1,3,1,0,5
1345825,959474,2020-05-19,Senate,"[First] hearing set for [05-19-2020]: Failed passage in Committee. Reconsideration granted",5,0,0,0,5
1345830,958326,2020-05-12,Senate,"Do pass as amended, but first amend, and re-refer to the Committee on [Appropriations]",14,0,2,0,16
1345830,964329,2020-06-09,Senate,"Placed on suspense file",7,0,0,0,7
1345835,958764,2020-05-14,Senate,"Do pass, but first be re-referred to the Committee on [Appropriations]",3,2,0,0,5
1345835,964420,2020-06-09,Senate,"Placed on suspense file",7,0,0,0,7
1345835,967475,2020-06-18,Senate,"Do pass",4,3,0,0,7
1345835,969779,2020-06-25,Senate,"Senate 3rd Reading SB1173 Durazo",21,14,5,0,40
1345835,974903,2020-08-05,Assembly,"Do pass and be re-referred to the Committee on [Appropriations]",4,1,2,0,7
1345835,976395,2020-08-20,Assembly,"Do pass as amended",11,7,0,0,18
1345835,977980,2020-08-31,Assembly,"SB 1173 Durazo Senate Third Reading By Cooper",55,16,8,0,79
1345837,960434,2020-05-26,Senate,"Do pass as amended, but first amend, and re-refer to the Committee on [Appropriations]",5,1,3,0,9
1345837,964396,2020-06-09,Senate,"Placed on suspense file",7,0,0,0,7
1345837,967479,2020-06-18,Senate,"Do pass as amended",5,1,1,0,7
1345837,969430,2020-06-26,Senate,"Senate 3rd Reading SB1175 Stern",29,8,3,0,40
1345837,974828,2020-08-04,Assembly,"Do pass as amended and be re-referred to the Committee on [Appropriations]",8,3,3,0,14
1345837,976368,2020-08-20,Assembly,"Do pass as amended",13,5,0,0,18
1345837,978132,2020-08-31,Assembly,"SB 1175 Stern Senate Third Reading By Kamlager",49,16,14,0,79
1345839,958564,2020-05-13,Senate,"Do pass, but first be re-referred to the Committee on [Appropriations] with the recommendation: To Consent Calendar",4,0,3,0,7
1345839,963494,2020-05-27,Senate,"Do pass, but first be re-referred to the Committee on [Appropriations] with the recommendation: To Consent Calendar",7,0,0,0,7
1345839,965604,2020-06-11,Senate,"Consent Calendar SB1177",39,0,1,0,40
1345843,958322,2020-05-12,Senate,"Do pass and be ordered to the Consent Calendar",6,0,1,0,7
1345843,965700,2020-06-11,Senate,"Consent Calendar SB1181 ED",39,0,1,0,40
1345847,961701,2020-05-29,Senate,"Do pass, but first be re-referred to the Committee on [Appropriations]",5,0,2,0,7
1345847,968052,2020-06-22,Senate,"Senate 3rd Reading SB1185 Moorlach",33,3,4,0,40
1345851,959304,2020-05-18,Senate,"Do pass, but first be re-referred to the Committee on [Appropriations]",9,0,0,0,9
1345851,964342,2020-06-09,Senate,"Placed on suspense file",7,0,0,0,7
1345851,967412,2020-06-18,Senate,"Do pass as amended",7,0,0,0,7
1345851,968709,2020-06-24,Senate,"Special Consent SB1189",39,0,1,0,40
1345851,975315,2020-08-10,Assembly,"Do pass and be re-referred to the Committee on [Appropriations] with recommendation: To Consent Calendar",19,0,0,0,19
1345851,976084,2020-08-10,Assembly,"Do pass as amended, and be re-referred to the Committee on [Appropriations] with recommendation: To Consent Calendar",19,0,0,0,19
1345851,976426,2020-08-20,Assembly,"Do pass",18,0,0,0,18
1345851,976731,2020-08-25,Assembly,"SB 1189 McGuire Senate Third Reading By Low",75,0,4,0,79
1345851,977330,2020-08-28,Senate,"Unfinished Business SB1189 McGuire et al. Concurrence",39,0,1,0,40
1345852,960167,2020-05-22,Senate,"Do pass as amended, but first amend, and re-refer to the Committee on [Appropriations]",5,1,3,0,9
1345852,964335,2020-06-09,Senate,"Placed on suspense file",7,0,0,0,7
1345852,967500,2020-06-18,Senate,"Do pass",5,2,0,0,7
1345852,969724,2020-06-25,Senate,"Senate 3rd Reading SB1190 Durazo et al",27,11,2,0,40
1345852,975654,2020-08-12,Assembly,"Do pass",8,3,0,0,11
1345852,978171,2020-08-30,Assembly,"SB 1190 Durazo Senate Third Reading By Weber",45,15,19,0,79
1345852,978172,2020-08-31,Senate,"Unfinished Business SB1190 Durazo et al. Concurrence",27,10,3,0,40
1345854,958794,2020-05-14,Senate,"Do pass, but first be re-referred to the Committee on [Appropriations] with the recommendation: To Consent Calendar",11,0,2,0,13
1345854,964359,2020-06-09,Senate,"Do pass",7,0,0,0,7
1345854,965693,2020-06-11,Senate,"Senate 3rd Reading SB1192 Bradford",39,0,1,0,40
1345854,975537,2020-08-11,Assembly,"Do pass and be re-referred to the Committee on [Appropriations] with recommendation: To Consent Calendar",13,0,1,0,14
1345854,976106,2020-08-18,Assembly,"Do pass. To Consent Calendar",18,0,0,0,18
1345854,977856,2020-08-30,Assembly,"SB 1192 Bradford Consent Calendar Second Day Regular Session",75,0,4,0,79
1345858,960908,2020-05-27,Senate,"Do pass as amended, but first amend, and re-refer to the Committee on [Appropriations]",5,0,2,0,7
1345858,964411,2020-06-09,Senate,"Placed on suspense file",7,0,0,0,7
1345858,967492,2020-06-18,Senate,"Do pass as amended",5,2,0,0,7
1345858,969389,2020-06-26,Senate,"Senate 3rd Reading SB1196 Umberg et al",39,0,1,0,40
1345858,974933,2020-08-05,Assembly,"Do pass as amended and be re-referred to the Committee on [Appropriations]",8,0,0,0,8
1345858,976298,2020-08-20,Assembly,"Do pass",18,0,0,0,18
1345858,977942,2020-08-30,Assembly,"SB 1196 Umberg Senate Third Reading By Petrie-Norris",71,0,8,0,79
1345858,977943,2020-08-31,Senate,"Unfinished Business SB1196 Umberg et al. Concurrence",39,0,1,0,40
1345861,958316,2020-05-12,Senate,"Do pass, but first be re-referred to the Committee on [Appropriations]",10,3,3,0,16
1345861,964395,2020-06-09,Senate,"Placed on suspense file",7,0,0,0,7
1345861,967375,2020-06-18,Senate,"Do pass as amended",5,2,0,0,7
1345861,969413,2020-06-26,Senate,"Senate 3rd Reading SB1199 McGuire et al",29,8,3,0,40
1345864,959820,2020-05-19,Senate,"Do pass, but first be re-referred to the Committee on [Appropriations]",7,0,0,0,7
1345864,964370,2020-06-09,Senate,"Placed on suspense file",7,0,0,0,7
1345869,958527,2020-05-13,Senate,"Do pass as amended, but first amend, and re-refer to the Committee on [Appropriations]",8,0,1,0,9
1345869,968068,2020-06-22,Senate,"Senate 3rd Reading SB1207 Jackson",36,0,4,0,40
1345869,975003,2020-08-04,Assembly,"Do pass as amended and be re-referred to the Committee on [Appropriations]",12,0,3,0,15
1345869,976500,2020-08-20,Assembly,"Do pass",14,0,4,0,18
1345869,978074,2020-08-30,Assembly,"SB 1207 Jackson Senate Third Reading By Nazarian",63,0,16,0,79
1345869,978075,2020-08-31,Senate,"Unfinished Business SB1207 Jackson Concurrence",37,1,2,0,40
1345874,959956,2020-05-21,Senate,"Do pass and be ordered to the Consent Calendar",7,0,0,0,7
1345874,965653,2020-06-11,Senate,"Consent Calendar SB1212",39,0,1,0,40
1345874,975534,2020-08-11,Assembly,"Do pass. To Consent Calendar",8,0,0,0,8
1345874,977863,2020-08-30,Assembly,"SB 1212 Rubio Consent Calendar Second Day Regular Session",75,0,4,0,79
1345875,958309,2020-05-12,Senate,"Do pass, but first be re-referred to the Committee on [Appropriations] with the recommendation: To Consent Calendar",6,0,1,0,7
1345875,964330,2020-06-09,Senate,"Placed on suspense file",7,0,0,0,7
1345875,967410,2020-06-18,Senate,"Do pass",7,0,0,0,7
1345875,969716,2020-06-25,Senate,"Senate 3rd Reading SB1213 Leyva",38,0,2,0,40
1345877,960453,2020-05-26,Senate,"Do pass as amended, but first amend, and re-refer to the Committee on [Appropriations]",9,0,4,0,13
1345877,964381,2020-06-09,Senate,"Placed on suspense file",7,0,0,0,7
1345877,967403,2020-06-18,Senate,"Do pass as amended",5,2,0,0,7
1345877,969433,2020-06-26,Senate,"Senate 3rd Reading SB1215 Stern",28,8,4,0,40
1345882,960911,2020-05-27,Senate,"Do pass, but first be re-referred to the Committee on [Appropriations]",4,0,3,0,7
1345882,964367,2020-06-09,Senate,"Placed on suspense file",7,0,0,0,7
1345882,967432,2020-06-18,Senate,"Do pass as amended",4,1,2,0,7
1345882,969428,2020-06-26,Senate,"Senate 3rd Reading SB1220 Umberg",34,0,6,0,40
1345882,974953,2020-08-05,Assembly,"Do pass and be re-referred to the Committee on [Appropriations]",6,0,2,0,8
1345882,976427,2020-08-20,Assembly,"Do pass",17,0,1,0,18
1345882,977955,2020-08-30,Assembly,"SB 1220 Umberg Senate Third Reading By Bauer-Kahan",67,0,12,0,79
1345882,977956,2020-08-31,Senate,"Unfinished Business SB1220 Umberg Concurrence",35,1,4,0,40
1345884,958768,2020-05-14,Senate,"Do pass, but first be re-referred to the Committee on [Appropriations]",9,2,2,0,13
1345884,964353,2020-06-09,Senate,"Placed on suspense file",7,0,0,0,7
1345893,959489,2020-05-19,Senate,"Do pass, but first be re-referred to the Committee on [Appropriations] with the recommendation: To Consent Calendar",7,0,2,0,9
1345893,965649,2020-06-11,Senate,"Consent Calendar SB1231",39,0,1,0,40
1345893,974832,2020-08-04,Assembly,"Do pass and be re-referred to the Committee on [Appropriations] with recommendation: To Consent Calendar",14,0,0,0,14
1345893,975525,2020-08-11,Assembly,"Do pass. To Consent Calendar",17,0,0,0,17
1345893,977864,2020-08-30,Assembly,"SB 1231 Monning Consent Calendar Second Day Regular Session",75,0,4,0,79
1345894,959821,2020-05-19,Senate,"Do pass as amended, but first amend, and re-refer to the Committee on [Appropriations]",6,0,1,0,7
1345894,964373,2020-06-09,Senate,"Placed on suspense file",7,0,0,0,7
1345894,967504,2020-06-18,Senate,"Do pass as amended",7,0,0,0,7
1345894,969774,2020-06-25,Senate,"Senate 3rd Reading SB1232",40,0,0,0,40
1345894,974750,2020-08-03,Assembly,"Do pass and be re-referred to the Committee on [Appropriations]",6,0,2,0,8
1345894,976076,2020-08-18,Assembly,"Do pass as amended. To Consent Calendar",18,0,0,0,18
1345894,977902,2020-08-30,Senate,"Unfinished Business SB1232 Glazer et al. Concurrence",39,0,1,0,40
1345894,977903,2020-08-30,Assembly,"SB 1232 Glazer Consent Calendar Second Day Regular Session",75,0,4,0,79
1345899,959325,2020-05-18,Senate,"Do pass as amended, but first amend, and re-refer to the Committee on [Appropriations]",8,0,1,0,9
1345899,964412,2020-06-09,Senate,"Placed on suspense file",7,0,0,0,7
1345899,967388,2020-06-18,Senate,"Do pass as amended",6,0,1,0,7
1345899,969422,2020-06-26,Senate,"Senate 3rd Reading SB1237 Dodd et al",35,1,4,0,40
1345899,975319,2020-08-10,Assembly,"Do pass and be re-referred to the Committee on [Appropriations]",16,1,2,0,19
1345899,976100,2020-08-10,Assembly,"Do pass as amended and be re-referred to the Committee on [Appropriations]",16,1,2,0,19
1345899,976341,2020-08-20,Assembly,"Do pass as amended",15,1,2,0,18
1345899,977819,2020-08-31,Senate,"Unfinished Business SB1237 Dodd et al. Concurrence",31,3,6,0,40
1345899,977820,2020-08-31,Assembly,"SB 1237 Dodd Senate Third Reading By Burke",68,0,11,0,79
1345900,961693,2020-05-29,Senate,"Do pass, but first be re-referred to the Committee on [Appropriations] with the recommendation: To Consent Calendar",13,0,2,0,15
1345900,964387,2020-06-09,Senate,"Placed on suspense file",7,0,0,0,7
1345900,967413,2020-06-18,Senate,"Do pass as amended",7,0,0,0,7
1345900,969420,2020-06-26,Senate,"Senate 3rd Reading SB1238 Hueso",37,0,3,0,40
1345906,959299,2020-05-18,Senate,"Do pass, but first be re-referred to the Committee on [Appropriations]",9,0,0,0,9
1345906,965623,2020-06-11,Senate,"Senate 3rd Reading SB1244 Bradford",39,0,1,0,40
1345906,975345,2020-08-10,Assembly,"Do pass. To Consent Calendar",19,0,0,0,19
1345906,976107,2020-08-10,Assembly,"Do pass as amended, and be re-referred to the Committee on [Appropriations] with recommendation: To Consent Calendar",19,0,0,0,19
1345906,977876,2020-08-30,Assembly,"SB 1244 Bradford Senate Third Reading By Bonta",74,0,5,0,79
1345906,977877,2020-08-31,Senate,"Unfinished Business SB1244 Bradford Concurrence Special Consent",39,0,1,0,40
1347192,958778,2020-05-14,Assembly,"Do pass and be re-referred to the Committee on [Appropriations] with recommendation: To Consent Calendar",9,0,0,0,9
1347192,962393,2020-06-02,Assembly,"Do pass. To Consent Calendar",18,0,0,0,18
1347192,963503,2020-06-08,Assembly,"AB 2849 Chau Consent Calendar Second Day Regular Session",76,0,3,0,79
1347193,957449,2020-05-05,Assembly,"Do pass and be re-referred to the Committee on [Appropriations]",5,1,1,0,7
1347193,962755,2020-06-03,Assembly,"Do pass",13,4,1,0,18
1347193,964997,2020-06-10,Assembly,"AB 2850 Low Assembly Third Reading",59,17,3,0,79
1347193,975550,2020-08-11,Senate,"Do pass, but first be re-referred to the Committee on [Appropriations]",3,1,1,0,5
1347193,976011,2020-08-17,Senate,"Placed on suspense file",7,0,0,0,7
1347193,976391,2020-08-20,Senate,"Do pass",5,2,0,0,7
1347193,977327,2020-08-28,Senate,"Assembly 3rd Reading AB2850 Low By Beall",27,11,2,0,40
1347193,978112,2020-08-30,Assembly,"AB 2850 Low Concurrence in Senate Amendments",60,12,7,0,79
1347197,959955,2020-05-21,Assembly,"Do pass and be re-referred to the Committee on [Appropriations] with recommendation: To Consent Calendar",19,0,0,0,19
1347197,962473,2020-06-02,Assembly,"Do pass. To Consent Calendar",18,0,0,0,18
1347197,963569,2020-06-08,Assembly,"AB 2854 B. & P. Consent Calendar Second Day Regular Session",76,0,3,0,79
1347218,958151,2020-05-11,Assembly,"Do pass. To Consent Calendar",10,0,1,0,11
1347218,960467,2020-05-26,Assembly,"AB 2875 Obernolte Consent Calendar Second Day Regular Session",75,0,4,0,79
1347219,959322,2020-05-18,Assembly,"Do pass and be re-referred to the Committee on [Appropriations] with recommendation: To Consent Calendar",15,0,0,0,15
1347219,962726,2020-06-03,Assembly,"Do pass",18,0,0,0,18
1347219,965044,2020-06-10,Assembly,"AB 2876 Waldron Assembly Third Reading",78,0,1,0,79
1347219,974981,2020-08-07,Senate,"Do pass, but first be re-referred to the Committee on [Appropriations]",7,0,0,0,7
1347219,975984,2020-08-17,Senate,"Placed on suspense file",7,0,0,0,7
1347225,958776,2020-05-14,Assembly,"Do pass and be re-referred to the Committee on [Appropriations]",7,0,2,0,9
1347225,962761,2020-06-03,Assembly,"Do pass",15,0,3,0,18
1347225,964978,2020-06-10,Assembly,"AB 2882 Chu Assembly Third Reading",65,4,10,0,79
1347226,957758,2020-05-07,Assembly,"Do pass and be re-referred to the Committee on [Appropriations] with recommendation: To Consent Calendar",8,0,0,0,8
1347226,962732,2020-06-03,Assembly,"Do pass",18,0,0,0,18
1347226,965060,2020-06-10,Assembly,"AB 2883 Quirk-Silva Assembly Third Reading",78,0,1,0,79
1347227,958578,2020-05-13,Assembly,"Do pass as amended and be re-referred to the Committee on [Appropriations]",10,1,1,0,12
1347227,962448,2020-06-02,Assembly,"Do pass",15,0,3,0,18
1347227,965004,2020-06-10,Assembly,"AB 2884 Berman Assembly Third Reading",71,1,7,0,79
1347227,975942,2020-08-14,Senate,"Do pass, but first be re-referred to the Committee on [Appropriations]",12,2,2,0,16
1347227,976165,2020-08-19,Senate,"Placed on suspense file",7,0,0,0,7
1347227,976459,2020-08-20,Senate,"Do pass",5,2,0,0,7
1347227,977329,2020-08-28,Senate,"Assembly 3rd Reading AB2884 Berman By Allen Urgency Clause",32,7,1,0,40
1347227,978054,2020-08-30,Assembly,"AB 2884 Berman Concurrence - Urgency Added",70,1,8,0,79
1347234,959754,2020-05-19,Assembly,"Do pass and be re-referred to the Committee on [Appropriations] with recommendation: To Consent Calendar",8,0,0,0,8
1347234,962861,2020-06-03,Assembly,"Do pass as amended",17,0,1,0,18
1347234,966494,2020-06-15,Assembly,"AB 2891 Jones-Sawyer Assembly Third Reading",77,1,1,0,79
1347234,974987,2020-08-07,Senate,"Do pass, but first be re-referred to the Committee on [Appropriations]",4,3,0,0,7
1347234,975999,2020-08-17,Senate,"Placed on suspense file",7,0,0,0,7
1347238,960251,2020-05-20,Assembly,"Do pass as amended",5,2,1,0,8
1347238,965058,2020-06-10,Assembly,"AB 2895 Quirk-Silva Assembly Third Reading",50,18,11,0,79
1347263,958787,2020-05-14,Assembly,"Do pass and be re-referred to the Committee on [Appropriations] with recommendation: To Consent Calendar",9,0,0,0,9
1347263,962457,2020-06-02,Assembly,"Do pass. To Consent Calendar",18,0,0,0,18
1347263,963500,2020-06-08,Assembly,"AB 2920 Obernolte Consent Calendar Second Day Regular Session",76,0,3,0,79
1347263,975530,2020-08-11,Senate,"Do pass, but first be re-referred to the Committee on [Appropriations] with the recommendation: To Consent Calendar",5,0,2,0,7
1347263,976020,2020-08-17,Senate,"Placed on suspense file",7,0,0,0,7
1347263,976326,2020-08-20,Senate,"Do pass",7,0,0,0,7
1347263,977326,2020-08-28,Senate,"Special Consent AB2920",39,0,1,0,40
1347263,978013,2020-08-30,Assembly,"AB 2920 Obernolte Concurrence in Senate Amendments",75,0,4,0,79
1347264,959486,2020-05-19,Assembly,"Do pass",11,0,1,0,12
1347264,963626,2020-06-08,Assembly,"AB 2921 Mark Stone Assembly Third Reading",76,0,3,0,79
1347269,957788,2020-05-07,Assembly,"Do pass and be re-referred to the Committee on [Appropriations]",8,0,0,0,8
1347269,962440,2020-06-02,Assembly,"Do pass",18,0,0,0,18
1347269,963579,2020-06-08,Assembly,"AB 2926 Calderon Assembly Third Reading",77,0,2,0,79
1347269,975321,2020-08-10,Senate,"Do pass as amended, but first amend, and re-refer to the Committee on [Appropriations]",7,0,0,0,7
1347269,976155,2020-08-19,Senate,"Placed on suspense file",7,0,0,0,7
1347275,958303,2020-05-12,Assembly,"Do pass",8,0,0,0,8
1347275,966483,2020-06-15,Assembly,"AB 2932 O'Donnell Third Reading Urgency",79,0,0,0,79
1347275,974262,2020-07-29,Senate,"Do pass and be ordered to the Consent Calendar",7,0,0,0,7
1347275,977350,2020-08-28,Senate,"Consent Calendar AB2932 O'Donnell Urgency Clause",39,0,1,0,40
1347279,958136,2020-05-11,Assembly,"Do pass and be re-referred to the Committee on [Appropriations]",9,2,0,0,11
1347279,962795,2020-06-03,Assembly,"Do pass",13,5,0,0,18
1347279,964995,2020-06-10,Assembly,"AB 2936 Wicks Assembly Third Reading",45,20,14,0,79
1347287,957757,2020-05-07,Assembly,"Do pass and be re-referred to the Committee on [Appropriations] with recommendation: To Consent Calendar",8,0,0,0,8
1347287,962413,2020-06-02,Assembly,"Do pass. To Consent Calendar",18,0,0,0,18
1347287,963599,2020-06-08,Assembly,"AB 2944 Mark Stone Consent Calendar Second Day Regular Session",76,0,3,0,79
1347287,975322,2020-08-10,Senate,"Do pass as amended, but first amend, and re-refer to the Committee on [Appropriations] with the recommendation: To Consent Calendar",7,0,0,0,7
1347287,977312,2020-08-28,Senate,"Consent Calendar AB2944 Mark Stone Urgency Clause",39,0,1,0,40
1347287,977726,2020-08-30,Assembly,"AB 2944 Mark Stone Concurrence - Urgency Added",75,0,4,0,79
1347297,958543,2020-05-13,Assembly,"Do pass and be re-referred to the Committee on [Appropriations]",7,3,1,0,11
1347297,962373,2020-06-02,Assembly,"Do pass",12,5,1,0,18
1347297,963613,2020-06-08,Assembly,"AB 2954 Robert Rivas Assembly Third Reading",43,23,13,0,79
1347297,975940,2020-08-14,Senate,"Do pass, but first be re-referred to the Committee on [Appropriations]",4,2,1,0,7
1347297,976164,2020-08-19,Senate,"Placed on suspense file",7,0,0,0,7
1347300,958548,2020-05-12,Assembly,"Do pass and be re-referred to the Committee on [Appropriations]",19,0,2,0,21
1347300,962472,2020-06-02,Assembly,"Do pass",18,0,0,0,18
1347300,963532,2020-06-08,Assembly,"AB 2957 Robert Rivas Assembly Third Reading",77,0,2,0,79
1347302,958521,2020-05-13,Assembly,"Do pass",7,2,2,0,11
1347302,963618,2020-06-08,Assembly,"AB 2959 Calderon Assembly Third Reading",47,16,16,0,79
1347303,960236,2020-05-20,Assembly,"Do pass as amended and be re-referred to the Committee on [Appropriations]",8,0,0,0,8
1347303,962818,2020-06-03,Assembly,"Do pass",18,0,0,0,18
1347303,965617,2020-06-11,Assembly,"AB 2960 Gipson Assembly Third Reading",78,0,1,0,79
1347303,974974,2020-08-06,Senate,"Do pass, but first be re-referred to the Committee on [Appropriations] with the recommendation: To Consent Calendar",11,0,0,0,11
1347303,977172,2020-08-27,Senate,"Assembly 3rd Reading AB2960 Gipson et al. By Caballero",30,0,10,0,40
1347303,978014,2020-08-30,Assembly,"AB 2960 Gipson Concurrence in Senate Amendments",74,0,5,0,79
1347310,957440,2020-05-05,Assembly,"Do pass and be re-referred to the Committee on [Appropriations] with recommendation: To Consent Calendar",7,0,0,0,7
1347310,962367,2020-06-02,Assembly,"Do pass. To Consent Calendar",18,0,0,0,18
1347310,963609,2020-06-08,Assembly,"AB 2967 O'Donnell Consent Calendar Second Day Regular Session",76,0,3,0,79
1347310,975512,2020-08-11,Senate,"Do pass, but first be re-referred to the Committee on [Appropriations]",4,1,0,0,5
1347310,976625,2020-08-24,Senate,"Assembly 3rd Reading AB2967 O'Donnell et al. By Pan",30,6,4,0,40
1347310,977452,2020-08-30,Assembly,"With recommendation: That Senate amendments be concurred in",5,1,1,0,7
1347310,978193,2020-08-30,Assembly,"AB 2967 O'Donnell Concurrence in Senate Amendments",61,7,11,0,79
1347311,958525,2020-05-12,Assembly,"Do pass and be re-referred to the Committee on [Appropriations] with recommendation: To Consent Calendar",20,0,1,0,21
1347311,962856,2020-06-03,Assembly,"Do pass",18,0,0,0,18
1347311,964989,2020-06-10,Assembly,"AB 2968 Rodriguez Assembly Third Reading",78,0,1,0,79
1347311,975953,2020-08-14,Senate,"Do pass, but first be re-referred to the Committee on [Appropriations] with the recommendation: To Consent Calendar",16,0,0,0,16
1347311,977391,2020-08-28,Senate,"Consent Calendar AB2968",39,0,1,0,40
1347315,958574,2020-05-13,Assembly,"Do pass and be re-referred to the Committee on [Appropriations]",9,1,2,0,12
1347315,962460,2020-06-02,Assembly,"Do pass",13,4,1,0,18
1347315,963619,2020-06-08,Assembly,"AB 2972 Limón Assembly Third Reading",59,12,8,0,79
1347316,958143,2020-05-11,Assembly,"Do pass and be re-referred to the Committee on [Appropriations]",8,3,0,0,11
1347326,959960,2020-05-21,Assembly,"Do pass and be re-referred to the Committee on [Appropriations]",10,4,5,0,19
1347326,962477,2020-06-02,Assembly,"Do pass",11,6,1,0,18
1347326,967383,2020-06-18,Assembly,"AB 2983 Holden Assembly Third Reading",48,17,14,0,79
1347332,959314,2020-05-18,Assembly,"Do pass and be re-referred to the Committee on [Appropriations]",11,0,0,0,11
1347332,962866,2020-06-03,Assembly,"Do pass as amended",18,0,0,0,18
1347332,965021,2020-06-10,Assembly,"AB 2989 Arambula Assembly Third Reading",78,0,1,0,79
1347333,957763,2020-05-06,Assembly,"Do pass as amended and be re-referred to the Committee on [Appropriations]",5,2,0,0,7
1347333,962802,2020-06-03,Assembly,"Do pass as amended",12,5,1,0,18
1347333,963526,2020-06-08,Assembly,"AB 2990 Cristina Garcia Assembly Third Reading",27,21,31,0,79
1347334,958535,2020-05-13,Assembly,"Do pass as amended and be re-referred to the Committee on [Appropriations]",7,2,2,0,11
1347335,959772,2020-05-20,Assembly,"Do pass and be re-referred to the Committee on [Appropriations]",7,0,0,0,7
1347335,962730,2020-06-03,Assembly,"Do pass",17,0,1,0,18
1347335,965668,2020-06-11,Assembly,"AB 2992 Weber Assembly Third Reading",77,0,2,0,79
1347335,975517,2020-08-11,Senate,"Do pass, but first be re-referred to the Committee on [Appropriations]",4,1,0,0,5
1347335,976032,2020-08-17,Senate,"Placed on suspense file",7,0,0,0,7
1347335,976435,2020-08-20,Senate,"Do pass as amended",5,1,1,0,7
1347335,977432,2020-08-29,Senate,"Assembly 3rd Reading AB2992 Weber et al. By Bradford",34,3,3,0,40
1347335,977979,2020-08-30,Assembly,"AB 2992 Weber Concurrence in Senate Amendments",75,0,4,0,79
1347342,959785,2020-05-20,Assembly,"Do pass and be re-referred to the Committee on [Appropriations]",5,1,1,0,7
1347342,962754,2020-06-03,Assembly,"Do pass",13,4,1,0,18
1347342,965009,2020-06-10,Assembly,"AB 2999 Low Assembly Third Reading",45,13,21,0,79
1347348,958766,2020-05-14,Assembly,"Do pass and be re-referred to the Committee on [Appropriations]",14,0,0,0,14
1347348,962443,2020-06-02,Assembly,"Do pass as amended",18,0,0,0,18
1347348,965082,2020-06-10,Assembly,"AB 3005 Robert Rivas Third Reading Urgency",78,0,1,0,79
1347348,975657,2020-08-12,Senate,"Do pass as amended, but first amend, and re-refer to the Committee on [Appropriations]",8,0,1,0,9
1347348,976175,2020-08-19,Senate,"Placed on suspense file",7,0,0,0,7
1347348,976312,2020-08-20,Senate,"Do pass",7,0,0,0,7
1347348,977737,2020-08-30,Senate,"Assembly 3rd Reading AB3005 Robert Rivas et al. By Monning Urgency Clause",39,0,1,0,40
1347348,977738,2020-08-31,Assembly,"AB 3005 Robert Rivas Concurrence - Urgency Added",75,1,3,0,79
1347350,957439,2020-05-05,Assembly,"Do pass as amended and be re-referred to the Committee on [Appropriations]",10,2,1,0,13
1347355,957775,2020-05-07,Assembly,"Do pass as amended",13,0,1,0,14
1347355,965068,2020-06-10,Assembly,"AB 3012 Wood Assembly Third Reading",72,0,7,0,79
1347355,974807,2020-08-04,Senate,"Do pass as amended",12,0,1,0,13
1347355,977164,2020-08-27,Senate,"Assembly 3rd Reading AB3012 Wood et al. By Dodd",30,0,10,0,40
1347355,978050,2020-08-30,Assembly,"AB 3012 Wood Concurrence in Senate Amendments",71,0,8,0,79
1347359,959943,2020-05-21,Assembly,"Do pass and be re-referred to the Committee on [Appropriations]",19,0,0,0,19
1347359,962867,2020-06-03,Assembly,"Do pass",17,0,1,0,18
1347359,965081,2020-06-10,Assembly,"AB 3016 Megan Dahle Assembly Third Reading",64,0,15,0,79
1347363,960898,2020-05-27,Assembly,"Do pass",7,3,1,0,11
1347363,963542,2020-06-08,Assembly,"AB 3020 Gloria Assembly Third Reading",57,17,5,0,79
1347363,974483,2020-07-30,Senate,"Do pass",7,1,1,0,9
1347363,976631,2020-08-24,Senate,"Assembly 3rd Reading AB3020 Gloria et al. By Hueso",29,11,0,0,40
1347365,958800,2020-05-14,Assembly,"Do pass and be re-referred to the Committee on [Appropriations] with recommendation: To Consent Calendar",14,0,0,0,14
1347373,958513,2020-05-13,Assembly,"Do pass and be re-referred to the Committee on [Appropriations]",8,3,0,0,11
1347373,962782,2020-06-03,Assembly,"Do pass as amended",13,5,0,0,18
1347373,963612,2020-06-08,Assembly,"AB 3030 Kalra Assembly Third Reading",45,19,15,0,79
1347373,975644,2020-08-12,Senate,"Do pass as amended, but first amend, and re-refer to the Committee on [Appropriations]",6,2,1,0,9
1347373,976177,2020-08-19,Senate,"Placed on suspense file",7,0,0,0,7
1347378,959764,2020-05-19,Assembly,"Do pass",7,0,1,0,8
1347378,963632,2020-06-08,Assembly,"AB 3035 Patterson Assembly Third Reading",71,1,7,0,79
1347382,958802,2020-05-14,Assembly,"Do pass and be re-referred to the Committee on [Appropriations]",9,0,0,0,9
1347382,962437,2020-06-02,Assembly,"Do pass",18,0,0,0,18
1347382,965079,2020-06-10,Assembly,"AB 3039 Quirk Assembly Third Reading By MURATSUCHI",78,0,1,0,79
1347383,960232,2020-05-20,Assembly,"Do pass and be re-referred to the Committee on [Appropriations]",7,0,1,0,8
1347383,962817,2020-06-03,Assembly,"Do pass",18,0,0,0,18
1347383,965034,2020-06-10,Assembly,"AB 3040 Chiu Assembly Third Reading",71,4,4,0,79
1347383,974970,2020-08-06,Senate,"Do pass, but first be re-referred to the Committee on [Appropriations]",9,2,0,0,11
1347383,975838,2020-08-13,Senate,"Placed on suspense file",7,0,0,0,7
1347386,959727,2020-05-19,Assembly,"Do pass and be re-referred to the Committee on [Appropriations] with recommendation: To Consent Calendar",8,0,0,0,8
1347386,962381,2020-06-02,Assembly,"Do pass. To Consent Calendar",18,0,0,0,18
1347386,963588,2020-06-08,Assembly,"AB 3043 Jones-Sawyer Consent Calendar Second Day Regular Session",76,0,3,0,79
1347386,974611,2020-07-31,Senate,"Do pass, but first be re-referred to the Committee on [Appropriations] with the recommendation: To Consent Calendar",7,0,0,0,7
1347386,975836,2020-08-13,Senate,"Placed on suspense file",7,0,0,0,7
1347386,976305,2020-08-20,Senate,"Do pass",7,0,0,0,7
1347386,977358,2020-08-28,Senate,"Special Consent AB3043",39,0,1,0,40
1347386,978012,2020-08-30,Assembly,"AB 3043 Jones-Sawyer Concurrence in Senate Amendments",75,0,4,0,79
1347388,959973,2020-05-21,Assembly,"Do pass and be re-referred to the Committee on [Appropriations]",19,0,0,0,19
1347388,962796,2020-06-03,Assembly,"Do pass",18,0,0,0,18
1347388,965002,2020-06-10,Assembly,"AB 3045 Gray Assembly Third Reading",77,0,2,0,79
1347395,959756,2020-05-19,Assembly,"Do pass and be re-referred to the Committee on [Appropriations]",8,0,0,0,8
1347396,959740,2020-05-20,Assembly,"Do pass and be re-referred to the Committee on [Appropriations] with recommendation: To Consent Calendar",7,0,0,0,7
1347396,962840,2020-06-03,Assembly,"Do pass as amended",18,0,0,0,18
1347396,964979,2020-06-10,Assembly,"AB 3053 Daly Assembly Third Reading",76,0,3,0,79
1347396,974881,2020-08-05,Senate,"Do pass, but first be re-referred to the Committee on [Appropriations] with the recommendation: To Consent Calendar",5,0,0,0,5
1347396,975785,2020-08-13,Senate,"Placed on suspense file",7,0,0,0,7
1347396,976387,2020-08-20,Senate,"Do pass",7,0,0,0,7
1347396,977281,2020-08-28,Senate,"Special Consent AB3053",39,0,1,0,40
1347399,959768,2020-05-20,Assembly,"Do pass and be re-referred to the Committee on [Appropriations]",6,1,0,0,7
1347399,962773,2020-06-03,Assembly,"Do pass",14,4,0,0,18
1347399,966451,2020-06-15,Assembly,"AB 3056 Gonzalez Assembly Third Reading",52,20,7,0,79
1347399,974891,2020-08-05,Senate,"Do pass, but first be re-referred to the Committee on [Appropriations]",4,1,0,0,5
1347399,975765,2020-08-13,Senate,"Placed on suspense file",7,0,0,0,7
1347399,976497,2020-08-20,Senate,"Do pass as amended",5,2,0,0,7
1347405,958132,2020-05-11,Assembly,"Do pass as amended, and be re-referred to the Committee on [Appropriations] with recommendation: To Consent Calendar",10,0,1,0,11
1347405,962446,2020-06-02,Assembly,"Do pass. To Consent Calendar",18,0,0,0,18
1347405,963625,2020-06-08,Assembly,"AB 3062 Obernolte Consent Calendar Second Day Regular Session",76,0,3,0,79
1347412,957438,2020-05-05,Assembly,"Do pass and be re-referred to the Committee on [Appropriations]",7,0,0,0,7
1347413,958128,2020-05-11,Assembly,"Do pass and be re-referred to the Committee on [Appropriations]",8,3,0,0,11
1347413,962458,2020-06-02,Assembly,"Do pass",13,5,0,0,18
1347413,965657,2020-06-11,Assembly,"AB 3070 Weber Assembly Third Reading",53,16,10,0,79
1347413,974989,2020-08-07,Senate,"Do pass as amended, but first amend, and re-refer to the Committee on [Appropriations]",4,3,0,0,7
1347413,976173,2020-08-19,Senate,"Placed on suspense file",7,0,0,0,7
1347413,976503,2020-08-20,Senate,"Do pass as amended",5,2,0,0,7
1347413,977777,2020-08-30,Senate,"Assembly 3rd Reading AB3070 Weber et al. By Wiener",18,11,11,0,40
1347413,977778,2020-08-30,Senate,"Assembly 3rd Reading AB3070 Weber et al. By Wiener Reconsider",39,0,1,0,40
1347413,977779,2020-08-31,Senate,"Assembly 3rd Reading AB3070 Weber et al. By Wiener",21,16,3,0,40
1347413,977780,2020-08-31,Assembly,"AB 3070 WEBER Concurrence in Senate Amendments",49,17,13,0,79
1347416,957778,2020-05-07,Assembly,"Do pass and be re-referred to the Committee on [Appropriations] with recommendation: To Consent Calendar",8,0,0,0,8
1347416,962368,2020-06-02,Assembly,"Do pass. To Consent Calendar",18,0,0,0,18
1347416,963576,2020-06-08,Assembly,"AB 3073 Wicks Consent Calendar Second Day Regular Session",76,0,3,0,79
1347416,975351,2020-08-10,Senate,"Do pass, but first be re-referred to the Committee on [Appropriations] with the recommendation: To Consent Calendar",7,0,0,0,7
1347416,977283,2020-08-28,Senate,"Consent Calendar AB3073",39,0,1,0,40
1347416,978141,2020-08-30,Assembly,"AB 3073 Wicks Concurrence in Senate Amendments",75,0,4,0,79
1347417,958551,2020-05-13,Assembly,"Do pass and be re-referred to the Committee on [Appropriations]",9,0,2,0,11
1347417,962804,2020-06-03,Assembly,"Do pass",14,0,4,0,18
1347417,965075,2020-06-10,Assembly,"AB 3074 Friedman Assembly Third Reading",73,0,6,0,79
1347417,975662,2020-08-12,Senate,"Do pass, but first be re-referred to the Committee on [Appropriations]",9,0,0,0,9
1347417,975997,2020-08-17,Senate,"Placed on suspense file",7,0,0,0,7
1347417,976353,2020-08-20,Senate,"Do pass as amended",6,0,1,0,7
1347417,977823,2020-08-30,Senate,"Assembly 3rd Reading AB3074 Friedman et al. By Jackson",37,0,3,0,40
1347417,977824,2020-08-31,Assembly,"AB 3074 Friedman Concurrence in Senate Amendments",72,0,7,0,79
1347418,959483,2020-05-19,Assembly,"Do pass and be re-referred to the Committee on [Appropriations]",9,3,0,0,12
1347418,962788,2020-06-03,Assembly,"Do pass",13,5,0,0,18
1347418,966499,2020-06-15,Assembly,"AB 3075 Gonzalez Assembly Third Reading",53,19,7,0,79
1347418,974897,2020-08-05,Senate,"Do pass, but first be re-referred to the Committee on [Appropriations]",4,0,1,0,5
1347418,975842,2020-08-13,Senate,"Placed on suspense file",7,0,0,0,7
1347418,976315,2020-08-20,Senate,"Do pass as amended",5,1,1,0,7
1347418,977751,2020-08-31,Senate,"Assembly 3rd Reading AB3075 Gonzalez et al. By Durazo",28,3,9,0,40
1347418,977752,2020-08-31,Assembly,"AB 3075 Gonzalez Concurrence in Senate Amendments",59,11,9,0,79
1347422,957436,2020-05-05,Assembly,"Do pass and be re-referred to the Committee on [Appropriations]",9,0,4,0,13
1347426,959345,2020-05-18,Assembly,"Do pass as amended and be re-referred to the Committee on [Appropriations]",15,0,0,0,15
1347430,959967,2020-05-21,Assembly,"Do pass and be re-referred to the Committee on [Appropriations] with recommendation: To Consent Calendar",19,0,0,0,19
1347430,962451,2020-06-02,Assembly,"Do pass. To Consent Calendar",18,0,0,0,18
1347430,963510,2020-06-08,Assembly,"AB 3087 Brough Consent Calendar Second Day Regular Session",76,0,3,0,79
1347430,975312,2020-08-08,Senate,"Do pass, but first be re-referred to the Committee on [Appropriations] with the recommendation: To Consent Calendar",9,0,0,0,9
1347430,977319,2020-08-28,Senate,"Consent Calendar AB3087",39,0,1,0,40
1347431,960245,2020-05-20,Assembly,"Do pass",7,0,1,0,8
1347431,963585,2020-06-08,Assembly,"AB 3088 Chiu Assembly Third Reading",70,0,9,0,79
1347431,974485,2020-07-30,Senate,"Do pass as amended, and be ordered to the Consent Calendar",9,0,0,0,9
1347431,977429,2020-08-29,Senate,"Do pass, but first be re-referred to the Committee on [Appropriations]",7,0,2,0,9
1347431,977485,2020-08-31,Assembly,"With recommendation: That Senate amendments be concurred in",6,0,2,0,8
1347431,978145,2020-08-31,Senate,"Assembly 3rd Reading AB3088 Chiu et al. By Caballero Urgency Clause",33,2,5,0,40
1347431,978146,2020-08-31,Assembly,"AB 3088 CHIU Concurrence - Urgency Added",61,8,10,0,79
1347435,958130,2020-05-11,Assembly,"Do pass and be re-referred to the Committee on [Appropriations]",10,0,1,0,11
1347435,962846,2020-06-03,Assembly,"Do pass",15,0,3,0,18
1347435,965046,2020-06-10,Assembly,"AB 3092 Wicks Assembly Third Reading",70,1,8,0,79
1347435,975758,2020-08-13,Senate,"Do pass, but first be re-referred to the Committee on [Appropriations]",8,0,1,0,9
1347435,976170,2020-08-19,Senate,"Placed on suspense file",7,0,0,0,7
1347435,976399,2020-08-20,Senate,"Do pass",5,0,2,0,7
1347435,977351,2020-08-28,Senate,"Assembly 3rd Reading AB3092 Wicks et al. By Monning",38,0,2,0,40
1347435,978206,2020-08-30,Assembly,"AB 3092 Wicks Concurrence in Senate Amendments By CHAU",70,0,9,0,79
1347439,957447,2020-05-05,Assembly,"Do pass and be re-referred to the Committee on [Appropriations]",5,2,0,0,7
1347439,962786,2020-06-03,Assembly,"Do pass",11,5,2,0,18
1347439,965041,2020-06-10,Assembly,"AB 3096 Chiu Assembly Third Reading",60,15,4,0,79
1347440,957783,2020-05-06,Assembly,"Do pass and be re-referred to the Committee on [Appropriations] with recommendation: To Consent Calendar",7,0,0,0,7
1347440,962450,2020-06-02,Assembly,"Do pass. To Consent Calendar",18,0,0,0,18
1347440,963529,2020-06-08,Assembly,"AB 3097 Frazier Consent Calendar Second Day Regular Session",76,0,3,0,79
1347442,959729,2020-05-19,Assembly,"Do pass and be re-referred to the Committee on [Appropriations] with recommendation: To Consent Calendar",8,0,0,0,8
1347442,962785,2020-06-03,Assembly,"Do pass",18,0,0,0,18
1347442,965064,2020-06-10,Assembly,"AB 3099 Ramos Assembly Third Reading",77,0,2,0,79
1347442,974624,2020-07-31,Senate,"Do pass, but first be re-referred to the Committee on [Appropriations] with the recommendation: To Consent Calendar",7,0,0,0,7
1347442,975804,2020-08-13,Senate,"Placed on suspense file",7,0,0,0,7
1347442,976379,2020-08-20,Senate,"Do pass",7,0,0,0,7
1347442,977385,2020-08-28,Senate,"Special Consent AB3099",39,0,1,0,40
1347442,978179,2020-08-30,Assembly,"AB 3099 Ramos Concurrence in Senate Amendments",75,0,4,0,79
1347444,958328,2020-05-12,Assembly,"Do pass and be re-referred to the Committee on [Appropriations]",7,0,0,0,7
1347445,958510,2020-05-12,Assembly,"Do pass and be re-referred to the Committee on [Appropriations] with recommendation: To Consent Calendar",20,0,1,0,21
1347450,960240,2020-05-20,Assembly,"Do pass and be re-referred to the Committee on [Appropriations]",5,2,1,0,8
1347450,962874,2020-06-03,Assembly,"Do pass",12,4,2,0,18
1347450,965065,2020-06-10,Assembly,"AB 3107 Bloom Assembly Third Reading",52,14,13,0,79
1347459,957599,2020-05-05,Assembly,"Do pass as amended and be re-referred to the Committee on [Appropriations]",9,1,1,0,11
1347461,959301,2020-05-18,Assembly,"Do pass and be re-referred to the Committee on [Appropriations]",15,0,0,0,15
1347464,958127,2020-05-11,Assembly,"Do pass and be re-referred to the Committee on [Appropriations]",8,3,0,0,11
1347464,962744,2020-06-03,Assembly,"Do pass",13,4,1,0,18
1347464,965563,2020-06-11,Assembly,"AB 3121 Weber Assembly Third Reading",61,12,6,0,79
1347464,974472,2020-07-30,Senate,"Do pass, but first be re-referred to the Committee on [Appropriations]",7,1,1,0,9
1347464,975797,2020-08-13,Senate,"Placed on suspense file",7,0,0,0,7
1347464,976487,2020-08-20,Senate,"Do pass as amended",5,1,1,0,7
1347464,977421,2020-08-29,Senate,"Assembly 3rd Reading AB3121 Weber et al. By Mitchell",33,3,4,0,40
1347464,978111,2020-08-30,Assembly,"AB 3121 Weber Concurrence in Senate Amendments",58,12,9,0,79
1347476,960896,2020-05-27,Assembly,"Do pass",10,0,1,0,11
1347476,963620,2020-06-08,Assembly,"AB 3133 Aguiar-Curry Assembly Third Reading",74,0,5,0,79
1347476,974476,2020-07-30,Senate,"Do pass",8,0,1,0,9
1347476,976639,2020-08-24,Senate,"Assembly 3rd Reading AB3133 Aguiar-Curry et al. By Durazo",34,0,6,0,40
1347477,957777,2020-05-07,Assembly,"Do pass and be re-referred to the Committee on [Appropriations]",8,0,0,0,8
1347477,962794,2020-06-03,Assembly,"Do pass as amended",16,0,2,0,18
1347477,964983,2020-06-10,Assembly,"AB 3134 Reyes Assembly Third Reading",72,0,7,0,79
1347477,975355,2020-08-10,Senate,"Do pass, but first be re-referred to the Committee on [Appropriations]",5,1,1,0,7
1347477,976046,2020-08-17,Senate,"Placed on suspense file",7,0,0,0,7
1347477,976464,2020-08-20,Senate,"Do pass",5,2,0,0,7
1347480,958577,2020-05-13,Assembly,"Do pass as amended and be re-referred to the Committee on [Appropriations]",12,0,0,0,12
1347480,962478,2020-06-02,Assembly,"Do pass. To Consent Calendar",18,0,0,0,18
1347480,963558,2020-06-08,Assembly,"AB 3137 Voepel Consent Calendar Second Day Regular Session",76,0,3,0,79
1347480,974298,2020-07-29,Senate,"Do pass, but first be re-referred to the Committee on [Appropriations] with the recommendation: To Consent Calendar",7,0,0,0,7
1347480,977304,2020-08-28,Senate,"Consent Calendar AB3137",39,0,1,0,40
1347482,958557,2020-05-12,Assembly,"Do pass and be re-referred to the Committee on [Appropriations] with recommendation: To Consent Calendar",20,0,1,0,21
1347482,962362,2020-06-02,Assembly,"Do pass. To Consent Calendar",18,0,0,0,18
1347482,963594,2020-06-08,Assembly,"AB 3139 Gray Consent Calendar Second Day Regular Session",76,0,3,0,79
1347482,975948,2020-08-14,Senate,"Do pass, but first be re-referred to the Committee on [Appropriations] with the recommendation: To Consent Calendar",16,0,0,0,16
1347482,977166,2020-08-27,Senate,"Assembly 3rd Reading AB3139 Gray et al. By Dodd Urgency Clause",30,0,10,0,40
1347482,977885,2020-08-30,Assembly,"AB 3139 Gray Concurrence - Urgency Added",74,0,5,0,79
1347496,958305,2020-05-12,Assembly,"Do pass as amended and be re-referred to the Committee on [Appropriations]",6,0,2,0,8
1347496,962435,2020-06-02,Assembly,"Do pass",13,4,1,0,18
1347496,963528,2020-06-08,Assembly,"AB 3153 Robert Rivas Assembly Third Reading",57,13,9,0,79
1347498,960246,2020-05-20,Assembly,"Do pass as amended and be re-referred to the Committee on [Appropriations]",5,0,3,0,8
1347504,959957,2020-05-21,Assembly,"Do pass and be re-referred to the Committee on [Appropriations] with recommendation: To Consent Calendar",19,0,0,0,19
1347504,962445,2020-06-02,Assembly,"Do pass. To Consent Calendar",18,0,0,0,18
1347504,963560,2020-06-08,Assembly,"AB 3161 Chen Consent Calendar Second Day Regular Session",76,0,3,0,79
1347506,958563,2020-05-13,Assembly,"Do pass and be re-referred to the Committee on [Appropriations]",7,2,2,0,11
1347506,962408,2020-06-02,Assembly,"Do pass",12,2,4,0,18
1347506,963573,2020-06-08,Assembly,"AB 3163 Salas Assembly Third Reading",52,11,16,0,79
1347506,974764,2020-08-03,Senate,"Do pass, but first be re-referred to the Committee on [Appropriations]",11,1,1,0,13
1347506,975777,2020-08-13,Senate,"Placed on suspense file",7,0,0,0,7
1347506,976351,2020-08-20,Senate,"Do pass",7,0,0,0,7
1347506,977347,2020-08-28,Senate,"Assembly 3rd Reading AB3163 Salas et al. By Hueso",31,7,2,0,40
1347507,958567,2020-05-13,Assembly,"Do pass and be re-referred to the Committee on [Appropriations] with recommendation: To Consent Calendar",11,0,0,0,11
1347507,962828,2020-06-03,Assembly,"Do pass",18,0,0,0,18
1347507,965048,2020-06-10,Assembly,"AB 3164 Friedman Assembly Third Reading",78,0,1,0,79
1347507,974912,2020-08-05,Senate,"Do pass as amended, but first amend, and re-refer to the Committee on [Appropriations] with the recommendation: To Consent Calendar",9,0,0,0,9
1347507,975979,2020-08-17,Senate,"Placed on suspense file",7,0,0,0,7
1347507,976467,2020-08-20,Senate,"Do pass as amended",7,0,0,0,7
1347507,977178,2020-08-27,Senate,"Assembly 3rd Reading AB3164 Friedman et al. By McGuire",30,0,10,0,40
1347507,978022,2020-08-30,Assembly,"AB 3164 Friedman Concurrence in Senate Amendments",75,0,4,0,79
1347508,958534,2020-05-12,Assembly,"Do pass. To Consent Calendar",20,0,1,0,21
1347508,960465,2020-05-26,Assembly,"AB 3165 Gray Consent Calendar Second Day Regular Session",75,0,4,0,79
1347512,958555,2020-05-12,Assembly,"Do pass as amended and be re-referred to the Committee on [Appropriations]",18,0,3,0,21
1347512,962790,2020-06-03,Assembly,"Do pass as amended",18,0,0,0,18
1347512,966445,2020-06-15,Assembly,"AB 3169 Gipson Assembly Third Reading",78,0,1,0,79
1347513,958545,2020-05-12,Assembly,"Do pass and be re-referred to the Committee on [Appropriations] with recommendation: To Consent Calendar",20,0,1,0,21
1347515,958319,2020-05-12,Assembly,"Do pass. To Consent Calendar",8,0,0,0,8
1347515,960442,2020-05-26,Assembly,"AB 3172 Gray Consent Calendar Second Day Regular Session",75,0,4,0,79
1347518,959766,2020-05-20,Assembly,"Do pass and be re-referred to the Committee on [Appropriations] with recommendation: To Consent Calendar",7,0,0,0,7
1347518,962444,2020-06-02,Assembly,"Do pass. To Consent Calendar",18,0,0,0,18
1347518,963571,2020-06-08,Assembly,"AB 3175 Levine Consent Calendar Second Day Regular Session",76,0,3,0,79
1347518,975496,2020-08-11,Senate,"Do pass, but first be re-referred to the Committee on [Appropriations]",4,0,1,0,5
1347518,977162,2020-08-27,Senate,"Assembly 3rd Reading AB3175 Levine By Hill Urgency Clause",30,0,10,0,40
1347518,978198,2020-08-30,Assembly,"AB 3175 Levine Concurrence - Urgency Added",73,0,6,0,79
1347525,960250,2020-05-20,Assembly,"Do pass",5,2,1,0,8
1347525,965594,2020-06-11,Assembly,"AB 3182 Ting Assembly Third Reading",55,17,7,0,79
1347525,974969,2020-08-06,Senate,"Do pass",8,2,1,0,11
1347525,977827,2020-08-30,Senate,"Assembly 3rd Reading AB3182 Ting By Gonzalez",23,9,8,0,40
1347525,977828,2020-08-31,Assembly,"AB 3182 Ting Concurrence in Senate Amendments",54,16,9,0,79
1347548,958318,2020-05-12,Assembly,"Do pass as amended and be re-referred to the Committee on [Appropriations]",7,0,0,0,7
1347548,962746,2020-06-03,Assembly,"Do pass",18,0,0,0,18
1347548,965071,2020-06-10,Assembly,"AB 3205 Salas Assembly Third Reading",78,0,1,0,79
1347548,975344,2020-08-08,Senate,"Do pass, but first be re-referred to the Committee on [Appropriations] with the recommendation: To Consent Calendar",9,0,0,0,9
1347548,975796,2020-08-13,Senate,"Placed on suspense file",7,0,0,0,7
1347556,957328,2020-05-04,Assembly,"Do pass and be re-referred to the Committee on [Appropriations]",15,0,0,0,15
1347557,958566,2020-05-13,Assembly,"Do pass and be re-referred to the Committee on [Appropriations]",8,3,0,0,11
1347557,962772,2020-06-03,Assembly,"Do pass",13,5,0,0,18
1347557,965024,2020-06-10,Assembly,"AB 3214 Limón Assembly Third Reading",41,28,10,0,79
1347557,975649,2020-08-12,Senate,"Do pass as amended, but first amend, and re-refer to the Committee on [Appropriations]",7,2,0,0,9
1347557,977310,2020-08-28,Senate,"Assembly 3rd Reading AB3214 Limón et al. By Hertzberg",26,12,2,0,40
1347557,977814,2020-08-31,Assembly,"AB 3214 Limón Concurrence in Senate Amendments",48,18,13,0,79
1347559,959748,2020-05-20,Assembly,"Do pass and be re-referred to the Committee on [Appropriations]",5,1,1,0,7
1347559,962869,2020-06-03,Assembly,"Do pass as amended",12,4,2,0,18
1347559,967474,2020-06-18,Assembly,"AB 3216 Kalra Assembly Third Reading",44,17,18,0,79
1347559,975519,2020-08-11,Senate,"Do pass, but first be re-referred to the Committee on [Appropriations]",3,2,0,0,5
1347559,976025,2020-08-17,Senate,"Placed on suspense file",7,0,0,0,7
1347559,976367,2020-08-20,Senate,"Do pass as amended",5,2,0,0,7
1347559,977768,2020-08-30,Senate,"Assembly 3rd Reading AB3216 Kalra et al. By Durazo",26,12,2,0,40
1347559,977769,2020-08-31,Assembly,"AB 3216 Kalra Concurrence in Senate Amendments",46,16,17,0,79
1347563,958799,2020-05-14,Assembly,"Do pass and be re-referred to the Committee on [Appropriations] with recommendation: To Consent Calendar",9,0,0,0,9
1347563,962859,2020-06-03,Assembly,"Do pass",18,0,0,0,18
1347563,965043,2020-06-10,Assembly,"AB 3220 E.S. & T.M. Assembly Third Reading By MATHIS",78,0,1,0,79
1347563,975521,2020-08-11,Senate,"Do pass, but first be re-referred to the Committee on [Appropriations] with the recommendation: To Consent Calendar",5,0,2,0,7
1347563,975985,2020-08-17,Senate,"Placed on suspense file",7,0,0,0,7
1347563,976354,2020-08-20,Senate,"Do pass",7,0,0,0,7
1347563,977298,2020-08-28,Senate,"Special Consent AB3220 E.S. & T.M",39,0,1,0,40
1347563,978007,2020-08-30,Assembly,"AB 3220 E.S. & T.M. Concurrence in Senate Amendments By QUIRK",75,0,4,0,79
1347567,959341,2020-05-18,Assembly,"Do pass and be re-referred to the Committee on [Appropriations]",15,0,0,0,15
1347567,962870,2020-06-03,Assembly,"Do pass",18,0,0,0,18
1347567,965015,2020-06-10,Assembly,"AB 3224 Rodriguez Assembly Third Reading",76,0,3,0,79
1347567,975380,2020-08-10,Senate,"Do pass, but first be re-referred to the Committee on [Appropriations]",8,0,1,0,9
1347567,976036,2020-08-17,Senate,"Placed on suspense file",7,0,0,0,7
1347569,958773,2020-05-14,Assembly,"Do pass and be re-referred to the Committee on [Appropriations] with recommendation: To Consent Calendar",14,0,0,0,14
1347569,962851,2020-06-03,Assembly,"Do pass as amended",18,0,0,0,18
1347569,963544,2020-06-08,Assembly,"AB 3226 McCarty Assembly Third Reading",76,0,3,0,79
1347569,974896,2020-08-05,Senate,"Do pass, but first be re-referred to the Committee on [Appropriations] with the recommendation: To Consent Calendar",9,0,0,0,9
1347569,975778,2020-08-13,Senate,"Placed on suspense file",7,0,0,0,7
1347571,959730,2020-05-19,Assembly,"Do pass and be re-referred to the Committee on [Appropriations]",7,1,0,0,8
1347571,962816,2020-06-03,Assembly,"Do pass as amended",14,4,0,0,18
1347571,965018,2020-06-10,Assembly,"AB 3228 Bonta Assembly Third Reading",61,14,4,0,79
1347571,975834,2020-08-13,Senate,"Do pass",7,0,2,0,9
1347571,976622,2020-08-24,Senate,"Assembly 3rd Reading AB3228 Bonta By Durazo",28,9,3,0,40
1347571,976929,2020-08-26,Assembly,"AB 3228 Bonta Concurrence in Senate Amendments",57,13,9,0,79
1347577,958310,2020-05-12,Assembly,"Do pass as amended and be re-referred to the Committee on [Appropriations]",8,0,0,0,8
1347577,962412,2020-06-02,Assembly,"Do pass. To Consent Calendar",18,0,0,0,18
1347577,974749,2020-08-03,Assembly,"AB 3234 GLORIA Remove from Inactive File By TING Amendment Set #1",40,18,21,0,79
1347577,974931,2020-08-05,Assembly,"Do pass as amended",5,3,0,0,8
1347577,976610,2020-08-24,Assembly,"AB 3234 TING Assembly Third Reading",43,26,10,0,79
1347577,977815,2020-08-31,Senate,"Assembly 3rd Reading AB3234 Ting By Mitchell",27,10,3,0,40
1347578,960168,2020-05-21,Assembly,"Do pass and be re-referred to the Committee on [Appropriations]",9,2,8,0,19
1347581,957772,2020-05-07,Assembly,"Do pass as amended, and be re-referred to the Committee on [Appropriations] with recommendation: To Consent Calendar",8,0,0,0,8
1347585,959333,2020-05-18,Assembly,"Do pass as amended, and be re-referred to the Committee on [Appropriations] with recommendation: To Consent Calendar",15,0,0,0,15
1347585,962419,2020-06-02,Assembly,"Do pass. To Consent Calendar",18,0,0,0,18
1347585,963630,2020-06-08,Assembly,"AB 3242 Irwin Consent Calendar Second Day Regular Session",76,0,3,0,79
1347585,974659,2020-08-01,Senate,"Do pass as amended, but first amend, and re-refer to the Committee on [Rules]",8,0,1,0,9
1347585,977786,2020-08-30,Senate,"Assembly 3rd Reading AB3242 Irwin By Rubio",39,0,1,0,40
1347585,977787,2020-08-31,Assembly,"AB 3242 Irwin Concurrence in Senate Amendments",76,0,3,0,79
1347595,958774,2020-05-14,Assembly,"Do pass and be re-referred to the Committee on [Appropriations] with recommendation: To Consent Calendar",14,0,0,0,14
1347597,960909,2020-05-27,Assembly,"Do pass",10,0,1,0,11
1347597,963551,2020-06-08,Assembly,"AB 3254 Limón Assembly Third Reading",75,0,4,0,79
1347597,976102,2020-08-18,Senate,"Do pass and be ordered to the Consent Calendar",9,0,0,0,9
1347597,977354,2020-08-28,Senate,"Assembly 3rd Reading AB3254 Limón By Gonzalez",39,0,1,0,40
1347599,958573,2020-05-13,Assembly,"Do pass as amended and be re-referred to the Committee on [Appropriations]",7,1,3,0,11
1347599,962793,2020-06-03,Assembly,"Do pass as amended and be re-referred to the Committee on [Rules]",13,4,1,0,18
1347603,958146,2020-05-11,Assembly,"Do pass",7,3,1,0,11
1347604,958818,2020-05-14,Assembly,"Do pass and be re-referred to the Committee on [Appropriations] with recommendation: To Consent Calendar",9,0,0,0,9
1347604,962421,2020-06-02,Assembly,"Do pass. To Consent Calendar",18,0,0,0,18
1347604,963525,2020-06-08,Assembly,"AB 3261 E.S. & T.M. Consent Calendar Second Day Regular Session",76,0,3,0,79
1347605,958126,2020-05-11,Assembly,"Do pass",8,3,0,0,11
1347605,965658,2020-06-11,Assembly,"AB 3262 Mark Stone Assembly Third Reading",54,14,11,0,79
1347605,976104,2020-08-18,Senate,"Do pass as amended",7,0,2,0,9
1347610,958568,2020-05-12,Assembly,"Do pass and be re-referred to the Committee on [Appropriations] with recommendation: To Consent Calendar",20,0,1,0,21
1347610,962464,2020-06-02,Assembly,"Do pass. To Consent Calendar",18,0,0,0,18
1347610,963582,2020-06-08,Assembly,"AB 3267 Smith Consent Calendar Second Day Regular Session",76,0,3,0,79
1347610,975947,2020-08-14,Senate,"Do pass, but first be re-referred to the Committee on [Appropriations] with the recommendation: To Consent Calendar",16,0,0,0,16
1347610,977368,2020-08-28,Senate,"Consent Calendar AB3267",39,0,1,0,40
1347612,960234,2020-05-20,Assembly,"Do pass as amended and be re-referred to the Committee on [Appropriations]",6,1,1,0,8
1347612,962741,2020-06-03,Assembly,"Do pass as amended",12,0,6,0,18
1347612,965022,2020-06-10,Assembly,"AB 3269 Chiu Assembly Third Reading",58,10,11,0,79
1347612,974967,2020-08-06,Senate,"Do pass, but first be re-referred to the Committee on [Appropriations]",7,3,1,0,11
1347612,975782,2020-08-13,Senate,"Placed on suspense file",7,0,0,0,7
1347614,960894,2020-05-27,Assembly,"Do pass",10,0,1,0,11
1347614,966438,2020-06-15,Assembly,"AB 3271 Kiley Assembly Third Reading",78,0,1,0,79
1347615,957787,2020-05-07,Assembly,"Do pass and be re-referred to the Committee on [Appropriations] with recommendation: To Consent Calendar",8,0,0,0,8
1347620,957326,2020-05-04,Assembly,"Do pass and be re-referred to the Committee on [Appropriations]",15,0,0,0,15
1347620,962434,2020-06-02,Assembly,"Do pass. To Consent Calendar",18,0,0,0,18
1347620,963548,2020-06-08,Assembly,"AB 3277 Jones-Sawyer Consent Calendar Second Day Regular Session",76,0,3,0,79
1347620,974827,2020-08-04,Senate,"Do pass, but first be re-referred to the Committee on [Appropriations] with the recommendation: To Consent Calendar",14,0,1,0,15
1347620,975755,2020-08-13,Senate,"Do pass",7,0,0,0,7
1347620,976629,2020-08-24,Senate,"Assembly 3rd Reading AB3277 Jones-Sawyer By Allen",40,0,0,0,40
1347620,976918,2020-08-26,Assembly,"AB 3277 Jones-Sawyer Concurrence in Senate Amendments",72,0,7,0,79
1347621,957318,2020-05-04,Assembly,"Do pass and be re-referred to the Committee on [Appropriations]",12,1,2,0,15
1347622,958514,2020-05-13,Assembly,"Do pass and be re-referred to the Committee on [Appropriations]",9,2,0,0,11
1347622,962760,2020-06-03,Assembly,"Do pass as amended",15,1,2,0,18
1347622,963506,2020-06-08,Assembly,"AB 3279 Friedman Assembly Third Reading",64,2,13,0,79
1347622,975511,2020-08-11,Senate,"Do pass, but first be re-referred to the Committee on [Appropriations]",5,0,2,0,7
1347622,976017,2020-08-17,Senate,"Placed on suspense file",7,0,0,0,7
1347643,960247,2020-05-20,Assembly,"Do pass and be re-referred to the Committee on [Appropriations]",6,1,1,0,8
1347643,962749,2020-06-03,Assembly,"Do pass as amended",12,3,3,0,18
1347643,966442,2020-06-15,Assembly,"AB 3300 Santiago Assembly Third Reading",62,2,15,0,79
1347645,957444,2020-05-05,Assembly,"Do pass and be re-referred to the Committee on [Appropriations]",6,1,0,0,7
1347645,962811,2020-06-03,Assembly,"Do pass",17,1,0,0,18
1347645,964999,2020-06-10,Assembly,"AB 3302 Salas Assembly Third Reading",70,4,5,0,79
1347650,958306,2020-05-12,Assembly,"Do pass as amended and be re-referred to the Committee on [Appropriations]",7,0,0,0,7
1347650,962750,2020-06-03,Assembly,"Do pass",18,0,0,0,18
1347650,965091,2020-06-10,Assembly,"AB 3307 Eduardo Garcia Assembly Third Reading",78,0,1,0,79
1347650,975318,2020-08-08,Senate,"Do pass, but first be re-referred to the Committee on [Appropriations] with the recommendation: To Consent Calendar",9,0,0,0,9
1347650,975789,2020-08-13,Senate,"Placed on suspense file",7,0,0,0,7
1347651,960248,2020-05-20,Assembly,"Do pass as amended",8,0,0,0,8
1347651,963519,2020-06-08,Assembly,"AB 3308 Gabriel Assembly Third Reading",71,0,8,0,79
1347651,974973,2020-08-06,Senate,"Do pass",9,2,0,0,11
1347651,977833,2020-08-30,Senate,"Assembly 3rd Reading AB3308 Gabriel et al. By Hertzberg",35,2,3,0,40
1347651,977834,2020-08-31,Assembly,"AB 3308 Gabriel Concurrence in Senate Amendments",73,1,5,0,79
1347655,958329,2020-05-12,Assembly,"Do pass",8,0,0,0,8
1347655,965590,2020-06-11,Assembly,"AB 3312 Gray Assembly Third Reading",78,0,1,0,79
1347655,974288,2020-07-29,Senate,"Do pass as amended",7,0,0,0,7
1347655,976617,2020-08-24,Senate,"Assembly 3rd Reading AB3312 Gray By Galgiani",40,0,0,0,40
1347655,976909,2020-08-26,Assembly,"AB 3312 Gray Concurrence in Senate Amendments",74,0,5,0,79
1347673,959937,2020-05-21,Assembly,"Do pass and be re-referred to the Committee on [Appropriations]",12,0,7,0,19
1347673,962745,2020-06-03,Assembly,"Do pass as amended",11,0,7,0,18
1347673,975361,2020-08-10,Assembly,"Do pass as amended and be re-referred to the Committee on [Appropriations]",10,6,3,0,19
1347673,976081,2020-08-18,Assembly,"Do pass",11,6,1,0,18
1347673,976735,2020-08-25,Assembly,"AB 3330 Calderon Assembly Third Reading",46,19,14,0,79
1347673,977451,2020-08-29,Senate,"Do pass",11,5,2,0,18
1347673,977792,2020-08-31,Senate,"Assembly 3rd Reading AB3330 Calderon By Mitchell",25,10,5,0,40
1347679,959320,2020-05-18,Assembly,"Do pass and be re-referred to the Committee on [Appropriations]",8,4,3,0,15
1347679,962380,2020-06-02,Assembly,"Do pass",11,7,0,0,18
1347679,967417,2020-06-18,Assembly,"AB 3336 Carrillo Assembly Third Reading",41,18,20,0,79
1347679,975360,2020-08-10,Senate,"Do pass as amended, but first amend, and re-refer to the Committee on [Appropriations]",7,1,1,0,9
1347679,977756,2020-08-30,Senate,"Assembly 3rd Reading AB3336 Carrillo By Monning",31,6,3,0,40
1347679,977757,2020-08-31,Assembly,"AB 3336 Carrillo Concurrence in Senate Amendments",58,9,12,0,79
1347695,960238,2020-05-20,Assembly,"Do pass and be re-referred to the Committee on [Appropriations]",6,1,1,0,8
1347695,962829,2020-06-03,Assembly,"Do pass",13,4,1,0,18
1347695,965055,2020-06-10,Assembly,"AB 3352 Friedman Assembly Third Reading",51,20,8,0,79
1347706,938033,2020-02-27,Assembly,"Be adopted. To Consent Calendar",10,0,2,0,12
1347706,944396,2020-03-05,Assembly,"ACR 176 Reyes Consent Calendar Second Day Regular Session",72,0,8,0,80
1347706,967416,2020-06-18,Senate,"Special Consent ACR176",40,0,0,0,40
1347716,958816,2020-05-14,Senate,"Do pass as amended, but first amend, and re-refer to the Committee on [Appropriations] with the recommendation: To Consent Calendar",11,0,2,0,13
1347716,964348,2020-06-09,Senate,"Placed on suspense file",7,0,0,0,7
1347716,967396,2020-06-18,Senate,"Do pass",7,0,0,0,7
1347716,968693,2020-06-24,Senate,"Special Consent SB1255 INS",39,0,1,0,40
1347716,975513,2020-08-11,Assembly,"Do pass and be re-referred to the Committee on [Appropriations] with recommendation: To Consent Calendar",13,0,1,0,14
1347716,976074,2020-08-18,Assembly,"Do pass. To Consent Calendar",18,0,0,0,18
1347716,977896,2020-08-30,Senate,"Unfinished Business SB1255 INS. (Rubio) Concurrence",39,0,1,0,40
1347716,977897,2020-08-30,Assembly,"SB 1255 INS. Consent Calendar Second Day Regular Session",75,0,4,0,79
1347718,958815,2020-05-14,Senate,"Do pass, but first be re-referred to the Committee on [Appropriations]",4,0,1,0,5
1347718,964328,2020-06-09,Senate,"Placed on suspense file",7,0,0,0,7
1347718,967484,2020-06-18,Senate,"Do pass",5,2,0,0,7
1347718,969718,2020-06-25,Senate,"Senate 3rd Reading SB1257 Durazo",27,11,2,0,40
1347718,974263,2020-07-29,Assembly,"Do pass and be re-referred to the Committee on [Appropriations]",7,0,0,0,7
1347718,976409,2020-08-20,Assembly,"Do pass as amended",14,4,0,0,18
1347718,976933,2020-08-26,Assembly,"SB 1257 Durazo Senate Third Reading By RIVAS, L",58,12,9,0,79
1347718,977927,2020-08-30,Senate,"Unfinished Business SB1257 Durazo et al. Concurrence",28,10,2,0,40
1347719,959353,2020-05-18,Senate,"Do pass, but first be re-referred to the Committee on [Appropriations]",9,0,0,0,9
1347719,964360,2020-06-09,Senate,"Placed on suspense file",7,0,0,0,7
1347720,959822,2020-05-19,Senate,"Do pass as amended, but first amend, and re-refer to the Committee on [Appropriations] with the recommendation: To Consent Calendar",7,0,0,0,7
1347720,964356,2020-06-09,Senate,"Placed on suspense file",7,0,0,0,7
1347720,967448,2020-06-18,Senate,"Do pass as amended",7,0,0,0,7
1347720,968703,2020-06-24,Senate,"Special Consent SB1259",39,0,1,0,40
1347720,974747,2020-08-03,Assembly,"Do pass and be re-referred to the Committee on [Appropriations]",6,0,2,0,8
1347725,959823,2020-05-19,Senate,"Do pass as amended, but first amend, and re-refer to the Committee on [Appropriations] with the recommendation: To Consent Calendar",7,0,0,0,7
1347725,964394,2020-06-09,Senate,"Placed on suspense file",7,0,0,0,7
1347725,967489,2020-06-18,Senate,"Do pass as amended",7,0,0,0,7
1347725,969717,2020-06-25,Senate,"Senate 3rd Reading SB1264 HUMAN S",40,0,0,0,40
1347725,974756,2020-08-03,Assembly,"Do pass and be re-referred to the Committee on [Appropriations]",6,0,2,0,8
1347725,976072,2020-08-18,Assembly,"Do pass. To Consent Calendar",18,0,0,0,18
1347725,978009,2020-08-30,Senate,"Unfinished Business SB1264 HUMAN S. (Hurtado) Concurrence",39,0,1,0,40
1347725,978010,2020-08-30,Assembly,"SB 1264 HUM. S. Consent Calendar Second Day Regular Session",75,0,4,0,79
1347732,959334,2020-05-18,Senate,"Do pass as amended, but first amend, and re-refer to the Committee on [Appropriations]",9,0,0,0,9
1347732,964400,2020-06-09,Senate,"Do pass",7,0,0,0,7
1347732,966497,2020-06-15,Senate,"Senate 3rd Reading SB1271 Morrell",40,0,0,0,40
1347737,960892,2020-05-27,Senate,"Do pass, but first be re-referred to the Committee on [Appropriations] with the recommendation: To Consent Calendar",7,0,0,0,7
1347737,965607,2020-06-11,Senate,"Consent Calendar SB1276",39,0,1,0,40
1347737,974928,2020-08-05,Assembly,"Do pass and be re-referred to the Committee on [Appropriations] with recommendation: To Consent Calendar",8,0,0,0,8
1347737,975510,2020-08-11,Assembly,"Do pass. To Consent Calendar",17,0,0,0,17
1347737,977922,2020-08-30,Assembly,"SB 1276 Rubio Consent Calendar Second Day Regular Session",75,0,4,0,79
1347746,958517,2020-05-13,Senate,"Do pass and be ordered to the Consent Calendar",9,0,0,0,9
1347746,965689,2020-06-11,Senate,"Consent Calendar SB1285",39,0,1,0,40
1347751,959776,2020-05-20,Senate,"Do pass, but first be re-referred to the Committee on [Appropriations]",5,1,1,0,7
1347751,965572,2020-06-11,Senate,"Senate 3rd Reading SB1290 Durazo et al",32,2,6,0,40
1347751,974944,2020-08-05,Assembly,"Do pass and be re-referred to the Committee on [Appropriations]",7,1,0,0,8
1347751,976077,2020-08-18,Assembly,"Do pass",14,3,1,0,18
1347751,976613,2020-08-24,Assembly,"SB 1290 Durazo Senate Third Reading By Chiu",64,4,11,0,79
1347752,961697,2020-05-29,Senate,"Do pass, but first be re-referred to the Committee on [Appropriations] with the recommendation: To Consent Calendar",13,0,2,0,15
1347752,965576,2020-06-11,Senate,"Consent Calendar SB1291 TRANS. (Beall) Urgency Clause",39,0,1,0,40
1347752,975372,2020-08-10,Assembly,"Do pass and be re-referred to the Committee on [Appropriations]",15,0,0,0,15
1347752,976098,2020-08-18,Assembly,"Do pass. To Consent Calendar",18,0,0,0,18
1347752,978187,2020-08-30,Assembly,"SB 1291 TRANS. Consent Calendar Second Day Regular Session",75,0,4,0,79
1347757,959481,2020-05-19,Senate,"Do pass as amended, but first amend, and re-refer to the Committee on [Appropriations]",7,0,2,0,9
1347757,964333,2020-06-09,Senate,"Placed on suspense file",7,0,0,0,7
1347760,960439,2020-05-26,Senate,"Do pass, but first be re-referred to the Committee on [Appropriations]",10,0,1,0,11
1347760,964380,2020-06-09,Senate,"Placed on suspense file",7,0,0,0,7
1347760,967418,2020-06-18,Senate,"Do pass as amended",7,0,0,0,7
1347760,968685,2020-06-24,Senate,"Special Consent SB1299",39,0,1,0,40
1347760,974294,2020-07-29,Assembly,"Do pass as amended and be re-referred to the Committee on [Appropriations]",7,0,1,0,8
1347760,976375,2020-08-20,Assembly,"Do pass as amended",13,0,5,0,18
1347761,961336,2020-05-28,Senate,"Do pass, but first be re-referred to the Committee on [Appropriations]",5,0,2,0,7
1347761,964392,2020-06-09,Senate,"Placed on suspense file",7,0,0,0,7
1347762,960449,2020-05-26,Senate,"Do pass, but first be re-referred to the Committee on [Appropriations]",6,0,3,0,9
1347762,964358,2020-06-09,Senate,"Placed on suspense file",7,0,0,0,7
1347762,967389,2020-06-18,Senate,"Do pass as amended",6,0,1,0,7
1347762,969427,2020-06-26,Senate,"Senate 3rd Reading SB1301 Hueso",37,0,3,0,40
1347762,974935,2020-08-06,Assembly,"Do pass as amended and be re-referred to the Committee on [Appropriations]",10,0,1,0,11
1347762,976380,2020-08-20,Assembly,"Do pass as amended",14,0,4,0,18
1347762,976930,2020-08-26,Assembly,"SB 1301 Hueso Senate Third Reading By Gloria",66,1,12,0,79
1347762,977901,2020-08-30,Senate,"Unfinished Business SB1301 Hueso Concurrence",39,0,1,0,40
1347766,960170,2020-05-22,Senate,"Do pass and be ordered to the Consent Calendar",8,0,1,0,9
1347766,965630,2020-06-11,Senate,"Consent Calendar SB1305",39,0,1,0,40
1347766,975656,2020-08-12,Assembly,"Do pass. To Consent Calendar",11,0,0,0,11
1347766,977941,2020-08-30,Assembly,"SB 1305 Roth Consent Calendar Second Day Regular Session",75,0,4,0,79
1347768,958122,2020-05-11,Senate,"Do pass and be ordered to the Consent Calendar",7,0,0,0,7
1347768,965701,2020-06-11,Senate,"Consent Calendar SB1307",39,0,1,0,40
1347768,975507,2020-08-11,Assembly,"Do pass. To Consent Calendar",8,0,0,0,8
1347768,977860,2020-08-30,Assembly,"SB 1307 Rubio Consent Calendar Second Day Regular Session",75,0,4,0,79
1347773,960441,2020-05-26,Senate,"Do pass as amended, but first amend, and re-refer to the Committee on [Appropriations]",9,0,4,0,13
1347773,964343,2020-06-09,Senate,"Placed on suspense file",7,0,0,0,7
1347773,967402,2020-06-18,Senate,"Do pass",4,2,1,0,7
1347773,969760,2020-06-25,Senate,"Senate 3rd Reading SB1312 McGuire et al",30,3,7,0,40
1347780,962857,2020-06-03,Senate,"Do pass, but first be re-referred to the Committee on [Appropriations]",2,3,2,0,7
1347780,962858,2020-06-03,Senate,"[First] hearing set for [06-03-2020]: Failed passage in Committee. Reconsideration granted",6,0,1,0,7
1347781,960433,2020-05-26,Senate,"Do pass, but first be re-referred to the Committee on [Appropriations]",6,1,2,0,9
1347781,964357,2020-06-09,Senate,"Placed on suspense file",7,0,0,0,7
1347781,967506,2020-06-18,Senate,"Do pass as amended",6,1,0,0,7
1347781,969408,2020-06-26,Senate,"Senate 3rd Reading SB1320 Stern",32,7,1,0,40
1347781,974957,2020-08-06,Assembly,"Do pass as amended and be re-referred to the Committee on [Appropriations]",8,2,1,0,11
1347781,976479,2020-08-20,Assembly,"Do pass as amended",13,4,1,0,18
1347781,976912,2020-08-26,Assembly,"SB 1320 Stern Senate Third Reading By Robert Rivas",60,11,8,0,79
1347781,977842,2020-08-30,Senate,"Unfinished Business SB1320 Stern et al. Concurrence",33,5,2,0,40
1347802,959824,2020-05-19,Senate,"Do pass, but first be re-referred to the Committee on [Appropriations]",6,0,1,0,7
1347802,964410,2020-06-09,Senate,"Placed on suspense file",7,0,0,0,7
1347802,967430,2020-06-18,Senate,"Do pass as amended",7,0,0,0,7
1347802,969396,2020-06-26,Senate,"Senate 3rd Reading SB1341 Hurtado",40,0,0,0,40
1347802,974738,2020-08-03,Assembly,"Do pass and be re-referred to the Committee on [Appropriations] with recommendation: To Consent Calendar",6,0,2,0,8
1347802,976434,2020-08-20,Assembly,"Do pass as amended",18,0,0,0,18
1347802,976922,2020-08-26,Assembly,"SB 1341 Hurtado Senate Third Reading By Reyes",71,0,8,0,79
1347802,977414,2020-08-29,Senate,"Unfinished Business SB1341 Hurtado Concurrence",38,0,2,0,40
1347808,959347,2020-05-18,Senate,"Do pass as amended, but first amend, and re-refer to the Committee on [Appropriations]",8,0,1,0,9
1347808,968058,2020-06-22,Senate,"Senate 3rd Reading SB1347 Galgiani et al",40,0,0,0,40
1347808,975316,2020-08-10,Assembly,"Do pass as amended and be re-referred to the Committee on [Appropriations]",13,0,6,0,19
1347808,975665,2020-08-10,Assembly,"Do pass and be re-referred to the Committee on [Appropriations]",9,1,9,0,19
1347809,959472,2020-05-19,Senate,"Do pass, but first be re-referred to the Committee on [Appropriations]",6,1,2,0,9
1347809,964425,2020-06-09,Senate,"Placed on suspense file",7,0,0,0,7
1347809,967468,2020-06-18,Senate,"Do pass as amended",5,2,0,0,7
1347809,969387,2020-06-26,Senate,"Senate 3rd Reading SB1348 Stern",32,5,3,0,40
1347809,974963,2020-08-06,Assembly,"Do pass and be re-referred to the Committee on [Appropriations]",8,0,3,0,11
1347809,976466,2020-08-20,Assembly,"Do pass as amended",13,4,1,0,18
1347810,959966,2020-05-21,Senate,"Do pass",3,2,2,0,7
1347810,961339,2020-05-28,Senate,"[05-28-2020] hearing: Motion to Reconsider. [Reconsideration Granted.]",7,0,0,0,7
1347810,962871,2020-06-03,Senate,"Do pass",4,2,1,0,7
1347810,965662,2020-06-11,Senate,"Senate 3rd Reading SB1349 Glazer",27,11,2,0,40
1347810,975502,2020-08-11,Assembly,"Do pass",5,3,0,0,8
1347810,977925,2020-08-30,Assembly,"SB 1349 Glazer Senate Third Reading By Grayson",48,23,8,0,79
1347810,977926,2020-08-31,Senate,"Unfinished Business SB1349 Glazer Concurrence",29,10,1,0,40
1347812,961688,2020-05-29,Senate,"Do pass, but first be re-referred to the Committee on [Appropriations] with the recommendation: To Consent Calendar",13,0,2,0,15
1347812,965652,2020-06-11,Senate,"Consent Calendar SB1351",39,0,1,0,40
1347812,975346,2020-08-10,Assembly,"Do pass and be re-referred to the Committee on [Appropriations]",11,3,1,0,15
1347812,976419,2020-08-20,Assembly,"Do pass as amended",13,5,0,0,18
1347812,977797,2020-08-31,Senate,"Unfinished Business SB1351 Beall et al. Concurrence",28,10,2,0,40
1347812,977798,2020-08-31,Assembly,"SB 1351 Beall Senate Third Reading By Daly",58,17,4,0,79
1347832,960177,2020-05-22,Senate,"Do pass and be ordered to the Consent Calendar",8,0,1,0,9
1347832,965626,2020-06-11,Senate,"Consent Calendar SB1371 JUD",39,0,1,0,40
1347832,975653,2020-08-12,Assembly,"Do pass. To Consent Calendar",11,0,0,0,11
1347832,977774,2020-08-30,Assembly,"SB 1371 JUD. Consent Calendar Second Day Regular Session",75,0,4,0,79
1347834,961689,2020-05-29,Senate,"Do pass, but first be re-referred to the Committee on [Appropriations]",12,0,3,0,15
1347834,969397,2020-06-26,Senate,"Senate 3rd Reading SB1373 Bates et al",24,6,10,0,40
1347841,960470,2020-05-26,Senate,"Do pass as amended, but first amend, and re-refer to the Committee on [Appropriations]",7,0,2,0,9
1347841,969762,2020-06-25,Senate,"Senate 3rd Reading SB1380",40,0,0,0,40
1347841,974948,2020-08-06,Assembly,"Do pass and be re-referred to the Committee on [Appropriations]",10,0,1,0,11
1347841,976101,2020-08-18,Assembly,"Do pass. To Consent Calendar",18,0,0,0,18
1347841,977727,2020-08-30,Senate,"Unfinished Business SB1380 Allen Concurrence",39,0,1,0,40
1347841,977728,2020-08-30,Assembly,"SB 1380 Allen Consent Calendar Second Day Regular Session",75,0,4,0,79
1347844,958801,2020-05-14,Senate,"Do pass, but first be re-referred to the Committee on [Appropriations]",3,0,2,0,5
1347844,964350,2020-06-09,Senate,"Placed on suspense file",7,0,0,0,7
1347844,967494,2020-06-18,Senate,"Do pass as amended",5,2,0,0,7
1347844,969764,2020-06-24,Senate,"Do pass",10,8,0,0,18
1347844,970415,2020-07-02,Senate,"Senate 3rd Reading SB1383 Jackson et al",21,12,7,0,40
1347844,974260,2020-07-29,Assembly,"Do pass and be re-referred to the Committee on [Appropriations]",5,2,0,0,7
1347844,976335,2020-08-20,Assembly,"Do pass",11,5,2,0,18
1347844,977753,2020-08-31,Assembly,"SB 1383 Jackson Senate Third Reading By Gonzalez",46,16,17,0,79
1347845,958806,2020-05-14,Senate,"Do pass, but first be re-referred to the Committee on [Appropriations]",4,0,1,0,5
1347845,968059,2020-06-22,Senate,"Senate 3rd Reading SB1384 Monning",31,7,2,0,40
1347845,974308,2020-07-29,Assembly,"Do pass and be re-referred to the Committee on [Appropriations]",6,1,0,0,7
1347845,975545,2020-08-11,Assembly,"Do pass",13,4,0,0,17
1347845,976637,2020-08-24,Assembly,"SB 1384 Monning Senate Third Reading By Luz Rivas",61,12,6,0,79
1347846,961335,2020-05-28,Senate,"Do pass, but first be re-referred to the Committee on [Appropriations]",6,0,1,0,7
1347846,964389,2020-06-09,Senate,"Placed on suspense file",7,0,0,0,7
1347846,967431,2020-06-18,Senate,"Do pass as amended",7,0,0,0,7
1347846,968686,2020-06-24,Senate,"Special Consent SB1385",39,0,1,0,40
1347846,975529,2020-08-11,Assembly,"Do pass and be re-referred to the Committee on [Appropriations]",3,2,3,0,8
1347847,959946,2020-05-21,Senate,"Do pass",7,0,0,0,7
1347847,965614,2020-06-11,Senate,"Special Consent SB1386",39,0,1,0,40
1347847,975498,2020-08-11,Assembly,"Do pass. To Consent Calendar",8,0,0,0,8
1347847,977987,2020-08-30,Senate,"Unfinished Business SB1386 Moorlach et al. Concurrence",39,0,1,0,40
1347847,977988,2020-08-30,Assembly,"SB 1386 Moorlach Consent Calendar Second Day Regular Session",75,0,4,0,79
1347860,958819,2020-05-14,Senate,"Do pass as amended, but first amend, and re-refer to the Committee on [Appropriations]",4,0,1,0,5
1347860,964431,2020-06-09,Senate,"Placed on suspense file",7,0,0,0,7
1347860,967507,2020-06-18,Senate,"Do pass",5,2,0,0,7
1347860,969781,2020-06-25,Senate,"Senate 3rd Reading SB1399 Durazo et al",25,11,4,0,40
1347860,974269,2020-07-29,Assembly,"Do pass and be re-referred to the Committee on [Appropriations]",5,1,1,0,7
1347860,976436,2020-08-20,Assembly,"Do pass as amended",12,4,2,0,18
1347864,958784,2020-05-14,Senate,"Do pass, but first be re-referred to the Committee on [Appropriations]",9,0,4,0,13
1347864,964352,2020-06-09,Senate,"Placed on suspense file",7,0,0,0,7
1347864,967495,2020-06-18,Senate,"Do pass",5,1,1,0,7
1347864,968066,2020-06-22,Senate,"Senate 3rd Reading SB1403 Hueso",30,4,6,0,40
1347870,959974,2020-05-21,Senate,"Do pass as amended, but first amend, and re-refer to the Committee on [Appropriations]",6,0,1,0,7
1347870,964336,2020-06-09,Senate,"Placed on suspense file",7,0,0,0,7
1347870,967433,2020-06-18,Senate,"Do pass",7,0,0,0,7
1347870,969425,2020-06-26,Senate,"Senate 3rd Reading SB1409 Caballero",36,0,4,0,40
1347870,974195,2020-07-27,Assembly,"Do pass as amended and be re-referred to the Committee on [Appropriations]",8,0,2,0,10
1347870,976463,2020-08-20,Assembly,"Do pass",14,0,4,0,18
1347870,976931,2020-08-26,Assembly,"SB 1409 Caballero Senate Third Reading By RUBIO",66,0,13,0,79
1347870,977916,2020-08-30,Senate,"Unfinished Business SB1409 Caballero Concurrence",38,0,2,0,40
1347871,960899,2020-05-27,Senate,"Do pass, but first be re-referred to the Committee on [Appropriations]",10,0,1,0,11
1347871,964324,2020-06-09,Senate,"Placed on suspense file",7,0,0,0,7
1347871,968048,2020-06-22,Senate,"Do pass, but first be re-referred to the Committee on [Appropriations]",5,0,2,0,7
1347871,968314,2020-06-23,Senate,"Do pass",5,2,0,0,7
1347871,969398,2020-06-26,Senate,"Senate 3rd Reading SB1410 Caballero et al",28,9,3,0,40
1347871,975661,2020-08-12,Assembly,"Do pass and be re-referred to the Committee on [Appropriations]",7,3,1,0,11
1347892,959952,2020-05-21,Senate,"Do pass, but first be re-referred to the Committee on [Appropriations]",4,3,0,0,7
1347892,964393,2020-06-09,Senate,"Placed on suspense file",7,0,0,0,7
1347902,958133,2020-05-11,Senate,"Do pass, but first be re-referred to the Committee on [Appropriations]",7,0,0,0,7
1347902,965686,2020-06-11,Senate,"Senate 3rd Reading SB1441 McGuire",39,0,1,0,40
1347902,974193,2020-07-27,Assembly,"Do pass and be re-referred to the Committee on [Appropriations] with recommendation: To Consent Calendar",9,0,1,0,10
1347902,976492,2020-08-20,Assembly,"Do pass",18,0,0,0,18
1347902,977899,2020-08-30,Assembly,"SB 1441 McGuire Senate Third Reading By Burke",73,1,5,0,79
1347902,977900,2020-08-31,Senate,"Unfinished Business SB1441 McGuire Concurrence",39,0,1,0,40
1347908,959476,2020-05-19,Senate,"Do pass",7,0,0,0,7
1347908,965613,2020-06-11,Senate,"Special Consent SB1447",39,0,1,0,40
1347908,975648,2020-08-12,Assembly,"Do pass. To Consent Calendar",11,0,0,0,11
1347908,977455,2020-08-30,Assembly,"Do pass",10,1,0,0,11
1347908,977869,2020-08-31,Senate,"Unfinished Business SB1447 Bradford et al. Concurrence",36,0,4,0,40
1347908,977870,2020-08-31,Assembly,"SB 1447 Bradford Senate Third Reading By Cervantes",76,0,3,0,79
1347909,960426,2020-05-26,Senate,"Do pass as amended, but first amend, and re-refer to the Committee on [Appropriations]",12,0,1,0,13
1347909,965677,2020-06-11,Senate,"Senate 3rd Reading SB1448 Bradford",39,0,1,0,40
1347918,958307,2020-05-12,Senate,"Do pass, but first be re-referred to the Committee on [Appropriations]",14,0,2,0,16
1347918,964351,2020-06-09,Senate,"Placed on suspense file",7,0,0,0,7
1347918,967420,2020-06-18,Senate,"Do pass as amended",7,0,0,0,7
1347918,968701,2020-06-24,Senate,"Special Consent SB1457",39,0,1,0,40
1347918,974810,2020-08-04,Assembly,"Do pass as amended and be re-referred to the Committee on [Appropriations]",6,0,1,0,7
1347920,961695,2020-05-29,Senate,"Do pass and be ordered to the Consent Calendar",13,0,2,0,15
1347920,965621,2020-06-11,Senate,"Consent Calendar SB1459 Caballero Urgency Clause",39,0,1,0,40
1347920,975382,2020-08-10,Assembly,"Do pass and be re-referred to the Committee on [Appropriations] with recommendation: To Consent Calendar",15,0,0,0,15
1347920,976307,2020-08-20,Assembly,"Do pass",18,0,0,0,18
1347920,976924,2020-08-26,Assembly,"SB 1459 Caballero Senate Third Reading By Gipson",73,0,6,0,79
1347920,977975,2020-08-30,Senate,"Unfinished Business SB1459 Caballero Concurrence Special Consent",39,0,1,0,40
1348808,940144,2020-03-02,Assembly,"Be adopted. To third reading",10,0,2,0,12
1349952,938010,2020-02-27,Assembly,"Be adopted. To third reading",10,0,2,0,12
1349952,967511,2020-06-18,Senate,"Special Consent ACR178 Blanca Rubio et al",40,0,0,0,40
1349953,944384,2020-03-05,Assembly,"Be adopted. To third reading",10,0,2,0,12
1349954,965685,2020-06-11,Senate,"Special Consent SR79",39,0,1,0,40
1351645,944402,2020-03-05,Assembly,"Be adopted. To Consent Calendar",10,0,2,0,12
1351645,950994,2020-03-12,Assembly,"HR 86 Eggman Consent Calendar Second Day Regular Session",71,0,9,0,80
1351649,959480,2020-05-19,Senate,"Be adopted and be ordered to the Consent Calendar",7,0,2,0,9
1351649,965697,2020-06-11,Senate,"Consent Calendar SJR14",39,0,1,0,40
1351650,938025,2020-02-27,Senate,"Senate 3rd Reading SR80 Atkins",31,0,8,0,39
1354570,944415,2020-03-05,Assembly,"Be adopted. To Consent Calendar",10,0,2,0,12
1354570,950967,2020-03-12,Assembly,"ACR 181 Reyes Consent Calendar Second Day",71,0,9,0,80
1354572,950977,2020-03-12,Assembly,"Be adopted. To Consent Calendar",10,0,2,0,12
1354572,960459,2020-05-26,Assembly,"HR 88 Flora Consent Calendar Second Day Regular Session",75,0,4,0,79
1356017,950974,2020-03-12,Assembly,"Be adopted. To third reading",10,0,2,0,12
1356018,951003,2020-03-12,Assembly,"Be adopted. To third reading",10,0,2,0,12
1356018,978184,2020-08-30,Assembly,"ACR 183 Mullin Consent Calendar Second Day",75,0,4,0,79
1356019,950989,2020-03-12,Assembly,"Be adopted. To third reading",10,0,2,0,12
1356019,978301,2020-08-30,Assembly,"HR 89 Eggman Consent Calendar Second Day Regular Session",75,0,4,0,79
1356020,965673,2020-06-11,Senate,"Special Consent SCR88",39,0,1,0,40
1356706,958134,2020-05-11,Assembly,"Do pass as amended and be re-referred to the Committee on [Appropriations]",11,0,0,0,11
1356706,962396,2020-06-02,Assembly,"Do pass. To Consent Calendar",18,0,0,0,18
1356706,963611,2020-06-08,Assembly,"AB 3362 JUD. Consent Calendar Second Day Regular Session",76,0,3,0,79
1356706,975835,2020-08-13,Senate,"Do pass, but first be re-referred to the Committee on [Appropriations] with the recommendation: To Consent Calendar",9,0,0,0,9
1356706,977364,2020-08-28,Senate,"Consent Calendar AB3362 JUD",39,0,1,0,40
1356706,978197,2020-08-30,Assembly,"AB 3362 JUD. Concurrence in Senate Amendments By STONE",75,0,4,0,79
1356707,958135,2020-05-11,Assembly,"Do pass and be re-referred to the Committee on [Appropriations] with recommendation: To Consent Calendar",10,0,1,0,11
1356707,962392,2020-06-02,Assembly,"Do pass. To Consent Calendar",18,0,0,0,18
1356707,963504,2020-06-08,Assembly,"AB 3363 JUD. Consent Calendar Second Day Regular Session",76,0,3,0,79
1356708,958129,2020-05-11,Assembly,"Do pass and be re-referred to the Committee on [Appropriations] with recommendation: To Consent Calendar",10,0,1,0,11
1356708,962418,2020-06-02,Assembly,"Do pass. To Consent Calendar",18,0,0,0,18
1356708,963597,2020-06-08,Assembly,"AB 3364 JUD. Consent Calendar Second Day Regular Session",76,0,3,0,79
1356708,975802,2020-08-13,Senate,"Do pass, but first be re-referred to the Committee on [Appropriations] with the recommendation: To Consent Calendar",9,0,0,0,9
1356708,976152,2020-08-19,Senate,"Placed on suspense file",7,0,0,0,7
1356708,976489,2020-08-20,Senate,"Do pass as amended",7,0,0,0,7
1356708,978107,2020-08-30,Senate,"Assembly 3rd Reading AB3364 JUD. (Stone) By Jackson",39,0,1,0,40
1356708,978108,2020-08-31,Assembly,"AB 3364 JUD. Concurrence in Senate Amendments By STONE",75,1,3,0,79
1356709,958125,2020-05-11,Assembly,"Do pass and be re-referred to the Committee on [Appropriations] with recommendation: To Consent Calendar",10,0,1,0,11
1356709,962372,2020-06-02,Assembly,"Do pass. To Consent Calendar",18,0,0,0,18
1356709,963497,2020-06-08,Assembly,"AB 3365 JUD. Consent Calendar Second Day Regular Session",76,0,3,0,79
1356710,960900,2020-05-27,Assembly,"Do pass as amended",8,0,3,0,11
1356710,962394,2020-06-02,Assembly,"Do pass",13,0,5,0,18
1356710,966472,2020-06-15,Assembly,"AB 3366 JUD. Third Reading Urgency By STONE",62,2,15,0,79
1356710,974477,2020-07-30,Senate,"Do pass, but first be re-referred to the Committee on [Appropriations]",7,0,2,0,9
1356710,977361,2020-08-28,Senate,"Assembly 3rd Reading AB3366 JUD. (Stone) By Jackson Urgency Clause",30,2,8,0,40
1356712,958323,2020-05-12,Assembly,"Do pass as amended and be re-referred to the Committee on [Appropriations]",7,0,0,0,7
1356714,959482,2020-05-19,Senate,"Do pass, but first be re-referred to the Committee on [Appropriations]",7,0,2,0,9
1356714,968054,2020-06-22,Senate,"Senate 3rd Reading SB1472 N.R. & W. (Stern)",40,0,0,0,40
1356714,974946,2020-08-06,Assembly,"Do pass and be re-referred to the Committee on [Appropriations] with recommendation: To Consent Calendar",9,0,2,0,11
1356714,976094,2020-08-18,Assembly,"Do pass. To Consent Calendar",18,0,0,0,18
1356714,977973,2020-08-30,Senate,"Unfinished Business SB1472 N.R. & W. (Stern) Concurrence",39,0,1,0,40
1356714,977974,2020-08-30,Assembly,"SB 1472 N.R. & W. Consent Calendar Second Day Regular Session",75,0,4,0,79
1358011,959751,2020-05-20,Assembly,"Do pass and be re-referred to the Committee on [Appropriations] with recommendation: To Consent Calendar",7,0,0,0,7
1358011,962399,2020-06-02,Assembly,"Do pass. To Consent Calendar",18,0,0,0,18
1358011,963505,2020-06-08,Assembly,"AB 3369 A.,E.,S.,T., & I.M. Consent Calendar Second Day Regular Session",76,0,3,0,79
1358011,975536,2020-08-11,Senate,"Do pass, but first be re-referred to the Committee on [Appropriations] with the recommendation: To Consent Calendar",5,0,0,0,5
1358011,977772,2020-08-30,Senate,"Assembly 3rd Reading AB3369 A.,E.,S.,T., & I.M. (Chu) By Pan Urgency Clause",39,0,1,0,40
1358011,977773,2020-08-31,Assembly,"AB 3369 A.,E.,S.,T., & I.M. Concurrence - Urgency Added By CHU",76,0,3,0,79
1358564,950971,2020-03-12,Assembly,"Be adopted. To third reading",10,0,2,0,12
1358564,978212,2020-08-30,Assembly,"ACR 187 Boerner Horvath Consent Calendar Second Day Regular Session",75,0,4,0,79
1358565,965560,2020-06-11,Senate,"Special Consent SR81",39,0,1,0,40
1359157,958530,2020-05-13,Assembly,"Do pass. To Consent Calendar",7,0,0,0,7
1359157,960464,2020-05-26,Assembly,"AB 3370 E. & R. Consent Calendar Second Day Regular Session",75,0,4,0,79
1359157,974834,2020-08-04,Senate,"Do pass and be ordered to the Consent Calendar",5,0,0,0,5
1359157,977365,2020-08-28,Senate,"Consent Calendar AB3370 E. & R",39,0,1,0,40
1359157,978038,2020-08-30,Assembly,"AB 3370 E. & R. Concurrence in Senate Amendments By BERMAN",75,0,4,0,79
1359159,965610,2020-06-11,Senate,"Special Consent SR82",39,0,1,0,40
1359628,957593,2020-05-06,Assembly,"Do pass and be re-referred to the Committee on [Appropriations]",11,0,0,0,11
1359628,962370,2020-06-02,Assembly,"Do pass. To Consent Calendar",18,0,0,0,18
1359628,963590,2020-06-08,Assembly,"AB 3371 V. A. Consent Calendar Second Day Regular Session",76,0,3,0,79
1359628,975317,2020-08-10,Senate,"Do pass, but first be re-referred to the Committee on [Appropriations]",5,0,2,0,7
1359628,977176,2020-08-27,Senate,"Assembly 3rd Reading AB3371 V.A. (Irwin) By Hurtado",30,0,10,0,40
1359632,959975,2020-05-21,Senate,"Do pass, but first be re-referred to the Committee on [Appropriations] with the recommendation: To Consent Calendar",7,0,0,0,7
1359632,965675,2020-06-11,Senate,"Consent Calendar SB1473 GOV. & F",39,0,1,0,40
1359632,975548,2020-08-11,Assembly,"Do pass and be re-referred to the Committee on [Appropriations] with recommendation: To Consent Calendar",8,0,0,0,8
1359632,976071,2020-08-18,Assembly,"Do pass as amended. To Consent Calendar",18,0,0,0,18
1359632,977935,2020-08-31,Senate,"Unfinished Business SB1473 GOV. & F. (McGuire) Concurrence",39,0,1,0,40
1359632,977936,2020-08-31,Assembly,"SB 1473 GOV.& F. Senate Third Reading By AGUIAR-CURRY",76,0,3,0,79
1360387,959305,2020-05-18,Assembly,"Do pass and be re-referred to the Committee on [Appropriations] with recommendation: To Consent Calendar",11,0,0,0,11
1360387,962360,2020-06-02,Assembly,"Do pass. To Consent Calendar",18,0,0,0,18
1360387,963568,2020-06-08,Assembly,"AB 3372 REV. & TAX. Consent Calendar Second Day Regular Session",76,0,3,0,79
1360387,974275,2020-07-29,Senate,"Do pass, but first be re-referred to the Committee on [Appropriations] with the recommendation: To Consent Calendar",7,0,0,0,7
1360387,977379,2020-08-28,Senate,"Consent Calendar AB3372 REV. & TAX",39,0,1,0,40
1360387,978116,2020-08-30,Assembly,"AB 3372 REV. & TAX. Concurrence in Senate Amendments By BURKE",75,0,4,0,79
1360388,959297,2020-05-18,Assembly,"Do pass. To Consent Calendar",11,0,0,0,11
1360388,960445,2020-05-26,Assembly,"AB 3373 REV. & TAX. Consent Calendar Second Day Regular Session",75,0,4,0,79
1360388,974289,2020-07-29,Senate,"Do pass and be ordered to the Consent Calendar",7,0,0,0,7
1360388,977324,2020-08-28,Senate,"Consent Calendar AB3373 REV. & TAX",39,0,1,0,40
1360389,958560,2020-05-13,Assembly,"Do pass and be re-referred to the Committee on [Appropriations]",10,0,2,0,12
1360389,962409,2020-06-02,Assembly,"Do pass. To Consent Calendar",18,0,0,0,18
1360389,963581,2020-06-08,Assembly,"AB 3374 HIGHER ED. Consent Calendar Second Day Regular Session",76,0,3,0,79
1360389,974279,2020-07-29,Senate,"Do pass, but first be re-referred to the Committee on [Appropriations] with the recommendation: To Consent Calendar",7,0,0,0,7
1360389,977400,2020-08-28,Senate,"Consent Calendar AB3374 HIGHER ED",39,0,1,0,40
1360390,952438,2020-03-16,Senate,"W/O REF. TO FILE ACR189 Rendon",32,0,7,0,39
1360390,952439,2020-03-16,Assembly,"ACR 189 RENDON Assembly Third Reading",68,0,12,0,80
1360393,959328,2020-05-18,Senate,"Do pass, but first be re-referred to the Committee on [Appropriations]",9,0,0,0,9
1360393,964436,2020-06-09,Senate,"Placed on suspense file",7,0,0,0,7
1360393,967376,2020-06-18,Senate,"Do pass as amended",7,0,0,0,7
1360393,968699,2020-06-24,Senate,"Special Consent SB1474 B.P.&E.D",39,0,1,0,40
1360393,975329,2020-08-10,Assembly,"Do pass and be re-referred to the Committee on [Appropriations] with recommendation: To Consent Calendar",19,0,0,0,19
1360393,975520,2020-08-10,Assembly,"Do pass and be re-referred to the Committee on [Appropriations]",19,0,0,0,19
1360393,976087,2020-08-10,Assembly,"Do pass as amended, and be re-referred to the Committee on [Appropriations] with recommendation: To Consent Calendar",19,0,0,0,19
1360393,976402,2020-08-20,Assembly,"Do pass as amended",18,0,0,0,18
1360393,977871,2020-08-30,Assembly,"SB 1474 B., P. & E.D. Senate Third Reading By LOW",75,0,4,0,79
1360393,977872,2020-08-31,Senate,"Unfinished Business SB1474 B.P.&E.D. (Glazer) Concurrence",39,0,1,0,40
1366781,962862,2020-06-03,Assembly,"Be adopted as amended",10,0,2,0,12
1366781,965045,2020-06-10,Assembly,"ACA 25 Mullin Assembly Third Reading",60,13,6,0,79
1367729,967399,2020-06-18,Assembly,"Be adopted. To Consent Calendar",9,0,3,0,12
1367729,974744,2020-08-03,Assembly,"HR 96 Boerner Horvath Consent Calendar Second Day",72,0,7,0,79
1368489,974823,2020-08-04,Senate,"Be adopted, but first be re-referred to the Committee on [Appropriations] with recommendation: To Consent Calendar",13,1,1,0,15
1368489,977375,2020-08-28,Senate,"Special Consent SCR89 Dahle et al",38,0,2,0,40
1368489,978298,2020-08-30,Assembly,"SCR 89 Dahle Senate Third Reading By BIGELOW",75,0,4,0,79
1374555,974742,2020-08-03,Assembly,"HR 100 CALDERON Assembly Third Reading",54,15,10,0,79
1376694,976910,2020-08-26,Assembly,"Be adopted. To third reading",8,2,1,0,11
1376914,977191,2020-08-27,Assembly,"HR 105 Jones-Sawyer Assembly Third Reading",60,3,16,0,79
